Area,Year,Month,PeriodType,Period,LaborForce,Employment,Unemployment,UnemploymentRate,SeasonalAdjustment
Adair County,2020,May,3,5,9883,9268,615,6.2,Not seasonally adjusted
Adair County,2020,April,3,4,10047,9338,709,7.1,Not seasonally adjusted
Adair County,2020,March,3,3,10400,9989,411,4,Not seasonally adjusted
Adair County,2020,February,3,2,10246,9866,380,3.7,Not seasonally adjusted
Adair County,2020,January,3,1,10240,9794,446,4.4,Not seasonally adjusted
Adair County,2019,Annual Averages,1,0,10345,9945,400,3.9,Not seasonally adjusted
Adair County,2019,December,3,12,10369,10030,339,3.3,Not seasonally adjusted
Adair County,2019,November,3,11,10433,10105,328,3.1,Not seasonally adjusted
Adair County,2019,October,3,10,10442,10162,280,2.7,Not seasonally adjusted
Adair County,2019,September,3,9,10238,9938,300,2.9,Not seasonally adjusted
Adair County,2019,August,3,8,9932,9486,446,4.5,Not seasonally adjusted
Adair County,2019,July,3,7,10140,9613,527,5.2,Not seasonally adjusted
Adair County,2019,June,3,6,10318,9817,501,4.9,Not seasonally adjusted
Adair County,2019,May,3,5,10483,10067,416,4,Not seasonally adjusted
Adair County,2019,April,3,4,10523,10215,308,2.9,Not seasonally adjusted
Adair County,2019,March,3,3,10437,9964,473,4.5,Not seasonally adjusted
Adair County,2019,February,3,2,10422,10000,422,4,Not seasonally adjusted
Adair County,2019,January,3,1,10399,9939,460,4.4,Not seasonally adjusted
Andrew County,2020,May,3,5,9404,8905,499,5.3,Not seasonally adjusted
Andrew County,2020,April,3,4,9482,8907,575,6.1,Not seasonally adjusted
Andrew County,2020,March,3,3,9865,9538,327,3.3,Not seasonally adjusted
Andrew County,2020,February,3,2,9778,9452,326,3.3,Not seasonally adjusted
Andrew County,2020,January,3,1,9798,9452,346,3.5,Not seasonally adjusted
Andrew County,2019,Annual Averages,1,0,9767,9494,273,2.8,Not seasonally adjusted
Andrew County,2019,December,3,12,9789,9528,261,2.7,Not seasonally adjusted
Andrew County,2019,November,3,11,9764,9540,224,2.3,Not seasonally adjusted
Andrew County,2019,October,3,10,9843,9629,214,2.2,Not seasonally adjusted
Andrew County,2019,September,3,9,9679,9484,195,2,Not seasonally adjusted
Andrew County,2019,August,3,8,9686,9426,260,2.7,Not seasonally adjusted
Andrew County,2019,July,3,7,9941,9614,327,3.3,Not seasonally adjusted
Andrew County,2019,June,3,6,9845,9541,304,3.1,Not seasonally adjusted
Andrew County,2019,May,3,5,9707,9460,247,2.5,Not seasonally adjusted
Andrew County,2019,April,3,4,9753,9512,241,2.5,Not seasonally adjusted
Andrew County,2019,March,3,3,9744,9413,331,3.4,Not seasonally adjusted
Andrew County,2019,February,3,2,9760,9416,344,3.5,Not seasonally adjusted
Andrew County,2019,January,3,1,9691,9366,325,3.4,Not seasonally adjusted
Atchison County,2020,May,3,5,2750,2606,144,5.2,Not seasonally adjusted
Atchison County,2020,April,3,4,2850,2683,167,5.9,Not seasonally adjusted
Atchison County,2020,March,3,3,2769,2681,88,3.2,Not seasonally adjusted
Atchison County,2020,February,3,2,2716,2628,88,3.2,Not seasonally adjusted
Atchison County,2020,January,3,1,2710,2610,100,3.7,Not seasonally adjusted
Atchison County,2019,Annual Averages,1,0,2703,2603,100,3.7,Not seasonally adjusted
Atchison County,2019,December,3,12,2662,2573,89,3.3,Not seasonally adjusted
Atchison County,2019,November,3,11,2677,2596,81,3,Not seasonally adjusted
Atchison County,2019,October,3,10,2784,2712,72,2.6,Not seasonally adjusted
Atchison County,2019,September,3,9,2603,2539,64,2.5,Not seasonally adjusted
Atchison County,2019,August,3,8,2515,2408,107,4.3,Not seasonally adjusted
Atchison County,2019,July,3,7,2623,2469,154,5.9,Not seasonally adjusted
Atchison County,2019,June,3,6,2686,2546,140,5.2,Not seasonally adjusted
Atchison County,2019,May,3,5,2802,2698,104,3.7,Not seasonally adjusted
Atchison County,2019,April,3,4,2836,2727,109,3.8,Not seasonally adjusted
Atchison County,2019,March,3,3,2764,2670,94,3.4,Not seasonally adjusted
Atchison County,2019,February,3,2,2747,2652,95,3.5,Not seasonally adjusted
Atchison County,2019,January,3,1,2739,2646,93,3.4,Not seasonally adjusted
Audrain County,2020,May,3,5,10746,9634,1112,10.3,Not seasonally adjusted
Audrain County,2020,April,3,4,10904,9782,1122,10.3,Not seasonally adjusted
Audrain County,2020,March,3,3,10844,10444,400,3.7,Not seasonally adjusted
Audrain County,2020,February,3,2,10737,10308,429,4,Not seasonally adjusted
Audrain County,2020,January,3,1,10759,10308,451,4.2,Not seasonally adjusted
Audrain County,2019,Annual Averages,1,0,10697,10337,360,3.4,Not seasonally adjusted
Audrain County,2019,December,3,12,10678,10333,345,3.2,Not seasonally adjusted
Audrain County,2019,November,3,11,10678,10351,327,3.1,Not seasonally adjusted
Audrain County,2019,October,3,10,10759,10476,283,2.6,Not seasonally adjusted
Audrain County,2019,September,3,9,10529,10253,276,2.6,Not seasonally adjusted
Audrain County,2019,August,3,8,10344,9987,357,3.5,Not seasonally adjusted
Audrain County,2019,July,3,7,10659,10239,420,3.9,Not seasonally adjusted
Audrain County,2019,June,3,6,10711,10319,392,3.7,Not seasonally adjusted
Audrain County,2019,May,3,5,10841,10481,360,3.3,Not seasonally adjusted
Audrain County,2019,April,3,4,10811,10535,276,2.6,Not seasonally adjusted
Audrain County,2019,March,3,3,10794,10389,405,3.8,Not seasonally adjusted
Audrain County,2019,February,3,2,10793,10359,434,4,Not seasonally adjusted
Audrain County,2019,January,3,1,10773,10327,446,4.1,Not seasonally adjusted
Barry County,2020,May,3,5,15945,14349,1596,10,Not seasonally adjusted
Barry County,2020,April,3,4,15966,14547,1419,8.9,Not seasonally adjusted
Barry County,2020,March,3,3,16255,15401,854,5.3,Not seasonally adjusted
Barry County,2020,February,3,2,15829,15150,679,4.3,Not seasonally adjusted
Barry County,2020,January,3,1,15864,15056,808,5.1,Not seasonally adjusted
Barry County,2019,Annual Averages,1,0,15589,15044,545,3.5,Not seasonally adjusted
Barry County,2019,December,3,12,15483,14889,594,3.8,Not seasonally adjusted
Barry County,2019,November,3,11,15536,14984,552,3.6,Not seasonally adjusted
Barry County,2019,October,3,10,15719,15255,464,3,Not seasonally adjusted
Barry County,2019,September,3,9,15405,14958,447,2.9,Not seasonally adjusted
Barry County,2019,August,3,8,14912,14361,551,3.7,Not seasonally adjusted
Barry County,2019,July,3,7,15378,14804,574,3.7,Not seasonally adjusted
Barry County,2019,June,3,6,15557,15071,486,3.1,Not seasonally adjusted
Barry County,2019,May,3,5,15730,15283,447,2.8,Not seasonally adjusted
Barry County,2019,April,3,4,15798,15366,432,2.7,Not seasonally adjusted
Barry County,2019,March,3,3,15828,15138,690,4.4,Not seasonally adjusted
Barry County,2019,February,3,2,15938,15260,678,4.3,Not seasonally adjusted
Barry County,2019,January,3,1,15783,15161,622,3.9,Not seasonally adjusted
Barton County,2020,May,3,5,5169,4813,356,6.9,Not seasonally adjusted
Barton County,2020,April,3,4,5327,4875,452,8.5,Not seasonally adjusted
Barton County,2020,March,3,3,5308,5102,206,3.9,Not seasonally adjusted
Barton County,2020,February,3,2,5273,5100,173,3.3,Not seasonally adjusted
Barton County,2020,January,3,1,5335,5126,209,3.9,Not seasonally adjusted
Barton County,2019,Annual Averages,1,0,5202,5026,176,3.4,Not seasonally adjusted
Barton County,2019,December,3,12,5192,5013,179,3.4,Not seasonally adjusted
Barton County,2019,November,3,11,5193,5031,162,3.1,Not seasonally adjusted
Barton County,2019,October,3,10,5301,5167,134,2.5,Not seasonally adjusted
Barton County,2019,September,3,9,5127,4995,132,2.6,Not seasonally adjusted
Barton County,2019,August,3,8,5004,4810,194,3.9,Not seasonally adjusted
Barton County,2019,July,3,7,5084,4848,236,4.6,Not seasonally adjusted
Barton County,2019,June,3,6,5206,4996,210,4,Not seasonally adjusted
Barton County,2019,May,3,5,5332,5151,181,3.4,Not seasonally adjusted
Barton County,2019,April,3,4,5297,5156,141,2.7,Not seasonally adjusted
Barton County,2019,March,3,3,5198,5001,197,3.8,Not seasonally adjusted
Barton County,2019,February,3,2,5216,5042,174,3.3,Not seasonally adjusted
Barton County,2019,January,3,1,5273,5099,174,3.3,Not seasonally adjusted
Bates County,2020,May,3,5,7497,7005,492,6.6,Not seasonally adjusted
Bates County,2020,April,3,4,7573,7061,512,6.8,Not seasonally adjusted
Bates County,2020,March,3,3,8028,7650,378,4.7,Not seasonally adjusted
Bates County,2020,February,3,2,8009,7655,354,4.4,Not seasonally adjusted
Bates County,2020,January,3,1,7990,7605,385,4.8,Not seasonally adjusted
Bates County,2019,Annual Averages,1,0,7908,7590,318,4,Not seasonally adjusted
Bates County,2019,December,3,12,7893,7595,298,3.8,Not seasonally adjusted
Bates County,2019,November,3,11,7887,7630,257,3.3,Not seasonally adjusted
Bates County,2019,October,3,10,7989,7758,231,2.9,Not seasonally adjusted
Bates County,2019,September,3,9,7813,7562,251,3.2,Not seasonally adjusted
Bates County,2019,August,3,8,7868,7529,339,4.3,Not seasonally adjusted
Bates County,2019,July,3,7,7991,7608,383,4.8,Not seasonally adjusted
Bates County,2019,June,3,6,7917,7564,353,4.5,Not seasonally adjusted
Bates County,2019,May,3,5,7902,7623,279,3.5,Not seasonally adjusted
Bates County,2019,April,3,4,7918,7653,265,3.3,Not seasonally adjusted
Bates County,2019,March,3,3,7907,7526,381,4.8,Not seasonally adjusted
Bates County,2019,February,3,2,7915,7517,398,5,Not seasonally adjusted
Bates County,2019,January,3,1,7903,7517,386,4.9,Not seasonally adjusted
Benton County,2020,May,3,5,7175,6450,725,10.1,Not seasonally adjusted
Benton County,2020,April,3,4,7184,6486,698,9.7,Not seasonally adjusted
Benton County,2020,March,3,3,7371,6944,427,5.8,Not seasonally adjusted
Benton County,2020,February,3,2,7290,6827,463,6.4,Not seasonally adjusted
Benton County,2020,January,3,1,7253,6818,435,6,Not seasonally adjusted
Benton County,2019,Annual Averages,1,0,7201,6855,346,4.8,Not seasonally adjusted
Benton County,2019,December,3,12,7185,6838,347,4.8,Not seasonally adjusted
Benton County,2019,November,3,11,7210,6878,332,4.6,Not seasonally adjusted
Benton County,2019,October,3,10,7251,6992,259,3.6,Not seasonally adjusted
Benton County,2019,September,3,9,7226,6867,359,5,Not seasonally adjusted
Benton County,2019,August,3,8,6960,6643,317,4.6,Not seasonally adjusted
Benton County,2019,July,3,7,6935,6578,357,5.1,Not seasonally adjusted
Benton County,2019,June,3,6,7306,6958,348,4.8,Not seasonally adjusted
Benton County,2019,May,3,5,7298,7001,297,4.1,Not seasonally adjusted
Benton County,2019,April,3,4,7294,7015,279,3.8,Not seasonally adjusted
Benton County,2019,March,3,3,7318,6898,420,5.7,Not seasonally adjusted
Benton County,2019,February,3,2,7237,6819,418,5.8,Not seasonally adjusted
Benton County,2019,January,3,1,7199,6775,424,5.9,Not seasonally adjusted
Bollinger County,2020,May,3,5,5125,4696,429,8.4,Not seasonally adjusted
Bollinger County,2020,April,3,4,5393,4876,517,9.6,Not seasonally adjusted
Bollinger County,2020,March,3,3,5576,5339,237,4.3,Not seasonally adjusted
Bollinger County,2020,February,3,2,5580,5342,238,4.3,Not seasonally adjusted
Bollinger County,2020,January,3,1,5592,5318,274,4.9,Not seasonally adjusted
Bollinger County,2019,Annual Averages,1,0,5484,5270,214,3.9,Not seasonally adjusted
Bollinger County,2019,December,3,12,5531,5317,214,3.9,Not seasonally adjusted
Bollinger County,2019,November,3,11,5525,5311,214,3.9,Not seasonally adjusted
Bollinger County,2019,October,3,10,5549,5380,169,3,Not seasonally adjusted
Bollinger County,2019,September,3,9,5409,5247,162,3,Not seasonally adjusted
Bollinger County,2019,August,3,8,5395,5167,228,4.2,Not seasonally adjusted
Bollinger County,2019,July,3,7,5370,5134,236,4.4,Not seasonally adjusted
Bollinger County,2019,June,3,6,5501,5254,247,4.5,Not seasonally adjusted
Bollinger County,2019,May,3,5,5511,5316,195,3.5,Not seasonally adjusted
Bollinger County,2019,April,3,4,5493,5324,169,3.1,Not seasonally adjusted
Bollinger County,2019,March,3,3,5497,5263,234,4.3,Not seasonally adjusted
Bollinger County,2019,February,3,2,5530,5273,257,4.6,Not seasonally adjusted
Bollinger County,2019,January,3,1,5496,5259,237,4.3,Not seasonally adjusted
Boone County,2020,May,3,5,93649,87474,6175,6.6,Not seasonally adjusted
Boone County,2020,April,3,4,96279,90019,6260,6.5,Not seasonally adjusted
Boone County,2020,March,3,3,100786,98180,2606,2.6,Not seasonally adjusted
Boone County,2020,February,3,2,99179,96662,2517,2.5,Not seasonally adjusted
Boone County,2020,January,3,1,97338,94248,3090,3.2,Not seasonally adjusted
Boone County,2019,Annual Averages,1,0,98300,95937,2363,2.4,Not seasonally adjusted
Boone County,2019,December,3,12,99481,97069,2412,2.4,Not seasonally adjusted
Boone County,2019,November,3,11,99976,97734,2242,2.2,Not seasonally adjusted
Boone County,2019,October,3,10,99703,97819,1884,1.9,Not seasonally adjusted
Boone County,2019,September,3,9,99063,97222,1841,1.9,Not seasonally adjusted
Boone County,2019,August,3,8,96631,94045,2586,2.7,Not seasonally adjusted
Boone County,2019,July,3,7,97250,94392,2858,2.9,Not seasonally adjusted
Boone County,2019,June,3,6,96112,93576,2536,2.6,Not seasonally adjusted
Boone County,2019,May,3,5,98620,96399,2221,2.3,Not seasonally adjusted
Boone County,2019,April,3,4,98838,96946,1892,1.9,Not seasonally adjusted
Boone County,2019,March,3,3,99258,96638,2620,2.6,Not seasonally adjusted
Boone County,2019,February,3,2,98958,96373,2585,2.6,Not seasonally adjusted
Boone County,2019,January,3,1,95710,93026,2684,2.8,Not seasonally adjusted
Buchanan County,2020,May,3,5,43284,40326,2958,6.8,Not seasonally adjusted
Buchanan County,2020,April,3,4,43384,40220,3164,7.3,Not seasonally adjusted
Buchanan County,2020,March,3,3,45170,43501,1669,3.7,Not seasonally adjusted
Buchanan County,2020,February,3,2,44526,42935,1591,3.6,Not seasonally adjusted
Buchanan County,2020,January,3,1,44618,42874,1744,3.9,Not seasonally adjusted
Buchanan County,2019,Annual Averages,1,0,44669,43301,1368,3.1,Not seasonally adjusted
Buchanan County,2019,December,3,12,44825,43455,1370,3.1,Not seasonally adjusted
Buchanan County,2019,November,3,11,44757,43534,1223,2.7,Not seasonally adjusted
Buchanan County,2019,October,3,10,44832,43685,1147,2.6,Not seasonally adjusted
Buchanan County,2019,September,3,9,44469,43410,1059,2.4,Not seasonally adjusted
Buchanan County,2019,August,3,8,44537,43114,1423,3.2,Not seasonally adjusted
Buchanan County,2019,July,3,7,45581,43984,1597,3.5,Not seasonally adjusted
Buchanan County,2019,June,3,6,45171,43764,1407,3.1,Not seasonally adjusted
Buchanan County,2019,May,3,5,44268,43035,1233,2.8,Not seasonally adjusted
Buchanan County,2019,April,3,4,44419,43229,1190,2.7,Not seasonally adjusted
Buchanan County,2019,March,3,3,44464,42881,1583,3.6,Not seasonally adjusted
Buchanan County,2019,February,3,2,44508,42926,1582,3.6,Not seasonally adjusted
Buchanan County,2019,January,3,1,44190,42589,1601,3.6,Not seasonally adjusted
Butler County,2020,May,3,5,17890,16103,1787,10,Not seasonally adjusted
Butler County,2020,April,3,4,18110,16149,1961,10.8,Not seasonally adjusted
Butler County,2020,March,3,3,18699,17755,944,5,Not seasonally adjusted
Butler County,2020,February,3,2,18123,17296,827,4.6,Not seasonally adjusted
Butler County,2020,January,3,1,18095,17170,925,5.1,Not seasonally adjusted
Butler County,2019,Annual Averages,1,0,17986,17140,846,4.7,Not seasonally adjusted
Butler County,2019,December,3,12,18276,17416,860,4.7,Not seasonally adjusted
Butler County,2019,November,3,11,18002,17313,689,3.8,Not seasonally adjusted
Butler County,2019,October,3,10,17978,17377,601,3.3,Not seasonally adjusted
Butler County,2019,September,3,9,17983,17383,600,3.3,Not seasonally adjusted
Butler County,2019,August,3,8,17771,16935,836,4.7,Not seasonally adjusted
Butler County,2019,July,3,7,17821,16928,893,5,Not seasonally adjusted
Butler County,2019,June,3,6,18287,17105,1182,6.5,Not seasonally adjusted
Butler County,2019,May,3,5,18149,17187,962,5.3,Not seasonally adjusted
Butler County,2019,April,3,4,18029,17095,934,5.2,Not seasonally adjusted
Butler County,2019,March,3,3,17965,17076,889,4.9,Not seasonally adjusted
Butler County,2019,February,3,2,17843,17011,832,4.7,Not seasonally adjusted
Butler County,2019,January,3,1,17731,16855,876,4.9,Not seasonally adjusted
Caldwell County,2020,May,3,5,4316,3925,391,9.1,Not seasonally adjusted
Caldwell County,2020,April,3,4,4374,3963,411,9.4,Not seasonally adjusted
Caldwell County,2020,March,3,3,4452,4266,186,4.2,Not seasonally adjusted
Caldwell County,2020,February,3,2,4442,4271,171,3.8,Not seasonally adjusted
Caldwell County,2020,January,3,1,4416,4243,173,3.9,Not seasonally adjusted
Caldwell County,2019,Annual Averages,1,0,4369,4230,139,3.2,Not seasonally adjusted
Caldwell County,2019,December,3,12,4368,4228,140,3.2,Not seasonally adjusted
Caldwell County,2019,November,3,11,4381,4249,132,3,Not seasonally adjusted
Caldwell County,2019,October,3,10,4436,4332,104,2.3,Not seasonally adjusted
Caldwell County,2019,September,3,9,4304,4206,98,2.3,Not seasonally adjusted
Caldwell County,2019,August,3,8,4327,4186,141,3.3,Not seasonally adjusted
Caldwell County,2019,July,3,7,4395,4233,162,3.7,Not seasonally adjusted
Caldwell County,2019,June,3,6,4349,4206,143,3.3,Not seasonally adjusted
Caldwell County,2019,May,3,5,4388,4258,130,3,Not seasonally adjusted
Caldwell County,2019,April,3,4,4389,4279,110,2.5,Not seasonally adjusted
Caldwell County,2019,March,3,3,4367,4198,169,3.9,Not seasonally adjusted
Caldwell County,2019,February,3,2,4366,4193,173,4,Not seasonally adjusted
Caldwell County,2019,January,3,1,4354,4194,160,3.7,Not seasonally adjusted
Callaway County,2020,May,3,5,20815,19540,1275,6.1,Not seasonally adjusted
Callaway County,2020,April,3,4,20669,19244,1425,6.9,Not seasonally adjusted
Callaway County,2020,March,3,3,21597,20853,744,3.4,Not seasonally adjusted
Callaway County,2020,February,3,2,21433,20691,742,3.5,Not seasonally adjusted
Callaway County,2020,January,3,1,21452,20634,818,3.8,Not seasonally adjusted
Callaway County,2019,Annual Averages,1,0,21383,20758,625,2.9,Not seasonally adjusted
Callaway County,2019,December,3,12,21220,20573,647,3,Not seasonally adjusted
Callaway County,2019,November,3,11,21355,20778,577,2.7,Not seasonally adjusted
Callaway County,2019,October,3,10,21366,20893,473,2.2,Not seasonally adjusted
Callaway County,2019,September,3,9,21251,20786,465,2.2,Not seasonally adjusted
Callaway County,2019,August,3,8,21541,20827,714,3.3,Not seasonally adjusted
Callaway County,2019,July,3,7,21803,21075,728,3.3,Not seasonally adjusted
Callaway County,2019,June,3,6,21527,20848,679,3.2,Not seasonally adjusted
Callaway County,2019,May,3,5,21366,20788,578,2.7,Not seasonally adjusted
Callaway County,2019,April,3,4,21314,20839,475,2.2,Not seasonally adjusted
Callaway County,2019,March,3,3,21370,20676,694,3.2,Not seasonally adjusted
Callaway County,2019,February,3,2,21289,20553,736,3.5,Not seasonally adjusted
Callaway County,2019,January,3,1,21193,20463,730,3.4,Not seasonally adjusted
Camden County,2020,May,3,5,18237,16355,1882,10.3,Not seasonally adjusted
Camden County,2020,April,3,4,18844,16329,2515,13.3,Not seasonally adjusted
Camden County,2020,March,3,3,18536,17384,1152,6.2,Not seasonally adjusted
Camden County,2020,February,3,2,17790,16561,1229,6.9,Not seasonally adjusted
Camden County,2020,January,3,1,17850,16492,1358,7.6,Not seasonally adjusted
Camden County,2019,Annual Averages,1,0,18861,18013,848,4.5,Not seasonally adjusted
Camden County,2019,December,3,12,18301,17164,1137,6.2,Not seasonally adjusted
Camden County,2019,November,3,11,18275,17406,869,4.8,Not seasonally adjusted
Camden County,2019,October,3,10,18600,17926,674,3.6,Not seasonally adjusted
Camden County,2019,September,3,9,19198,18539,659,3.4,Not seasonally adjusted
Camden County,2019,August,3,8,20003,19238,765,3.8,Not seasonally adjusted
Camden County,2019,July,3,7,20653,19936,717,3.5,Not seasonally adjusted
Camden County,2019,June,3,6,20392,19698,694,3.4,Not seasonally adjusted
Camden County,2019,May,3,5,19104,18396,708,3.7,Not seasonally adjusted
Camden County,2019,April,3,4,18216,17562,654,3.6,Not seasonally adjusted
Camden County,2019,March,3,3,18073,17089,984,5.4,Not seasonally adjusted
Camden County,2019,February,3,2,17822,16678,1144,6.4,Not seasonally adjusted
Camden County,2019,January,3,1,17697,16522,1175,6.6,Not seasonally adjusted
Cape Girardeau County,2020,May,3,5,37830,34471,3359,8.9,Not seasonally adjusted
Cape Girardeau County,2020,April,3,4,39440,35694,3746,9.5,Not seasonally adjusted
Cape Girardeau County,2020,March,3,3,41710,40172,1538,3.7,Not seasonally adjusted
Cape Girardeau County,2020,February,3,2,41330,39999,1331,3.2,Not seasonally adjusted
Cape Girardeau County,2020,January,3,1,41213,39747,1466,3.6,Not seasonally adjusted
Cape Girardeau County,2019,Annual Averages,1,0,40851,39654,1197,2.9,Not seasonally adjusted
Cape Girardeau County,2019,December,3,12,41392,40164,1228,3,Not seasonally adjusted
Cape Girardeau County,2019,November,3,11,41300,40080,1220,3,Not seasonally adjusted
Cape Girardeau County,2019,October,3,10,41182,40133,1049,2.5,Not seasonally adjusted
Cape Girardeau County,2019,September,3,9,40816,39793,1023,2.5,Not seasonally adjusted
Cape Girardeau County,2019,August,3,8,40517,39136,1381,3.4,Not seasonally adjusted
Cape Girardeau County,2019,July,3,7,40166,38781,1385,3.4,Not seasonally adjusted
Cape Girardeau County,2019,June,3,6,41220,39927,1293,3.1,Not seasonally adjusted
Cape Girardeau County,2019,May,3,5,40845,39742,1103,2.7,Not seasonally adjusted
Cape Girardeau County,2019,April,3,4,40558,39623,935,2.3,Not seasonally adjusted
Cape Girardeau County,2019,March,3,3,40745,39485,1260,3.1,Not seasonally adjusted
Cape Girardeau County,2019,February,3,2,40829,39594,1235,3,Not seasonally adjusted
Cape Girardeau County,2019,January,3,1,40638,39386,1252,3.1,Not seasonally adjusted
Carroll County,2020,May,3,5,4637,4341,296,6.4,Not seasonally adjusted
Carroll County,2020,April,3,4,4768,4425,343,7.2,Not seasonally adjusted
Carroll County,2020,March,3,3,4847,4657,190,3.9,Not seasonally adjusted
Carroll County,2020,February,3,2,4897,4724,173,3.5,Not seasonally adjusted
Carroll County,2020,January,3,1,4872,4684,188,3.9,Not seasonally adjusted
Carroll County,2019,Annual Averages,1,0,4808,4653,155,3.2,Not seasonally adjusted
Carroll County,2019,December,3,12,4714,4543,171,3.6,Not seasonally adjusted
Carroll County,2019,November,3,11,4741,4573,168,3.5,Not seasonally adjusted
Carroll County,2019,October,3,10,4842,4699,143,3,Not seasonally adjusted
Carroll County,2019,September,3,9,4624,4512,112,2.4,Not seasonally adjusted
Carroll County,2019,August,3,8,4555,4402,153,3.4,Not seasonally adjusted
Carroll County,2019,July,3,7,4571,4400,171,3.7,Not seasonally adjusted
Carroll County,2019,June,3,6,4572,4413,159,3.5,Not seasonally adjusted
Carroll County,2019,May,3,5,4740,4608,132,2.8,Not seasonally adjusted
Carroll County,2019,April,3,4,4875,4755,120,2.5,Not seasonally adjusted
Carroll County,2019,March,3,3,5206,5026,180,3.5,Not seasonally adjusted
Carroll County,2019,February,3,2,5191,5004,187,3.6,Not seasonally adjusted
Carroll County,2019,January,3,1,5067,4900,167,3.3,Not seasonally adjusted
Carter County,2020,May,3,5,2505,2291,214,8.5,Not seasonally adjusted
Carter County,2020,April,3,4,2509,2299,210,8.4,Not seasonally adjusted
Carter County,2020,March,3,3,2627,2464,163,6.2,Not seasonally adjusted
Carter County,2020,February,3,2,2554,2388,166,6.5,Not seasonally adjusted
Carter County,2020,January,3,1,2569,2411,158,6.2,Not seasonally adjusted
Carter County,2019,Annual Averages,1,0,2546,2421,125,4.9,Not seasonally adjusted
Carter County,2019,December,3,12,2554,2432,122,4.8,Not seasonally adjusted
Carter County,2019,November,3,11,2514,2413,101,4,Not seasonally adjusted
Carter County,2019,October,3,10,2557,2462,95,3.7,Not seasonally adjusted
Carter County,2019,September,3,9,2575,2483,92,3.6,Not seasonally adjusted
Carter County,2019,August,3,8,2633,2504,129,4.9,Not seasonally adjusted
Carter County,2019,July,3,7,2539,2411,128,5,Not seasonally adjusted
Carter County,2019,June,3,6,2613,2466,147,5.6,Not seasonally adjusted
Carter County,2019,May,3,5,2589,2468,121,4.7,Not seasonally adjusted
Carter County,2019,April,3,4,2548,2418,130,5.1,Not seasonally adjusted
Carter County,2019,March,3,3,2526,2376,150,5.9,Not seasonally adjusted
Carter County,2019,February,3,2,2480,2338,142,5.7,Not seasonally adjusted
Carter County,2019,January,3,1,2429,2286,143,5.9,Not seasonally adjusted
Cass County,2020,May,3,5,52161,47924,4237,8.1,Not seasonally adjusted
Cass County,2020,April,3,4,52490,47895,4595,8.8,Not seasonally adjusted
Cass County,2020,March,3,3,55668,53607,2061,3.7,Not seasonally adjusted
Cass County,2020,February,3,2,55265,53354,1911,3.5,Not seasonally adjusted
Cass County,2020,January,3,1,55160,52948,2212,4,Not seasonally adjusted
Cass County,2019,Annual Averages,1,0,54895,53239,1656,3,Not seasonally adjusted
Cass County,2019,December,3,12,55207,53529,1678,3,Not seasonally adjusted
Cass County,2019,November,3,11,55217,53720,1497,2.7,Not seasonally adjusted
Cass County,2019,October,3,10,55186,53887,1299,2.4,Not seasonally adjusted
Cass County,2019,September,3,9,54836,53566,1270,2.3,Not seasonally adjusted
Cass County,2019,August,3,8,55038,53335,1703,3.1,Not seasonally adjusted
Cass County,2019,July,3,7,55783,53813,1970,3.5,Not seasonally adjusted
Cass County,2019,June,3,6,55362,53663,1699,3.1,Not seasonally adjusted
Cass County,2019,May,3,5,54457,52991,1466,2.7,Not seasonally adjusted
Cass County,2019,April,3,4,54247,52913,1334,2.5,Not seasonally adjusted
Cass County,2019,March,3,3,54495,52542,1953,3.6,Not seasonally adjusted
Cass County,2019,February,3,2,54493,52509,1984,3.6,Not seasonally adjusted
Cass County,2019,January,3,1,54413,52394,2019,3.7,Not seasonally adjusted
Cedar County,2020,May,3,5,5645,5354,291,5.2,Not seasonally adjusted
Cedar County,2020,April,3,4,5702,5417,285,5,Not seasonally adjusted
Cedar County,2020,March,3,3,5940,5707,233,3.9,Not seasonally adjusted
Cedar County,2020,February,3,2,5823,5599,224,3.8,Not seasonally adjusted
Cedar County,2020,January,3,1,5875,5615,260,4.4,Not seasonally adjusted
Cedar County,2019,Annual Averages,1,0,5764,5550,214,3.7,Not seasonally adjusted
Cedar County,2019,December,3,12,5750,5547,203,3.5,Not seasonally adjusted
Cedar County,2019,November,3,11,5770,5559,211,3.7,Not seasonally adjusted
Cedar County,2019,October,3,10,5878,5700,178,3,Not seasonally adjusted
Cedar County,2019,September,3,9,5760,5593,167,2.9,Not seasonally adjusted
Cedar County,2019,August,3,8,5576,5350,226,4.1,Not seasonally adjusted
Cedar County,2019,July,3,7,5711,5447,264,4.6,Not seasonally adjusted
Cedar County,2019,June,3,6,5781,5547,234,4,Not seasonally adjusted
Cedar County,2019,May,3,5,5825,5628,197,3.4,Not seasonally adjusted
Cedar County,2019,April,3,4,5855,5684,171,2.9,Not seasonally adjusted
Cedar County,2019,March,3,3,5787,5540,247,4.3,Not seasonally adjusted
Cedar County,2019,February,3,2,5745,5507,238,4.1,Not seasonally adjusted
Cedar County,2019,January,3,1,5729,5501,228,4,Not seasonally adjusted
Chariton County,2020,May,3,5,3667,3502,165,4.5,Not seasonally adjusted
Chariton County,2020,April,3,4,3763,3567,196,5.2,Not seasonally adjusted
Chariton County,2020,March,3,3,3874,3719,155,4,Not seasonally adjusted
Chariton County,2020,February,3,2,3805,3658,147,3.9,Not seasonally adjusted
Chariton County,2020,January,3,1,3802,3644,158,4.2,Not seasonally adjusted
Chariton County,2019,Annual Averages,1,0,3727,3614,113,3,Not seasonally adjusted
Chariton County,2019,December,3,12,3797,3667,130,3.4,Not seasonally adjusted
Chariton County,2019,November,3,11,3766,3659,107,2.8,Not seasonally adjusted
Chariton County,2019,October,3,10,3829,3746,83,2.2,Not seasonally adjusted
Chariton County,2019,September,3,9,3665,3585,80,2.2,Not seasonally adjusted
Chariton County,2019,August,3,8,3478,3353,125,3.6,Not seasonally adjusted
Chariton County,2019,July,3,7,3522,3390,132,3.7,Not seasonally adjusted
Chariton County,2019,June,3,6,3707,3581,126,3.4,Not seasonally adjusted
Chariton County,2019,May,3,5,3806,3710,96,2.5,Not seasonally adjusted
Chariton County,2019,April,3,4,3802,3720,82,2.2,Not seasonally adjusted
Chariton County,2019,March,3,3,3799,3673,126,3.3,Not seasonally adjusted
Chariton County,2019,February,3,2,3790,3651,139,3.7,Not seasonally adjusted
Chariton County,2019,January,3,1,3764,3636,128,3.4,Not seasonally adjusted
Christian County,2020,May,3,5,43627,40191,3436,7.9,Not seasonally adjusted
Christian County,2020,April,3,4,44133,40182,3951,9,Not seasonally adjusted
Christian County,2020,March,3,3,46073,44563,1510,3.3,Not seasonally adjusted
Christian County,2020,February,3,2,45477,44015,1462,3.2,Not seasonally adjusted
Christian County,2020,January,3,1,45496,43784,1712,3.8,Not seasonally adjusted
Christian County,2019,Annual Averages,1,0,44998,43771,1227,2.7,Not seasonally adjusted
Christian County,2019,December,3,12,45463,44188,1275,2.8,Not seasonally adjusted
Christian County,2019,November,3,11,45464,44270,1194,2.6,Not seasonally adjusted
Christian County,2019,October,3,10,45199,44201,998,2.2,Not seasonally adjusted
Christian County,2019,September,3,9,45135,44164,971,2.2,Not seasonally adjusted
Christian County,2019,August,3,8,44609,43287,1322,3,Not seasonally adjusted
Christian County,2019,July,3,7,45633,44270,1363,3,Not seasonally adjusted
Christian County,2019,June,3,6,44989,43786,1203,2.7,Not seasonally adjusted
Christian County,2019,May,3,5,44656,43612,1044,2.3,Not seasonally adjusted
Christian County,2019,April,3,4,44438,43475,963,2.2,Not seasonally adjusted
Christian County,2019,March,3,3,44904,43471,1433,3.2,Not seasonally adjusted
Christian County,2019,February,3,2,44948,43505,1443,3.2,Not seasonally adjusted
Christian County,2019,January,3,1,44526,43017,1509,3.4,Not seasonally adjusted
Clark County,2020,May,3,5,3268,2962,306,9.4,Not seasonally adjusted
Clark County,2020,April,3,4,3350,3008,342,10.2,Not seasonally adjusted
Clark County,2020,March,3,3,3269,3124,145,4.4,Not seasonally adjusted
Clark County,2020,February,3,2,3256,3104,152,4.7,Not seasonally adjusted
Clark County,2020,January,3,1,3264,3103,161,4.9,Not seasonally adjusted
Clark County,2019,Annual Averages,1,0,3205,3091,114,3.6,Not seasonally adjusted
Clark County,2019,December,3,12,3197,3075,122,3.8,Not seasonally adjusted
Clark County,2019,November,3,11,3199,3096,103,3.2,Not seasonally adjusted
Clark County,2019,October,3,10,3250,3173,77,2.4,Not seasonally adjusted
Clark County,2019,September,3,9,3137,3063,74,2.4,Not seasonally adjusted
Clark County,2019,August,3,8,3155,3046,109,3.5,Not seasonally adjusted
Clark County,2019,July,3,7,3086,2965,121,3.9,Not seasonally adjusted
Clark County,2019,June,3,6,3254,3123,131,4,Not seasonally adjusted
Clark County,2019,May,3,5,3270,3173,97,3,Not seasonally adjusted
Clark County,2019,April,3,4,3266,3164,102,3.1,Not seasonally adjusted
Clark County,2019,March,3,3,3219,3084,135,4.2,Not seasonally adjusted
Clark County,2019,February,3,2,3193,3043,150,4.7,Not seasonally adjusted
Clark County,2019,January,3,1,3243,3092,151,4.7,Not seasonally adjusted
Clay County,2020,May,3,5,135878,119013,16865,12.4,Not seasonally adjusted
Clay County,2020,April,3,4,135933,118820,17113,12.6,Not seasonally adjusted
Clay County,2020,March,3,3,138243,133639,4604,3.3,Not seasonally adjusted
Clay County,2020,February,3,2,136876,132799,4077,3,Not seasonally adjusted
Clay County,2020,January,3,1,136418,131679,4739,3.5,Not seasonally adjusted
Clay County,2019,Annual Averages,1,0,136610,132701,3909,2.9,Not seasonally adjusted
Clay County,2019,December,3,12,137324,133415,3909,2.8,Not seasonally adjusted
Clay County,2019,November,3,11,137536,133935,3601,2.6,Not seasonally adjusted
Clay County,2019,October,3,10,137455,134032,3423,2.5,Not seasonally adjusted
Clay County,2019,September,3,9,136805,133724,3081,2.3,Not seasonally adjusted
Clay County,2019,August,3,8,137287,133101,4186,3,Not seasonally adjusted
Clay County,2019,July,3,7,139808,134274,5534,4,Not seasonally adjusted
Clay County,2019,June,3,6,137948,134061,3887,2.8,Not seasonally adjusted
Clay County,2019,May,3,5,135436,131974,3462,2.6,Not seasonally adjusted
Clay County,2019,April,3,4,134800,131710,3090,2.3,Not seasonally adjusted
Clay County,2019,March,3,3,135123,130901,4222,3.1,Not seasonally adjusted
Clay County,2019,February,3,2,135011,130852,4159,3.1,Not seasonally adjusted
Clay County,2019,January,3,1,134785,130436,4349,3.2,Not seasonally adjusted
Clinton County,2020,May,3,5,10682,9490,1192,11.2,Not seasonally adjusted
Clinton County,2020,April,3,4,10798,9530,1268,11.7,Not seasonally adjusted
Clinton County,2020,March,3,3,10871,10497,374,3.4,Not seasonally adjusted
Clinton County,2020,February,3,2,10815,10454,361,3.3,Not seasonally adjusted
Clinton County,2020,January,3,1,10783,10366,417,3.9,Not seasonally adjusted
Clinton County,2019,Annual Averages,1,0,10738,10414,324,3,Not seasonally adjusted
Clinton County,2019,December,3,12,10755,10427,328,3,Not seasonally adjusted
Clinton County,2019,November,3,11,10746,10480,266,2.5,Not seasonally adjusted
Clinton County,2019,October,3,10,10811,10573,238,2.2,Not seasonally adjusted
Clinton County,2019,September,3,9,10673,10432,241,2.3,Not seasonally adjusted
Clinton County,2019,August,3,8,10700,10377,323,3,Not seasonally adjusted
Clinton County,2019,July,3,7,10963,10480,483,4.4,Not seasonally adjusted
Clinton County,2019,June,3,6,10776,10455,321,3,Not seasonally adjusted
Clinton County,2019,May,3,5,10690,10424,266,2.5,Not seasonally adjusted
Clinton County,2019,April,3,4,10700,10441,259,2.4,Not seasonally adjusted
Clinton County,2019,March,3,3,10695,10305,390,3.6,Not seasonally adjusted
Clinton County,2019,February,3,2,10697,10300,397,3.7,Not seasonally adjusted
Clinton County,2019,January,3,1,10651,10273,378,3.5,Not seasonally adjusted
Cole County,2020,May,3,5,37972,35606,2366,6.2,Not seasonally adjusted
Cole County,2020,April,3,4,37523,34970,2553,6.8,Not seasonally adjusted
Cole County,2020,March,3,3,39443,38191,1252,3.2,Not seasonally adjusted
Cole County,2020,February,3,2,39002,37870,1132,2.9,Not seasonally adjusted
Cole County,2020,January,3,1,39126,37783,1343,3.4,Not seasonally adjusted
Cole County,2019,Annual Averages,1,0,39051,38037,1014,2.6,Not seasonally adjusted
Cole County,2019,December,3,12,38822,37767,1055,2.7,Not seasonally adjusted
Cole County,2019,November,3,11,39092,38118,974,2.5,Not seasonally adjusted
Cole County,2019,October,3,10,38999,38212,787,2,Not seasonally adjusted
Cole County,2019,September,3,9,38934,38175,759,1.9,Not seasonally adjusted
Cole County,2019,August,3,8,39447,38270,1177,3,Not seasonally adjusted
Cole County,2019,July,3,7,39910,38710,1200,3,Not seasonally adjusted
Cole County,2019,June,3,6,39369,38289,1080,2.7,Not seasonally adjusted
Cole County,2019,May,3,5,38876,37986,890,2.3,Not seasonally adjusted
Cole County,2019,April,3,4,38815,38019,796,2.1,Not seasonally adjusted
Cole County,2019,March,3,3,38961,37840,1121,2.9,Not seasonally adjusted
Cole County,2019,February,3,2,38786,37608,1178,3,Not seasonally adjusted
Cole County,2019,January,3,1,38602,37449,1153,3,Not seasonally adjusted
Cooper County,2020,May,3,5,7304,6655,649,8.9,Not seasonally adjusted
Cooper County,2020,April,3,4,7429,6755,674,9.1,Not seasonally adjusted
Cooper County,2020,March,3,3,7542,7252,290,3.8,Not seasonally adjusted
Cooper County,2020,February,3,2,7541,7238,303,4,Not seasonally adjusted
Cooper County,2020,January,3,1,7490,7173,317,4.2,Not seasonally adjusted
Cooper County,2019,Annual Averages,1,0,7481,7205,276,3.7,Not seasonally adjusted
Cooper County,2019,December,3,12,7526,7273,253,3.4,Not seasonally adjusted
Cooper County,2019,November,3,11,7556,7318,238,3.1,Not seasonally adjusted
Cooper County,2019,October,3,10,7598,7402,196,2.6,Not seasonally adjusted
Cooper County,2019,September,3,9,7507,7318,189,2.5,Not seasonally adjusted
Cooper County,2019,August,3,8,7197,6937,260,3.6,Not seasonally adjusted
Cooper County,2019,July,3,7,7348,7060,288,3.9,Not seasonally adjusted
Cooper County,2019,June,3,6,7476,7205,271,3.6,Not seasonally adjusted
Cooper County,2019,May,3,5,7536,7314,222,2.9,Not seasonally adjusted
Cooper County,2019,April,3,4,7486,7280,206,2.8,Not seasonally adjusted
Cooper County,2019,March,3,3,7555,7127,428,5.7,Not seasonally adjusted
Cooper County,2019,February,3,2,7603,7138,465,6.1,Not seasonally adjusted
Cooper County,2019,January,3,1,7381,7087,294,4,Not seasonally adjusted
Crawford County,2020,May,3,5,10784,9779,1005,9.3,Not seasonally adjusted
Crawford County,2020,April,3,4,10875,9838,1037,9.5,Not seasonally adjusted
Crawford County,2020,March,3,3,11307,10739,568,5,Not seasonally adjusted
Crawford County,2020,February,3,2,11056,10539,517,4.7,Not seasonally adjusted
Crawford County,2020,January,3,1,11035,10501,534,4.8,Not seasonally adjusted
Crawford County,2019,Annual Averages,1,0,10980,10566,414,3.8,Not seasonally adjusted
Crawford County,2019,December,3,12,10985,10510,475,4.3,Not seasonally adjusted
Crawford County,2019,November,3,11,10985,10559,426,3.9,Not seasonally adjusted
Crawford County,2019,October,3,10,11003,10662,341,3.1,Not seasonally adjusted
Crawford County,2019,September,3,9,10988,10668,320,2.9,Not seasonally adjusted
Crawford County,2019,August,3,8,10914,10508,406,3.7,Not seasonally adjusted
Crawford County,2019,July,3,7,11135,10678,457,4.1,Not seasonally adjusted
Crawford County,2019,June,3,6,11201,10775,426,3.8,Not seasonally adjusted
Crawford County,2019,May,3,5,10950,10591,359,3.3,Not seasonally adjusted
Crawford County,2019,April,3,4,10893,10564,329,3,Not seasonally adjusted
Crawford County,2019,March,3,3,10909,10457,452,4.1,Not seasonally adjusted
Crawford County,2019,February,3,2,10954,10454,500,4.6,Not seasonally adjusted
Crawford County,2019,January,3,1,10837,10361,476,4.4,Not seasonally adjusted
Dade County,2020,May,3,5,3547,3360,187,5.3,Not seasonally adjusted
Dade County,2020,April,3,4,3618,3423,195,5.4,Not seasonally adjusted
Dade County,2020,March,3,3,3669,3526,143,3.9,Not seasonally adjusted
Dade County,2020,February,3,2,3611,3477,134,3.7,Not seasonally adjusted
Dade County,2020,January,3,1,3595,3447,148,4.1,Not seasonally adjusted
Dade County,2019,Annual Averages,1,0,3545,3434,111,3.1,Not seasonally adjusted
Dade County,2019,December,3,12,3533,3415,118,3.3,Not seasonally adjusted
Dade County,2019,November,3,11,3553,3450,103,2.9,Not seasonally adjusted
Dade County,2019,October,3,10,3627,3532,95,2.6,Not seasonally adjusted
Dade County,2019,September,3,9,3514,3417,97,2.8,Not seasonally adjusted
Dade County,2019,August,3,8,3322,3201,121,3.6,Not seasonally adjusted
Dade County,2019,July,3,7,3383,3262,121,3.6,Not seasonally adjusted
Dade County,2019,June,3,6,3572,3456,116,3.2,Not seasonally adjusted
Dade County,2019,May,3,5,3665,3564,101,2.8,Not seasonally adjusted
Dade County,2019,April,3,4,3671,3575,96,2.6,Not seasonally adjusted
Dade County,2019,March,3,3,3563,3439,124,3.5,Not seasonally adjusted
Dade County,2019,February,3,2,3572,3459,113,3.2,Not seasonally adjusted
Dade County,2019,January,3,1,3572,3441,131,3.7,Not seasonally adjusted
Dallas County,2020,May,3,5,6879,6347,532,7.7,Not seasonally adjusted
Dallas County,2020,April,3,4,7030,6399,631,9,Not seasonally adjusted
Dallas County,2020,March,3,3,7214,6891,323,4.5,Not seasonally adjusted
Dallas County,2020,February,3,2,7155,6830,325,4.5,Not seasonally adjusted
Dallas County,2020,January,3,1,7170,6787,383,5.3,Not seasonally adjusted
Dallas County,2019,Annual Averages,1,0,7081,6762,319,4.5,Not seasonally adjusted
Dallas County,2019,December,3,12,7189,6780,409,5.7,Not seasonally adjusted
Dallas County,2019,November,3,11,7170,6807,363,5.1,Not seasonally adjusted
Dallas County,2019,October,3,10,7197,6880,317,4.4,Not seasonally adjusted
Dallas County,2019,September,3,9,7090,6761,329,4.6,Not seasonally adjusted
Dallas County,2019,August,3,8,7018,6626,392,5.6,Not seasonally adjusted
Dallas County,2019,July,3,7,7064,6782,282,4,Not seasonally adjusted
Dallas County,2019,June,3,6,6986,6705,281,4,Not seasonally adjusted
Dallas County,2019,May,3,5,7111,6804,307,4.3,Not seasonally adjusted
Dallas County,2019,April,3,4,7061,6823,238,3.4,Not seasonally adjusted
Dallas County,2019,March,3,3,7036,6745,291,4.1,Not seasonally adjusted
Dallas County,2019,February,3,2,7048,6750,298,4.2,Not seasonally adjusted
Dallas County,2019,January,3,1,7000,6681,319,4.6,Not seasonally adjusted
Daviess County,2020,May,3,5,4193,3965,228,5.4,Not seasonally adjusted
Daviess County,2020,April,3,4,4296,4053,243,5.7,Not seasonally adjusted
Daviess County,2020,March,3,3,4239,4084,155,3.7,Not seasonally adjusted
Daviess County,2020,February,3,2,4169,4014,155,3.7,Not seasonally adjusted
Daviess County,2020,January,3,1,4175,4002,173,4.1,Not seasonally adjusted
Daviess County,2019,Annual Averages,1,0,4102,3965,137,3.3,Not seasonally adjusted
Daviess County,2019,December,3,12,4071,3937,134,3.3,Not seasonally adjusted
Daviess County,2019,November,3,11,4098,3975,123,3,Not seasonally adjusted
Daviess County,2019,October,3,10,4248,4139,109,2.6,Not seasonally adjusted
Daviess County,2019,September,3,9,4028,3936,92,2.3,Not seasonally adjusted
Daviess County,2019,August,3,8,3842,3707,135,3.5,Not seasonally adjusted
Daviess County,2019,July,3,7,3924,3762,162,4.1,Not seasonally adjusted
Daviess County,2019,June,3,6,4123,3998,125,3,Not seasonally adjusted
Daviess County,2019,May,3,5,4253,4137,116,2.7,Not seasonally adjusted
Daviess County,2019,April,3,4,4278,4164,114,2.7,Not seasonally adjusted
Daviess County,2019,March,3,3,4163,3970,193,4.6,Not seasonally adjusted
Daviess County,2019,February,3,2,4101,3917,184,4.5,Not seasonally adjusted
Daviess County,2019,January,3,1,4099,3939,160,3.9,Not seasonally adjusted
Dekalb County,2020,May,3,5,4744,4478,266,5.6,Not seasonally adjusted
Dekalb County,2020,April,3,4,4808,4513,295,6.1,Not seasonally adjusted
Dekalb County,2020,March,3,3,4912,4720,192,3.9,Not seasonally adjusted
Dekalb County,2020,February,3,2,4877,4680,197,4,Not seasonally adjusted
Dekalb County,2020,January,3,1,4881,4671,210,4.3,Not seasonally adjusted
Dekalb County,2019,Annual Averages,1,0,4838,4689,149,3.1,Not seasonally adjusted
Dekalb County,2019,December,3,12,4815,4670,145,3,Not seasonally adjusted
Dekalb County,2019,November,3,11,4814,4691,123,2.6,Not seasonally adjusted
Dekalb County,2019,October,3,10,4890,4777,113,2.3,Not seasonally adjusted
Dekalb County,2019,September,3,9,4755,4649,106,2.2,Not seasonally adjusted
Dekalb County,2019,August,3,8,4755,4614,141,3,Not seasonally adjusted
Dekalb County,2019,July,3,7,4894,4712,182,3.7,Not seasonally adjusted
Dekalb County,2019,June,3,6,4838,4683,155,3.2,Not seasonally adjusted
Dekalb County,2019,May,3,5,4837,4716,121,2.5,Not seasonally adjusted
Dekalb County,2019,April,3,4,4903,4769,134,2.7,Not seasonally adjusted
Dekalb County,2019,March,3,3,4865,4669,196,4,Not seasonally adjusted
Dekalb County,2019,February,3,2,4866,4673,193,4,Not seasonally adjusted
Dekalb County,2019,January,3,1,4820,4642,178,3.7,Not seasonally adjusted
Dent County,2020,May,3,5,6114,5751,363,5.9,Not seasonally adjusted
Dent County,2020,April,3,4,6159,5781,378,6.1,Not seasonally adjusted
Dent County,2020,March,3,3,6552,6280,272,4.2,Not seasonally adjusted
Dent County,2020,February,3,2,6298,6045,253,4,Not seasonally adjusted
Dent County,2020,January,3,1,6377,6067,310,4.9,Not seasonally adjusted
Dent County,2019,Annual Averages,1,0,6269,6044,225,3.6,Not seasonally adjusted
Dent County,2019,December,3,12,6304,6047,257,4.1,Not seasonally adjusted
Dent County,2019,November,3,11,6301,6080,221,3.5,Not seasonally adjusted
Dent County,2019,October,3,10,6376,6174,202,3.2,Not seasonally adjusted
Dent County,2019,September,3,9,6302,6126,176,2.8,Not seasonally adjusted
Dent County,2019,August,3,8,6028,5774,254,4.2,Not seasonally adjusted
Dent County,2019,July,3,7,6062,5817,245,4,Not seasonally adjusted
Dent County,2019,June,3,6,6410,6166,244,3.8,Not seasonally adjusted
Dent County,2019,May,3,5,6331,6128,203,3.2,Not seasonally adjusted
Dent County,2019,April,3,4,6277,6104,173,2.8,Not seasonally adjusted
Dent County,2019,March,3,3,6305,6074,231,3.7,Not seasonally adjusted
Dent County,2019,February,3,2,6241,6007,234,3.7,Not seasonally adjusted
Dent County,2019,January,3,1,6280,6025,255,4.1,Not seasonally adjusted
Douglas County,2020,May,3,5,5265,4576,689,13.1,Not seasonally adjusted
Douglas County,2020,April,3,4,5360,4614,746,13.9,Not seasonally adjusted
Douglas County,2020,March,3,3,5220,4950,270,5.2,Not seasonally adjusted
Douglas County,2020,February,3,2,5122,4872,250,4.9,Not seasonally adjusted
Douglas County,2020,January,3,1,5475,4859,616,11.3,Not seasonally adjusted
Douglas County,2019,Annual Averages,1,0,5107,4849,258,5.1,Not seasonally adjusted
Douglas County,2019,December,3,12,5153,4843,310,6,Not seasonally adjusted
Douglas County,2019,November,3,11,5078,4834,244,4.8,Not seasonally adjusted
Douglas County,2019,October,3,10,5104,4897,207,4.1,Not seasonally adjusted
Douglas County,2019,September,3,9,5320,4743,577,10.8,Not seasonally adjusted
Douglas County,2019,August,3,8,4986,4621,365,7.3,Not seasonally adjusted
Douglas County,2019,July,3,7,4986,4776,210,4.2,Not seasonally adjusted
Douglas County,2019,June,3,6,5067,4862,205,4,Not seasonally adjusted
Douglas County,2019,May,3,5,5136,4950,186,3.6,Not seasonally adjusted
Douglas County,2019,April,3,4,5123,4982,141,2.8,Not seasonally adjusted
Douglas County,2019,March,3,3,5074,4867,207,4.1,Not seasonally adjusted
Douglas County,2019,February,3,2,5143,4925,218,4.2,Not seasonally adjusted
Douglas County,2019,January,3,1,5111,4886,225,4.4,Not seasonally adjusted
Dunklin County,2020,May,3,5,11518,10459,1059,9.2,Not seasonally adjusted
Dunklin County,2020,April,3,4,11707,10669,1038,8.9,Not seasonally adjusted
Dunklin County,2020,March,3,3,11937,11075,862,7.2,Not seasonally adjusted
Dunklin County,2020,February,3,2,11764,10971,793,6.7,Not seasonally adjusted
Dunklin County,2020,January,3,1,11736,10959,777,6.6,Not seasonally adjusted
Dunklin County,2019,Annual Averages,1,0,11598,10956,642,5.5,Not seasonally adjusted
Dunklin County,2019,December,3,12,11424,10780,644,5.6,Not seasonally adjusted
Dunklin County,2019,November,3,11,11408,10867,541,4.7,Not seasonally adjusted
Dunklin County,2019,October,3,10,11593,11123,470,4.1,Not seasonally adjusted
Dunklin County,2019,September,3,9,11277,10809,468,4.2,Not seasonally adjusted
Dunklin County,2019,August,3,8,11060,10410,650,5.9,Not seasonally adjusted
Dunklin County,2019,July,3,7,11137,10389,748,6.7,Not seasonally adjusted
Dunklin County,2019,June,3,6,11739,11023,716,6.1,Not seasonally adjusted
Dunklin County,2019,May,3,5,11830,11244,586,5,Not seasonally adjusted
Dunklin County,2019,April,3,4,11922,11348,574,4.8,Not seasonally adjusted
Dunklin County,2019,March,3,3,11883,11138,745,6.3,Not seasonally adjusted
Dunklin County,2019,February,3,2,11961,11184,777,6.5,Not seasonally adjusted
Dunklin County,2019,January,3,1,11946,11161,785,6.6,Not seasonally adjusted
Franklin County,2020,May,3,5,52056,46377,5679,10.9,Not seasonally adjusted
Franklin County,2020,April,3,4,52314,46725,5589,10.7,Not seasonally adjusted
Franklin County,2020,March,3,3,54195,51948,2247,4.1,Not seasonally adjusted
Franklin County,2020,February,3,2,53448,51376,2072,3.9,Not seasonally adjusted
Franklin County,2020,January,3,1,53547,51246,2301,4.3,Not seasonally adjusted
Franklin County,2019,Annual Averages,1,0,53226,51511,1715,3.2,Not seasonally adjusted
Franklin County,2019,December,3,12,53487,51644,1843,3.4,Not seasonally adjusted
Franklin County,2019,November,3,11,53505,51881,1624,3,Not seasonally adjusted
Franklin County,2019,October,3,10,53758,52058,1700,3.2,Not seasonally adjusted
Franklin County,2019,September,3,9,53179,51896,1283,2.4,Not seasonally adjusted
Franklin County,2019,August,3,8,53463,51659,1804,3.4,Not seasonally adjusted
Franklin County,2019,July,3,7,54209,52306,1903,3.5,Not seasonally adjusted
Franklin County,2019,June,3,6,53541,51880,1661,3.1,Not seasonally adjusted
Franklin County,2019,May,3,5,52824,51281,1543,2.9,Not seasonally adjusted
Franklin County,2019,April,3,4,52659,51244,1415,2.7,Not seasonally adjusted
Franklin County,2019,March,3,3,52738,50894,1844,3.5,Not seasonally adjusted
Franklin County,2019,February,3,2,52889,50902,1987,3.8,Not seasonally adjusted
Franklin County,2019,January,3,1,52460,50483,1977,3.8,Not seasonally adjusted
Gasconade County,2020,May,3,5,7753,7000,753,9.7,Not seasonally adjusted
Gasconade County,2020,April,3,4,7817,7070,747,9.6,Not seasonally adjusted
Gasconade County,2020,March,3,3,7865,7589,276,3.5,Not seasonally adjusted
Gasconade County,2020,February,3,2,7705,7429,276,3.6,Not seasonally adjusted
Gasconade County,2020,January,3,1,7699,7393,306,4,Not seasonally adjusted
Gasconade County,2019,Annual Averages,1,0,7732,7470,262,3.4,Not seasonally adjusted
Gasconade County,2019,December,3,12,7695,7423,272,3.5,Not seasonally adjusted
Gasconade County,2019,November,3,11,7733,7493,240,3.1,Not seasonally adjusted
Gasconade County,2019,October,3,10,8083,7650,433,5.4,Not seasonally adjusted
Gasconade County,2019,September,3,9,7694,7517,177,2.3,Not seasonally adjusted
Gasconade County,2019,August,3,8,7557,7339,218,2.9,Not seasonally adjusted
Gasconade County,2019,July,3,7,7594,7332,262,3.5,Not seasonally adjusted
Gasconade County,2019,June,3,6,7767,7547,220,2.8,Not seasonally adjusted
Gasconade County,2019,May,3,5,7808,7566,242,3.1,Not seasonally adjusted
Gasconade County,2019,April,3,4,7763,7553,210,2.7,Not seasonally adjusted
Gasconade County,2019,March,3,3,7685,7406,279,3.6,Not seasonally adjusted
Gasconade County,2019,February,3,2,7740,7435,305,3.9,Not seasonally adjusted
Gasconade County,2019,January,3,1,7661,7376,285,3.7,Not seasonally adjusted
Gentry County,2020,May,3,5,3462,3344,118,3.4,Not seasonally adjusted
Gentry County,2020,April,3,4,3585,3424,161,4.5,Not seasonally adjusted
Gentry County,2020,March,3,3,3567,3461,106,3,Not seasonally adjusted
Gentry County,2020,February,3,2,3535,3435,100,2.8,Not seasonally adjusted
Gentry County,2020,January,3,1,3548,3433,115,3.2,Not seasonally adjusted
Gentry County,2019,Annual Averages,1,0,3529,3433,96,2.7,Not seasonally adjusted
Gentry County,2019,December,3,12,3464,3365,99,2.9,Not seasonally adjusted
Gentry County,2019,November,3,11,3464,3370,94,2.7,Not seasonally adjusted
Gentry County,2019,October,3,10,3576,3492,84,2.3,Not seasonally adjusted
Gentry County,2019,September,3,9,3389,3316,73,2.2,Not seasonally adjusted
Gentry County,2019,August,3,8,3403,3298,105,3.1,Not seasonally adjusted
Gentry County,2019,July,3,7,3525,3393,132,3.7,Not seasonally adjusted
Gentry County,2019,June,3,6,3566,3452,114,3.2,Not seasonally adjusted
Gentry County,2019,May,3,5,3676,3580,96,2.6,Not seasonally adjusted
Gentry County,2019,April,3,4,3682,3601,81,2.2,Not seasonally adjusted
Gentry County,2019,March,3,3,3526,3435,91,2.6,Not seasonally adjusted
Gentry County,2019,February,3,2,3526,3437,89,2.5,Not seasonally adjusted
Gentry County,2019,January,3,1,3546,3454,92,2.6,Not seasonally adjusted
Greene County,2020,May,3,5,148160,135575,12585,8.5,Not seasonally adjusted
Greene County,2020,April,3,4,149940,135666,14274,9.5,Not seasonally adjusted
Greene County,2020,March,3,3,155382,150267,5115,3.3,Not seasonally adjusted
Greene County,2020,February,3,2,152787,148135,4652,3,Not seasonally adjusted
Greene County,2020,January,3,1,152665,147141,5524,3.6,Not seasonally adjusted
Greene County,2019,Annual Averages,1,0,151535,147461,4074,2.7,Not seasonally adjusted
Greene County,2019,December,3,12,153178,148575,4603,3,Not seasonally adjusted
Greene County,2019,November,3,11,153203,149009,4194,2.7,Not seasonally adjusted
Greene County,2019,October,3,10,152127,148696,3431,2.3,Not seasonally adjusted
Greene County,2019,September,3,9,152156,148785,3371,2.2,Not seasonally adjusted
Greene County,2019,August,3,8,150343,145662,4681,3.1,Not seasonally adjusted
Greene County,2019,July,3,7,153320,149049,4271,2.8,Not seasonally adjusted
Greene County,2019,June,3,6,151710,147657,4053,2.7,Not seasonally adjusted
Greene County,2019,May,3,5,150934,147157,3777,2.5,Not seasonally adjusted
Greene County,2019,April,3,4,150048,146800,3248,2.2,Not seasonally adjusted
Greene County,2019,March,3,3,150958,146565,4393,2.9,Not seasonally adjusted
Greene County,2019,February,3,2,151018,146733,4285,2.8,Not seasonally adjusted
Greene County,2019,January,3,1,149418,144841,4577,3.1,Not seasonally adjusted
Grundy County,2020,May,3,5,4353,4097,256,5.9,Not seasonally adjusted
Grundy County,2020,April,3,4,4479,4169,310,6.9,Not seasonally adjusted
Grundy County,2020,March,3,3,4470,4317,153,3.4,Not seasonally adjusted
Grundy County,2020,February,3,2,4453,4300,153,3.4,Not seasonally adjusted
Grundy County,2020,January,3,1,4448,4258,190,4.3,Not seasonally adjusted
Grundy County,2019,Annual Averages,1,0,4394,4240,154,3.5,Not seasonally adjusted
Grundy County,2019,December,3,12,4407,4244,163,3.7,Not seasonally adjusted
Grundy County,2019,November,3,11,4417,4252,165,3.7,Not seasonally adjusted
Grundy County,2019,October,3,10,4477,4367,110,2.5,Not seasonally adjusted
Grundy County,2019,September,3,9,4300,4189,111,2.6,Not seasonally adjusted
Grundy County,2019,August,3,8,4049,3892,157,3.9,Not seasonally adjusted
Grundy County,2019,July,3,7,4241,4037,204,4.8,Not seasonally adjusted
Grundy County,2019,June,3,6,4315,4163,152,3.5,Not seasonally adjusted
Grundy County,2019,May,3,5,4498,4360,138,3.1,Not seasonally adjusted
Grundy County,2019,April,3,4,4567,4435,132,2.9,Not seasonally adjusted
Grundy County,2019,March,3,3,4459,4289,170,3.8,Not seasonally adjusted
Grundy County,2019,February,3,2,4524,4351,173,3.8,Not seasonally adjusted
Grundy County,2019,January,3,1,4472,4296,176,3.9,Not seasonally adjusted
Harrison County,2020,May,3,5,3828,3632,196,5.1,Not seasonally adjusted
Harrison County,2020,April,3,4,3920,3709,211,5.4,Not seasonally adjusted
Harrison County,2020,March,3,3,3978,3802,176,4.4,Not seasonally adjusted
Harrison County,2020,February,3,2,3889,3693,196,5,Not seasonally adjusted
Harrison County,2020,January,3,1,3892,3700,192,4.9,Not seasonally adjusted
Harrison County,2019,Annual Averages,1,0,3822,3695,127,3.3,Not seasonally adjusted
Harrison County,2019,December,3,12,3777,3649,128,3.4,Not seasonally adjusted
Harrison County,2019,November,3,11,3780,3672,108,2.9,Not seasonally adjusted
Harrison County,2019,October,3,10,3883,3777,106,2.7,Not seasonally adjusted
Harrison County,2019,September,3,9,3672,3569,103,2.8,Not seasonally adjusted
Harrison County,2019,August,3,8,3578,3431,147,4.1,Not seasonally adjusted
Harrison County,2019,July,3,7,3683,3544,139,3.8,Not seasonally adjusted
Harrison County,2019,June,3,6,3759,3653,106,2.8,Not seasonally adjusted
Harrison County,2019,May,3,5,3928,3823,105,2.7,Not seasonally adjusted
Harrison County,2019,April,3,4,3951,3869,82,2.1,Not seasonally adjusted
Harrison County,2019,March,3,3,3941,3780,161,4.1,Not seasonally adjusted
Harrison County,2019,February,3,2,3960,3784,176,4.4,Not seasonally adjusted
Harrison County,2019,January,3,1,3956,3794,162,4.1,Not seasonally adjusted
Henry County,2020,May,3,5,9578,8753,825,8.6,Not seasonally adjusted
Henry County,2020,April,3,4,9552,8805,747,7.8,Not seasonally adjusted
Henry County,2020,March,3,3,9999,9603,396,4,Not seasonally adjusted
Henry County,2020,February,3,2,9790,9363,427,4.4,Not seasonally adjusted
Henry County,2020,January,3,1,9791,9306,485,5,Not seasonally adjusted
Henry County,2019,Annual Averages,1,0,9728,9364,364,3.7,Not seasonally adjusted
Henry County,2019,December,3,12,9722,9377,345,3.5,Not seasonally adjusted
Henry County,2019,November,3,11,9702,9378,324,3.3,Not seasonally adjusted
Henry County,2019,October,3,10,9757,9469,288,3,Not seasonally adjusted
Henry County,2019,September,3,9,9638,9374,264,2.7,Not seasonally adjusted
Henry County,2019,August,3,8,9426,9041,385,4.1,Not seasonally adjusted
Henry County,2019,July,3,7,9601,9187,414,4.3,Not seasonally adjusted
Henry County,2019,June,3,6,9860,9437,423,4.3,Not seasonally adjusted
Henry County,2019,May,3,5,9920,9528,392,4,Not seasonally adjusted
Henry County,2019,April,3,4,9792,9516,276,2.8,Not seasonally adjusted
Henry County,2019,March,3,3,9803,9408,395,4,Not seasonally adjusted
Henry County,2019,February,3,2,9780,9351,429,4.4,Not seasonally adjusted
Henry County,2019,January,3,1,9736,9307,429,4.4,Not seasonally adjusted
Hickory County,2020,May,3,5,3779,3557,222,5.9,Not seasonally adjusted
Hickory County,2020,April,3,4,3844,3579,265,6.9,Not seasonally adjusted
Hickory County,2020,March,3,3,3900,3708,192,4.9,Not seasonally adjusted
Hickory County,2020,February,3,2,3829,3633,196,5.1,Not seasonally adjusted
Hickory County,2020,January,3,1,3827,3610,217,5.7,Not seasonally adjusted
Hickory County,2019,Annual Averages,1,0,3842,3681,161,4.2,Not seasonally adjusted
Hickory County,2019,December,3,12,3802,3626,176,4.6,Not seasonally adjusted
Hickory County,2019,November,3,11,3806,3657,149,3.9,Not seasonally adjusted
Hickory County,2019,October,3,10,3946,3809,137,3.5,Not seasonally adjusted
Hickory County,2019,September,3,9,3949,3801,148,3.7,Not seasonally adjusted
Hickory County,2019,August,3,8,3840,3662,178,4.6,Not seasonally adjusted
Hickory County,2019,July,3,7,3883,3721,162,4.2,Not seasonally adjusted
Hickory County,2019,June,3,6,3956,3802,154,3.9,Not seasonally adjusted
Hickory County,2019,May,3,5,3888,3758,130,3.3,Not seasonally adjusted
Hickory County,2019,April,3,4,3830,3706,124,3.2,Not seasonally adjusted
Hickory County,2019,March,3,3,3763,3588,175,4.7,Not seasonally adjusted
Hickory County,2019,February,3,2,3720,3526,194,5.2,Not seasonally adjusted
Hickory County,2019,January,3,1,3726,3519,207,5.6,Not seasonally adjusted
Holt County,2020,May,3,5,2549,2458,91,3.6,Not seasonally adjusted
Holt County,2020,April,3,4,2638,2511,127,4.8,Not seasonally adjusted
Holt County,2020,March,3,3,2602,2533,69,2.7,Not seasonally adjusted
Holt County,2020,February,3,2,2589,2509,80,3.1,Not seasonally adjusted
Holt County,2020,January,3,1,2601,2505,96,3.7,Not seasonally adjusted
Holt County,2019,Annual Averages,1,0,2588,2515,73,2.8,Not seasonally adjusted
Holt County,2019,December,3,12,2534,2470,64,2.5,Not seasonally adjusted
Holt County,2019,November,3,11,2545,2486,59,2.3,Not seasonally adjusted
Holt County,2019,October,3,10,2635,2582,53,2,Not seasonally adjusted
Holt County,2019,September,3,9,2501,2449,52,2.1,Not seasonally adjusted
Holt County,2019,August,3,8,2490,2409,81,3.3,Not seasonally adjusted
Holt County,2019,July,3,7,2500,2389,111,4.4,Not seasonally adjusted
Holt County,2019,June,3,6,2597,2498,99,3.8,Not seasonally adjusted
Holt County,2019,May,3,5,2684,2613,71,2.6,Not seasonally adjusted
Holt County,2019,April,3,4,2693,2623,70,2.6,Not seasonally adjusted
Holt County,2019,March,3,3,2615,2542,73,2.8,Not seasonally adjusted
Holt County,2019,February,3,2,2626,2558,68,2.6,Not seasonally adjusted
Holt County,2019,January,3,1,2628,2557,71,2.7,Not seasonally adjusted
Howard County,2020,May,3,5,4678,4399,279,6,Not seasonally adjusted
Howard County,2020,April,3,4,4722,4462,260,5.5,Not seasonally adjusted
Howard County,2020,March,3,3,4975,4818,157,3.2,Not seasonally adjusted
Howard County,2020,February,3,2,4911,4743,168,3.4,Not seasonally adjusted
Howard County,2020,January,3,1,4908,4709,199,4.1,Not seasonally adjusted
Howard County,2019,Annual Averages,1,0,4898,4746,152,3.1,Not seasonally adjusted
Howard County,2019,December,3,12,4917,4773,144,2.9,Not seasonally adjusted
Howard County,2019,November,3,11,4928,4788,140,2.8,Not seasonally adjusted
Howard County,2019,October,3,10,4940,4824,116,2.3,Not seasonally adjusted
Howard County,2019,September,3,9,4856,4739,117,2.4,Not seasonally adjusted
Howard County,2019,August,3,8,4643,4492,151,3.3,Not seasonally adjusted
Howard County,2019,July,3,7,4721,4533,188,4,Not seasonally adjusted
Howard County,2019,June,3,6,4832,4672,160,3.3,Not seasonally adjusted
Howard County,2019,May,3,5,4936,4802,134,2.7,Not seasonally adjusted
Howard County,2019,April,3,4,4976,4864,112,2.3,Not seasonally adjusted
Howard County,2019,March,3,3,5017,4832,185,3.7,Not seasonally adjusted
Howard County,2019,February,3,2,5041,4834,207,4.1,Not seasonally adjusted
Howard County,2019,January,3,1,4964,4793,171,3.4,Not seasonally adjusted
Howell County,2020,May,3,5,16139,14736,1403,8.7,Not seasonally adjusted
Howell County,2020,April,3,4,16347,14783,1564,9.6,Not seasonally adjusted
Howell County,2020,March,3,3,16961,16213,748,4.4,Not seasonally adjusted
Howell County,2020,February,3,2,16677,16006,671,4,Not seasonally adjusted
Howell County,2020,January,3,1,16978,16021,957,5.6,Not seasonally adjusted
Howell County,2019,Annual Averages,1,0,16541,15870,671,4.1,Not seasonally adjusted
Howell County,2019,December,3,12,16898,16078,820,4.9,Not seasonally adjusted
Howell County,2019,November,3,11,16755,16031,724,4.3,Not seasonally adjusted
Howell County,2019,October,3,10,16802,16137,665,4,Not seasonally adjusted
Howell County,2019,September,3,9,16678,15983,695,4.2,Not seasonally adjusted
Howell County,2019,August,3,8,16331,15647,684,4.2,Not seasonally adjusted
Howell County,2019,July,3,7,16304,15526,778,4.8,Not seasonally adjusted
Howell County,2019,June,3,6,16583,15909,674,4.1,Not seasonally adjusted
Howell County,2019,May,3,5,16437,15886,551,3.4,Not seasonally adjusted
Howell County,2019,April,3,4,16320,15847,473,2.9,Not seasonally adjusted
Howell County,2019,March,3,3,16530,15883,647,3.9,Not seasonally adjusted
Howell County,2019,February,3,2,16462,15796,666,4,Not seasonally adjusted
Howell County,2019,January,3,1,16386,15711,675,4.1,Not seasonally adjusted
Iron County,2020,May,3,5,3501,3157,344,9.8,Not seasonally adjusted
Iron County,2020,April,3,4,3469,3175,294,8.5,Not seasonally adjusted
Iron County,2020,March,3,3,3680,3443,237,6.4,Not seasonally adjusted
Iron County,2020,February,3,2,3568,3362,206,5.8,Not seasonally adjusted
Iron County,2020,January,3,1,3565,3348,217,6.1,Not seasonally adjusted
Iron County,2019,Annual Averages,1,0,3534,3365,169,4.8,Not seasonally adjusted
Iron County,2019,December,3,12,3532,3349,183,5.2,Not seasonally adjusted
Iron County,2019,November,3,11,3499,3349,150,4.3,Not seasonally adjusted
Iron County,2019,October,3,10,3491,3373,118,3.4,Not seasonally adjusted
Iron County,2019,September,3,9,3471,3348,123,3.5,Not seasonally adjusted
Iron County,2019,August,3,8,3455,3275,180,5.2,Not seasonally adjusted
Iron County,2019,July,3,7,3510,3282,228,6.5,Not seasonally adjusted
Iron County,2019,June,3,6,3615,3439,176,4.9,Not seasonally adjusted
Iron County,2019,May,3,5,3563,3416,147,4.1,Not seasonally adjusted
Iron County,2019,April,3,4,3537,3410,127,3.6,Not seasonally adjusted
Iron County,2019,March,3,3,3581,3396,185,5.2,Not seasonally adjusted
Iron County,2019,February,3,2,3575,3379,196,5.5,Not seasonally adjusted
Iron County,2019,January,3,1,3585,3366,219,6.1,Not seasonally adjusted
Jackson County,2020,May,3,5,354270,313247,41023,11.6,Not seasonally adjusted
Jackson County,2020,April,3,4,352702,312421,40281,11.4,Not seasonally adjusted
Jackson County,2020,March,3,3,368459,352353,16106,4.4,Not seasonally adjusted
Jackson County,2020,February,3,2,364637,350283,14354,3.9,Not seasonally adjusted
Jackson County,2020,January,3,1,363222,347539,15683,4.3,Not seasonally adjusted
Jackson County,2019,Annual Averages,1,0,363539,350008,13531,3.7,Not seasonally adjusted
Jackson County,2019,December,3,12,365774,352321,13453,3.7,Not seasonally adjusted
Jackson County,2019,November,3,11,365901,353495,12406,3.4,Not seasonally adjusted
Jackson County,2019,October,3,10,365288,353499,11789,3.2,Not seasonally adjusted
Jackson County,2019,September,3,9,363860,352946,10914,3,Not seasonally adjusted
Jackson County,2019,August,3,8,366256,351433,14823,4,Not seasonally adjusted
Jackson County,2019,July,3,7,371169,354459,16710,4.5,Not seasonally adjusted
Jackson County,2019,June,3,6,367535,353695,13840,3.8,Not seasonally adjusted
Jackson County,2019,May,3,5,359802,347643,12159,3.4,Not seasonally adjusted
Jackson County,2019,April,3,4,357955,346695,11260,3.1,Not seasonally adjusted
Jackson County,2019,March,3,3,360065,345057,15008,4.2,Not seasonally adjusted
Jackson County,2019,February,3,2,359431,344882,14549,4,Not seasonally adjusted
Jackson County,2019,January,3,1,359426,343971,15455,4.3,Not seasonally adjusted
Jasper County,2020,May,3,5,56205,51185,5020,8.9,Not seasonally adjusted
Jasper County,2020,April,3,4,56789,51114,5675,10,Not seasonally adjusted
Jasper County,2020,March,3,3,58158,56138,2020,3.5,Not seasonally adjusted
Jasper County,2020,February,3,2,57797,55993,1804,3.1,Not seasonally adjusted
Jasper County,2020,January,3,1,58193,56049,2144,3.7,Not seasonally adjusted
Jasper County,2019,Annual Averages,1,0,57304,55590,1714,3,Not seasonally adjusted
Jasper County,2019,December,3,12,58049,56206,1843,3.2,Not seasonally adjusted
Jasper County,2019,November,3,11,57883,56188,1695,2.9,Not seasonally adjusted
Jasper County,2019,October,3,10,57637,56136,1501,2.6,Not seasonally adjusted
Jasper County,2019,September,3,9,57220,55802,1418,2.5,Not seasonally adjusted
Jasper County,2019,August,3,8,57231,55419,1812,3.2,Not seasonally adjusted
Jasper County,2019,July,3,7,57815,55771,2044,3.5,Not seasonally adjusted
Jasper County,2019,June,3,6,57128,55342,1786,3.1,Not seasonally adjusted
Jasper County,2019,May,3,5,56765,55148,1617,2.8,Not seasonally adjusted
Jasper County,2019,April,3,4,56486,55120,1366,2.4,Not seasonally adjusted
Jasper County,2019,March,3,3,57249,55392,1857,3.2,Not seasonally adjusted
Jasper County,2019,February,3,2,57117,55355,1762,3.1,Not seasonally adjusted
Jasper County,2019,January,3,1,57061,55198,1863,3.3,Not seasonally adjusted
Jefferson County,2020,May,3,5,114128,102488,11640,10.2,Not seasonally adjusted
Jefferson County,2020,April,3,4,114902,103023,11879,10.3,Not seasonally adjusted
Jefferson County,2020,March,3,3,120251,115406,4845,4,Not seasonally adjusted
Jefferson County,2020,February,3,2,118591,114107,4484,3.8,Not seasonally adjusted
Jefferson County,2020,January,3,1,118858,113892,4966,4.2,Not seasonally adjusted
Jefferson County,2019,Annual Averages,1,0,118177,114498,3679,3.1,Not seasonally adjusted
Jefferson County,2019,December,3,12,118932,115032,3900,3.3,Not seasonally adjusted
Jefferson County,2019,November,3,11,118964,115469,3495,2.9,Not seasonally adjusted
Jefferson County,2019,October,3,10,118536,115560,2976,2.5,Not seasonally adjusted
Jefferson County,2019,September,3,9,118438,115599,2839,2.4,Not seasonally adjusted
Jefferson County,2019,August,3,8,118919,115120,3799,3.2,Not seasonally adjusted
Jefferson County,2019,July,3,7,120563,116515,4048,3.4,Not seasonally adjusted
Jefferson County,2019,June,3,6,119201,115525,3676,3.1,Not seasonally adjusted
Jefferson County,2019,May,3,5,116881,113675,3206,2.7,Not seasonally adjusted
Jefferson County,2019,April,3,4,116451,113414,3037,2.6,Not seasonally adjusted
Jefferson County,2019,March,3,3,117317,112980,4337,3.7,Not seasonally adjusted
Jefferson County,2019,February,3,2,117460,112990,4470,3.8,Not seasonally adjusted
Jefferson County,2019,January,3,1,116460,112093,4367,3.7,Not seasonally adjusted
Johnson County,2020,May,3,5,23070,21196,1874,8.1,Not seasonally adjusted
Johnson County,2020,April,3,4,23231,21279,1952,8.4,Not seasonally adjusted
Johnson County,2020,March,3,3,24103,23063,1040,4.3,Not seasonally adjusted
Johnson County,2020,February,3,2,23560,22539,1021,4.3,Not seasonally adjusted
Johnson County,2020,January,3,1,23487,22385,1102,4.7,Not seasonally adjusted
Johnson County,2019,Annual Averages,1,0,23105,22247,858,3.7,Not seasonally adjusted
Johnson County,2019,December,3,12,23201,22369,832,3.6,Not seasonally adjusted
Johnson County,2019,November,3,11,23430,22618,812,3.5,Not seasonally adjusted
Johnson County,2019,October,3,10,23572,22785,787,3.3,Not seasonally adjusted
Johnson County,2019,September,3,9,23254,22593,661,2.8,Not seasonally adjusted
Johnson County,2019,August,3,8,22713,21793,920,4.1,Not seasonally adjusted
Johnson County,2019,July,3,7,22833,21728,1105,4.8,Not seasonally adjusted
Johnson County,2019,June,3,6,23196,22304,892,3.8,Not seasonally adjusted
Johnson County,2019,May,3,5,23062,22295,767,3.3,Not seasonally adjusted
Johnson County,2019,April,3,4,23127,22433,694,3,Not seasonally adjusted
Johnson County,2019,March,3,3,22996,22023,973,4.2,Not seasonally adjusted
Johnson County,2019,February,3,2,22996,22076,920,4,Not seasonally adjusted
Johnson County,2019,January,3,1,22876,21944,932,4.1,Not seasonally adjusted
Knox County,2020,May,3,5,1742,1673,69,4,Not seasonally adjusted
Knox County,2020,April,3,4,1780,1708,72,4,Not seasonally adjusted
Knox County,2020,March,3,3,1806,1739,67,3.7,Not seasonally adjusted
Knox County,2020,February,3,2,1808,1720,88,4.9,Not seasonally adjusted
Knox County,2020,January,3,1,1803,1734,69,3.8,Not seasonally adjusted
Knox County,2019,Annual Averages,1,0,1772,1720,52,2.9,Not seasonally adjusted
Knox County,2019,December,3,12,1777,1724,53,3,Not seasonally adjusted
Knox County,2019,November,3,11,1764,1721,43,2.4,Not seasonally adjusted
Knox County,2019,October,3,10,1823,1787,36,2,Not seasonally adjusted
Knox County,2019,September,3,9,1740,1705,35,2,Not seasonally adjusted
Knox County,2019,August,3,8,1669,1621,48,2.9,Not seasonally adjusted
Knox County,2019,July,3,7,1712,1651,61,3.6,Not seasonally adjusted
Knox County,2019,June,3,6,1751,1693,58,3.3,Not seasonally adjusted
Knox County,2019,May,3,5,1804,1756,48,2.7,Not seasonally adjusted
Knox County,2019,April,3,4,1833,1784,49,2.7,Not seasonally adjusted
Knox County,2019,March,3,3,1794,1735,59,3.3,Not seasonally adjusted
Knox County,2019,February,3,2,1774,1712,62,3.5,Not seasonally adjusted
Knox County,2019,January,3,1,1814,1746,68,3.7,Not seasonally adjusted
Laclede County,2020,May,3,5,17227,15146,2081,12.1,Not seasonally adjusted
Laclede County,2020,April,3,4,17908,15242,2666,14.9,Not seasonally adjusted
Laclede County,2020,March,3,3,17551,16493,1058,6,Not seasonally adjusted
Laclede County,2020,February,3,2,17273,16243,1030,6,Not seasonally adjusted
Laclede County,2020,January,3,1,17442,16174,1268,7.3,Not seasonally adjusted
Laclede County,2019,Annual Averages,1,0,17386,16190,1196,6.9,Not seasonally adjusted
Laclede County,2019,December,3,12,17760,15981,1779,10,Not seasonally adjusted
Laclede County,2019,November,3,11,17589,16017,1572,8.9,Not seasonally adjusted
Laclede County,2019,October,3,10,17909,16227,1682,9.4,Not seasonally adjusted
Laclede County,2019,September,3,9,18102,16095,2007,11.1,Not seasonally adjusted
Laclede County,2019,August,3,8,17283,15695,1588,9.2,Not seasonally adjusted
Laclede County,2019,July,3,7,16771,16067,704,4.2,Not seasonally adjusted
Laclede County,2019,June,3,6,17178,16482,696,4.1,Not seasonally adjusted
Laclede County,2019,May,3,5,17988,16487,1501,8.3,Not seasonally adjusted
Laclede County,2019,April,3,4,17196,16470,726,4.2,Not seasonally adjusted
Laclede County,2019,March,3,3,16986,16231,755,4.4,Not seasonally adjusted
Laclede County,2019,February,3,2,16933,16278,655,3.9,Not seasonally adjusted
Laclede County,2019,January,3,1,16929,16247,682,4,Not seasonally adjusted
Lafayette County,2020,May,3,5,16249,14928,1321,8.1,Not seasonally adjusted
Lafayette County,2020,April,3,4,16424,15010,1414,8.6,Not seasonally adjusted
Lafayette County,2020,March,3,3,17116,16464,652,3.8,Not seasonally adjusted
Lafayette County,2020,February,3,2,17049,16401,648,3.8,Not seasonally adjusted
Lafayette County,2020,January,3,1,16961,16256,705,4.2,Not seasonally adjusted
Lafayette County,2019,Annual Averages,1,0,16847,16328,519,3.1,Not seasonally adjusted
Lafayette County,2019,December,3,12,16849,16331,518,3.1,Not seasonally adjusted
Lafayette County,2019,November,3,11,16908,16422,486,2.9,Not seasonally adjusted
Lafayette County,2019,October,3,10,17009,16590,419,2.5,Not seasonally adjusted
Lafayette County,2019,September,3,9,16726,16335,391,2.3,Not seasonally adjusted
Lafayette County,2019,August,3,8,16738,16246,492,2.9,Not seasonally adjusted
Lafayette County,2019,July,3,7,17051,16412,639,3.7,Not seasonally adjusted
Lafayette County,2019,June,3,6,16911,16374,537,3.2,Not seasonally adjusted
Lafayette County,2019,May,3,5,16824,16369,455,2.7,Not seasonally adjusted
Lafayette County,2019,April,3,4,16842,16411,431,2.6,Not seasonally adjusted
Lafayette County,2019,March,3,3,16788,16170,618,3.7,Not seasonally adjusted
Lafayette County,2019,February,3,2,16798,16163,635,3.8,Not seasonally adjusted
Lafayette County,2019,January,3,1,16719,16115,604,3.6,Not seasonally adjusted
Lawrence County,2020,May,3,5,17914,16423,1491,8.3,Not seasonally adjusted
Lawrence County,2020,April,3,4,18085,16559,1526,8.4,Not seasonally adjusted
Lawrence County,2020,March,3,3,18677,17813,864,4.6,Not seasonally adjusted
Lawrence County,2020,February,3,2,18219,17460,759,4.2,Not seasonally adjusted
Lawrence County,2020,January,3,1,18343,17445,898,4.9,Not seasonally adjusted
Lawrence County,2019,Annual Averages,1,0,18018,17385,633,3.5,Not seasonally adjusted
Lawrence County,2019,December,3,12,18027,17358,669,3.7,Not seasonally adjusted
Lawrence County,2019,November,3,11,18122,17496,626,3.5,Not seasonally adjusted
Lawrence County,2019,October,3,10,18274,17766,508,2.8,Not seasonally adjusted
Lawrence County,2019,September,3,9,17910,17433,477,2.7,Not seasonally adjusted
Lawrence County,2019,August,3,8,17419,16755,664,3.8,Not seasonally adjusted
Lawrence County,2019,July,3,7,17778,17024,754,4.2,Not seasonally adjusted
Lawrence County,2019,June,3,6,18071,17462,609,3.4,Not seasonally adjusted
Lawrence County,2019,May,3,5,18047,17531,516,2.9,Not seasonally adjusted
Lawrence County,2019,April,3,4,18110,17619,491,2.7,Not seasonally adjusted
Lawrence County,2019,March,3,3,18207,17425,782,4.3,Not seasonally adjusted
Lawrence County,2019,February,3,2,18169,17397,772,4.2,Not seasonally adjusted
Lawrence County,2019,January,3,1,18089,17356,733,4.1,Not seasonally adjusted
Lewis County,2020,May,3,5,5057,4679,378,7.5,Not seasonally adjusted
Lewis County,2020,April,3,4,5138,4766,372,7.2,Not seasonally adjusted
Lewis County,2020,March,3,3,5117,4935,182,3.6,Not seasonally adjusted
Lewis County,2020,February,3,2,5011,4828,183,3.7,Not seasonally adjusted
Lewis County,2020,January,3,1,5011,4808,203,4.1,Not seasonally adjusted
Lewis County,2019,Annual Averages,1,0,5003,4843,160,3.2,Not seasonally adjusted
Lewis County,2019,December,3,12,5004,4841,163,3.3,Not seasonally adjusted
Lewis County,2019,November,3,11,4984,4838,146,2.9,Not seasonally adjusted
Lewis County,2019,October,3,10,5088,4957,131,2.6,Not seasonally adjusted
Lewis County,2019,September,3,9,4943,4813,130,2.6,Not seasonally adjusted
Lewis County,2019,August,3,8,4815,4645,170,3.5,Not seasonally adjusted
Lewis County,2019,July,3,7,4864,4689,175,3.6,Not seasonally adjusted
Lewis County,2019,June,3,6,5008,4851,157,3.1,Not seasonally adjusted
Lewis County,2019,May,3,5,5113,4969,144,2.8,Not seasonally adjusted
Lewis County,2019,April,3,4,5107,4962,145,2.8,Not seasonally adjusted
Lewis County,2019,March,3,3,5072,4875,197,3.9,Not seasonally adjusted
Lewis County,2019,February,3,2,5040,4854,186,3.7,Not seasonally adjusted
Lewis County,2019,January,3,1,4998,4824,174,3.5,Not seasonally adjusted
Lincoln County,2020,May,3,5,28038,24849,3189,11.4,Not seasonally adjusted
Lincoln County,2020,April,3,4,28607,25069,3538,12.4,Not seasonally adjusted
Lincoln County,2020,March,3,3,28895,27739,1156,4,Not seasonally adjusted
Lincoln County,2020,February,3,2,28539,27439,1100,3.9,Not seasonally adjusted
Lincoln County,2020,January,3,1,28983,27361,1622,5.6,Not seasonally adjusted
Lincoln County,2019,Annual Averages,1,0,28448,27497,951,3.3,Not seasonally adjusted
Lincoln County,2019,December,3,12,28476,27532,944,3.3,Not seasonally adjusted
Lincoln County,2019,November,3,11,28521,27673,848,3,Not seasonally adjusted
Lincoln County,2019,October,3,10,28737,27814,923,3.2,Not seasonally adjusted
Lincoln County,2019,September,3,9,28366,27665,701,2.5,Not seasonally adjusted
Lincoln County,2019,August,3,8,28462,27530,932,3.3,Not seasonally adjusted
Lincoln County,2019,July,3,7,28901,27882,1019,3.5,Not seasonally adjusted
Lincoln County,2019,June,3,6,28627,27660,967,3.4,Not seasonally adjusted
Lincoln County,2019,May,3,5,28230,27422,808,2.9,Not seasonally adjusted
Lincoln County,2019,April,3,4,28222,27430,792,2.8,Not seasonally adjusted
Lincoln County,2019,March,3,3,28334,27190,1144,4,Not seasonally adjusted
Lincoln County,2019,February,3,2,28375,27196,1179,4.2,Not seasonally adjusted
Lincoln County,2019,January,3,1,28122,26968,1154,4.1,Not seasonally adjusted
Linn County,2020,May,3,5,4956,4624,332,6.7,Not seasonally adjusted
Linn County,2020,April,3,4,5094,4670,424,8.3,Not seasonally adjusted
Linn County,2020,March,3,3,5268,4980,288,5.5,Not seasonally adjusted
Linn County,2020,February,3,2,5157,4880,277,5.4,Not seasonally adjusted
Linn County,2020,January,3,1,5188,4877,311,6,Not seasonally adjusted
Linn County,2019,Annual Averages,1,0,5124,4875,249,4.9,Not seasonally adjusted
Linn County,2019,December,3,12,5150,4893,257,5,Not seasonally adjusted
Linn County,2019,November,3,11,5182,4951,231,4.5,Not seasonally adjusted
Linn County,2019,October,3,10,5238,5050,188,3.6,Not seasonally adjusted
Linn County,2019,September,3,9,5037,4849,188,3.7,Not seasonally adjusted
Linn County,2019,August,3,8,4943,4634,309,6.3,Not seasonally adjusted
Linn County,2019,July,3,7,4956,4651,305,6.2,Not seasonally adjusted
Linn County,2019,June,3,6,5197,4931,266,5.1,Not seasonally adjusted
Linn County,2019,May,3,5,5197,4976,221,4.3,Not seasonally adjusted
Linn County,2019,April,3,4,5126,4957,169,3.3,Not seasonally adjusted
Linn County,2019,March,3,3,5147,4873,274,5.3,Not seasonally adjusted
Linn County,2019,February,3,2,5149,4847,302,5.9,Not seasonally adjusted
Linn County,2019,January,3,1,5175,4892,283,5.5,Not seasonally adjusted
Livingston County,2020,May,3,5,7225,6915,310,4.3,Not seasonally adjusted
Livingston County,2020,April,3,4,7460,7016,444,6,Not seasonally adjusted
Livingston County,2020,March,3,3,7599,7374,225,3,Not seasonally adjusted
Livingston County,2020,February,3,2,7443,7211,232,3.1,Not seasonally adjusted
Livingston County,2020,January,3,1,7431,7161,270,3.6,Not seasonally adjusted
Livingston County,2019,Annual Averages,1,0,7357,7170,187,2.5,Not seasonally adjusted
Livingston County,2019,December,3,12,7328,7128,200,2.7,Not seasonally adjusted
Livingston County,2019,November,3,11,7283,7095,188,2.6,Not seasonally adjusted
Livingston County,2019,October,3,10,7432,7268,164,2.2,Not seasonally adjusted
Livingston County,2019,September,3,9,7202,7063,139,1.9,Not seasonally adjusted
Livingston County,2019,August,3,8,7141,6955,186,2.6,Not seasonally adjusted
Livingston County,2019,July,3,7,7354,7168,186,2.5,Not seasonally adjusted
Livingston County,2019,June,3,6,7411,7242,169,2.3,Not seasonally adjusted
Livingston County,2019,May,3,5,7387,7225,162,2.2,Not seasonally adjusted
Livingston County,2019,April,3,4,7488,7343,145,1.9,Not seasonally adjusted
Livingston County,2019,March,3,3,7391,7158,233,3.2,Not seasonally adjusted
Livingston County,2019,February,3,2,7418,7171,247,3.3,Not seasonally adjusted
Livingston County,2019,January,3,1,7448,7222,226,3,Not seasonally adjusted
Macon County,2020,May,3,5,7281,6875,406,5.6,Not seasonally adjusted
Macon County,2020,April,3,4,7388,6932,456,6.2,Not seasonally adjusted
Macon County,2020,March,3,3,7745,7406,339,4.4,Not seasonally adjusted
Macon County,2020,February,3,2,7645,7333,312,4.1,Not seasonally adjusted
Macon County,2020,January,3,1,7688,7352,336,4.4,Not seasonally adjusted
Macon County,2019,Annual Averages,1,0,7535,7280,255,3.4,Not seasonally adjusted
Macon County,2019,December,3,12,7594,7330,264,3.5,Not seasonally adjusted
Macon County,2019,November,3,11,7537,7314,223,3,Not seasonally adjusted
Macon County,2019,October,3,10,7609,7425,184,2.4,Not seasonally adjusted
Macon County,2019,September,3,9,7419,7230,189,2.5,Not seasonally adjusted
Macon County,2019,August,3,8,7198,6946,252,3.5,Not seasonally adjusted
Macon County,2019,July,3,7,7466,7197,269,3.6,Not seasonally adjusted
Macon County,2019,June,3,6,7558,7314,244,3.2,Not seasonally adjusted
Macon County,2019,May,3,5,7593,7379,214,2.8,Not seasonally adjusted
Macon County,2019,April,3,4,7641,7439,202,2.6,Not seasonally adjusted
Macon County,2019,March,3,3,7586,7255,331,4.4,Not seasonally adjusted
Macon County,2019,February,3,2,7581,7245,336,4.4,Not seasonally adjusted
Macon County,2019,January,3,1,7634,7281,353,4.6,Not seasonally adjusted
Madison County,2020,May,3,5,5519,5010,509,9.2,Not seasonally adjusted
Madison County,2020,April,3,4,5611,5041,570,10.2,Not seasonally adjusted
Madison County,2020,March,3,3,5757,5461,296,5.1,Not seasonally adjusted
Madison County,2020,February,3,2,5535,5285,250,4.5,Not seasonally adjusted
Madison County,2020,January,3,1,5543,5288,255,4.6,Not seasonally adjusted
Madison County,2019,Annual Averages,1,0,5484,5295,189,3.4,Not seasonally adjusted
Madison County,2019,December,3,12,5509,5301,208,3.8,Not seasonally adjusted
Madison County,2019,November,3,11,5480,5301,179,3.3,Not seasonally adjusted
Madison County,2019,October,3,10,5504,5361,143,2.6,Not seasonally adjusted
Madison County,2019,September,3,9,5434,5292,142,2.6,Not seasonally adjusted
Madison County,2019,August,3,8,5428,5242,186,3.4,Not seasonally adjusted
Madison County,2019,July,3,7,5433,5201,232,4.3,Not seasonally adjusted
Madison County,2019,June,3,6,5494,5296,198,3.6,Not seasonally adjusted
Madison County,2019,May,3,5,5536,5363,173,3.1,Not seasonally adjusted
Madison County,2019,April,3,4,5497,5339,158,2.9,Not seasonally adjusted
Madison County,2019,March,3,3,5515,5313,202,3.7,Not seasonally adjusted
Madison County,2019,February,3,2,5492,5269,223,4.1,Not seasonally adjusted
Madison County,2019,January,3,1,5483,5265,218,4,Not seasonally adjusted
Maries County,2020,May,3,5,3811,3575,236,6.2,Not seasonally adjusted
Maries County,2020,April,3,4,3808,3594,214,5.6,Not seasonally adjusted
Maries County,2020,March,3,3,3983,3834,149,3.7,Not seasonally adjusted
Maries County,2020,February,3,2,3934,3787,147,3.7,Not seasonally adjusted
Maries County,2020,January,3,1,3942,3774,168,4.3,Not seasonally adjusted
Maries County,2019,Annual Averages,1,0,3884,3747,137,3.5,Not seasonally adjusted
Maries County,2019,December,3,12,3902,3763,139,3.6,Not seasonally adjusted
Maries County,2019,November,3,11,3901,3771,130,3.3,Not seasonally adjusted
Maries County,2019,October,3,10,3936,3824,112,2.8,Not seasonally adjusted
Maries County,2019,September,3,9,3821,3726,95,2.5,Not seasonally adjusted
Maries County,2019,August,3,8,3755,3614,141,3.8,Not seasonally adjusted
Maries County,2019,July,3,7,3757,3582,175,4.7,Not seasonally adjusted
Maries County,2019,June,3,6,3905,3762,143,3.7,Not seasonally adjusted
Maries County,2019,May,3,5,3934,3822,112,2.8,Not seasonally adjusted
Maries County,2019,April,3,4,3963,3838,125,3.2,Not seasonally adjusted
Maries County,2019,March,3,3,3923,3772,151,3.8,Not seasonally adjusted
Maries County,2019,February,3,2,3930,3757,173,4.4,Not seasonally adjusted
Maries County,2019,January,3,1,3871,3728,143,3.7,Not seasonally adjusted
Marion County,2020,May,3,5,14070,13200,870,6.2,Not seasonally adjusted
Marion County,2020,April,3,4,14280,13292,988,6.9,Not seasonally adjusted
Marion County,2020,March,3,3,14820,14260,560,3.8,Not seasonally adjusted
Marion County,2020,February,3,2,14415,13921,494,3.4,Not seasonally adjusted
Marion County,2020,January,3,1,14539,13982,557,3.8,Not seasonally adjusted
Marion County,2019,Annual Averages,1,0,14565,14104,461,3.2,Not seasonally adjusted
Marion County,2019,December,3,12,14724,14258,466,3.2,Not seasonally adjusted
Marion County,2019,November,3,11,14828,14393,435,2.9,Not seasonally adjusted
Marion County,2019,October,3,10,14670,14292,378,2.6,Not seasonally adjusted
Marion County,2019,September,3,9,14545,14203,342,2.4,Not seasonally adjusted
Marion County,2019,August,3,8,14291,13825,466,3.3,Not seasonally adjusted
Marion County,2019,July,3,7,14520,14024,496,3.4,Not seasonally adjusted
Marion County,2019,June,3,6,14661,14173,488,3.3,Not seasonally adjusted
Marion County,2019,May,3,5,14519,14096,423,2.9,Not seasonally adjusted
Marion County,2019,April,3,4,14546,14165,381,2.6,Not seasonally adjusted
Marion County,2019,March,3,3,14538,14008,530,3.6,Not seasonally adjusted
Marion County,2019,February,3,2,14458,13887,571,3.9,Not seasonally adjusted
Marion County,2019,January,3,1,14480,13920,560,3.9,Not seasonally adjusted
Mcdonald County,2020,May,3,5,10490,9838,652,6.2,Not seasonally adjusted
Mcdonald County,2020,April,3,4,10487,9779,708,6.8,Not seasonally adjusted
Mcdonald County,2020,March,3,3,11123,10670,453,4.1,Not seasonally adjusted
Mcdonald County,2020,February,3,2,10925,10566,359,3.3,Not seasonally adjusted
Mcdonald County,2020,January,3,1,10931,10500,431,3.9,Not seasonally adjusted
Mcdonald County,2019,Annual Averages,1,0,10690,10334,356,3.3,Not seasonally adjusted
Mcdonald County,2019,December,3,12,10864,10485,379,3.5,Not seasonally adjusted
Mcdonald County,2019,November,3,11,10849,10489,360,3.3,Not seasonally adjusted
Mcdonald County,2019,October,3,10,10867,10573,294,2.7,Not seasonally adjusted
Mcdonald County,2019,September,3,9,10695,10413,282,2.6,Not seasonally adjusted
Mcdonald County,2019,August,3,8,10637,10258,379,3.6,Not seasonally adjusted
Mcdonald County,2019,July,3,7,10827,10344,483,4.5,Not seasonally adjusted
Mcdonald County,2019,June,3,6,10628,10205,423,4,Not seasonally adjusted
Mcdonald County,2019,May,3,5,10615,10278,337,3.2,Not seasonally adjusted
Mcdonald County,2019,April,3,4,10573,10290,283,2.7,Not seasonally adjusted
Mcdonald County,2019,March,3,3,10617,10273,344,3.2,Not seasonally adjusted
Mcdonald County,2019,February,3,2,10622,10272,350,3.3,Not seasonally adjusted
Mcdonald County,2019,January,3,1,10490,10132,358,3.4,Not seasonally adjusted
Mercer County,2020,May,3,5,1971,1894,77,3.9,Not seasonally adjusted
Mercer County,2020,April,3,4,2042,1968,74,3.6,Not seasonally adjusted
Mercer County,2020,March,3,3,1956,1887,69,3.5,Not seasonally adjusted
Mercer County,2020,February,3,2,1942,1862,80,4.1,Not seasonally adjusted
Mercer County,2020,January,3,1,1944,1858,86,4.4,Not seasonally adjusted
Mercer County,2019,Annual Averages,1,0,1861,1802,59,3.2,Not seasonally adjusted
Mercer County,2019,December,3,12,1852,1794,58,3.1,Not seasonally adjusted
Mercer County,2019,November,3,11,1859,1808,51,2.7,Not seasonally adjusted
Mercer County,2019,October,3,10,1964,1926,38,1.9,Not seasonally adjusted
Mercer County,2019,September,3,9,1809,1767,42,2.3,Not seasonally adjusted
Mercer County,2019,August,3,8,1651,1597,54,3.3,Not seasonally adjusted
Mercer County,2019,July,3,7,1671,1617,54,3.2,Not seasonally adjusted
Mercer County,2019,June,3,6,1819,1766,53,2.9,Not seasonally adjusted
Mercer County,2019,May,3,5,1964,1917,47,2.4,Not seasonally adjusted
Mercer County,2019,April,3,4,2022,1969,53,2.6,Not seasonally adjusted
Mercer County,2019,March,3,3,1909,1820,89,4.7,Not seasonally adjusted
Mercer County,2019,February,3,2,1897,1809,88,4.6,Not seasonally adjusted
Mercer County,2019,January,3,1,1905,1830,75,3.9,Not seasonally adjusted
Miller County,2020,May,3,5,12256,11061,1195,9.8,Not seasonally adjusted
Miller County,2020,April,3,4,12537,11063,1474,11.8,Not seasonally adjusted
Miller County,2020,March,3,3,12516,11779,737,5.9,Not seasonally adjusted
Miller County,2020,February,3,2,12300,11615,685,5.6,Not seasonally adjusted
Miller County,2020,January,3,1,12318,11595,723,5.9,Not seasonally adjusted
Miller County,2019,Annual Averages,1,0,12313,11850,463,3.8,Not seasonally adjusted
Miller County,2019,December,3,12,12307,11770,537,4.4,Not seasonally adjusted
Miller County,2019,November,3,11,12291,11829,462,3.8,Not seasonally adjusted
Miller County,2019,October,3,10,12445,12043,402,3.2,Not seasonally adjusted
Miller County,2019,September,3,9,12398,12086,312,2.5,Not seasonally adjusted
Miller County,2019,August,3,8,12217,11777,440,3.6,Not seasonally adjusted
Miller County,2019,July,3,7,12153,11711,442,3.6,Not seasonally adjusted
Miller County,2019,June,3,6,12836,12418,418,3.3,Not seasonally adjusted
Miller County,2019,May,3,5,12525,12162,363,2.9,Not seasonally adjusted
Miller County,2019,April,3,4,12303,11960,343,2.8,Not seasonally adjusted
Miller County,2019,March,3,3,12176,11611,565,4.6,Not seasonally adjusted
Miller County,2019,February,3,2,12063,11429,634,5.3,Not seasonally adjusted
Miller County,2019,January,3,1,12031,11399,632,5.3,Not seasonally adjusted
Mississippi County,2020,May,3,5,5648,5321,327,5.8,Not seasonally adjusted
Mississippi County,2020,April,3,4,5718,5408,310,5.4,Not seasonally adjusted
Mississippi County,2020,March,3,3,5975,5660,315,5.3,Not seasonally adjusted
Mississippi County,2020,February,3,2,5855,5597,258,4.4,Not seasonally adjusted
Mississippi County,2020,January,3,1,5867,5587,280,4.8,Not seasonally adjusted
Mississippi County,2019,Annual Averages,1,0,5792,5555,237,4.1,Not seasonally adjusted
Mississippi County,2019,December,3,12,5784,5534,250,4.3,Not seasonally adjusted
Mississippi County,2019,November,3,11,5760,5540,220,3.8,Not seasonally adjusted
Mississippi County,2019,October,3,10,5867,5685,182,3.1,Not seasonally adjusted
Mississippi County,2019,September,3,9,5685,5500,185,3.3,Not seasonally adjusted
Mississippi County,2019,August,3,8,5651,5397,254,4.5,Not seasonally adjusted
Mississippi County,2019,July,3,7,5608,5274,334,6,Not seasonally adjusted
Mississippi County,2019,June,3,6,5828,5548,280,4.8,Not seasonally adjusted
Mississippi County,2019,May,3,5,5908,5705,203,3.4,Not seasonally adjusted
Mississippi County,2019,April,3,4,5878,5702,176,3,Not seasonally adjusted
Mississippi County,2019,March,3,3,5850,5597,253,4.3,Not seasonally adjusted
Mississippi County,2019,February,3,2,5840,5603,237,4.1,Not seasonally adjusted
Mississippi County,2019,January,3,1,5844,5579,265,4.5,Not seasonally adjusted
Moniteau County,2020,May,3,5,7251,6835,416,5.7,Not seasonally adjusted
Moniteau County,2020,April,3,4,7215,6809,406,5.6,Not seasonally adjusted
Moniteau County,2020,March,3,3,7425,7145,280,3.8,Not seasonally adjusted
Moniteau County,2020,February,3,2,7375,7112,263,3.6,Not seasonally adjusted
Moniteau County,2020,January,3,1,7375,7083,292,4,Not seasonally adjusted
Moniteau County,2019,Annual Averages,1,0,7313,7097,216,3,Not seasonally adjusted
Moniteau County,2019,December,3,12,7193,6984,209,2.9,Not seasonally adjusted
Moniteau County,2019,November,3,11,7269,7071,198,2.7,Not seasonally adjusted
Moniteau County,2019,October,3,10,7366,7205,161,2.2,Not seasonally adjusted
Moniteau County,2019,September,3,9,7194,7035,159,2.2,Not seasonally adjusted
Moniteau County,2019,August,3,8,7267,7037,230,3.2,Not seasonally adjusted
Moniteau County,2019,July,3,7,7407,7134,273,3.7,Not seasonally adjusted
Moniteau County,2019,June,3,6,7288,7056,232,3.2,Not seasonally adjusted
Moniteau County,2019,May,3,5,7371,7185,186,2.5,Not seasonally adjusted
Moniteau County,2019,April,3,4,7425,7251,174,2.3,Not seasonally adjusted
Moniteau County,2019,March,3,3,7363,7103,260,3.5,Not seasonally adjusted
Moniteau County,2019,February,3,2,7326,7064,262,3.6,Not seasonally adjusted
Moniteau County,2019,January,3,1,7285,7036,249,3.4,Not seasonally adjusted
Monroe County,2020,May,3,5,3730,3444,286,7.7,Not seasonally adjusted
Monroe County,2020,April,3,4,3812,3487,325,8.5,Not seasonally adjusted
Monroe County,2020,March,3,3,3852,3666,186,4.8,Not seasonally adjusted
Monroe County,2020,February,3,2,3894,3703,191,4.9,Not seasonally adjusted
Monroe County,2020,January,3,1,3898,3693,205,5.3,Not seasonally adjusted
Monroe County,2019,Annual Averages,1,0,3872,3711,161,4.2,Not seasonally adjusted
Monroe County,2019,December,3,12,3906,3733,173,4.4,Not seasonally adjusted
Monroe County,2019,November,3,11,3922,3763,159,4.1,Not seasonally adjusted
Monroe County,2019,October,3,10,3959,3828,131,3.3,Not seasonally adjusted
Monroe County,2019,September,3,9,3890,3769,121,3.1,Not seasonally adjusted
Monroe County,2019,August,3,8,3710,3538,172,4.6,Not seasonally adjusted
Monroe County,2019,July,3,7,3715,3537,178,4.8,Not seasonally adjusted
Monroe County,2019,June,3,6,3892,3715,177,4.5,Not seasonally adjusted
Monroe County,2019,May,3,5,3941,3804,137,3.5,Not seasonally adjusted
Monroe County,2019,April,3,4,3917,3786,131,3.3,Not seasonally adjusted
Monroe County,2019,March,3,3,3888,3697,191,4.9,Not seasonally adjusted
Monroe County,2019,February,3,2,3875,3689,186,4.8,Not seasonally adjusted
Monroe County,2019,January,3,1,3851,3672,179,4.6,Not seasonally adjusted
Montgomery County,2020,May,3,5,5746,5295,451,7.8,Not seasonally adjusted
Montgomery County,2020,April,3,4,5844,5375,469,8,Not seasonally adjusted
Montgomery County,2020,March,3,3,5906,5685,221,3.7,Not seasonally adjusted
Montgomery County,2020,February,3,2,5803,5584,219,3.8,Not seasonally adjusted
Montgomery County,2020,January,3,1,5842,5575,267,4.6,Not seasonally adjusted
Montgomery County,2019,Annual Averages,1,0,5738,5558,180,3.1,Not seasonally adjusted
Montgomery County,2019,December,3,12,5730,5553,177,3.1,Not seasonally adjusted
Montgomery County,2019,November,3,11,5740,5582,158,2.8,Not seasonally adjusted
Montgomery County,2019,October,3,10,5900,5712,188,3.2,Not seasonally adjusted
Montgomery County,2019,September,3,9,5716,5590,126,2.2,Not seasonally adjusted
Montgomery County,2019,August,3,8,5685,5507,178,3.1,Not seasonally adjusted
Montgomery County,2019,July,3,7,5658,5450,208,3.7,Not seasonally adjusted
Montgomery County,2019,June,3,6,5722,5529,193,3.4,Not seasonally adjusted
Montgomery County,2019,May,3,5,5818,5658,160,2.8,Not seasonally adjusted
Montgomery County,2019,April,3,4,5837,5688,149,2.6,Not seasonally adjusted
Montgomery County,2019,March,3,3,5707,5492,215,3.8,Not seasonally adjusted
Montgomery County,2019,February,3,2,5682,5474,208,3.7,Not seasonally adjusted
Montgomery County,2019,January,3,1,5665,5461,204,3.6,Not seasonally adjusted
Morgan County,2020,May,3,5,8011,7299,712,8.9,Not seasonally adjusted
Morgan County,2020,April,3,4,8172,7351,821,10,Not seasonally adjusted
Morgan County,2020,March,3,3,8209,7760,449,5.5,Not seasonally adjusted
Morgan County,2020,February,3,2,8170,7689,481,5.9,Not seasonally adjusted
Morgan County,2020,January,3,1,8196,7670,526,6.4,Not seasonally adjusted
Morgan County,2019,Annual Averages,1,0,8127,7776,351,4.3,Not seasonally adjusted
Morgan County,2019,December,3,12,8131,7737,394,4.8,Not seasonally adjusted
Morgan County,2019,November,3,11,8045,7698,347,4.3,Not seasonally adjusted
Morgan County,2019,October,3,10,8215,7917,298,3.6,Not seasonally adjusted
Morgan County,2019,September,3,9,8051,7795,256,3.2,Not seasonally adjusted
Morgan County,2019,August,3,8,8214,7891,323,3.9,Not seasonally adjusted
Morgan County,2019,July,3,7,8272,7930,342,4.1,Not seasonally adjusted
Morgan County,2019,June,3,6,8457,8141,316,3.7,Not seasonally adjusted
Morgan County,2019,May,3,5,8198,7913,285,3.5,Not seasonally adjusted
Morgan County,2019,April,3,4,8009,7747,262,3.3,Not seasonally adjusted
Morgan County,2019,March,3,3,8010,7575,435,5.4,Not seasonally adjusted
Morgan County,2019,February,3,2,8007,7509,498,6.2,Not seasonally adjusted
Morgan County,2019,January,3,1,7908,7457,451,5.7,Not seasonally adjusted
New Madrid County,2020,May,3,5,8452,7787,665,7.9,Not seasonally adjusted
New Madrid County,2020,April,3,4,8582,7943,639,7.4,Not seasonally adjusted
New Madrid County,2020,March,3,3,8675,8226,449,5.2,Not seasonally adjusted
New Madrid County,2020,February,3,2,8457,8046,411,4.9,Not seasonally adjusted
New Madrid County,2020,January,3,1,8440,8005,435,5.2,Not seasonally adjusted
New Madrid County,2019,Annual Averages,1,0,8236,7880,356,4.3,Not seasonally adjusted
New Madrid County,2019,December,3,12,8232,7853,379,4.6,Not seasonally adjusted
New Madrid County,2019,November,3,11,8211,7873,338,4.1,Not seasonally adjusted
New Madrid County,2019,October,3,10,8353,8068,285,3.4,Not seasonally adjusted
New Madrid County,2019,September,3,9,8064,7784,280,3.5,Not seasonally adjusted
New Madrid County,2019,August,3,8,7944,7556,388,4.9,Not seasonally adjusted
New Madrid County,2019,July,3,7,8066,7635,431,5.3,Not seasonally adjusted
New Madrid County,2019,June,3,6,8259,7862,397,4.8,Not seasonally adjusted
New Madrid County,2019,May,3,5,8384,8077,307,3.7,Not seasonally adjusted
New Madrid County,2019,April,3,4,8393,8100,293,3.5,Not seasonally adjusted
New Madrid County,2019,March,3,3,8349,7949,400,4.8,Not seasonally adjusted
New Madrid County,2019,February,3,2,8316,7936,380,4.6,Not seasonally adjusted
New Madrid County,2019,January,3,1,8261,7864,397,4.8,Not seasonally adjusted
Newton County,2020,May,3,5,26996,24587,2409,8.9,Not seasonally adjusted
Newton County,2020,April,3,4,27470,24629,2841,10.3,Not seasonally adjusted
Newton County,2020,March,3,3,27824,26770,1054,3.8,Not seasonally adjusted
Newton County,2020,February,3,2,27666,26734,932,3.4,Not seasonally adjusted
Newton County,2020,January,3,1,27860,26753,1107,4,Not seasonally adjusted
Newton County,2019,Annual Averages,1,0,27392,26498,894,3.3,Not seasonally adjusted
Newton County,2019,December,3,12,27615,26731,884,3.2,Not seasonally adjusted
Newton County,2019,November,3,11,27597,26743,854,3.1,Not seasonally adjusted
Newton County,2019,October,3,10,27588,26836,752,2.7,Not seasonally adjusted
Newton County,2019,September,3,9,27218,26515,703,2.6,Not seasonally adjusted
Newton County,2019,August,3,8,27263,26329,934,3.4,Not seasonally adjusted
Newton County,2019,July,3,7,27700,26512,1188,4.3,Not seasonally adjusted
Newton County,2019,June,3,6,27288,26297,991,3.6,Not seasonally adjusted
Newton County,2019,May,3,5,27231,26380,851,3.1,Not seasonally adjusted
Newton County,2019,April,3,4,27157,26417,740,2.7,Not seasonally adjusted
Newton County,2019,March,3,3,27404,26442,962,3.5,Not seasonally adjusted
Newton County,2019,February,3,2,27353,26423,930,3.4,Not seasonally adjusted
Newton County,2019,January,3,1,27295,26355,940,3.4,Not seasonally adjusted
Nodaway County,2020,May,3,5,10985,10428,557,5.1,Not seasonally adjusted
Nodaway County,2020,April,3,4,11623,10554,1069,9.2,Not seasonally adjusted
Nodaway County,2020,March,3,3,11435,11051,384,3.4,Not seasonally adjusted
Nodaway County,2020,February,3,2,11100,10738,362,3.3,Not seasonally adjusted
Nodaway County,2020,January,3,1,10999,10586,413,3.8,Not seasonally adjusted
Nodaway County,2019,Annual Averages,1,0,10790,10468,322,3,Not seasonally adjusted
Nodaway County,2019,December,3,12,10953,10661,292,2.7,Not seasonally adjusted
Nodaway County,2019,November,3,11,10983,10697,286,2.6,Not seasonally adjusted
Nodaway County,2019,October,3,10,11109,10874,235,2.1,Not seasonally adjusted
Nodaway County,2019,September,3,9,10900,10649,251,2.3,Not seasonally adjusted
Nodaway County,2019,August,3,8,10398,10021,377,3.6,Not seasonally adjusted
Nodaway County,2019,July,3,7,10498,10043,455,4.3,Not seasonally adjusted
Nodaway County,2019,June,3,6,10758,10361,397,3.7,Not seasonally adjusted
Nodaway County,2019,May,3,5,10679,10361,318,3,Not seasonally adjusted
Nodaway County,2019,April,3,4,11045,10798,247,2.2,Not seasonally adjusted
Nodaway County,2019,March,3,3,10795,10459,336,3.1,Not seasonally adjusted
Nodaway County,2019,February,3,2,10761,10425,336,3.1,Not seasonally adjusted
Nodaway County,2019,January,3,1,10595,10265,330,3.1,Not seasonally adjusted
Oregon County,2020,May,3,5,4003,3684,319,8,Not seasonally adjusted
Oregon County,2020,April,3,4,4079,3732,347,8.5,Not seasonally adjusted
Oregon County,2020,March,3,3,4180,3943,237,5.7,Not seasonally adjusted
Oregon County,2020,February,3,2,4098,3904,194,4.7,Not seasonally adjusted
Oregon County,2020,January,3,1,4129,3895,234,5.7,Not seasonally adjusted
Oregon County,2019,Annual Averages,1,0,3981,3824,157,3.9,Not seasonally adjusted
Oregon County,2019,December,3,12,4043,3858,185,4.6,Not seasonally adjusted
Oregon County,2019,November,3,11,4020,3870,150,3.7,Not seasonally adjusted
Oregon County,2019,October,3,10,4087,3947,140,3.4,Not seasonally adjusted
Oregon County,2019,September,3,9,4012,3848,164,4.1,Not seasonally adjusted
Oregon County,2019,August,3,8,3922,3757,165,4.2,Not seasonally adjusted
Oregon County,2019,July,3,7,3710,3537,173,4.7,Not seasonally adjusted
Oregon County,2019,June,3,6,3863,3694,169,4.4,Not seasonally adjusted
Oregon County,2019,May,3,5,4017,3873,144,3.6,Not seasonally adjusted
Oregon County,2019,April,3,4,4046,3925,121,3,Not seasonally adjusted
Oregon County,2019,March,3,3,4017,3861,156,3.9,Not seasonally adjusted
Oregon County,2019,February,3,2,4024,3867,157,3.9,Not seasonally adjusted
Oregon County,2019,January,3,1,4013,3851,162,4,Not seasonally adjusted
Osage County,2020,May,3,5,6918,6613,305,4.4,Not seasonally adjusted
Osage County,2020,April,3,4,6903,6554,349,5.1,Not seasonally adjusted
Osage County,2020,March,3,3,7191,6972,219,3,Not seasonally adjusted
Osage County,2020,February,3,2,7125,6946,179,2.5,Not seasonally adjusted
Osage County,2020,January,3,1,7155,6932,223,3.1,Not seasonally adjusted
Osage County,2019,Annual Averages,1,0,7106,6936,170,2.4,Not seasonally adjusted
Osage County,2019,December,3,12,7027,6862,165,2.3,Not seasonally adjusted
Osage County,2019,November,3,11,7094,6931,163,2.3,Not seasonally adjusted
Osage County,2019,October,3,10,7173,7030,143,2,Not seasonally adjusted
Osage County,2019,September,3,9,7018,6903,115,1.6,Not seasonally adjusted
Osage County,2019,August,3,8,7111,6915,196,2.8,Not seasonally adjusted
Osage County,2019,July,3,7,7203,7002,201,2.8,Not seasonally adjusted
Osage County,2019,June,3,6,7093,6914,179,2.5,Not seasonally adjusted
Osage County,2019,May,3,5,7140,6982,158,2.2,Not seasonally adjusted
Osage County,2019,April,3,4,7149,7019,130,1.8,Not seasonally adjusted
Osage County,2019,March,3,3,7101,6923,178,2.5,Not seasonally adjusted
Osage County,2019,February,3,2,7107,6882,225,3.2,Not seasonally adjusted
Osage County,2019,January,3,1,7047,6865,182,2.6,Not seasonally adjusted
Ozark County,2020,May,3,5,3499,3148,351,10,Not seasonally adjusted
Ozark County,2020,April,3,4,3568,3197,371,10.4,Not seasonally adjusted
Ozark County,2020,March,3,3,3520,3332,188,5.3,Not seasonally adjusted
Ozark County,2020,February,3,2,3363,3162,201,6,Not seasonally adjusted
Ozark County,2020,January,3,1,3439,3136,303,8.8,Not seasonally adjusted
Ozark County,2019,Annual Averages,1,0,3412,3214,198,5.8,Not seasonally adjusted
Ozark County,2019,December,3,12,3371,3118,253,7.5,Not seasonally adjusted
Ozark County,2019,November,3,11,3365,3174,191,5.7,Not seasonally adjusted
Ozark County,2019,October,3,10,3443,3283,160,4.6,Not seasonally adjusted
Ozark County,2019,September,3,9,3434,3249,185,5.4,Not seasonally adjusted
Ozark County,2019,August,3,8,3303,3091,212,6.4,Not seasonally adjusted
Ozark County,2019,July,3,7,3184,2996,188,5.9,Not seasonally adjusted
Ozark County,2019,June,3,6,3513,3320,193,5.5,Not seasonally adjusted
Ozark County,2019,May,3,5,3574,3408,166,4.6,Not seasonally adjusted
Ozark County,2019,April,3,4,3497,3346,151,4.3,Not seasonally adjusted
Ozark County,2019,March,3,3,3449,3250,199,5.8,Not seasonally adjusted
Ozark County,2019,February,3,2,3387,3164,223,6.6,Not seasonally adjusted
Ozark County,2019,January,3,1,3415,3166,249,7.3,Not seasonally adjusted
Pemiscot County,2020,May,3,5,6463,5793,670,10.4,Not seasonally adjusted
Pemiscot County,2020,April,3,4,6449,5871,578,9,Not seasonally adjusted
Pemiscot County,2020,March,3,3,6622,6230,392,5.9,Not seasonally adjusted
Pemiscot County,2020,February,3,2,6451,6072,379,5.9,Not seasonally adjusted
Pemiscot County,2020,January,3,1,6455,6059,396,6.1,Not seasonally adjusted
Pemiscot County,2019,Annual Averages,1,0,6364,6043,321,5,Not seasonally adjusted
Pemiscot County,2019,December,3,12,6354,5995,359,5.6,Not seasonally adjusted
Pemiscot County,2019,November,3,11,6318,6033,285,4.5,Not seasonally adjusted
Pemiscot County,2019,October,3,10,6374,6125,249,3.9,Not seasonally adjusted
Pemiscot County,2019,September,3,9,6301,6056,245,3.9,Not seasonally adjusted
Pemiscot County,2019,August,3,8,6338,5989,349,5.5,Not seasonally adjusted
Pemiscot County,2019,July,3,7,6183,5780,403,6.5,Not seasonally adjusted
Pemiscot County,2019,June,3,6,6474,6106,368,5.7,Not seasonally adjusted
Pemiscot County,2019,May,3,5,6461,6182,279,4.3,Not seasonally adjusted
Pemiscot County,2019,April,3,4,6428,6176,252,3.9,Not seasonally adjusted
Pemiscot County,2019,March,3,3,6407,6061,346,5.4,Not seasonally adjusted
Pemiscot County,2019,February,3,2,6380,6024,356,5.6,Not seasonally adjusted
Pemiscot County,2019,January,3,1,6350,5986,364,5.7,Not seasonally adjusted
Perry County,2020,May,3,5,10263,8988,1275,12.4,Not seasonally adjusted
Perry County,2020,April,3,4,10675,9096,1579,14.8,Not seasonally adjusted
Perry County,2020,March,3,3,10160,9845,315,3.1,Not seasonally adjusted
Perry County,2020,February,3,2,10011,9704,307,3.1,Not seasonally adjusted
Perry County,2020,January,3,1,10077,9746,331,3.3,Not seasonally adjusted
Perry County,2019,Annual Averages,1,0,10065,9801,264,2.6,Not seasonally adjusted
Perry County,2019,December,3,12,10061,9786,275,2.7,Not seasonally adjusted
Perry County,2019,November,3,11,10014,9748,266,2.7,Not seasonally adjusted
Perry County,2019,October,3,10,10050,9842,208,2.1,Not seasonally adjusted
Perry County,2019,September,3,9,9847,9642,205,2.1,Not seasonally adjusted
Perry County,2019,August,3,8,9911,9645,266,2.7,Not seasonally adjusted
Perry County,2019,July,3,7,9981,9693,288,2.9,Not seasonally adjusted
Perry County,2019,June,3,6,10113,9828,285,2.8,Not seasonally adjusted
Perry County,2019,May,3,5,10102,9873,229,2.3,Not seasonally adjusted
Perry County,2019,April,3,4,10156,9936,220,2.2,Not seasonally adjusted
Perry County,2019,March,3,3,10119,9816,303,3,Not seasonally adjusted
Perry County,2019,February,3,2,10164,9847,317,3.1,Not seasonally adjusted
Perry County,2019,January,3,1,10266,9955,311,3,Not seasonally adjusted
Pettis County,2020,May,3,5,21323,19024,2299,10.8,Not seasonally adjusted
Pettis County,2020,April,3,4,21327,19170,2157,10.1,Not seasonally adjusted
Pettis County,2020,March,3,3,21910,20742,1168,5.3,Not seasonally adjusted
Pettis County,2020,February,3,2,21799,20469,1330,6.1,Not seasonally adjusted
Pettis County,2020,January,3,1,21245,20356,889,4.2,Not seasonally adjusted
Pettis County,2019,Annual Averages,1,0,20971,20227,744,3.5,Not seasonally adjusted
Pettis County,2019,December,3,12,21095,20388,707,3.4,Not seasonally adjusted
Pettis County,2019,November,3,11,21276,20400,876,4.1,Not seasonally adjusted
Pettis County,2019,October,3,10,21168,20597,571,2.7,Not seasonally adjusted
Pettis County,2019,September,3,9,20862,20323,539,2.6,Not seasonally adjusted
Pettis County,2019,August,3,8,21178,20310,868,4.1,Not seasonally adjusted
Pettis County,2019,July,3,7,20651,19728,923,4.5,Not seasonally adjusted
Pettis County,2019,June,3,6,20879,20072,807,3.9,Not seasonally adjusted
Pettis County,2019,May,3,5,20914,20259,655,3.1,Not seasonally adjusted
Pettis County,2019,April,3,4,20804,20255,549,2.6,Not seasonally adjusted
Pettis County,2019,March,3,3,21001,20195,806,3.8,Not seasonally adjusted
Pettis County,2019,February,3,2,20996,20177,819,3.9,Not seasonally adjusted
Pettis County,2019,January,3,1,20827,20015,812,3.9,Not seasonally adjusted
Phelps County,2020,May,3,5,18913,17764,1149,6.1,Not seasonally adjusted
Phelps County,2020,April,3,4,19102,17826,1276,6.7,Not seasonally adjusted
Phelps County,2020,March,3,3,20383,19595,788,3.9,Not seasonally adjusted
Phelps County,2020,February,3,2,19945,19181,764,3.8,Not seasonally adjusted
Phelps County,2020,January,3,1,19922,19033,889,4.5,Not seasonally adjusted
Phelps County,2019,Annual Averages,1,0,19828,19177,651,3.3,Not seasonally adjusted
Phelps County,2019,December,3,12,19934,19258,676,3.4,Not seasonally adjusted
Phelps County,2019,November,3,11,19915,19289,626,3.1,Not seasonally adjusted
Phelps County,2019,October,3,10,19864,19335,529,2.7,Not seasonally adjusted
Phelps County,2019,September,3,9,19791,19276,515,2.6,Not seasonally adjusted
Phelps County,2019,August,3,8,19854,19178,676,3.4,Not seasonally adjusted
Phelps County,2019,July,3,7,19570,18831,739,3.8,Not seasonally adjusted
Phelps County,2019,June,3,6,19743,19057,686,3.5,Not seasonally adjusted
Phelps County,2019,May,3,5,19910,19315,595,3,Not seasonally adjusted
Phelps County,2019,April,3,4,19812,19277,535,2.7,Not seasonally adjusted
Phelps County,2019,March,3,3,19959,19249,710,3.6,Not seasonally adjusted
Phelps County,2019,February,3,2,19924,19177,747,3.7,Not seasonally adjusted
Phelps County,2019,January,3,1,19664,18882,782,4,Not seasonally adjusted
Pike County,2020,May,3,5,7478,6795,683,9.1,Not seasonally adjusted
Pike County,2020,April,3,4,7457,6848,609,8.2,Not seasonally adjusted
Pike County,2020,March,3,3,7738,7428,310,4,Not seasonally adjusted
Pike County,2020,February,3,2,7481,7181,300,4,Not seasonally adjusted
Pike County,2020,January,3,1,7428,7068,360,4.8,Not seasonally adjusted
Pike County,2019,Annual Averages,1,0,7492,7224,268,3.6,Not seasonally adjusted
Pike County,2019,December,3,12,7504,7225,279,3.7,Not seasonally adjusted
Pike County,2019,November,3,11,7483,7227,256,3.4,Not seasonally adjusted
Pike County,2019,October,3,10,7528,7297,231,3.1,Not seasonally adjusted
Pike County,2019,September,3,9,7419,7198,221,3,Not seasonally adjusted
Pike County,2019,August,3,8,7325,7034,291,4,Not seasonally adjusted
Pike County,2019,July,3,7,7293,6996,297,4.1,Not seasonally adjusted
Pike County,2019,June,3,6,7535,7248,287,3.8,Not seasonally adjusted
Pike County,2019,May,3,5,7582,7344,238,3.1,Not seasonally adjusted
Pike County,2019,April,3,4,7599,7377,222,2.9,Not seasonally adjusted
Pike County,2019,March,3,3,7611,7328,283,3.7,Not seasonally adjusted
Pike County,2019,February,3,2,7583,7294,289,3.8,Not seasonally adjusted
Pike County,2019,January,3,1,7437,7120,317,4.3,Not seasonally adjusted
Platte County,2020,May,3,5,57195,51387,5808,10.2,Not seasonally adjusted
Platte County,2020,April,3,4,57026,51326,5700,10,Not seasonally adjusted
Platte County,2020,March,3,3,59422,57649,1773,3,Not seasonally adjusted
Platte County,2020,February,3,2,58888,57286,1602,2.7,Not seasonally adjusted
Platte County,2020,January,3,1,58694,56795,1899,3.2,Not seasonally adjusted
Platte County,2019,Annual Averages,1,0,58805,57239,1566,2.7,Not seasonally adjusted
Platte County,2019,December,3,12,59109,57523,1586,2.7,Not seasonally adjusted
Platte County,2019,November,3,11,59208,57757,1451,2.5,Not seasonally adjusted
Platte County,2019,October,3,10,59202,57823,1379,2.3,Not seasonally adjusted
Platte County,2019,September,3,9,58901,57659,1242,2.1,Not seasonally adjusted
Platte County,2019,August,3,8,59037,57384,1653,2.8,Not seasonally adjusted
Platte County,2019,July,3,7,60086,57897,2189,3.6,Not seasonally adjusted
Platte County,2019,June,3,6,59390,57811,1579,2.7,Not seasonally adjusted
Platte County,2019,May,3,5,58360,56954,1406,2.4,Not seasonally adjusted
Platte County,2019,April,3,4,58116,56856,1260,2.2,Not seasonally adjusted
Platte County,2019,March,3,3,58198,56476,1722,3,Not seasonally adjusted
Platte County,2019,February,3,2,58086,56456,1630,2.8,Not seasonally adjusted
Platte County,2019,January,3,1,57963,56270,1693,2.9,Not seasonally adjusted
Polk County,2020,May,3,5,14010,13103,907,6.5,Not seasonally adjusted
Polk County,2020,April,3,4,14019,13157,862,6.1,Not seasonally adjusted
Polk County,2020,March,3,3,14836,14319,517,3.5,Not seasonally adjusted
Polk County,2020,February,3,2,14727,14231,496,3.4,Not seasonally adjusted
Polk County,2020,January,3,1,14782,14191,591,4,Not seasonally adjusted
Polk County,2019,Annual Averages,1,0,14584,14081,503,3.4,Not seasonally adjusted
Polk County,2019,December,3,12,14680,14202,478,3.3,Not seasonally adjusted
Polk County,2019,November,3,11,14665,14220,445,3,Not seasonally adjusted
Polk County,2019,October,3,10,14799,14339,460,3.1,Not seasonally adjusted
Polk County,2019,September,3,9,14589,14116,473,3.2,Not seasonally adjusted
Polk County,2019,August,3,8,14425,13866,559,3.9,Not seasonally adjusted
Polk County,2019,July,3,7,14708,14175,533,3.6,Not seasonally adjusted
Polk County,2019,June,3,6,14483,13971,512,3.5,Not seasonally adjusted
Polk County,2019,May,3,5,14533,14085,448,3.1,Not seasonally adjusted
Polk County,2019,April,3,4,14490,14080,410,2.8,Not seasonally adjusted
Polk County,2019,March,3,3,14557,14008,549,3.8,Not seasonally adjusted
Polk County,2019,February,3,2,14579,14006,573,3.9,Not seasonally adjusted
Polk County,2019,January,3,1,14503,13906,597,4.1,Not seasonally adjusted
Pulaski County,2020,May,3,5,14233,13150,1083,7.6,Not seasonally adjusted
Pulaski County,2020,April,3,4,14324,13213,1111,7.8,Not seasonally adjusted
Pulaski County,2020,March,3,3,15090,14453,637,4.2,Not seasonally adjusted
Pulaski County,2020,February,3,2,14809,14210,599,4,Not seasonally adjusted
Pulaski County,2020,January,3,1,14787,14056,731,4.9,Not seasonally adjusted
Pulaski County,2019,Annual Averages,1,0,14692,14094,598,4.1,Not seasonally adjusted
Pulaski County,2019,December,3,12,14715,14022,693,4.7,Not seasonally adjusted
Pulaski County,2019,November,3,11,14780,14151,629,4.3,Not seasonally adjusted
Pulaski County,2019,October,3,10,14708,14168,540,3.7,Not seasonally adjusted
Pulaski County,2019,September,3,9,14680,14091,589,4,Not seasonally adjusted
Pulaski County,2019,August,3,8,14717,14065,652,4.4,Not seasonally adjusted
Pulaski County,2019,July,3,7,14535,13939,596,4.1,Not seasonally adjusted
Pulaski County,2019,June,3,6,14781,14223,558,3.8,Not seasonally adjusted
Pulaski County,2019,May,3,5,14699,14110,589,4,Not seasonally adjusted
Pulaski County,2019,April,3,4,14583,14119,464,3.2,Not seasonally adjusted
Pulaski County,2019,March,3,3,14694,14059,635,4.3,Not seasonally adjusted
Pulaski County,2019,February,3,2,14776,14164,612,4.1,Not seasonally adjusted
Pulaski County,2019,January,3,1,14634,14011,623,4.3,Not seasonally adjusted
Putnam County,2020,May,3,5,2295,2156,139,6.1,Not seasonally adjusted
Putnam County,2020,April,3,4,2343,2223,120,5.1,Not seasonally adjusted
Putnam County,2020,March,3,3,2316,2226,90,3.9,Not seasonally adjusted
Putnam County,2020,February,3,2,2306,2215,91,3.9,Not seasonally adjusted
Putnam County,2020,January,3,1,2306,2195,111,4.8,Not seasonally adjusted
Putnam County,2019,Annual Averages,1,0,2291,2207,84,3.7,Not seasonally adjusted
Putnam County,2019,December,3,12,2225,2150,75,3.4,Not seasonally adjusted
Putnam County,2019,November,3,11,2237,2172,65,2.9,Not seasonally adjusted
Putnam County,2019,October,3,10,2331,2266,65,2.8,Not seasonally adjusted
Putnam County,2019,September,3,9,2186,2116,70,3.2,Not seasonally adjusted
Putnam County,2019,August,3,8,2215,2108,107,4.8,Not seasonally adjusted
Putnam County,2019,July,3,7,2227,2142,85,3.8,Not seasonally adjusted
Putnam County,2019,June,3,6,2244,2166,78,3.5,Not seasonally adjusted
Putnam County,2019,May,3,5,2353,2279,74,3.1,Not seasonally adjusted
Putnam County,2019,April,3,4,2391,2325,66,2.8,Not seasonally adjusted
Putnam County,2019,March,3,3,2343,2249,94,4,Not seasonally adjusted
Putnam County,2019,February,3,2,2373,2271,102,4.3,Not seasonally adjusted
Putnam County,2019,January,3,1,2359,2237,122,5.2,Not seasonally adjusted
Ralls County,2020,May,3,5,5508,5179,329,6,Not seasonally adjusted
Ralls County,2020,April,3,4,5606,5232,374,6.7,Not seasonally adjusted
Ralls County,2020,March,3,3,5746,5548,198,3.4,Not seasonally adjusted
Ralls County,2020,February,3,2,5639,5429,210,3.7,Not seasonally adjusted
Ralls County,2020,January,3,1,5677,5451,226,4,Not seasonally adjusted
Ralls County,2019,Annual Averages,1,0,5662,5484,178,3.1,Not seasonally adjusted
Ralls County,2019,December,3,12,5708,5529,179,3.1,Not seasonally adjusted
Ralls County,2019,November,3,11,5745,5583,162,2.8,Not seasonally adjusted
Ralls County,2019,October,3,10,5715,5579,136,2.4,Not seasonally adjusted
Ralls County,2019,September,3,9,5623,5500,123,2.2,Not seasonally adjusted
Ralls County,2019,August,3,8,5521,5356,165,3,Not seasonally adjusted
Ralls County,2019,July,3,7,5612,5437,175,3.1,Not seasonally adjusted
Ralls County,2019,June,3,6,5658,5487,171,3,Not seasonally adjusted
Ralls County,2019,May,3,5,5667,5504,163,2.9,Not seasonally adjusted
Ralls County,2019,April,3,4,5698,5543,155,2.7,Not seasonally adjusted
Ralls County,2019,March,3,3,5693,5456,237,4.2,Not seasonally adjusted
Ralls County,2019,February,3,2,5652,5411,241,4.3,Not seasonally adjusted
Ralls County,2019,January,3,1,5650,5426,224,4,Not seasonally adjusted
Randolph County,2020,May,3,5,10157,9263,894,8.8,Not seasonally adjusted
Randolph County,2020,April,3,4,10245,9345,900,8.8,Not seasonally adjusted
Randolph County,2020,March,3,3,10694,10234,460,4.3,Not seasonally adjusted
Randolph County,2020,February,3,2,10623,10173,450,4.2,Not seasonally adjusted
Randolph County,2020,January,3,1,10442,9939,503,4.8,Not seasonally adjusted
Randolph County,2019,Annual Averages,1,0,10380,9978,402,3.9,Not seasonally adjusted
Randolph County,2019,December,3,12,10528,10107,421,4,Not seasonally adjusted
Randolph County,2019,November,3,11,10513,10117,396,3.8,Not seasonally adjusted
Randolph County,2019,October,3,10,10475,10155,320,3.1,Not seasonally adjusted
Randolph County,2019,September,3,9,10401,10071,330,3.2,Not seasonally adjusted
Randolph County,2019,August,3,8,10059,9631,428,4.3,Not seasonally adjusted
Randolph County,2019,July,3,7,10304,9823,481,4.7,Not seasonally adjusted
Randolph County,2019,June,3,6,10371,9962,409,3.9,Not seasonally adjusted
Randolph County,2019,May,3,5,10428,10087,341,3.3,Not seasonally adjusted
Randolph County,2019,April,3,4,10344,10042,302,2.9,Not seasonally adjusted
Randolph County,2019,March,3,3,10493,10055,438,4.2,Not seasonally adjusted
Randolph County,2019,February,3,2,10453,9971,482,4.6,Not seasonally adjusted
Randolph County,2019,January,3,1,10187,9711,476,4.7,Not seasonally adjusted
Ray County,2020,May,3,5,11268,9601,1667,14.8,Not seasonally adjusted
Ray County,2020,April,3,4,11334,9608,1726,15.2,Not seasonally adjusted
Ray County,2020,March,3,3,11136,10711,425,3.8,Not seasonally adjusted
Ray County,2020,February,3,2,11073,10657,416,3.8,Not seasonally adjusted
Ray County,2020,January,3,1,11050,10572,478,4.3,Not seasonally adjusted
Ray County,2019,Annual Averages,1,0,11033,10632,401,3.6,Not seasonally adjusted
Ray County,2019,December,3,12,11062,10676,386,3.5,Not seasonally adjusted
Ray County,2019,November,3,11,11067,10720,347,3.1,Not seasonally adjusted
Ray County,2019,October,3,10,11089,10768,321,2.9,Not seasonally adjusted
Ray County,2019,September,3,9,10984,10687,297,2.7,Not seasonally adjusted
Ray County,2019,August,3,8,11083,10635,448,4,Not seasonally adjusted
Ray County,2019,July,3,7,11320,10733,587,5.2,Not seasonally adjusted
Ray County,2019,June,3,6,11148,10708,440,3.9,Not seasonally adjusted
Ray County,2019,May,3,5,10932,10600,332,3,Not seasonally adjusted
Ray County,2019,April,3,4,10904,10595,309,2.8,Not seasonally adjusted
Ray County,2019,March,3,3,10936,10501,435,4,Not seasonally adjusted
Ray County,2019,February,3,2,10949,10497,452,4.1,Not seasonally adjusted
Ray County,2019,January,3,1,10923,10469,454,4.2,Not seasonally adjusted
Reynolds County,2020,May,3,5,2934,2716,218,7.4,Not seasonally adjusted
Reynolds County,2020,April,3,4,2956,2742,214,7.2,Not seasonally adjusted
Reynolds County,2020,March,3,3,3051,2908,143,4.7,Not seasonally adjusted
Reynolds County,2020,February,3,2,3010,2881,129,4.3,Not seasonally adjusted
Reynolds County,2020,January,3,1,3031,2883,148,4.9,Not seasonally adjusted
Reynolds County,2019,Annual Averages,1,0,3042,2929,113,3.7,Not seasonally adjusted
Reynolds County,2019,December,3,12,2996,2871,125,4.2,Not seasonally adjusted
Reynolds County,2019,November,3,11,2992,2882,110,3.7,Not seasonally adjusted
Reynolds County,2019,October,3,10,3056,2961,95,3.1,Not seasonally adjusted
Reynolds County,2019,September,3,9,3041,2953,88,2.9,Not seasonally adjusted
Reynolds County,2019,August,3,8,2933,2812,121,4.1,Not seasonally adjusted
Reynolds County,2019,July,3,7,3051,2934,117,3.8,Not seasonally adjusted
Reynolds County,2019,June,3,6,3230,3128,102,3.2,Not seasonally adjusted
Reynolds County,2019,May,3,5,3108,3009,99,3.2,Not seasonally adjusted
Reynolds County,2019,April,3,4,3021,2921,100,3.3,Not seasonally adjusted
Reynolds County,2019,March,3,3,3038,2907,131,4.3,Not seasonally adjusted
Reynolds County,2019,February,3,2,3019,2883,136,4.5,Not seasonally adjusted
Reynolds County,2019,January,3,1,3012,2886,126,4.2,Not seasonally adjusted
Ripley County,2020,May,3,5,5090,4466,624,12.3,Not seasonally adjusted
Ripley County,2020,April,3,4,5138,4502,636,12.4,Not seasonally adjusted
Ripley County,2020,March,3,3,5093,4840,253,5,Not seasonally adjusted
Ripley County,2020,February,3,2,5017,4769,248,4.9,Not seasonally adjusted
Ripley County,2020,January,3,1,5046,4768,278,5.5,Not seasonally adjusted
Ripley County,2019,Annual Averages,1,0,5039,4761,278,5.5,Not seasonally adjusted
Ripley County,2019,December,3,12,5026,4777,249,5,Not seasonally adjusted
Ripley County,2019,November,3,11,4990,4780,210,4.2,Not seasonally adjusted
Ripley County,2019,October,3,10,5069,4881,188,3.7,Not seasonally adjusted
Ripley County,2019,September,3,9,4974,4800,174,3.5,Not seasonally adjusted
Ripley County,2019,August,3,8,4842,4574,268,5.5,Not seasonally adjusted
Ripley County,2019,July,3,7,4929,4604,325,6.6,Not seasonally adjusted
Ripley County,2019,June,3,6,5152,4761,391,7.6,Not seasonally adjusted
Ripley County,2019,May,3,5,5167,4827,340,6.6,Not seasonally adjusted
Ripley County,2019,April,3,4,5159,4844,315,6.1,Not seasonally adjusted
Ripley County,2019,March,3,3,5074,4781,293,5.8,Not seasonally adjusted
Ripley County,2019,February,3,2,5052,4753,299,5.9,Not seasonally adjusted
Ripley County,2019,January,3,1,5039,4754,285,5.7,Not seasonally adjusted
Saline County,2020,May,3,5,10565,10065,500,4.7,Not seasonally adjusted
Saline County,2020,April,3,4,10703,10195,508,4.7,Not seasonally adjusted
Saline County,2020,March,3,3,11194,10788,406,3.6,Not seasonally adjusted
Saline County,2020,February,3,2,10729,10287,442,4.1,Not seasonally adjusted
Saline County,2020,January,3,1,10731,10270,461,4.3,Not seasonally adjusted
Saline County,2019,Annual Averages,1,0,10608,10267,341,3.2,Not seasonally adjusted
Saline County,2019,December,3,12,10566,10221,345,3.3,Not seasonally adjusted
Saline County,2019,November,3,11,10595,10260,335,3.2,Not seasonally adjusted
Saline County,2019,October,3,10,10711,10458,253,2.4,Not seasonally adjusted
Saline County,2019,September,3,9,10476,10228,248,2.4,Not seasonally adjusted
Saline County,2019,August,3,8,10156,9787,369,3.6,Not seasonally adjusted
Saline County,2019,July,3,7,10298,9882,416,4,Not seasonally adjusted
Saline County,2019,June,3,6,10790,10401,389,3.6,Not seasonally adjusted
Saline County,2019,May,3,5,10723,10401,322,3,Not seasonally adjusted
Saline County,2019,April,3,4,10842,10567,275,2.5,Not seasonally adjusted
Saline County,2019,March,3,3,10726,10339,387,3.6,Not seasonally adjusted
Saline County,2019,February,3,2,10719,10339,380,3.5,Not seasonally adjusted
Saline County,2019,January,3,1,10695,10323,372,3.5,Not seasonally adjusted
Schuyler County,2020,May,3,5,1902,1803,99,5.2,Not seasonally adjusted
Schuyler County,2020,April,3,4,1967,1840,127,6.5,Not seasonally adjusted
Schuyler County,2020,March,3,3,1971,1873,98,5,Not seasonally adjusted
Schuyler County,2020,February,3,2,1969,1871,98,5,Not seasonally adjusted
Schuyler County,2020,January,3,1,1965,1860,105,5.3,Not seasonally adjusted
Schuyler County,2019,Annual Averages,1,0,1948,1862,86,4.4,Not seasonally adjusted
Schuyler County,2019,December,3,12,1932,1860,72,3.7,Not seasonally adjusted
Schuyler County,2019,November,3,11,1943,1875,68,3.5,Not seasonally adjusted
Schuyler County,2019,October,3,10,2012,1932,80,4,Not seasonally adjusted
Schuyler County,2019,September,3,9,1898,1830,68,3.6,Not seasonally adjusted
Schuyler County,2019,August,3,8,1849,1758,91,4.9,Not seasonally adjusted
Schuyler County,2019,July,3,7,1895,1785,110,5.8,Not seasonally adjusted
Schuyler County,2019,June,3,6,1901,1807,94,4.9,Not seasonally adjusted
Schuyler County,2019,May,3,5,1978,1911,67,3.4,Not seasonally adjusted
Schuyler County,2019,April,3,4,2011,1951,60,3,Not seasonally adjusted
Schuyler County,2019,March,3,3,1982,1877,105,5.3,Not seasonally adjusted
Schuyler County,2019,February,3,2,1992,1880,112,5.6,Not seasonally adjusted
Schuyler County,2019,January,3,1,1986,1876,110,5.5,Not seasonally adjusted
Scotland County,2020,May,3,5,2350,2270,80,3.4,Not seasonally adjusted
Scotland County,2020,April,3,4,2432,2324,108,4.4,Not seasonally adjusted
Scotland County,2020,March,3,3,2428,2350,78,3.2,Not seasonally adjusted
Scotland County,2020,February,3,2,2420,2347,73,3,Not seasonally adjusted
Scotland County,2020,January,3,1,2451,2357,94,3.8,Not seasonally adjusted
Scotland County,2019,Annual Averages,1,0,2384,2311,73,3.1,Not seasonally adjusted
Scotland County,2019,December,3,12,2365,2310,55,2.3,Not seasonally adjusted
Scotland County,2019,November,3,11,2386,2325,61,2.6,Not seasonally adjusted
Scotland County,2019,October,3,10,2479,2417,62,2.5,Not seasonally adjusted
Scotland County,2019,September,3,9,2338,2283,55,2.4,Not seasonally adjusted
Scotland County,2019,August,3,8,2320,2243,77,3.3,Not seasonally adjusted
Scotland County,2019,July,3,7,2346,2274,72,3.1,Not seasonally adjusted
Scotland County,2019,June,3,6,2354,2279,75,3.2,Not seasonally adjusted
Scotland County,2019,May,3,5,2434,2360,74,3,Not seasonally adjusted
Scotland County,2019,April,3,4,2451,2390,61,2.5,Not seasonally adjusted
Scotland County,2019,March,3,3,2385,2291,94,3.9,Not seasonally adjusted
Scotland County,2019,February,3,2,2361,2267,94,4,Not seasonally adjusted
Scotland County,2019,January,3,1,2392,2298,94,3.9,Not seasonally adjusted
Scott County,2020,May,3,5,19223,17824,1399,7.3,Not seasonally adjusted
Scott County,2020,April,3,4,19655,18146,1509,7.7,Not seasonally adjusted
Scott County,2020,March,3,3,20446,19545,901,4.4,Not seasonally adjusted
Scott County,2020,February,3,2,20131,19317,814,4,Not seasonally adjusted
Scott County,2020,January,3,1,20122,19258,864,4.3,Not seasonally adjusted
Scott County,2019,Annual Averages,1,0,20000,19293,707,3.5,Not seasonally adjusted
Scott County,2019,December,3,12,20054,19310,744,3.7,Not seasonally adjusted
Scott County,2019,November,3,11,19960,19274,686,3.4,Not seasonally adjusted
Scott County,2019,October,3,10,20146,19540,606,3,Not seasonally adjusted
Scott County,2019,September,3,9,19765,19191,574,2.9,Not seasonally adjusted
Scott County,2019,August,3,8,19642,18881,761,3.9,Not seasonally adjusted
Scott County,2019,July,3,7,19700,18798,902,4.6,Not seasonally adjusted
Scott County,2019,June,3,6,20055,19269,786,3.9,Not seasonally adjusted
Scott County,2019,May,3,5,20141,19518,623,3.1,Not seasonally adjusted
Scott County,2019,April,3,4,20177,19631,546,2.7,Not seasonally adjusted
Scott County,2019,March,3,3,20114,19373,741,3.7,Not seasonally adjusted
Scott County,2019,February,3,2,20101,19364,737,3.7,Not seasonally adjusted
Scott County,2019,January,3,1,20150,19367,783,3.9,Not seasonally adjusted
Shannon County,2020,May,3,5,3286,2968,318,9.7,Not seasonally adjusted
Shannon County,2020,April,3,4,3397,3015,382,11.2,Not seasonally adjusted
Shannon County,2020,March,3,3,3339,3106,233,7,Not seasonally adjusted
Shannon County,2020,February,3,2,3208,3006,202,6.3,Not seasonally adjusted
Shannon County,2020,January,3,1,3251,3032,219,6.7,Not seasonally adjusted
Shannon County,2019,Annual Averages,1,0,3228,3048,180,5.6,Not seasonally adjusted
Shannon County,2019,December,3,12,3209,3000,209,6.5,Not seasonally adjusted
Shannon County,2019,November,3,11,3197,3016,181,5.7,Not seasonally adjusted
Shannon County,2019,October,3,10,3306,3163,143,4.3,Not seasonally adjusted
Shannon County,2019,September,3,9,3169,3048,121,3.8,Not seasonally adjusted
Shannon County,2019,August,3,8,3150,2985,165,5.2,Not seasonally adjusted
Shannon County,2019,July,3,7,3224,3038,186,5.8,Not seasonally adjusted
Shannon County,2019,June,3,6,3289,3110,179,5.4,Not seasonally adjusted
Shannon County,2019,May,3,5,3289,3137,152,4.6,Not seasonally adjusted
Shannon County,2019,April,3,4,3250,3102,148,4.6,Not seasonally adjusted
Shannon County,2019,March,3,3,3222,3002,220,6.8,Not seasonally adjusted
Shannon County,2019,February,3,2,3204,2972,232,7.2,Not seasonally adjusted
Shannon County,2019,January,3,1,3236,3008,228,7,Not seasonally adjusted
Shelby County,2020,May,3,5,3071,2937,134,4.4,Not seasonally adjusted
Shelby County,2020,April,3,4,3127,2994,133,4.3,Not seasonally adjusted
Shelby County,2020,March,3,3,3237,3080,157,4.9,Not seasonally adjusted
Shelby County,2020,February,3,2,3179,3035,144,4.5,Not seasonally adjusted
Shelby County,2020,January,3,1,3173,3029,144,4.5,Not seasonally adjusted
Shelby County,2019,Annual Averages,1,0,3061,2970,91,3,Not seasonally adjusted
Shelby County,2019,December,3,12,3060,2962,98,3.2,Not seasonally adjusted
Shelby County,2019,November,3,11,3060,2983,77,2.5,Not seasonally adjusted
Shelby County,2019,October,3,10,3141,3081,60,1.9,Not seasonally adjusted
Shelby County,2019,September,3,9,3010,2955,55,1.8,Not seasonally adjusted
Shelby County,2019,August,3,8,2913,2838,75,2.6,Not seasonally adjusted
Shelby County,2019,July,3,7,2902,2817,85,2.9,Not seasonally adjusted
Shelby County,2019,June,3,6,3066,2989,77,2.5,Not seasonally adjusted
Shelby County,2019,May,3,5,3141,3071,70,2.2,Not seasonally adjusted
Shelby County,2019,April,3,4,3139,3072,67,2.1,Not seasonally adjusted
Shelby County,2019,March,3,3,3103,2961,142,4.6,Not seasonally adjusted
Shelby County,2019,February,3,2,3100,2954,146,4.7,Not seasonally adjusted
Shelby County,2019,January,3,1,3095,2959,136,4.4,Not seasonally adjusted
St. Charles County,2020,May,3,5,219560,198885,20675,9.4,Not seasonally adjusted
St. Charles County,2020,April,3,4,221541,200359,21182,9.6,Not seasonally adjusted
St. Charles County,2020,March,3,3,230397,223260,7137,3.1,Not seasonally adjusted
St. Charles County,2020,February,3,2,226899,220432,6467,2.9,Not seasonally adjusted
St. Charles County,2020,January,3,1,228350,219683,8667,3.8,Not seasonally adjusted
St. Charles County,2019,Annual Averages,1,0,227085,221305,5780,2.5,Not seasonally adjusted
St. Charles County,2019,December,3,12,227773,221693,6080,2.7,Not seasonally adjusted
St. Charles County,2019,November,3,11,228381,222847,5534,2.4,Not seasonally adjusted
St. Charles County,2019,October,3,10,228399,223263,5136,2.2,Not seasonally adjusted
St. Charles County,2019,September,3,9,227777,223159,4618,2,Not seasonally adjusted
St. Charles County,2019,August,3,8,228067,222034,6033,2.6,Not seasonally adjusted
St. Charles County,2019,July,3,7,231144,224831,6313,2.7,Not seasonally adjusted
St. Charles County,2019,June,3,6,229219,223266,5953,2.6,Not seasonally adjusted
St. Charles County,2019,May,3,5,225606,220332,5274,2.3,Not seasonally adjusted
St. Charles County,2019,April,3,4,224952,220168,4784,2.1,Not seasonally adjusted
St. Charles County,2019,March,3,3,225141,218649,6492,2.9,Not seasonally adjusted
St. Charles County,2019,February,3,2,225220,218745,6475,2.9,Not seasonally adjusted
St. Charles County,2019,January,3,1,223345,216678,6667,3,Not seasonally adjusted
St. Clair County,2020,May,3,5,3751,3443,308,8.2,Not seasonally adjusted
St. Clair County,2020,April,3,4,3790,3497,293,7.7,Not seasonally adjusted
St. Clair County,2020,March,3,3,3839,3669,170,4.4,Not seasonally adjusted
St. Clair County,2020,February,3,2,3776,3593,183,4.8,Not seasonally adjusted
St. Clair County,2020,January,3,1,3831,3611,220,5.7,Not seasonally adjusted
St. Clair County,2019,Annual Averages,1,0,3749,3577,172,4.6,Not seasonally adjusted
St. Clair County,2019,December,3,12,3748,3572,176,4.7,Not seasonally adjusted
St. Clair County,2019,November,3,11,3711,3566,145,3.9,Not seasonally adjusted
St. Clair County,2019,October,3,10,3796,3656,140,3.7,Not seasonally adjusted
St. Clair County,2019,September,3,9,3656,3520,136,3.7,Not seasonally adjusted
St. Clair County,2019,August,3,8,3552,3354,198,5.6,Not seasonally adjusted
St. Clair County,2019,July,3,7,3654,3450,204,5.6,Not seasonally adjusted
St. Clair County,2019,June,3,6,3759,3561,198,5.3,Not seasonally adjusted
St. Clair County,2019,May,3,5,3863,3703,160,4.1,Not seasonally adjusted
St. Clair County,2019,April,3,4,3796,3672,124,3.3,Not seasonally adjusted
St. Clair County,2019,March,3,3,3788,3610,178,4.7,Not seasonally adjusted
St. Clair County,2019,February,3,2,3810,3612,198,5.2,Not seasonally adjusted
St. Clair County,2019,January,3,1,3846,3643,203,5.3,Not seasonally adjusted
St. Francois County,2020,May,3,5,26450,23620,2830,10.7,Not seasonally adjusted
St. Francois County,2020,April,3,4,26347,23703,2644,10,Not seasonally adjusted
St. Francois County,2020,March,3,3,27443,26044,1399,5.1,Not seasonally adjusted
St. Francois County,2020,February,3,2,26766,25428,1338,5,Not seasonally adjusted
St. Francois County,2020,January,3,1,26833,25429,1404,5.2,Not seasonally adjusted
St. Francois County,2019,Annual Averages,1,0,26637,25658,979,3.7,Not seasonally adjusted
St. Francois County,2019,December,3,12,26896,25788,1108,4.1,Not seasonally adjusted
St. Francois County,2019,November,3,11,26717,25766,951,3.6,Not seasonally adjusted
St. Francois County,2019,October,3,10,26571,25777,794,3,Not seasonally adjusted
St. Francois County,2019,September,3,9,26498,25728,770,2.9,Not seasonally adjusted
St. Francois County,2019,August,3,8,26557,25528,1029,3.9,Not seasonally adjusted
St. Francois County,2019,July,3,7,26605,25509,1096,4.1,Not seasonally adjusted
St. Francois County,2019,June,3,6,27160,26143,1017,3.7,Not seasonally adjusted
St. Francois County,2019,May,3,5,26621,25769,852,3.2,Not seasonally adjusted
St. Francois County,2019,April,3,4,26457,25695,762,2.9,Not seasonally adjusted
St. Francois County,2019,March,3,3,26537,25465,1072,4,Not seasonally adjusted
St. Francois County,2019,February,3,2,26547,25416,1131,4.3,Not seasonally adjusted
St. Francois County,2019,January,3,1,26468,25307,1161,4.4,Not seasonally adjusted
St. Louis City,2020,May,3,5,152395,131847,20548,13.5,Not seasonally adjusted
St. Louis City,2020,April,3,4,150250,132658,17592,11.7,Not seasonally adjusted
St. Louis City,2020,March,3,3,155432,148348,7084,4.6,Not seasonally adjusted
St. Louis City,2020,February,3,2,152631,146529,6102,4,Not seasonally adjusted
St. Louis City,2020,January,3,1,153083,146125,6958,4.5,Not seasonally adjusted
St. Louis City,2019,Annual Averages,1,0,153066,147111,5955,3.9,Not seasonally adjusted
St. Louis City,2019,December,3,12,153635,147586,6049,3.9,Not seasonally adjusted
St. Louis City,2019,November,3,11,153834,148255,5579,3.6,Not seasonally adjusted
St. Louis City,2019,October,3,10,153435,148387,5048,3.3,Not seasonally adjusted
St. Louis City,2019,September,3,9,153343,148480,4863,3.2,Not seasonally adjusted
St. Louis City,2019,August,3,8,154409,147791,6618,4.3,Not seasonally adjusted
St. Louis City,2019,July,3,7,156762,149613,7149,4.6,Not seasonally adjusted
St. Louis City,2019,June,3,6,155046,148484,6562,4.2,Not seasonally adjusted
St. Louis City,2019,May,3,5,151574,146231,5343,3.5,Not seasonally adjusted
St. Louis City,2019,April,3,4,151014,145993,5021,3.3,Not seasonally adjusted
St. Louis City,2019,March,3,3,151722,145238,6484,4.3,Not seasonally adjusted
St. Louis City,2019,February,3,2,151495,145283,6212,4.1,Not seasonally adjusted
St. Louis City,2019,January,3,1,150522,143993,6529,4.3,Not seasonally adjusted
St. Louis County,2020,May,3,5,516310,463126,53184,10.3,Not seasonally adjusted
St. Louis County,2020,April,3,4,512721,465883,46838,9.1,Not seasonally adjusted
St. Louis County,2020,March,3,3,540304,520981,19323,3.6,Not seasonally adjusted
St. Louis County,2020,February,3,2,532080,514851,17229,3.2,Not seasonally adjusted
St. Louis County,2020,January,3,1,534164,513607,20557,3.8,Not seasonally adjusted
St. Louis County,2019,Annual Averages,1,0,533085,516722,16363,3.1,Not seasonally adjusted
St. Louis County,2019,December,3,12,535325,518621,16704,3.1,Not seasonally adjusted
St. Louis County,2019,November,3,11,536436,520839,15597,2.9,Not seasonally adjusted
St. Louis County,2019,October,3,10,535475,521425,14050,2.6,Not seasonally adjusted
St. Louis County,2019,September,3,9,534934,521484,13450,2.5,Not seasonally adjusted
St. Louis County,2019,August,3,8,537065,519166,17899,3.3,Not seasonally adjusted
St. Louis County,2019,July,3,7,544124,525536,18588,3.4,Not seasonally adjusted
St. Louis County,2019,June,3,6,538570,521358,17212,3.2,Not seasonally adjusted
St. Louis County,2019,May,3,5,528571,513492,15079,2.9,Not seasonally adjusted
St. Louis County,2019,April,3,4,526302,512584,13718,2.6,Not seasonally adjusted
St. Louis County,2019,March,3,3,528174,510087,18087,3.4,Not seasonally adjusted
St. Louis County,2019,February,3,2,527769,510196,17573,3.3,Not seasonally adjusted
St. Louis County,2019,January,3,1,524275,505878,18397,3.5,Not seasonally adjusted
Ste. Genevieve County,2020,May,3,5,9013,8292,721,8,Not seasonally adjusted
Ste. Genevieve County,2020,April,3,4,9151,8369,782,8.5,Not seasonally adjusted
Ste. Genevieve County,2020,March,3,3,9407,9045,362,3.8,Not seasonally adjusted
Ste. Genevieve County,2020,February,3,2,9219,8852,367,4,Not seasonally adjusted
Ste. Genevieve County,2020,January,3,1,9200,8850,350,3.8,Not seasonally adjusted
Ste. Genevieve County,2019,Annual Averages,1,0,9197,8950,247,2.7,Not seasonally adjusted
Ste. Genevieve County,2019,December,3,12,9171,8907,264,2.9,Not seasonally adjusted
Ste. Genevieve County,2019,November,3,11,9178,8938,240,2.6,Not seasonally adjusted
Ste. Genevieve County,2019,October,3,10,9243,9053,190,2.1,Not seasonally adjusted
Ste. Genevieve County,2019,September,3,9,9176,8997,179,2,Not seasonally adjusted
Ste. Genevieve County,2019,August,3,8,9111,8865,246,2.7,Not seasonally adjusted
Ste. Genevieve County,2019,July,3,7,9204,8922,282,3.1,Not seasonally adjusted
Ste. Genevieve County,2019,June,3,6,9340,9076,264,2.8,Not seasonally adjusted
Ste. Genevieve County,2019,May,3,5,9237,9036,201,2.2,Not seasonally adjusted
Ste. Genevieve County,2019,April,3,4,9212,9022,190,2.1,Not seasonally adjusted
Ste. Genevieve County,2019,March,3,3,9221,8925,296,3.2,Not seasonally adjusted
Ste. Genevieve County,2019,February,3,2,9157,8845,312,3.4,Not seasonally adjusted
Ste. Genevieve County,2019,January,3,1,9115,8810,305,3.3,Not seasonally adjusted
Stoddard County,2020,May,3,5,13109,12068,1041,7.9,Not seasonally adjusted
Stoddard County,2020,April,3,4,13601,12233,1368,10.1,Not seasonally adjusted
Stoddard County,2020,March,3,3,13651,12885,766,5.6,Not seasonally adjusted
Stoddard County,2020,February,3,2,13227,12540,687,5.2,Not seasonally adjusted
Stoddard County,2020,January,3,1,13263,12482,781,5.9,Not seasonally adjusted
Stoddard County,2019,Annual Averages,1,0,13098,12480,618,4.7,Not seasonally adjusted
Stoddard County,2019,December,3,12,13062,12434,628,4.8,Not seasonally adjusted
Stoddard County,2019,November,3,11,13009,12481,528,4.1,Not seasonally adjusted
Stoddard County,2019,October,3,10,13284,12784,500,3.8,Not seasonally adjusted
Stoddard County,2019,September,3,9,12896,12446,450,3.5,Not seasonally adjusted
Stoddard County,2019,August,3,8,12980,12334,646,5,Not seasonally adjusted
Stoddard County,2019,July,3,7,12909,12215,694,5.4,Not seasonally adjusted
Stoddard County,2019,June,3,6,13039,12331,708,5.4,Not seasonally adjusted
Stoddard County,2019,May,3,5,13323,12745,578,4.3,Not seasonally adjusted
Stoddard County,2019,April,3,4,13264,12722,542,4.1,Not seasonally adjusted
Stoddard County,2019,March,3,3,13142,12444,698,5.3,Not seasonally adjusted
Stoddard County,2019,February,3,2,13142,12443,699,5.3,Not seasonally adjusted
Stoddard County,2019,January,3,1,13119,12376,743,5.7,Not seasonally adjusted
Stone County,2020,May,3,5,14242,12034,2208,15.5,Not seasonally adjusted
Stone County,2020,April,3,4,14405,12037,2368,16.4,Not seasonally adjusted
Stone County,2020,March,3,3,13867,12899,968,7,Not seasonally adjusted
Stone County,2020,February,3,2,12976,11561,1415,10.9,Not seasonally adjusted
Stone County,2020,January,3,1,13335,11923,1412,10.6,Not seasonally adjusted
Stone County,2019,Annual Averages,1,0,13873,13185,688,5,Not seasonally adjusted
Stone County,2019,December,3,12,13731,13082,649,4.7,Not seasonally adjusted
Stone County,2019,November,3,11,13924,13379,545,3.9,Not seasonally adjusted
Stone County,2019,October,3,10,13910,13477,433,3.1,Not seasonally adjusted
Stone County,2019,September,3,9,13938,13526,412,3,Not seasonally adjusted
Stone County,2019,August,3,8,14368,13809,559,3.9,Not seasonally adjusted
Stone County,2019,July,3,7,14945,14380,565,3.8,Not seasonally adjusted
Stone County,2019,June,3,6,15013,14469,544,3.6,Not seasonally adjusted
Stone County,2019,May,3,5,13851,13343,508,3.7,Not seasonally adjusted
Stone County,2019,April,3,4,13426,12917,509,3.8,Not seasonally adjusted
Stone County,2019,March,3,3,13440,12585,855,6.4,Not seasonally adjusted
Stone County,2019,February,3,2,12863,11505,1358,10.6,Not seasonally adjusted
Stone County,2019,January,3,1,13062,11743,1319,10.1,Not seasonally adjusted
Sullivan County,2020,May,3,5,2655,2550,105,4,Not seasonally adjusted
Sullivan County,2020,April,3,4,2764,2601,163,5.9,Not seasonally adjusted
Sullivan County,2020,March,3,3,2816,2679,137,4.9,Not seasonally adjusted
Sullivan County,2020,February,3,2,2751,2624,127,4.6,Not seasonally adjusted
Sullivan County,2020,January,3,1,2754,2616,138,5,Not seasonally adjusted
Sullivan County,2019,Annual Averages,1,0,2684,2589,95,3.5,Not seasonally adjusted
Sullivan County,2019,December,3,12,2661,2563,98,3.7,Not seasonally adjusted
Sullivan County,2019,November,3,11,2640,2558,82,3.1,Not seasonally adjusted
Sullivan County,2019,October,3,10,2724,2641,83,3,Not seasonally adjusted
Sullivan County,2019,September,3,9,2600,2526,74,2.8,Not seasonally adjusted
Sullivan County,2019,August,3,8,2507,2402,105,4.2,Not seasonally adjusted
Sullivan County,2019,July,3,7,2603,2506,97,3.7,Not seasonally adjusted
Sullivan County,2019,June,3,6,2642,2553,89,3.4,Not seasonally adjusted
Sullivan County,2019,May,3,5,2750,2669,81,2.9,Not seasonally adjusted
Sullivan County,2019,April,3,4,2792,2717,75,2.7,Not seasonally adjusted
Sullivan County,2019,March,3,3,2759,2632,127,4.6,Not seasonally adjusted
Sullivan County,2019,February,3,2,2777,2652,125,4.5,Not seasonally adjusted
Sullivan County,2019,January,3,1,2756,2648,108,3.9,Not seasonally adjusted
Taney County,2020,May,3,5,30145,23488,6657,22.1,Not seasonally adjusted
Taney County,2020,April,3,4,31170,23517,7653,24.6,Not seasonally adjusted
Taney County,2020,March,3,3,27293,25189,2104,7.7,Not seasonally adjusted
Taney County,2020,February,3,2,25552,22379,3173,12.4,Not seasonally adjusted
Taney County,2020,January,3,1,26278,23059,3219,12.2,Not seasonally adjusted
Taney County,2019,Annual Averages,1,0,27142,25753,1389,5.1,Not seasonally adjusted
Taney County,2019,December,3,12,26567,25463,1104,4.2,Not seasonally adjusted
Taney County,2019,November,3,11,27038,26112,926,3.4,Not seasonally adjusted
Taney County,2019,October,3,10,27082,26247,835,3.1,Not seasonally adjusted
Taney County,2019,September,3,9,27258,26466,792,2.9,Not seasonally adjusted
Taney County,2019,August,3,8,28099,27013,1086,3.9,Not seasonally adjusted
Taney County,2019,July,3,7,29220,28175,1045,3.6,Not seasonally adjusted
Taney County,2019,June,3,6,29426,28442,984,3.3,Not seasonally adjusted
Taney County,2019,May,3,5,27057,26121,936,3.5,Not seasonally adjusted
Taney County,2019,April,3,4,26236,25276,960,3.7,Not seasonally adjusted
Taney County,2019,March,3,3,26270,24561,1709,6.5,Not seasonally adjusted
Taney County,2019,February,3,2,25502,22374,3128,12.3,Not seasonally adjusted
Taney County,2019,January,3,1,25949,22790,3159,12.2,Not seasonally adjusted
Texas County,2020,May,3,5,8709,8124,585,6.7,Not seasonally adjusted
Texas County,2020,April,3,4,8886,8235,651,7.3,Not seasonally adjusted
Texas County,2020,March,3,3,9131,8643,488,5.3,Not seasonally adjusted
Texas County,2020,February,3,2,9128,8691,437,4.8,Not seasonally adjusted
Texas County,2020,January,3,1,9218,8713,505,5.5,Not seasonally adjusted
Texas County,2019,Annual Averages,1,0,9009,8607,402,4.5,Not seasonally adjusted
Texas County,2019,December,3,12,9102,8642,460,5.1,Not seasonally adjusted
Texas County,2019,November,3,11,9064,8671,393,4.3,Not seasonally adjusted
Texas County,2019,October,3,10,9242,8904,338,3.7,Not seasonally adjusted
Texas County,2019,September,3,9,8965,8636,329,3.7,Not seasonally adjusted
Texas County,2019,August,3,8,8492,8062,430,5.1,Not seasonally adjusted
Texas County,2019,July,3,7,8405,7982,423,5,Not seasonally adjusted
Texas County,2019,June,3,6,9043,8652,391,4.3,Not seasonally adjusted
Texas County,2019,May,3,5,9259,8886,373,4,Not seasonally adjusted
Texas County,2019,April,3,4,9204,8879,325,3.5,Not seasonally adjusted
Texas County,2019,March,3,3,9082,8623,459,5.1,Not seasonally adjusted
Texas County,2019,February,3,2,9113,8641,472,5.2,Not seasonally adjusted
Texas County,2019,January,3,1,9145,8709,436,4.8,Not seasonally adjusted
Vernon County,2020,May,3,5,9282,8806,476,5.1,Not seasonally adjusted
Vernon County,2020,April,3,4,9399,8947,452,4.8,Not seasonally adjusted
Vernon County,2020,March,3,3,9743,9365,378,3.9,Not seasonally adjusted
Vernon County,2020,February,3,2,9588,9237,351,3.7,Not seasonally adjusted
Vernon County,2020,January,3,1,9610,9215,395,4.1,Not seasonally adjusted
Vernon County,2019,Annual Averages,1,0,9466,9133,333,3.5,Not seasonally adjusted
Vernon County,2019,December,3,12,9397,9066,331,3.5,Not seasonally adjusted
Vernon County,2019,November,3,11,9407,9095,312,3.3,Not seasonally adjusted
Vernon County,2019,October,3,10,9596,9329,267,2.8,Not seasonally adjusted
Vernon County,2019,September,3,9,9238,8987,251,2.7,Not seasonally adjusted
Vernon County,2019,August,3,8,9001,8650,351,3.9,Not seasonally adjusted
Vernon County,2019,July,3,7,9110,8727,383,4.2,Not seasonally adjusted
Vernon County,2019,June,3,6,9497,9135,362,3.8,Not seasonally adjusted
Vernon County,2019,May,3,5,9657,9358,299,3.1,Not seasonally adjusted
Vernon County,2019,April,3,4,9733,9451,282,2.9,Not seasonally adjusted
Vernon County,2019,March,3,3,9686,9286,400,4.1,Not seasonally adjusted
Vernon County,2019,February,3,2,9648,9270,378,3.9,Not seasonally adjusted
Vernon County,2019,January,3,1,9627,9245,382,4,Not seasonally adjusted
Warren County,2020,May,3,5,17494,15751,1743,10,Not seasonally adjusted
Warren County,2020,April,3,4,17770,15883,1887,10.6,Not seasonally adjusted
Warren County,2020,March,3,3,18290,17596,694,3.8,Not seasonally adjusted
Warren County,2020,February,3,2,18071,17410,661,3.7,Not seasonally adjusted
Warren County,2020,January,3,1,18251,17366,885,4.8,Not seasonally adjusted
Warren County,2019,Annual Averages,1,0,17971,17446,525,2.9,Not seasonally adjusted
Warren County,2019,December,3,12,18029,17478,551,3.1,Not seasonally adjusted
Warren County,2019,November,3,11,18056,17563,493,2.7,Not seasonally adjusted
Warren County,2019,October,3,10,18136,17648,488,2.7,Not seasonally adjusted
Warren County,2019,September,3,9,17943,17557,386,2.2,Not seasonally adjusted
Warren County,2019,August,3,8,17977,17476,501,2.8,Not seasonally adjusted
Warren County,2019,July,3,7,18247,17697,550,3,Not seasonally adjusted
Warren County,2019,June,3,6,18064,17552,512,2.8,Not seasonally adjusted
Warren County,2019,May,3,5,17864,17386,478,2.7,Not seasonally adjusted
Warren County,2019,April,3,4,17821,17386,435,2.4,Not seasonally adjusted
Warren County,2019,March,3,3,17881,17247,634,3.5,Not seasonally adjusted
Warren County,2019,February,3,2,17918,17250,668,3.7,Not seasonally adjusted
Warren County,2019,January,3,1,17713,17109,604,3.4,Not seasonally adjusted
Washington County,2020,May,3,5,10130,9070,1060,10.5,Not seasonally adjusted
Washington County,2020,April,3,4,10174,9112,1062,10.4,Not seasonally adjusted
Washington County,2020,March,3,3,10623,9980,643,6.1,Not seasonally adjusted
Washington County,2020,February,3,2,10332,9704,628,6.1,Not seasonally adjusted
Washington County,2020,January,3,1,10348,9715,633,6.1,Not seasonally adjusted
Washington County,2019,Annual Averages,1,0,10241,9780,461,4.5,Not seasonally adjusted
Washington County,2019,December,3,12,10282,9781,501,4.9,Not seasonally adjusted
Washington County,2019,November,3,11,10236,9807,429,4.2,Not seasonally adjusted
Washington County,2019,October,3,10,10247,9899,348,3.4,Not seasonally adjusted
Washington County,2019,September,3,9,10252,9916,336,3.3,Not seasonally adjusted
Washington County,2019,August,3,8,9982,9542,440,4.4,Not seasonally adjusted
Washington County,2019,July,3,7,10041,9551,490,4.9,Not seasonally adjusted
Washington County,2019,June,3,6,10526,10048,478,4.5,Not seasonally adjusted
Washington County,2019,May,3,5,10259,9856,403,3.9,Not seasonally adjusted
Washington County,2019,April,3,4,10202,9817,385,3.8,Not seasonally adjusted
Washington County,2019,March,3,3,10312,9747,565,5.5,Not seasonally adjusted
Washington County,2019,February,3,2,10288,9708,580,5.6,Not seasonally adjusted
Washington County,2019,January,3,1,10260,9682,578,5.6,Not seasonally adjusted
Wayne County,2020,May,3,5,4945,4506,439,8.9,Not seasonally adjusted
Wayne County,2020,April,3,4,4941,4517,424,8.6,Not seasonally adjusted
Wayne County,2020,March,3,3,5236,4964,272,5.2,Not seasonally adjusted
Wayne County,2020,February,3,2,5207,4944,263,5.1,Not seasonally adjusted
Wayne County,2020,January,3,1,5296,5016,280,5.3,Not seasonally adjusted
Wayne County,2019,Annual Averages,1,0,5306,5050,256,4.8,Not seasonally adjusted
Wayne County,2019,December,3,12,5276,5029,247,4.7,Not seasonally adjusted
Wayne County,2019,November,3,11,5259,5044,215,4.1,Not seasonally adjusted
Wayne County,2019,October,3,10,5284,5096,188,3.6,Not seasonally adjusted
Wayne County,2019,September,3,9,5234,5051,183,3.5,Not seasonally adjusted
Wayne County,2019,August,3,8,5278,5016,262,5,Not seasonally adjusted
Wayne County,2019,July,3,7,5168,4888,280,5.4,Not seasonally adjusted
Wayne County,2019,June,3,6,5420,5108,312,5.8,Not seasonally adjusted
Wayne County,2019,May,3,5,5336,5077,259,4.9,Not seasonally adjusted
Wayne County,2019,April,3,4,5282,5042,240,4.5,Not seasonally adjusted
Wayne County,2019,March,3,3,5391,5095,296,5.5,Not seasonally adjusted
Wayne County,2019,February,3,2,5355,5064,291,5.4,Not seasonally adjusted
Wayne County,2019,January,3,1,5395,5095,300,5.6,Not seasonally adjusted
Webster County,2020,May,3,5,16884,15572,1312,7.8,Not seasonally adjusted
Webster County,2020,April,3,4,17212,15663,1549,9,Not seasonally adjusted
Webster County,2020,March,3,3,17714,17001,713,4,Not seasonally adjusted
Webster County,2020,February,3,2,17520,16840,680,3.9,Not seasonally adjusted
Webster County,2020,January,3,1,17530,16744,786,4.5,Not seasonally adjusted
Webster County,2019,Annual Averages,1,0,17309,16692,617,3.6,Not seasonally adjusted
Webster County,2019,December,3,12,17497,16772,725,4.1,Not seasonally adjusted
Webster County,2019,November,3,11,17452,16828,624,3.6,Not seasonally adjusted
Webster County,2019,October,3,10,17511,16952,559,3.2,Not seasonally adjusted
Webster County,2019,September,3,9,17285,16731,554,3.2,Not seasonally adjusted
Webster County,2019,August,3,8,17183,16398,785,4.6,Not seasonally adjusted
Webster County,2019,July,3,7,17464,16783,681,3.9,Not seasonally adjusted
Webster County,2019,June,3,6,17158,16590,568,3.3,Not seasonally adjusted
Webster County,2019,May,3,5,17285,16747,538,3.1,Not seasonally adjusted
Webster County,2019,April,3,4,17228,16765,463,2.7,Not seasonally adjusted
Webster County,2019,March,3,3,17257,16629,628,3.6,Not seasonally adjusted
Webster County,2019,February,3,2,17275,16639,636,3.7,Not seasonally adjusted
Webster County,2019,January,3,1,17105,16468,637,3.7,Not seasonally adjusted
Worth County,2020,May,3,5,1189,1135,54,4.5,Not seasonally adjusted
Worth County,2020,April,3,4,1257,1170,87,6.9,Not seasonally adjusted
Worth County,2020,March,3,3,1187,1152,35,2.9,Not seasonally adjusted
Worth County,2020,February,3,2,1182,1153,29,2.5,Not seasonally adjusted
Worth County,2020,January,3,1,1188,1151,37,3.1,Not seasonally adjusted
Worth County,2019,Annual Averages,1,0,1169,1138,31,2.7,Not seasonally adjusted
Worth County,2019,December,3,12,1160,1128,32,2.8,Not seasonally adjusted
Worth County,2019,November,3,11,1166,1139,27,2.3,Not seasonally adjusted
Worth County,2019,October,3,10,1211,1188,23,1.9,Not seasonally adjusted
Worth County,2019,September,3,9,1137,1114,23,2,Not seasonally adjusted
Worth County,2019,August,3,8,1081,1053,28,2.6,Not seasonally adjusted
Worth County,2019,July,3,7,1102,1056,46,4.2,Not seasonally adjusted
Worth County,2019,June,3,6,1194,1150,44,3.7,Not seasonally adjusted
Worth County,2019,May,3,5,1224,1199,25,2,Not seasonally adjusted
Worth County,2019,April,3,4,1239,1213,26,2.1,Not seasonally adjusted
Worth County,2019,March,3,3,1176,1146,30,2.6,Not seasonally adjusted
Worth County,2019,February,3,2,1173,1133,40,3.4,Not seasonally adjusted
Worth County,2019,January,3,1,1170,1137,33,2.8,Not seasonally adjusted
Wright County,2020,May,3,5,7530,6850,680,9,Not seasonally adjusted
Wright County,2020,April,3,4,7883,6981,902,11.4,Not seasonally adjusted
Wright County,2020,March,3,3,7630,7193,437,5.7,Not seasonally adjusted
Wright County,2020,February,3,2,7656,7250,406,5.3,Not seasonally adjusted
Wright County,2020,January,3,1,7800,7205,595,7.6,Not seasonally adjusted
Wright County,2019,Annual Averages,1,0,7495,7101,394,5.3,Not seasonally adjusted
Wright County,2019,December,3,12,7693,7072,621,8.1,Not seasonally adjusted
Wright County,2019,November,3,11,7565,7147,418,5.5,Not seasonally adjusted
Wright County,2019,October,3,10,7760,7353,407,5.2,Not seasonally adjusted
Wright County,2019,September,3,9,7566,7072,494,6.5,Not seasonally adjusted
Wright County,2019,August,3,8,7168,6688,480,6.7,Not seasonally adjusted
Wright County,2019,July,3,7,6954,6594,360,5.2,Not seasonally adjusted
Wright County,2019,June,3,6,7378,7062,316,4.3,Not seasonally adjusted
Wright County,2019,May,3,5,7651,7319,332,4.3,Not seasonally adjusted
Wright County,2019,April,3,4,7684,7409,275,3.6,Not seasonally adjusted
Wright County,2019,March,3,3,7521,7175,346,4.6,Not seasonally adjusted
Wright County,2019,February,3,2,7516,7181,335,4.5,Not seasonally adjusted
Wright County,2019,January,3,1,7485,7145,340,4.5,Not seasonally adjusted
Missouri,2020,May,3,5,3013983,2718715,295268,9.8,Not seasonally adjusted
Missouri,2020,April,3,4,3030512,2733032,297480,9.8,Not seasonally adjusted
Missouri,2020,March,3,3,3138290,3014950,123340,3.9,Not seasonally adjusted
Missouri,2020,February,3,2,3091488,2976387,115101,3.7,Not seasonally adjusted
Missouri,2020,January,3,1,3095286,2963025,132261,4.3,Not seasonally adjusted
Missouri,2019,Annual Averages,1,0,3083245,2981688,101557,3.3,Not seasonally adjusted
Missouri,2019,December,3,12,3096892,2991495,105397,3.4,Not seasonally adjusted
Missouri,2019,November,3,11,3099987,3003965,96022,3.1,Not seasonally adjusted
Missouri,2019,October,3,10,3103578,3017273,86305,2.8,Not seasonally adjusted
Missouri,2019,September,3,9,3083575,3001540,82035,2.7,Not seasonally adjusted
Missouri,2019,August,3,8,3077694,2968933,108761,3.5,Not seasonally adjusted
Missouri,2019,July,3,7,3117422,3000392,117030,3.8,Not seasonally adjusted
Missouri,2019,June,3,6,3108213,3003851,104362,3.4,Not seasonally adjusted
Missouri,2019,May,3,5,3072393,2980633,91760,3,Not seasonally adjusted
Missouri,2019,April,3,4,3060323,2977656,82667,2.7,Not seasonally adjusted
Missouri,2019,March,3,3,3068119,2955210,112909,3.7,Not seasonally adjusted
Missouri,2019,February,3,2,3064263,2949862,114401,3.7,Not seasonally adjusted
Missouri,2019,January,3,1,3046480,2929448,117032,3.8,Not seasonally adjusted
Ballwin city,2020,May,3,5,16372,14933,1439,8.8,Not seasonally adjusted
Ballwin city,2020,April,3,4,16387,15022,1365,8.3,Not seasonally adjusted
Ballwin city,2020,March,3,3,17285,16799,486,2.8,Not seasonally adjusted
Ballwin city,2020,February,3,2,17040,16601,439,2.6,Not seasonally adjusted
Ballwin city,2020,January,3,1,17063,16561,502,2.9,Not seasonally adjusted
Ballwin city,2019,Annual Averages,1,0,17047,16661,386,2.3,Not seasonally adjusted
Ballwin city,2019,December,3,12,17125,16723,402,2.3,Not seasonally adjusted
Ballwin city,2019,November,3,11,17180,16794,386,2.2,Not seasonally adjusted
Ballwin city,2019,October,3,10,17138,16813,325,1.9,Not seasonally adjusted
Ballwin city,2019,September,3,9,17150,16815,335,2,Not seasonally adjusted
Ballwin city,2019,August,3,8,17160,16740,420,2.4,Not seasonally adjusted
Ballwin city,2019,July,3,7,17355,16946,409,2.4,Not seasonally adjusted
Ballwin city,2019,June,3,6,17189,16811,378,2.2,Not seasonally adjusted
Ballwin city,2019,May,3,5,16915,16557,358,2.1,Not seasonally adjusted
Ballwin city,2019,April,3,4,16882,16528,354,2.1,Not seasonally adjusted
Ballwin city,2019,March,3,3,16873,16447,426,2.5,Not seasonally adjusted
Ballwin city,2019,February,3,2,16857,16451,406,2.4,Not seasonally adjusted
Ballwin city,2019,January,3,1,16748,16312,436,2.6,Not seasonally adjusted
Blue Springs city,2020,May,3,5,29868,26655,3213,10.8,Not seasonally adjusted
Blue Springs city,2020,April,3,4,30007,26585,3422,11.4,Not seasonally adjusted
Blue Springs city,2020,March,3,3,31124,29983,1141,3.7,Not seasonally adjusted
Blue Springs city,2020,February,3,2,30830,29807,1023,3.3,Not seasonally adjusted
Blue Springs city,2020,January,3,1,30719,29573,1146,3.7,Not seasonally adjusted
Blue Springs city,2019,Annual Averages,1,0,30749,29784,965,3.1,Not seasonally adjusted
Blue Springs city,2019,December,3,12,30930,29980,950,3.1,Not seasonally adjusted
Blue Springs city,2019,November,3,11,30965,30080,885,2.9,Not seasonally adjusted
Blue Springs city,2019,October,3,10,30847,30081,766,2.5,Not seasonally adjusted
Blue Springs city,2019,September,3,9,30775,30034,741,2.4,Not seasonally adjusted
Blue Springs city,2019,August,3,8,30909,29905,1004,3.2,Not seasonally adjusted
Blue Springs city,2019,July,3,7,31227,30162,1065,3.4,Not seasonally adjusted
Blue Springs city,2019,June,3,6,31044,30097,947,3.1,Not seasonally adjusted
Blue Springs city,2019,May,3,5,30488,29582,906,3,Not seasonally adjusted
Blue Springs city,2019,April,3,4,30352,29502,850,2.8,Not seasonally adjusted
Blue Springs city,2019,March,3,3,30584,29362,1222,4,Not seasonally adjusted
Blue Springs city,2019,February,3,2,30495,29347,1148,3.8,Not seasonally adjusted
Blue Springs city,2019,January,3,1,30361,29270,1091,3.6,Not seasonally adjusted
Cape Girardeau city,2020,May,3,5,18878,17056,1822,9.7,Not seasonally adjusted
Cape Girardeau city,2020,April,3,4,19622,17661,1961,10,Not seasonally adjusted
Cape Girardeau city,2020,March,3,3,20721,19877,844,4.1,Not seasonally adjusted
Cape Girardeau city,2020,February,3,2,20512,19791,721,3.5,Not seasonally adjusted
Cape Girardeau city,2020,January,3,1,20419,19666,753,3.7,Not seasonally adjusted
Cape Girardeau city,2019,Annual Averages,1,0,20223,19620,603,3,Not seasonally adjusted
Cape Girardeau city,2019,December,3,12,20478,19873,605,3,Not seasonally adjusted
Cape Girardeau city,2019,November,3,11,20406,19831,575,2.8,Not seasonally adjusted
Cape Girardeau city,2019,October,3,10,20342,19857,485,2.4,Not seasonally adjusted
Cape Girardeau city,2019,September,3,9,20186,19689,497,2.5,Not seasonally adjusted
Cape Girardeau city,2019,August,3,8,20036,19364,672,3.4,Not seasonally adjusted
Cape Girardeau city,2019,July,3,7,19928,19188,740,3.7,Not seasonally adjusted
Cape Girardeau city,2019,June,3,6,20446,19756,690,3.4,Not seasonally adjusted
Cape Girardeau city,2019,May,3,5,20232,19664,568,2.8,Not seasonally adjusted
Cape Girardeau city,2019,April,3,4,20068,19605,463,2.3,Not seasonally adjusted
Cape Girardeau city,2019,March,3,3,20198,19537,661,3.3,Not seasonally adjusted
Cape Girardeau city,2019,February,3,2,20202,19591,611,3,Not seasonally adjusted
Cape Girardeau city,2019,January,3,1,20159,19488,671,3.3,Not seasonally adjusted
Chesterfield city,2020,May,3,5,23731,21989,1742,7.3,Not seasonally adjusted
Chesterfield city,2020,April,3,4,23708,22120,1588,6.7,Not seasonally adjusted
Chesterfield city,2020,March,3,3,25481,24736,745,2.9,Not seasonally adjusted
Chesterfield city,2020,February,3,2,25101,24445,656,2.6,Not seasonally adjusted
Chesterfield city,2020,January,3,1,25181,24386,795,3.2,Not seasonally adjusted
Chesterfield city,2019,Annual Averages,1,0,25133,24534,599,2.4,Not seasonally adjusted
Chesterfield city,2019,December,3,12,25307,24624,683,2.7,Not seasonally adjusted
Chesterfield city,2019,November,3,11,25363,24729,634,2.5,Not seasonally adjusted
Chesterfield city,2019,October,3,10,25279,24757,522,2.1,Not seasonally adjusted
Chesterfield city,2019,September,3,9,25264,24760,504,2,Not seasonally adjusted
Chesterfield city,2019,August,3,8,25293,24650,643,2.5,Not seasonally adjusted
Chesterfield city,2019,July,3,7,25532,24952,580,2.3,Not seasonally adjusted
Chesterfield city,2019,June,3,6,25343,24754,589,2.3,Not seasonally adjusted
Chesterfield city,2019,May,3,5,24941,24380,561,2.2,Not seasonally adjusted
Chesterfield city,2019,April,3,4,24841,24337,504,2,Not seasonally adjusted
Chesterfield city,2019,March,3,3,24893,24219,674,2.7,Not seasonally adjusted
Chesterfield city,2019,February,3,2,24866,24224,642,2.6,Not seasonally adjusted
Chesterfield city,2019,January,3,1,24665,24019,646,2.6,Not seasonally adjusted
Columbia city,2020,May,3,5,64223,59890,4333,6.7,Not seasonally adjusted
Columbia city,2020,April,3,4,65970,61632,4338,6.6,Not seasonally adjusted
Columbia city,2020,March,3,3,68933,67220,1713,2.5,Not seasonally adjusted
Columbia city,2020,February,3,2,67829,66180,1649,2.4,Not seasonally adjusted
Columbia city,2020,January,3,1,66597,64528,2069,3.1,Not seasonally adjusted
Columbia city,2019,Annual Averages,1,0,67307,65684,1623,2.4,Not seasonally adjusted
Columbia city,2019,December,3,12,68108,66459,1649,2.4,Not seasonally adjusted
Columbia city,2019,November,3,11,68490,66914,1576,2.3,Not seasonally adjusted
Columbia city,2019,October,3,10,68269,66972,1297,1.9,Not seasonally adjusted
Columbia city,2019,September,3,9,67863,66564,1299,1.9,Not seasonally adjusted
Columbia city,2019,August,3,8,66217,64389,1828,2.8,Not seasonally adjusted
Columbia city,2019,July,3,7,66597,64626,1971,3,Not seasonally adjusted
Columbia city,2019,June,3,6,65822,64067,1755,2.7,Not seasonally adjusted
Columbia city,2019,May,3,5,67551,66000,1551,2.3,Not seasonally adjusted
Columbia city,2019,April,3,4,67709,66375,1334,2,Not seasonally adjusted
Columbia city,2019,March,3,3,67888,66164,1724,2.5,Not seasonally adjusted
Columbia city,2019,February,3,2,67689,65982,1707,2.5,Not seasonally adjusted
Columbia city,2019,January,3,1,65472,63691,1781,2.7,Not seasonally adjusted
Florissant city,2020,May,3,5,27626,24318,3308,12,Not seasonally adjusted
Florissant city,2020,April,3,4,27349,24463,2886,10.6,Not seasonally adjusted
Florissant city,2020,March,3,3,28567,27356,1211,4.2,Not seasonally adjusted
Florissant city,2020,February,3,2,28107,27034,1073,3.8,Not seasonally adjusted
Florissant city,2020,January,3,1,28305,26969,1336,4.7,Not seasonally adjusted
Florissant city,2019,Annual Averages,1,0,28151,27132,1019,3.6,Not seasonally adjusted
Florissant city,2019,December,3,12,28219,27232,987,3.5,Not seasonally adjusted
Florissant city,2019,November,3,11,28239,27349,890,3.2,Not seasonally adjusted
Florissant city,2019,October,3,10,28232,27379,853,3,Not seasonally adjusted
Florissant city,2019,September,3,9,28202,27382,820,2.9,Not seasonally adjusted
Florissant city,2019,August,3,8,28350,27261,1089,3.8,Not seasonally adjusted
Florissant city,2019,July,3,7,28771,27595,1176,4.1,Not seasonally adjusted
Florissant city,2019,June,3,6,28455,27376,1079,3.8,Not seasonally adjusted
Florissant city,2019,May,3,5,27921,26963,958,3.4,Not seasonally adjusted
Florissant city,2019,April,3,4,27810,26915,895,3.2,Not seasonally adjusted
Florissant city,2019,March,3,3,27966,26784,1182,4.2,Not seasonally adjusted
Florissant city,2019,February,3,2,27927,26790,1137,4.1,Not seasonally adjusted
Florissant city,2019,January,3,1,27725,26563,1162,4.2,Not seasonally adjusted
Gladstone city,2020,May,3,5,14747,12790,1957,13.3,Not seasonally adjusted
Gladstone city,2020,April,3,4,14736,12770,1966,13.3,Not seasonally adjusted
Gladstone city,2020,March,3,3,14926,14362,564,3.8,Not seasonally adjusted
Gladstone city,2020,February,3,2,14750,14272,478,3.2,Not seasonally adjusted
Gladstone city,2020,January,3,1,14714,14152,562,3.8,Not seasonally adjusted
Gladstone city,2019,Annual Averages,1,0,14753,14262,491,3.3,Not seasonally adjusted
Gladstone city,2019,December,3,12,14838,14338,500,3.4,Not seasonally adjusted
Gladstone city,2019,November,3,11,14836,14394,442,3,Not seasonally adjusted
Gladstone city,2019,October,3,10,14859,14405,454,3.1,Not seasonally adjusted
Gladstone city,2019,September,3,9,14743,14372,371,2.5,Not seasonally adjusted
Gladstone city,2019,August,3,8,14784,14305,479,3.2,Not seasonally adjusted
Gladstone city,2019,July,3,7,15105,14431,674,4.5,Not seasonally adjusted
Gladstone city,2019,June,3,6,14924,14408,516,3.5,Not seasonally adjusted
Gladstone city,2019,May,3,5,14635,14183,452,3.1,Not seasonally adjusted
Gladstone city,2019,April,3,4,14593,14155,438,3,Not seasonally adjusted
Gladstone city,2019,March,3,3,14620,14068,552,3.8,Not seasonally adjusted
Gladstone city,2019,February,3,2,14559,14063,496,3.4,Not seasonally adjusted
Gladstone city,2019,January,3,1,14541,14018,523,3.6,Not seasonally adjusted
Grandview city,2020,May,3,5,12644,11273,1371,10.8,Not seasonally adjusted
Grandview city,2020,April,3,4,12479,11243,1236,9.9,Not seasonally adjusted
Grandview city,2020,March,3,3,13232,12681,551,4.2,Not seasonally adjusted
Grandview city,2020,February,3,2,13111,12606,505,3.9,Not seasonally adjusted
Grandview city,2020,January,3,1,13076,12507,569,4.4,Not seasonally adjusted
Grandview city,2019,Annual Averages,1,0,13140,12596,544,4.1,Not seasonally adjusted
Grandview city,2019,December,3,12,13175,12679,496,3.8,Not seasonally adjusted
Grandview city,2019,November,3,11,13191,12722,469,3.6,Not seasonally adjusted
Grandview city,2019,October,3,10,13161,12722,439,3.3,Not seasonally adjusted
Grandview city,2019,September,3,9,13104,12702,402,3.1,Not seasonally adjusted
Grandview city,2019,August,3,8,13203,12647,556,4.2,Not seasonally adjusted
Grandview city,2019,July,3,7,13461,12756,705,5.2,Not seasonally adjusted
Grandview city,2019,June,3,6,13371,12729,642,4.8,Not seasonally adjusted
Grandview city,2019,May,3,5,13024,12511,513,3.9,Not seasonally adjusted
Grandview city,2019,April,3,4,12951,12477,474,3.7,Not seasonally adjusted
Grandview city,2019,March,3,3,13039,12418,621,4.8,Not seasonally adjusted
Grandview city,2019,February,3,2,13019,12412,607,4.7,Not seasonally adjusted
Grandview city,2019,January,3,1,12987,12379,608,4.7,Not seasonally adjusted
Hazelwood city,2020,May,3,5,13639,11920,1719,12.6,Not seasonally adjusted
Hazelwood city,2020,April,3,4,13446,11991,1455,10.8,Not seasonally adjusted
Hazelwood city,2020,March,3,3,14021,13409,612,4.4,Not seasonally adjusted
Hazelwood city,2020,February,3,2,13783,13251,532,3.9,Not seasonally adjusted
Hazelwood city,2020,January,3,1,13852,13219,633,4.6,Not seasonally adjusted
Hazelwood city,2019,Annual Averages,1,0,13778,13299,479,3.5,Not seasonally adjusted
Hazelwood city,2019,December,3,12,13819,13348,471,3.4,Not seasonally adjusted
Hazelwood city,2019,November,3,11,13854,13405,449,3.2,Not seasonally adjusted
Hazelwood city,2019,October,3,10,13869,13421,448,3.2,Not seasonally adjusted
Hazelwood city,2019,September,3,9,13824,13422,402,2.9,Not seasonally adjusted
Hazelwood city,2019,August,3,8,13898,13362,536,3.9,Not seasonally adjusted
Hazelwood city,2019,July,3,7,14028,13526,502,3.6,Not seasonally adjusted
Hazelwood city,2019,June,3,6,13882,13419,463,3.3,Not seasonally adjusted
Hazelwood city,2019,May,3,5,13677,13216,461,3.4,Not seasonally adjusted
Hazelwood city,2019,April,3,4,13610,13193,417,3.1,Not seasonally adjusted
Hazelwood city,2019,March,3,3,13674,13129,545,4,Not seasonally adjusted
Hazelwood city,2019,February,3,2,13633,13132,501,3.7,Not seasonally adjusted
Hazelwood city,2019,January,3,1,13572,13020,552,4.1,Not seasonally adjusted
Independence city,2020,May,3,5,57183,49407,7776,13.6,Not seasonally adjusted
Independence city,2020,April,3,4,57314,49277,8037,14,Not seasonally adjusted
Independence city,2020,March,3,3,58474,55575,2899,5,Not seasonally adjusted
Independence city,2020,February,3,2,57876,55249,2627,4.5,Not seasonally adjusted
Independence city,2020,January,3,1,57612,54816,2796,4.9,Not seasonally adjusted
Independence city,2019,Annual Averages,1,0,57491,55205,2286,4,Not seasonally adjusted
Independence city,2019,December,3,12,57834,55570,2264,3.9,Not seasonally adjusted
Independence city,2019,November,3,11,57797,55755,2042,3.5,Not seasonally adjusted
Independence city,2019,October,3,10,57664,55756,1908,3.3,Not seasonally adjusted
Independence city,2019,September,3,9,57490,55669,1821,3.2,Not seasonally adjusted
Independence city,2019,August,3,8,57757,55430,2327,4,Not seasonally adjusted
Independence city,2019,July,3,7,58702,55908,2794,4.8,Not seasonally adjusted
Independence city,2019,June,3,6,58022,55787,2235,3.9,Not seasonally adjusted
Independence city,2019,May,3,5,56883,54832,2051,3.6,Not seasonally adjusted
Independence city,2019,April,3,4,56614,54683,1931,3.4,Not seasonally adjusted
Independence city,2019,March,3,3,57101,54425,2676,4.7,Not seasonally adjusted
Independence city,2019,February,3,2,57078,54397,2681,4.7,Not seasonally adjusted
Independence city,2019,January,3,1,56958,54253,2705,4.7,Not seasonally adjusted
Jefferson City city,2020,May,3,5,20189,18808,1381,6.8,Not seasonally adjusted
Jefferson City city,2020,April,3,4,19947,18472,1475,7.4,Not seasonally adjusted
Jefferson City city,2020,March,3,3,20868,20173,695,3.3,Not seasonally adjusted
Jefferson City city,2020,February,3,2,20592,20004,588,2.9,Not seasonally adjusted
Jefferson City city,2020,January,3,1,20689,19958,731,3.5,Not seasonally adjusted
Jefferson City city,2019,Annual Averages,1,0,20670,20092,578,2.8,Not seasonally adjusted
Jefferson City city,2019,December,3,12,20551,19949,602,2.9,Not seasonally adjusted
Jefferson City city,2019,November,3,11,20691,20134,557,2.7,Not seasonally adjusted
Jefferson City city,2019,October,3,10,20634,20184,450,2.2,Not seasonally adjusted
Jefferson City city,2019,September,3,9,20606,20165,441,2.1,Not seasonally adjusted
Jefferson City city,2019,August,3,8,20926,20215,711,3.4,Not seasonally adjusted
Jefferson City city,2019,July,3,7,21149,20447,702,3.3,Not seasonally adjusted
Jefferson City city,2019,June,3,6,20855,20225,630,3,Not seasonally adjusted
Jefferson City city,2019,May,3,5,20569,20065,504,2.5,Not seasonally adjusted
Jefferson City city,2019,April,3,4,20529,20082,447,2.2,Not seasonally adjusted
Jefferson City city,2019,March,3,3,20593,19988,605,2.9,Not seasonally adjusted
Jefferson City city,2019,February,3,2,20507,19865,642,3.1,Not seasonally adjusted
Jefferson City city,2019,January,3,1,20431,19781,650,3.2,Not seasonally adjusted
"Jefferson city, Callaway County part, MO",2020,May,3,5,7,7,0,0,Not seasonally adjusted
"Jefferson city, Callaway County part, MO",2020,April,3,4,8,7,1,12.5,Not seasonally adjusted
"Jefferson city, Callaway County part, MO",2020,March,3,3,7,7,0,0,Not seasonally adjusted
"Jefferson city, Callaway County part, MO",2020,February,3,2,7,7,0,0,Not seasonally adjusted
"Jefferson city, Callaway County part, MO",2020,January,3,1,7,7,0,0,Not seasonally adjusted
"Jefferson city, Callaway County part, MO",2019,Annual Averages,1,0,7,7,0,0,Not seasonally adjusted
"Jefferson city, Callaway County part, MO",2019,December,3,12,7,7,0,0,Not seasonally adjusted
"Jefferson city, Callaway County part, MO",2019,November,3,11,7,7,0,0,Not seasonally adjusted
"Jefferson city, Callaway County part, MO",2019,October,3,10,7,7,0,0,Not seasonally adjusted
"Jefferson city, Callaway County part, MO",2019,September,3,9,7,7,0,0,Not seasonally adjusted
"Jefferson city, Callaway County part, MO",2019,August,3,8,7,7,0,0,Not seasonally adjusted
"Jefferson city, Callaway County part, MO",2019,July,3,7,7,7,0,0,Not seasonally adjusted
"Jefferson city, Callaway County part, MO",2019,June,3,6,7,7,0,0,Not seasonally adjusted
"Jefferson city, Callaway County part, MO",2019,May,3,5,7,7,0,0,Not seasonally adjusted
"Jefferson city, Callaway County part, MO",2019,April,3,4,7,7,0,0,Not seasonally adjusted
"Jefferson city, Callaway County part, MO",2019,March,3,3,7,7,0,0,Not seasonally adjusted
"Jefferson city, Callaway County part, MO",2019,February,3,2,7,7,0,0,Not seasonally adjusted
"Jefferson city, Callaway County part, MO",2019,January,3,1,7,7,0,0,Not seasonally adjusted
"Jefferson city, Cole County part, MO",2020,May,3,5,20182,18801,1381,6.8,Not seasonally adjusted
"Jefferson city, Cole County part, MO",2020,April,3,4,19939,18465,1474,7.4,Not seasonally adjusted
"Jefferson city, Cole County part, MO",2020,March,3,3,20861,20166,695,3.3,Not seasonally adjusted
"Jefferson city, Cole County part, MO",2020,February,3,2,20585,19997,588,2.9,Not seasonally adjusted
"Jefferson city, Cole County part, MO",2020,January,3,1,20682,19951,731,3.5,Not seasonally adjusted
"Jefferson city, Cole County part, MO",2019,Annual Averages,1,0,20663,20085,578,2.8,Not seasonally adjusted
"Jefferson city, Cole County part, MO",2019,December,3,12,20544,19942,602,2.9,Not seasonally adjusted
"Jefferson city, Cole County part, MO",2019,November,3,11,20684,20127,557,2.7,Not seasonally adjusted
"Jefferson city, Cole County part, MO",2019,October,3,10,20627,20177,450,2.2,Not seasonally adjusted
"Jefferson city, Cole County part, MO",2019,September,3,9,20599,20158,441,2.1,Not seasonally adjusted
"Jefferson city, Cole County part, MO",2019,August,3,8,20919,20208,711,3.4,Not seasonally adjusted
"Jefferson city, Cole County part, MO",2019,July,3,7,21142,20440,702,3.3,Not seasonally adjusted
"Jefferson city, Cole County part, MO",2019,June,3,6,20848,20218,630,3,Not seasonally adjusted
"Jefferson city, Cole County part, MO",2019,May,3,5,20562,20058,504,2.5,Not seasonally adjusted
"Jefferson city, Cole County part, MO",2019,April,3,4,20522,20075,447,2.2,Not seasonally adjusted
"Jefferson city, Cole County part, MO",2019,March,3,3,20586,19981,605,2.9,Not seasonally adjusted
"Jefferson city, Cole County part, MO",2019,February,3,2,20500,19858,642,3.1,Not seasonally adjusted
"Jefferson city, Cole County part, MO",2019,January,3,1,20424,19774,650,3.2,Not seasonally adjusted
Joplin city,2020,May,3,5,24488,22168,2320,9.5,Not seasonally adjusted
Joplin city,2020,April,3,4,24813,22148,2665,10.7,Not seasonally adjusted
Joplin city,2020,March,3,3,25230,24290,940,3.7,Not seasonally adjusted
Joplin city,2020,February,3,2,25070,24231,839,3.3,Not seasonally adjusted
Joplin city,2020,January,3,1,25193,24255,938,3.7,Not seasonally adjusted
Joplin city,2019,Annual Averages,1,0,24810,24051,759,3.1,Not seasonally adjusted
Joplin city,2019,December,3,12,25131,24310,821,3.3,Not seasonally adjusted
Joplin city,2019,November,3,11,25067,24306,761,3,Not seasonally adjusted
Joplin city,2019,October,3,10,24976,24297,679,2.7,Not seasonally adjusted
Joplin city,2019,September,3,9,24749,24133,616,2.5,Not seasonally adjusted
Joplin city,2019,August,3,8,24780,23967,813,3.3,Not seasonally adjusted
Joplin city,2019,July,3,7,25089,24121,968,3.9,Not seasonally adjusted
Joplin city,2019,June,3,6,24751,23934,817,3.3,Not seasonally adjusted
Joplin city,2019,May,3,5,24586,23872,714,2.9,Not seasonally adjusted
Joplin city,2019,April,3,4,24458,23865,593,2.4,Not seasonally adjusted
Joplin city,2019,March,3,3,24739,23971,768,3.1,Not seasonally adjusted
Joplin city,2019,February,3,2,24695,23954,741,3,Not seasonally adjusted
Joplin city,2019,January,3,1,24706,23887,819,3.3,Not seasonally adjusted
"Joplin City, Jasper County Part",2020,May,3,5,21184,19145,2039,9.6,Not seasonally adjusted
"Joplin City, Jasper County Part",2020,April,3,4,21466,19119,2347,10.9,Not seasonally adjusted
"Joplin City, Jasper County Part",2020,March,3,3,21840,20998,842,3.9,Not seasonally adjusted
"Joplin City, Jasper County Part",2020,February,3,2,21686,20944,742,3.4,Not seasonally adjusted
"Joplin City, Jasper County Part",2020,January,3,1,21784,20965,819,3.8,Not seasonally adjusted
"Joplin City, Jasper County Part",2019,Annual Averages,1,0,21451,20793,658,3.1,Not seasonally adjusted
"Joplin City, Jasper County Part",2019,December,3,12,21741,21023,718,3.3,Not seasonally adjusted
"Joplin City, Jasper County Part",2019,November,3,11,21681,21017,664,3.1,Not seasonally adjusted
"Joplin City, Jasper County Part",2019,October,3,10,21584,20997,587,2.7,Not seasonally adjusted
"Joplin City, Jasper County Part",2019,September,3,9,21411,20872,539,2.5,Not seasonally adjusted
"Joplin City, Jasper County Part",2019,August,3,8,21431,20729,702,3.3,Not seasonally adjusted
"Joplin City, Jasper County Part",2019,July,3,7,21702,20861,841,3.9,Not seasonally adjusted
"Joplin City, Jasper County Part",2019,June,3,6,21405,20700,705,3.3,Not seasonally adjusted
"Joplin City, Jasper County Part",2019,May,3,5,21235,20628,607,2.9,Not seasonally adjusted
"Joplin City, Jasper County Part",2019,April,3,4,21120,20617,503,2.4,Not seasonally adjusted
"Joplin City, Jasper County Part",2019,March,3,3,21381,20719,662,3.1,Not seasonally adjusted
"Joplin City, Jasper County Part",2019,February,3,2,21352,20705,647,3,Not seasonally adjusted
"Joplin City, Jasper County Part",2019,January,3,1,21372,20646,726,3.4,Not seasonally adjusted
"Joplin City, Newton County Part",2020,May,3,5,3304,3023,281,8.5,Not seasonally adjusted
"Joplin City, Newton County Part",2020,April,3,4,3347,3029,318,9.5,Not seasonally adjusted
"Joplin City, Newton County Part",2020,March,3,3,3390,3292,98,2.9,Not seasonally adjusted
"Joplin City, Newton County Part",2020,February,3,2,3384,3287,97,2.9,Not seasonally adjusted
"Joplin City, Newton County Part",2020,January,3,1,3409,3290,119,3.5,Not seasonally adjusted
"Joplin City, Newton County Part",2019,Annual Averages,1,0,3360,3259,101,3,Not seasonally adjusted
"Joplin City, Newton County Part",2019,December,3,12,3390,3287,103,3,Not seasonally adjusted
"Joplin City, Newton County Part",2019,November,3,11,3386,3289,97,2.9,Not seasonally adjusted
"Joplin City, Newton County Part",2019,October,3,10,3392,3300,92,2.7,Not seasonally adjusted
"Joplin City, Newton County Part",2019,September,3,9,3338,3261,77,2.3,Not seasonally adjusted
"Joplin City, Newton County Part",2019,August,3,8,3349,3238,111,3.3,Not seasonally adjusted
"Joplin City, Newton County Part",2019,July,3,7,3387,3260,127,3.7,Not seasonally adjusted
"Joplin City, Newton County Part",2019,June,3,6,3346,3234,112,3.3,Not seasonally adjusted
"Joplin City, Newton County Part",2019,May,3,5,3351,3244,107,3.2,Not seasonally adjusted
"Joplin City, Newton County Part",2019,April,3,4,3338,3248,90,2.7,Not seasonally adjusted
"Joplin City, Newton County Part",2019,March,3,3,3358,3252,106,3.2,Not seasonally adjusted
"Joplin City, Newton County Part",2019,February,3,2,3343,3249,94,2.8,Not seasonally adjusted
"Joplin City, Newton County Part",2019,January,3,1,3334,3241,93,2.8,Not seasonally adjusted
Kansas City city,2020,May,3,5,256668,225261,31407,12.2,Not seasonally adjusted
Kansas City city,2020,April,3,4,254601,224767,29834,11.7,Not seasonally adjusted
Kansas City city,2020,March,3,3,264110,253185,10925,4.1,Not seasonally adjusted
Kansas City city,2020,February,3,2,261221,251655,9566,3.7,Not seasonally adjusted
Kansas City city,2020,January,3,1,260273,249621,10652,4.1,Not seasonally adjusted
Kansas City city,2019,Annual Averages,1,0,260845,251461,9384,3.6,Not seasonally adjusted
Kansas City city,2019,December,3,12,262205,252990,9215,3.5,Not seasonally adjusted
Kansas City city,2019,November,3,11,262530,253893,8637,3.3,Not seasonally adjusted
Kansas City city,2019,October,3,10,262587,253979,8608,3.3,Not seasonally adjusted
Kansas City city,2019,September,3,9,261146,253493,7653,2.9,Not seasonally adjusted
Kansas City city,2019,August,3,8,263052,252366,10686,4.1,Not seasonally adjusted
Kansas City city,2019,July,3,7,267145,254563,12582,4.7,Not seasonally adjusted
Kansas City city,2019,June,3,6,263711,254074,9637,3.7,Not seasonally adjusted
Kansas City city,2019,May,3,5,258254,249902,8352,3.2,Not seasonally adjusted
Kansas City city,2019,April,3,4,256831,249298,7533,2.9,Not seasonally adjusted
Kansas City city,2019,March,3,3,257746,247968,9778,3.8,Not seasonally adjusted
Kansas City city,2019,February,3,2,257241,247856,9385,3.6,Not seasonally adjusted
Kansas City city,2019,January,3,1,257681,247144,10537,4.1,Not seasonally adjusted
"Kansas City City, Cass County Part",2020,May,3,5,99,97,2,2,Not seasonally adjusted
"Kansas City City, Cass County Part",2020,April,3,4,98,97,1,1,Not seasonally adjusted
"Kansas City City, Cass County Part",2020,March,3,3,111,109,2,1.8,Not seasonally adjusted
"Kansas City City, Cass County Part",2020,February,3,2,110,108,2,1.8,Not seasonally adjusted
"Kansas City City, Cass County Part",2020,January,3,1,110,107,3,2.7,Not seasonally adjusted
"Kansas City City, Cass County Part",2019,Annual Averages,1,0,111,108,3,2.7,Not seasonally adjusted
"Kansas City City, Cass County Part",2019,December,3,12,111,109,2,1.8,Not seasonally adjusted
"Kansas City City, Cass County Part",2019,November,3,11,112,109,3,2.7,Not seasonally adjusted
"Kansas City City, Cass County Part",2019,October,3,10,111,109,2,1.8,Not seasonally adjusted
"Kansas City City, Cass County Part",2019,September,3,9,111,109,2,1.8,Not seasonally adjusted
"Kansas City City, Cass County Part",2019,August,3,8,111,108,3,2.7,Not seasonally adjusted
"Kansas City City, Cass County Part",2019,July,3,7,112,109,3,2.7,Not seasonally adjusted
"Kansas City City, Cass County Part",2019,June,3,6,112,109,3,2.7,Not seasonally adjusted
"Kansas City City, Cass County Part",2019,May,3,5,111,108,3,2.7,Not seasonally adjusted
"Kansas City City, Cass County Part",2019,April,3,4,109,107,2,1.8,Not seasonally adjusted
"Kansas City City, Cass County Part",2019,March,3,3,110,107,3,2.7,Not seasonally adjusted
"Kansas City City, Cass County Part",2019,February,3,2,110,107,3,2.7,Not seasonally adjusted
"Kansas City City, Cass County Part",2019,January,3,1,109,106,3,2.8,Not seasonally adjusted
"Kansas City City, Clay County Part",2020,May,3,5,71469,62610,8859,12.4,Not seasonally adjusted
"Kansas City City, Clay County Part",2020,April,3,4,71432,62508,8924,12.5,Not seasonally adjusted
"Kansas City City, Clay County Part",2020,March,3,3,72760,70304,2456,3.4,Not seasonally adjusted
"Kansas City City, Clay County Part",2020,February,3,2,72012,69862,2150,3,Not seasonally adjusted
"Kansas City City, Clay County Part",2020,January,3,1,71736,69273,2463,3.4,Not seasonally adjusted
"Kansas City City, Clay County Part",2019,Annual Averages,1,0,71838,69811,2027,2.8,Not seasonally adjusted
"Kansas City City, Clay County Part",2019,December,3,12,72176,70186,1990,2.8,Not seasonally adjusted
"Kansas City City, Clay County Part",2019,November,3,11,72332,70460,1872,2.6,Not seasonally adjusted
"Kansas City City, Clay County Part",2019,October,3,10,72402,70511,1891,2.6,Not seasonally adjusted
"Kansas City City, Clay County Part",2019,September,3,9,72009,70349,1660,2.3,Not seasonally adjusted
"Kansas City City, Clay County Part",2019,August,3,8,72237,70021,2216,3.1,Not seasonally adjusted
"Kansas City City, Clay County Part",2019,July,3,7,73430,70638,2792,3.8,Not seasonally adjusted
"Kansas City City, Clay County Part",2019,June,3,6,72439,70526,1913,2.6,Not seasonally adjusted
"Kansas City City, Clay County Part",2019,May,3,5,71256,69428,1828,2.6,Not seasonally adjusted
"Kansas City City, Clay County Part",2019,April,3,4,70870,69289,1581,2.2,Not seasonally adjusted
"Kansas City City, Clay County Part",2019,March,3,3,70989,68864,2125,3,Not seasonally adjusted
"Kansas City City, Clay County Part",2019,February,3,2,71014,68838,2176,3.1,Not seasonally adjusted
"Kansas City City, Clay County Part",2019,January,3,1,70899,68619,2280,3.2,Not seasonally adjusted
"Kansas City City, Jackson County Part",2020,May,3,5,156389,137062,19327,12.4,Not seasonally adjusted
"Kansas City City, Jackson County Part",2020,April,3,4,154473,136700,17773,11.5,Not seasonally adjusted
"Kansas City City, Jackson County Part",2020,March,3,3,161810,154173,7637,4.7,Not seasonally adjusted
"Kansas City City, Jackson County Part",2020,February,3,2,159922,153267,6655,4.2,Not seasonally adjusted
"Kansas City City, Jackson County Part",2020,January,3,1,159318,152066,7252,4.6,Not seasonally adjusted
"Kansas City City, Jackson County Part",2019,Annual Averages,1,0,159719,153147,6572,4.1,Not seasonally adjusted
"Kansas City City, Jackson County Part",2019,December,3,12,160580,154159,6421,4,Not seasonally adjusted
"Kansas City City, Jackson County Part",2019,November,3,11,160707,154672,6035,3.8,Not seasonally adjusted
"Kansas City City, Jackson County Part",2019,October,3,10,160659,154674,5985,3.7,Not seasonally adjusted
"Kansas City City, Jackson County Part",2019,September,3,9,159793,154432,5361,3.4,Not seasonally adjusted
"Kansas City City, Jackson County Part",2019,August,3,8,161396,153770,7626,4.7,Not seasonally adjusted
"Kansas City City, Jackson County Part",2019,July,3,7,163791,155094,8697,5.3,Not seasonally adjusted
"Kansas City City, Jackson County Part",2019,June,3,6,161727,154760,6967,4.3,Not seasonally adjusted
"Kansas City City, Jackson County Part",2019,May,3,5,157929,152112,5817,3.7,Not seasonally adjusted
"Kansas City City, Jackson County Part",2019,April,3,4,157005,151697,5308,3.4,Not seasonally adjusted
"Kansas City City, Jackson County Part",2019,March,3,3,157787,150980,6807,4.3,Not seasonally adjusted
"Kansas City City, Jackson County Part",2019,February,3,2,157341,150904,6437,4.1,Not seasonally adjusted
"Kansas City City, Jackson County Part",2019,January,3,1,157909,150505,7404,4.7,Not seasonally adjusted
"Kansas City City, Platte County Part",2020,May,3,5,28711,25492,3219,11.2,Not seasonally adjusted
"Kansas City City, Platte County Part",2020,April,3,4,28598,25462,3136,11,Not seasonally adjusted
"Kansas City City, Platte County Part",2020,March,3,3,29429,28599,830,2.8,Not seasonally adjusted
"Kansas City City, Platte County Part",2020,February,3,2,29177,28418,759,2.6,Not seasonally adjusted
"Kansas City City, Platte County Part",2020,January,3,1,29109,28175,934,3.2,Not seasonally adjusted
"Kansas City City, Platte County Part",2019,Annual Averages,1,0,29177,28395,782,2.7,Not seasonally adjusted
"Kansas City City, Platte County Part",2019,December,3,12,29338,28536,802,2.7,Not seasonally adjusted
"Kansas City City, Platte County Part",2019,November,3,11,29379,28652,727,2.5,Not seasonally adjusted
"Kansas City City, Platte County Part",2019,October,3,10,29415,28685,730,2.5,Not seasonally adjusted
"Kansas City City, Platte County Part",2019,September,3,9,29233,28603,630,2.2,Not seasonally adjusted
"Kansas City City, Platte County Part",2019,August,3,8,29308,28467,841,2.9,Not seasonally adjusted
"Kansas City City, Platte County Part",2019,July,3,7,29812,28722,1090,3.7,Not seasonally adjusted
"Kansas City City, Platte County Part",2019,June,3,6,29433,28679,754,2.6,Not seasonally adjusted
"Kansas City City, Platte County Part",2019,May,3,5,28958,28254,704,2.4,Not seasonally adjusted
"Kansas City City, Platte County Part",2019,April,3,4,28847,28205,642,2.2,Not seasonally adjusted
"Kansas City City, Platte County Part",2019,March,3,3,28860,28017,843,2.9,Not seasonally adjusted
"Kansas City City, Platte County Part",2019,February,3,2,28776,28007,769,2.7,Not seasonally adjusted
"Kansas City City, Platte County Part",2019,January,3,1,28764,27914,850,3,Not seasonally adjusted
Kirkwood city,2020,May,3,5,15200,14054,1146,7.5,Not seasonally adjusted
Kirkwood city,2020,April,3,4,15190,14138,1052,6.9,Not seasonally adjusted
Kirkwood city,2020,March,3,3,16233,15810,423,2.6,Not seasonally adjusted
Kirkwood city,2020,February,3,2,16021,15624,397,2.5,Not seasonally adjusted
Kirkwood city,2020,January,3,1,16080,15586,494,3.1,Not seasonally adjusted
Kirkwood city,2019,Annual Averages,1,0,16026,15681,345,2.2,Not seasonally adjusted
Kirkwood city,2019,December,3,12,16131,15739,392,2.4,Not seasonally adjusted
Kirkwood city,2019,November,3,11,16155,15806,349,2.2,Not seasonally adjusted
Kirkwood city,2019,October,3,10,16114,15824,290,1.8,Not seasonally adjusted
Kirkwood city,2019,September,3,9,16080,15825,255,1.6,Not seasonally adjusted
Kirkwood city,2019,August,3,8,16089,15755,334,2.1,Not seasonally adjusted
Kirkwood city,2019,July,3,7,16328,15948,380,2.3,Not seasonally adjusted
Kirkwood city,2019,June,3,6,16186,15822,364,2.2,Not seasonally adjusted
Kirkwood city,2019,May,3,5,15889,15583,306,1.9,Not seasonally adjusted
Kirkwood city,2019,April,3,4,15836,15555,281,1.8,Not seasonally adjusted
Kirkwood city,2019,March,3,3,15872,15480,392,2.5,Not seasonally adjusted
Kirkwood city,2019,February,3,2,15871,15483,388,2.4,Not seasonally adjusted
Kirkwood city,2019,January,3,1,15755,15352,403,2.6,Not seasonally adjusted
Lee's Summit city,2020,May,3,5,52425,48472,3953,7.5,Not seasonally adjusted
Lee's Summit city,2020,April,3,4,52608,48347,4261,8.1,Not seasonally adjusted
Lee's Summit city,2020,March,3,3,56249,54518,1731,3.1,Not seasonally adjusted
Lee's Summit city,2020,February,3,2,55718,54198,1520,2.7,Not seasonally adjusted
Lee's Summit city,2020,January,3,1,55531,53774,1757,3.2,Not seasonally adjusted
Lee's Summit city,2019,Annual Averages,1,0,55571,54154,1417,2.5,Not seasonally adjusted
Lee's Summit city,2019,December,3,12,56039,54511,1528,2.7,Not seasonally adjusted
Lee's Summit city,2019,November,3,11,56033,54692,1341,2.4,Not seasonally adjusted
Lee's Summit city,2019,October,3,10,55876,54697,1179,2.1,Not seasonally adjusted
Lee's Summit city,2019,September,3,9,55760,54606,1154,2.1,Not seasonally adjusted
Lee's Summit city,2019,August,3,8,55883,54372,1511,2.7,Not seasonally adjusted
Lee's Summit city,2019,July,3,7,56320,54840,1480,2.6,Not seasonally adjusted
Lee's Summit city,2019,June,3,6,56081,54722,1359,2.4,Not seasonally adjusted
Lee's Summit city,2019,May,3,5,55109,53790,1319,2.4,Not seasonally adjusted
Lee's Summit city,2019,April,3,4,54888,53645,1243,2.3,Not seasonally adjusted
Lee's Summit city,2019,March,3,3,54989,53389,1600,2.9,Not seasonally adjusted
Lee's Summit city,2019,February,3,2,54973,53362,1611,2.9,Not seasonally adjusted
Lee's Summit city,2019,January,3,1,54904,53221,1683,3.1,Not seasonally adjusted
"Lee's Summit City, Cass County Part",2020,May,3,5,1109,1038,71,6.4,Not seasonally adjusted
"Lee's Summit City, Cass County Part",2020,April,3,4,1109,1038,71,6.4,Not seasonally adjusted
"Lee's Summit City, Cass County Part",2020,March,3,3,1211,1162,49,4,Not seasonally adjusted
"Lee's Summit City, Cass County Part",2020,February,3,2,1189,1156,33,2.8,Not seasonally adjusted
"Lee's Summit City, Cass County Part",2020,January,3,1,1183,1147,36,3,Not seasonally adjusted
"Lee's Summit City, Cass County Part",2019,Annual Averages,1,0,1178,1154,24,2,Not seasonally adjusted
"Lee's Summit City, Cass County Part",2019,December,3,12,1188,1160,28,2.4,Not seasonally adjusted
"Lee's Summit City, Cass County Part",2019,November,3,11,1183,1164,19,1.6,Not seasonally adjusted
"Lee's Summit City, Cass County Part",2019,October,3,10,1187,1168,19,1.6,Not seasonally adjusted
"Lee's Summit City, Cass County Part",2019,September,3,9,1183,1161,22,1.9,Not seasonally adjusted
"Lee's Summit City, Cass County Part",2019,August,3,8,1179,1156,23,2,Not seasonally adjusted
"Lee's Summit City, Cass County Part",2019,July,3,7,1188,1166,22,1.9,Not seasonally adjusted
"Lee's Summit City, Cass County Part",2019,June,3,6,1180,1163,17,1.4,Not seasonally adjusted
"Lee's Summit City, Cass County Part",2019,May,3,5,1165,1148,17,1.5,Not seasonally adjusted
"Lee's Summit City, Cass County Part",2019,April,3,4,1165,1146,19,1.6,Not seasonally adjusted
"Lee's Summit City, Cass County Part",2019,March,3,3,1171,1138,33,2.8,Not seasonally adjusted
"Lee's Summit City, Cass County Part",2019,February,3,2,1167,1138,29,2.5,Not seasonally adjusted
"Lee's Summit City, Cass County Part",2019,January,3,1,1170,1135,35,3,Not seasonally adjusted
"Lee's Summit City, Jackson County Part",2020,May,3,5,51316,47434,3882,7.6,Not seasonally adjusted
"Lee's Summit City, Jackson County Part",2020,April,3,4,51499,47309,4190,8.1,Not seasonally adjusted
"Lee's Summit City, Jackson County Part",2020,March,3,3,55038,53356,1682,3.1,Not seasonally adjusted
"Lee's Summit City, Jackson County Part",2020,February,3,2,54529,53042,1487,2.7,Not seasonally adjusted
"Lee's Summit City, Jackson County Part",2020,January,3,1,54348,52627,1721,3.2,Not seasonally adjusted
"Lee's Summit City, Jackson County Part",2019,Annual Averages,1,0,54394,53000,1394,2.6,Not seasonally adjusted
"Lee's Summit City, Jackson County Part",2019,December,3,12,54851,53351,1500,2.7,Not seasonally adjusted
"Lee's Summit City, Jackson County Part",2019,November,3,11,54850,53528,1322,2.4,Not seasonally adjusted
"Lee's Summit City, Jackson County Part",2019,October,3,10,54689,53529,1160,2.1,Not seasonally adjusted
"Lee's Summit City, Jackson County Part",2019,September,3,9,54577,53445,1132,2.1,Not seasonally adjusted
"Lee's Summit City, Jackson County Part",2019,August,3,8,54704,53216,1488,2.7,Not seasonally adjusted
"Lee's Summit City, Jackson County Part",2019,July,3,7,55132,53674,1458,2.6,Not seasonally adjusted
"Lee's Summit City, Jackson County Part",2019,June,3,6,54901,53559,1342,2.4,Not seasonally adjusted
"Lee's Summit City, Jackson County Part",2019,May,3,5,53944,52642,1302,2.4,Not seasonally adjusted
"Lee's Summit City, Jackson County Part",2019,April,3,4,53723,52499,1224,2.3,Not seasonally adjusted
"Lee's Summit City, Jackson County Part",2019,March,3,3,53818,52251,1567,2.9,Not seasonally adjusted
"Lee's Summit City, Jackson County Part",2019,February,3,2,53806,52224,1582,2.9,Not seasonally adjusted
"Lee's Summit City, Jackson County Part",2019,January,3,1,53734,52086,1648,3.1,Not seasonally adjusted
Liberty city,2020,May,3,5,16546,14468,2078,12.6,Not seasonally adjusted
Liberty city,2020,April,3,4,16554,14445,2109,12.7,Not seasonally adjusted
Liberty city,2020,March,3,3,16798,16246,552,3.3,Not seasonally adjusted
Liberty city,2020,February,3,2,16642,16144,498,3,Not seasonally adjusted
Liberty city,2020,January,3,1,16594,16008,586,3.5,Not seasonally adjusted
Liberty city,2019,Annual Averages,1,0,16597,16132,465,2.8,Not seasonally adjusted
Liberty city,2019,December,3,12,16719,16219,500,3,Not seasonally adjusted
Liberty city,2019,November,3,11,16727,16282,445,2.7,Not seasonally adjusted
Liberty city,2019,October,3,10,16641,16294,347,2.1,Not seasonally adjusted
Liberty city,2019,September,3,9,16634,16257,377,2.3,Not seasonally adjusted
Liberty city,2019,August,3,8,16723,16181,542,3.2,Not seasonally adjusted
Liberty city,2019,July,3,7,16934,16323,611,3.6,Not seasonally adjusted
Liberty city,2019,June,3,6,16770,16298,472,2.8,Not seasonally adjusted
Liberty city,2019,May,3,5,16473,16044,429,2.6,Not seasonally adjusted
Liberty city,2019,April,3,4,16379,16012,367,2.2,Not seasonally adjusted
Liberty city,2019,March,3,3,16408,15913,495,3,Not seasonally adjusted
Liberty city,2019,February,3,2,16395,15907,488,3,Not seasonally adjusted
Liberty city,2019,January,3,1,16365,15857,508,3.1,Not seasonally adjusted
Maryland Heights city,2020,May,3,5,15634,14147,1487,9.5,Not seasonally adjusted
Maryland Heights city,2020,April,3,4,15592,14231,1361,8.7,Not seasonally adjusted
Maryland Heights city,2020,March,3,3,16416,15914,502,3.1,Not seasonally adjusted
Maryland Heights city,2020,February,3,2,16201,15727,474,2.9,Not seasonally adjusted
Maryland Heights city,2020,January,3,1,16230,15689,541,3.3,Not seasonally adjusted
Maryland Heights city,2019,Annual Averages,1,0,16189,15784,405,2.5,Not seasonally adjusted
Maryland Heights city,2019,December,3,12,16284,15842,442,2.7,Not seasonally adjusted
Maryland Heights city,2019,November,3,11,16303,15910,393,2.4,Not seasonally adjusted
Maryland Heights city,2019,October,3,10,16273,15928,345,2.1,Not seasonally adjusted
Maryland Heights city,2019,September,3,9,16257,15930,327,2,Not seasonally adjusted
Maryland Heights city,2019,August,3,8,16277,15859,418,2.6,Not seasonally adjusted
Maryland Heights city,2019,July,3,7,16452,16053,399,2.4,Not seasonally adjusted
Maryland Heights city,2019,June,3,6,16317,15926,391,2.4,Not seasonally adjusted
Maryland Heights city,2019,May,3,5,16058,15686,372,2.3,Not seasonally adjusted
Maryland Heights city,2019,April,3,4,16001,15658,343,2.1,Not seasonally adjusted
Maryland Heights city,2019,March,3,3,16030,15582,448,2.8,Not seasonally adjusted
Maryland Heights city,2019,February,3,2,16064,15585,479,3,Not seasonally adjusted
Maryland Heights city,2019,January,3,1,15957,15453,504,3.2,Not seasonally adjusted
O'Fallon city,2020,May,3,5,48690,44018,4672,9.6,Not seasonally adjusted
O'Fallon city,2020,April,3,4,49166,44344,4822,9.8,Not seasonally adjusted
O'Fallon city,2020,March,3,3,51003,49413,1590,3.1,Not seasonally adjusted
O'Fallon city,2020,February,3,2,50167,48787,1380,2.8,Not seasonally adjusted
O'Fallon city,2020,January,3,1,50482,48621,1861,3.7,Not seasonally adjusted
O'Fallon city,2019,Annual Averages,1,0,50212,48980,1232,2.5,Not seasonally adjusted
O'Fallon city,2019,December,3,12,50302,49066,1236,2.5,Not seasonally adjusted
O'Fallon city,2019,November,3,11,50535,49321,1214,2.4,Not seasonally adjusted
O'Fallon city,2019,October,3,10,50535,49413,1122,2.2,Not seasonally adjusted
O'Fallon city,2019,September,3,9,50440,49390,1050,2.1,Not seasonally adjusted
O'Fallon city,2019,August,3,8,50458,49141,1317,2.6,Not seasonally adjusted
O'Fallon city,2019,July,3,7,51060,49760,1300,2.5,Not seasonally adjusted
O'Fallon city,2019,June,3,6,50620,49414,1206,2.4,Not seasonally adjusted
O'Fallon city,2019,May,3,5,49914,48764,1150,2.3,Not seasonally adjusted
O'Fallon city,2019,April,3,4,49753,48728,1025,2.1,Not seasonally adjusted
O'Fallon city,2019,March,3,3,49746,48392,1354,2.7,Not seasonally adjusted
O'Fallon city,2019,February,3,2,49765,48413,1352,2.7,Not seasonally adjusted
O'Fallon city,2019,January,3,1,49410,47956,1454,2.9,Not seasonally adjusted
Raytown city,2020,May,3,5,14814,12910,1904,12.9,Not seasonally adjusted
Raytown city,2020,April,3,4,14724,12876,1848,12.6,Not seasonally adjusted
Raytown city,2020,March,3,3,15362,14522,840,5.5,Not seasonally adjusted
Raytown city,2020,February,3,2,15211,14436,775,5.1,Not seasonally adjusted
Raytown city,2020,January,3,1,15112,14323,789,5.2,Not seasonally adjusted
Raytown city,2019,Annual Averages,1,0,15099,14425,674,4.5,Not seasonally adjusted
Raytown city,2019,December,3,12,15181,14520,661,4.4,Not seasonally adjusted
Raytown city,2019,November,3,11,15183,14569,614,4,Not seasonally adjusted
Raytown city,2019,October,3,10,15216,14569,647,4.3,Not seasonally adjusted
Raytown city,2019,September,3,9,15108,14546,562,3.7,Not seasonally adjusted
Raytown city,2019,August,3,8,15192,14484,708,4.7,Not seasonally adjusted
Raytown city,2019,July,3,7,15435,14608,827,5.4,Not seasonally adjusted
Raytown city,2019,June,3,6,15258,14577,681,4.5,Not seasonally adjusted
Raytown city,2019,May,3,5,14893,14328,565,3.8,Not seasonally adjusted
Raytown city,2019,April,3,4,14856,14289,567,3.8,Not seasonally adjusted
Raytown city,2019,March,3,3,14975,14221,754,5,Not seasonally adjusted
Raytown city,2019,February,3,2,14970,14214,756,5.1,Not seasonally adjusted
Raytown city,2019,January,3,1,14926,14176,750,5,Not seasonally adjusted
Springfield city,2020,May,3,5,86108,77941,8167,9.5,Not seasonally adjusted
Springfield city,2020,April,3,4,87357,77993,9364,10.7,Not seasonally adjusted
Springfield city,2020,March,3,3,89379,86387,2992,3.3,Not seasonally adjusted
Springfield city,2020,February,3,2,87956,85162,2794,3.2,Not seasonally adjusted
Springfield city,2020,January,3,1,87902,84590,3312,3.8,Not seasonally adjusted
Springfield city,2019,Annual Averages,1,0,87258,84774,2484,2.8,Not seasonally adjusted
Springfield city,2019,December,3,12,88230,85415,2815,3.2,Not seasonally adjusted
Springfield city,2019,November,3,11,88214,85664,2550,2.9,Not seasonally adjusted
Springfield city,2019,October,3,10,87573,85484,2089,2.4,Not seasonally adjusted
Springfield city,2019,September,3,9,87585,85535,2050,2.3,Not seasonally adjusted
Springfield city,2019,August,3,8,86610,83740,2870,3.3,Not seasonally adjusted
Springfield city,2019,July,3,7,88287,85687,2600,2.9,Not seasonally adjusted
Springfield city,2019,June,3,6,87373,84887,2486,2.8,Not seasonally adjusted
Springfield city,2019,May,3,5,86920,84599,2321,2.7,Not seasonally adjusted
Springfield city,2019,April,3,4,86381,84394,1987,2.3,Not seasonally adjusted
Springfield city,2019,March,3,3,86941,84259,2682,3.1,Not seasonally adjusted
Springfield city,2019,February,3,2,86930,84356,2574,3,Not seasonally adjusted
Springfield city,2019,January,3,1,86051,83268,2783,3.2,Not seasonally adjusted
St. Charles city,2020,May,3,5,38265,34613,3652,9.5,Not seasonally adjusted
St. Charles city,2020,April,3,4,38596,34869,3727,9.7,Not seasonally adjusted
St. Charles city,2020,March,3,3,40174,38855,1319,3.3,Not seasonally adjusted
St. Charles city,2020,February,3,2,39572,38363,1209,3.1,Not seasonally adjusted
St. Charles city,2020,January,3,1,39707,38232,1475,3.7,Not seasonally adjusted
St. Charles city,2019,Annual Averages,1,0,39586,38515,1071,2.7,Not seasonally adjusted
St. Charles city,2019,December,3,12,39656,38582,1074,2.7,Not seasonally adjusted
St. Charles city,2019,November,3,11,39746,38783,963,2.4,Not seasonally adjusted
St. Charles city,2019,October,3,10,39734,38856,878,2.2,Not seasonally adjusted
St. Charles city,2019,September,3,9,39661,38837,824,2.1,Not seasonally adjusted
St. Charles city,2019,August,3,8,39764,38642,1122,2.8,Not seasonally adjusted
St. Charles city,2019,July,3,7,40433,39128,1305,3.2,Not seasonally adjusted
St. Charles city,2019,June,3,6,40084,38856,1228,3.1,Not seasonally adjusted
St. Charles city,2019,May,3,5,39349,38345,1004,2.6,Not seasonally adjusted
St. Charles city,2019,April,3,4,39217,38317,900,2.3,Not seasonally adjusted
St. Charles city,2019,March,3,3,39220,38053,1167,3,Not seasonally adjusted
St. Charles city,2019,February,3,2,39229,38069,1160,3,Not seasonally adjusted
St. Charles city,2019,January,3,1,38938,37710,1228,3.2,Not seasonally adjusted
St. Joseph city,2020,May,3,5,36530,33873,2657,7.3,Not seasonally adjusted
St. Joseph city,2020,April,3,4,36602,33783,2819,7.7,Not seasonally adjusted
St. Joseph city,2020,March,3,3,37967,36539,1428,3.8,Not seasonally adjusted
St. Joseph city,2020,February,3,2,37449,36064,1385,3.7,Not seasonally adjusted
St. Joseph city,2020,January,3,1,37534,36013,1521,4.1,Not seasonally adjusted
St. Joseph city,2019,Annual Averages,1,0,37566,36371,1195,3.2,Not seasonally adjusted
St. Joseph city,2019,December,3,12,37691,36501,1190,3.2,Not seasonally adjusted
St. Joseph city,2019,November,3,11,37626,36567,1059,2.8,Not seasonally adjusted
St. Joseph city,2019,October,3,10,37691,36694,997,2.6,Not seasonally adjusted
St. Joseph city,2019,September,3,9,37397,36463,934,2.5,Not seasonally adjusted
St. Joseph city,2019,August,3,8,37476,36214,1262,3.4,Not seasonally adjusted
St. Joseph city,2019,July,3,7,38342,36945,1397,3.6,Not seasonally adjusted
St. Joseph city,2019,June,3,6,37980,36760,1220,3.2,Not seasonally adjusted
St. Joseph city,2019,May,3,5,37219,36148,1071,2.9,Not seasonally adjusted
St. Joseph city,2019,April,3,4,37368,36311,1057,2.8,Not seasonally adjusted
St. Joseph city,2019,March,3,3,37413,36019,1394,3.7,Not seasonally adjusted
St. Joseph city,2019,February,3,2,37431,36056,1375,3.7,Not seasonally adjusted
St. Joseph city,2019,January,3,1,37155,35773,1382,3.7,Not seasonally adjusted
St. Peters city,2020,May,3,5,33365,30110,3255,9.8,Not seasonally adjusted
St. Peters city,2020,April,3,4,33618,30333,3285,9.8,Not seasonally adjusted
St. Peters city,2020,March,3,3,34837,33801,1036,3,Not seasonally adjusted
St. Peters city,2020,February,3,2,34284,33372,912,2.7,Not seasonally adjusted
St. Peters city,2020,January,3,1,34472,33259,1213,3.5,Not seasonally adjusted
St. Peters city,2019,Annual Averages,1,0,34380,33504,876,2.5,Not seasonally adjusted
St. Peters city,2019,December,3,12,34521,33563,958,2.8,Not seasonally adjusted
St. Peters city,2019,November,3,11,34571,33738,833,2.4,Not seasonally adjusted
St. Peters city,2019,October,3,10,34573,33801,772,2.2,Not seasonally adjusted
St. Peters city,2019,September,3,9,34499,33785,714,2.1,Not seasonally adjusted
St. Peters city,2019,August,3,8,34547,33615,932,2.7,Not seasonally adjusted
St. Peters city,2019,July,3,7,35063,34038,1025,2.9,Not seasonally adjusted
St. Peters city,2019,June,3,6,34748,33801,947,2.7,Not seasonally adjusted
St. Peters city,2019,May,3,5,34128,33357,771,2.3,Not seasonally adjusted
St. Peters city,2019,April,3,4,34019,33332,687,2,Not seasonally adjusted
St. Peters city,2019,March,3,3,34063,33102,961,2.8,Not seasonally adjusted
St. Peters city,2019,February,3,2,34065,33117,948,2.8,Not seasonally adjusted
St. Peters city,2019,January,3,1,33769,32804,965,2.9,Not seasonally adjusted
University City city,2020,May,3,5,18060,16243,1817,10.1,Not seasonally adjusted
University City city,2020,April,3,4,17852,16340,1512,8.5,Not seasonally adjusted
University City city,2020,March,3,3,18886,18272,614,3.3,Not seasonally adjusted
University City city,2020,February,3,2,18642,18057,585,3.1,Not seasonally adjusted
University City city,2020,January,3,1,18717,18014,703,3.8,Not seasonally adjusted
University City city,2019,Annual Averages,1,0,18685,18123,562,3,Not seasonally adjusted
University City city,2019,December,3,12,18783,18190,593,3.2,Not seasonally adjusted
University City city,2019,November,3,11,18817,18267,550,2.9,Not seasonally adjusted
University City city,2019,October,3,10,18768,18288,480,2.6,Not seasonally adjusted
University City city,2019,September,3,9,18710,18290,420,2.2,Not seasonally adjusted
University City city,2019,August,3,8,18807,18209,598,3.2,Not seasonally adjusted
University City city,2019,July,3,7,19088,18432,656,3.4,Not seasonally adjusted
University City city,2019,June,3,6,18884,18286,598,3.2,Not seasonally adjusted
University City city,2019,May,3,5,18504,18010,494,2.7,Not seasonally adjusted
University City city,2019,April,3,4,18460,17978,482,2.6,Not seasonally adjusted
University City city,2019,March,3,3,18525,17890,635,3.4,Not seasonally adjusted
University City city,2019,February,3,2,18478,17894,584,3.2,Not seasonally adjusted
University City city,2019,January,3,1,18392,17743,649,3.5,Not seasonally adjusted
Wentzville city,2020,May,3,5,22036,19687,2349,10.7,Not seasonally adjusted
Wentzville city,2020,April,3,4,22286,19833,2453,11,Not seasonally adjusted
Wentzville city,2020,March,3,3,22803,22099,704,3.1,Not seasonally adjusted
Wentzville city,2020,February,3,2,22477,21819,658,2.9,Not seasonally adjusted
Wentzville city,2020,January,3,1,22852,21745,1107,4.8,Not seasonally adjusted
Wentzville city,2019,Annual Averages,1,0,22456,21906,550,2.4,Not seasonally adjusted
Wentzville city,2019,December,3,12,22542,21944,598,2.7,Not seasonally adjusted
Wentzville city,2019,November,3,11,22600,22059,541,2.4,Not seasonally adjusted
Wentzville city,2019,October,3,10,22714,22100,614,2.7,Not seasonally adjusted
Wentzville city,2019,September,3,9,22533,22089,444,2,Not seasonally adjusted
Wentzville city,2019,August,3,8,22563,21978,585,2.6,Not seasonally adjusted
Wentzville city,2019,July,3,7,22808,22255,553,2.4,Not seasonally adjusted
Wentzville city,2019,June,3,6,22587,22100,487,2.2,Not seasonally adjusted
Wentzville city,2019,May,3,5,22284,21810,474,2.1,Not seasonally adjusted
Wentzville city,2019,April,3,4,22231,21793,438,2,Not seasonally adjusted
Wentzville city,2019,March,3,3,22249,21643,606,2.7,Not seasonally adjusted
Wentzville city,2019,February,3,2,22279,21652,627,2.8,Not seasonally adjusted
Wentzville city,2019,January,3,1,22084,21448,636,2.9,Not seasonally adjusted
Wildwood city,2020,May,3,5,18096,16755,1341,7.4,Not seasonally adjusted
Wildwood city,2020,April,3,4,18100,16854,1246,6.9,Not seasonally adjusted
Wildwood city,2020,March,3,3,19338,18848,490,2.5,Not seasonally adjusted
Wildwood city,2020,February,3,2,19080,18626,454,2.4,Not seasonally adjusted
Wildwood city,2020,January,3,1,19160,18581,579,3,Not seasonally adjusted
Wildwood city,2019,Annual Averages,1,0,19144,18694,450,2.4,Not seasonally adjusted
Wildwood city,2019,December,3,12,19262,18762,500,2.6,Not seasonally adjusted
Wildwood city,2019,November,3,11,19304,18843,461,2.4,Not seasonally adjusted
Wildwood city,2019,October,3,10,19265,18864,401,2.1,Not seasonally adjusted
Wildwood city,2019,September,3,9,19275,18866,409,2.1,Not seasonally adjusted
Wildwood city,2019,August,3,8,19270,18782,488,2.5,Not seasonally adjusted
Wildwood city,2019,July,3,7,19471,19012,459,2.4,Not seasonally adjusted
Wildwood city,2019,June,3,6,19297,18861,436,2.3,Not seasonally adjusted
Wildwood city,2019,May,3,5,18990,18577,413,2.2,Not seasonally adjusted
Wildwood city,2019,April,3,4,18925,18544,381,2,Not seasonally adjusted
Wildwood city,2019,March,3,3,18929,18454,475,2.5,Not seasonally adjusted
Wildwood city,2019,February,3,2,18950,18458,492,2.6,Not seasonally adjusted
Wildwood city,2019,January,3,1,18787,18301,486,2.6,Not seasonally adjusted