County,Date,Geofips,Month,Year,Civilian Labor Force,Employment,Number of Records,Unemployment,Unemployment Rate
Benton,1/1/90,53005,1,1990,57997,53075,1,4922,8.50%
Benton,2/1/90,53005,2,1990,58398,53930,1,4468,7.70%
Benton,3/1/90,53005,3,1990,59499,55591,1,3908,6.60%
Benton,4/1/90,53005,4,1990,61916,58320,1,3596,5.80%
Benton,5/1/90,53005,5,1990,63267,59720,1,3547,5.60%
Benton,6/1/90,53005,6,1990,67686,64159,1,3527,5.20%
Benton,7/1/90,53005,7,1990,62032,58313,1,3719,6.00%
Benton,8/1/90,53005,8,1990,62999,59057,1,3942,6.30%
Benton,9/1/90,53005,9,1990,62353,58992,1,3361,5.40%
Benton,10/1/90,53005,10,1990,61533,58196,1,3337,5.40%
Benton,11/1/90,53005,11,1990,59355,55144,1,4211,7.10%
Benton,12/1/90,53005,12,1990,59004,54247,1,4757,8.10%
Benton,1/1/91,53005,1,1991,59006,53314,1,5692,9.60%
Benton,2/1/91,53005,2,1991,59074,54076,1,4998,8.50%
Benton,3/1/91,53005,3,1991,59867,55372,1,4495,7.50%
Benton,4/1/91,53005,4,1991,61972,58093,1,3879,6.30%
Benton,5/1/91,53005,5,1991,63072,59245,1,3827,6.10%
Benton,6/1/91,53005,6,1991,67935,63745,1,4190,6.20%
Benton,7/1/91,53005,7,1991,63871,59410,1,4461,7.00%
Benton,8/1/91,53005,8,1991,63203,58876,1,4327,6.80%
Benton,9/1/91,53005,9,1991,63280,59399,1,3881,6.10%
Benton,10/1/91,53005,10,1991,63199,59213,1,3986,6.30%
Benton,11/1/91,53005,11,1991,60839,56364,1,4475,7.40%
Benton,12/1/91,53005,12,1991,60398,55592,1,4806,8.00%
Benton,1/1/92,53005,1,1992,60246,54765,1,5481,9.10%
Benton,2/1/92,53005,2,1992,61057,55333,1,5724,9.40%
Benton,3/1/92,53005,3,1992,61849,56827,1,5022,8.10%
Benton,4/1/92,53005,4,1992,64965,60624,1,4341,6.70%
Benton,5/1/92,53005,5,1992,65891,61580,1,4311,6.50%
Benton,6/1/92,53005,6,1992,73182,68442,1,4740,6.50%
Benton,7/1/92,53005,7,1992,66922,62398,1,4524,6.80%
Benton,8/1/92,53005,8,1992,65898,61176,1,4722,7.20%
Benton,9/1/92,53005,9,1992,66049,61844,1,4205,6.40%
Benton,10/1/92,53005,10,1992,64989,60534,1,4455,6.90%
Benton,11/1/92,53005,11,1992,63041,58187,1,4854,7.70%
Benton,12/1/92,53005,12,1992,63957,58459,1,5498,8.60%
Benton,1/1/93,53005,1,1993,63689,57481,1,6208,9.70%
Benton,2/1/93,53005,2,1993,64497,58859,1,5638,8.70%
Benton,3/1/93,53005,3,1993,65277,60209,1,5068,7.80%
Benton,4/1/93,53005,4,1993,67035,62698,1,4337,6.50%
Benton,5/1/93,53005,5,1993,69063,64721,1,4342,6.30%
Benton,6/1/93,53005,6,1993,76006,71209,1,4797,6.30%
Benton,7/1/93,53005,7,1993,70100,65153,1,4947,7.10%
Benton,8/1/93,53005,8,1993,69308,64884,1,4424,6.40%
Benton,9/1/93,53005,9,1993,69345,65398,1,3947,5.70%
Benton,10/1/93,53005,10,1993,70537,66317,1,4220,6.00%
Benton,11/1/93,53005,11,1993,67596,63155,1,4441,6.60%
Benton,12/1/93,53005,12,1993,67717,63188,1,4529,6.70%
Benton,1/1/94,53005,1,1994,68904,63694,1,5210,7.60%
Benton,2/1/94,53005,2,1994,69244,64007,1,5237,7.60%
Benton,3/1/94,53005,3,1994,69582,65106,1,4476,6.40%
Benton,4/1/94,53005,4,1994,71459,67366,1,4093,5.70%
Benton,5/1/94,53005,5,1994,73163,69525,1,3638,5.00%
Benton,6/1/94,53005,6,1994,78066,74321,1,3745,4.80%
Benton,7/1/94,53005,7,1994,72781,69151,1,3630,5.00%
Benton,8/1/94,53005,8,1994,72663,68762,1,3901,5.40%
Benton,9/1/94,53005,9,1994,73264,69764,1,3500,4.80%
Benton,10/1/94,53005,10,1994,73686,69941,1,3745,5.10%
Benton,11/1/94,53005,11,1994,71191,66888,1,4303,6.00%
Benton,12/1/94,53005,12,1994,72175,67540,1,4635,6.40%
Benton,1/1/95,53005,1,1995,70589,65110,1,5479,7.80%
Benton,2/1/95,53005,2,1995,71385,65987,1,5398,7.60%
Benton,3/1/95,53005,3,1995,72001,66921,1,5080,7.10%
Benton,4/1/95,53005,4,1995,73538,68528,1,5010,6.80%
Benton,5/1/95,53005,5,1995,74350,68565,1,5785,7.80%
Benton,6/1/95,53005,6,1995,81568,74957,1,6611,8.10%
Benton,7/1/95,53005,7,1995,74271,68349,1,5922,8.00%
Benton,8/1/95,53005,8,1995,73241,67107,1,6134,8.40%
Benton,9/1/95,53005,9,1995,72871,67134,1,5737,7.90%
Benton,10/1/95,53005,10,1995,71942,66375,1,5567,7.70%
Benton,11/1/95,53005,11,1995,69258,63292,1,5966,8.60%
Benton,12/1/95,53005,12,1995,68859,62593,1,6266,9.10%
Benton,1/1/96,53005,1,1996,69247,62191,1,7056,10.20%
Benton,2/1/96,53005,2,1996,69268,62776,1,6492,9.40%
Benton,3/1/96,53005,3,1996,70512,64197,1,6315,9.00%
Benton,4/1/96,53005,4,1996,72578,66729,1,5849,8.10%
Benton,5/1/96,53005,5,1996,73445,67386,1,6059,8.20%
Benton,6/1/96,53005,6,1996,78210,72401,1,5809,7.40%
Benton,7/1/96,53005,7,1996,75778,69833,1,5945,7.80%
Benton,8/1/96,53005,8,1996,73496,68108,1,5388,7.30%
Benton,9/1/96,53005,9,1996,73722,68888,1,4834,6.60%
Benton,10/1/96,53005,10,1996,72588,67808,1,4780,6.60%
Benton,11/1/96,53005,11,1996,69746,64731,1,5015,7.20%
Benton,12/1/96,53005,12,1996,68458,63342,1,5116,7.50%
Benton,1/1/97,53005,1,1997,69287,63219,1,6068,8.80%
Benton,2/1/97,53005,2,1997,69544,63824,1,5720,8.20%
Benton,3/1/97,53005,3,1997,70329,65218,1,5111,7.30%
Benton,4/1/97,53005,4,1997,72195,67447,1,4748,6.60%
Benton,5/1/97,53005,5,1997,73491,69016,1,4475,6.10%
Benton,6/1/97,53005,6,1997,78739,74115,1,4624,5.90%
Benton,7/1/97,53005,7,1997,74382,70064,1,4318,5.80%
Benton,8/1/97,53005,8,1997,74427,69714,1,4713,6.30%
Benton,9/1/97,53005,9,1997,74146,69951,1,4195,5.70%
Benton,10/1/97,53005,10,1997,74009,69887,1,4122,5.60%
Benton,11/1/97,53005,11,1997,70911,66648,1,4263,6.00%
Benton,12/1/97,53005,12,1997,70789,66218,1,4571,6.50%
Benton,1/1/98,53005,1,1998,70607,64992,1,5615,8.00%
Benton,2/1/98,53005,2,1998,71500,65990,1,5510,7.70%
Benton,3/1/98,53005,3,1998,72423,67427,1,4996,6.90%
Benton,4/1/98,53005,4,1998,73693,69261,1,4432,6.00%
Benton,5/1/98,53005,5,1998,74781,70482,1,4299,5.70%
Benton,6/1/98,53005,6,1998,80093,75182,1,4911,6.10%
Benton,7/1/98,53005,7,1998,76048,71492,1,4556,6.00%
Benton,8/1/98,53005,8,1998,75176,70494,1,4682,6.20%
Benton,9/1/98,53005,9,1998,74894,70541,1,4353,5.80%
Benton,10/1/98,53005,10,1998,74858,70499,1,4359,5.80%
Benton,11/1/98,53005,11,1998,72148,67841,1,4307,6.00%
Benton,12/1/98,53005,12,1998,72434,67854,1,4580,6.30%
Benton,1/1/99,53005,1,1999,72628,67349,1,5279,7.30%
Benton,2/1/99,53005,2,1999,72975,67885,1,5090,7.00%
Benton,3/1/99,53005,3,1999,72949,68695,1,4254,5.80%
Benton,4/1/99,53005,4,1999,75355,71238,1,4117,5.50%
Benton,5/1/99,53005,5,1999,75860,71753,1,4107,5.40%
Benton,6/1/99,53005,6,1999,80383,75762,1,4621,5.70%
Benton,7/1/99,53005,7,1999,77996,73752,1,4244,5.40%
Benton,8/1/99,53005,8,1999,75828,71703,1,4125,5.40%
Benton,9/1/99,53005,9,1999,75654,72135,1,3519,4.70%
Benton,10/1/99,53005,10,1999,76226,72619,1,3607,4.70%
Benton,11/1/99,53005,11,1999,72468,68757,1,3711,5.10%
Benton,12/1/99,53005,12,1999,71913,67825,1,4088,5.70%
Benton,1/1/00,53005,1,2000,73509,68818,1,4691,6.40%
Benton,2/1/00,53005,2,2000,74517,69641,1,4876,6.50%
Benton,3/1/00,53005,3,2000,74187,69885,1,4302,5.80%
Benton,4/1/00,53005,4,2000,76225,72200,1,4025,5.30%
Benton,5/1/00,53005,5,2000,76817,72712,1,4105,5.30%
Benton,6/1/00,53005,6,2000,82049,77995,1,4054,4.90%
Benton,7/1/00,53005,7,2000,77257,73199,1,4058,5.30%
Benton,8/1/00,53005,8,2000,77620,73451,1,4169,5.40%
Benton,9/1/00,53005,9,2000,77455,73796,1,3659,4.70%
Benton,10/1/00,53005,10,2000,77167,73604,1,3563,4.60%
Benton,11/1/00,53005,11,2000,74450,70249,1,4201,5.60%
Benton,12/1/00,53005,12,2000,73443,68918,1,4525,6.20%
Benton,1/1/01,53005,1,2001,73848,68404,1,5444,7.40%
Benton,2/1/01,53005,2,2001,74397,69147,1,5250,7.10%
Benton,3/1/01,53005,3,2001,74095,69416,1,4679,6.30%
Benton,4/1/01,53005,4,2001,75484,71036,1,4448,5.90%
Benton,5/1/01,53005,5,2001,76437,72278,1,4159,5.40%
Benton,6/1/01,53005,6,2001,80803,76355,1,4448,5.50%
Benton,7/1/01,53005,7,2001,78029,73787,1,4242,5.40%
Benton,8/1/01,53005,8,2001,76519,71963,1,4556,6.00%
Benton,9/1/01,53005,9,2001,77688,73550,1,4138,5.30%
Benton,10/1/01,53005,10,2001,78962,74709,1,4253,5.40%
Benton,11/1/01,53005,11,2001,76291,71465,1,4826,6.30%
Benton,12/1/01,53005,12,2001,75489,70198,1,5291,7.00%
Benton,1/1/02,53005,1,2002,75375,69323,1,6052,8.00%
Benton,2/1/02,53005,2,2002,76880,71222,1,5658,7.40%
Benton,3/1/02,53005,3,2002,77334,72130,1,5204,6.70%
Benton,4/1/02,53005,4,2002,78512,73528,1,4984,6.30%
Benton,5/1/02,53005,5,2002,80038,75185,1,4853,6.10%
Benton,6/1/02,53005,6,2002,83888,78882,1,5006,6.00%
Benton,7/1/02,53005,7,2002,83138,78194,1,4944,5.90%
Benton,8/1/02,53005,8,2002,81444,76625,1,4819,5.90%
Benton,9/1/02,53005,9,2002,82187,77834,1,4353,5.30%
Benton,10/1/02,53005,10,2002,82341,77981,1,4360,5.30%
Benton,11/1/02,53005,11,2002,79264,74147,1,5117,6.50%
Benton,12/1/02,53005,12,2002,79286,73903,1,5383,6.80%
Benton,1/1/03,53005,1,2003,78787,72504,1,6283,8.00%
Benton,2/1/03,53005,2,2003,79877,73528,1,6349,7.90%
Benton,3/1/03,53005,3,2003,79477,73752,1,5725,7.20%
Benton,4/1/03,53005,4,2003,80844,75287,1,5557,6.90%
Benton,5/1/03,53005,5,2003,82120,76725,1,5395,6.60%
Benton,6/1/03,53005,6,2003,87667,81743,1,5924,6.80%
Benton,7/1/03,53005,7,2003,83767,78224,1,5543,6.60%
Benton,8/1/03,53005,8,2003,83369,77701,1,5668,6.80%
Benton,9/1/03,53005,9,2003,83639,78433,1,5206,6.20%
Benton,10/1/03,53005,10,2003,84279,79115,1,5164,6.10%
Benton,11/1/03,53005,11,2003,81427,75720,1,5707,7.00%
Benton,12/1/03,53005,12,2003,81220,75448,1,5772,7.10%
Benton,1/1/04,53005,1,2004,80155,73197,1,6958,8.70%
Benton,2/1/04,53005,2,2004,80944,74689,1,6255,7.70%
Benton,3/1/04,53005,3,2004,82056,76381,1,5675,6.90%
Benton,4/1/04,53005,4,2004,83889,78690,1,5199,6.20%
Benton,5/1/04,53005,5,2004,84810,79940,1,4870,5.70%
Benton,6/1/04,53005,6,2004,90016,84937,1,5079,5.60%
Benton,7/1/04,53005,7,2004,85606,80851,1,4755,5.60%
Benton,8/1/04,53005,8,2004,85928,81147,1,4781,5.60%
Benton,9/1/04,53005,9,2004,85974,81726,1,4248,4.90%
Benton,10/1/04,53005,10,2004,86956,82680,1,4276,4.90%
Benton,11/1/04,53005,11,2004,83863,79192,1,4671,5.60%
Benton,12/1/04,53005,12,2004,83220,78249,1,4971,6.00%
Benton,1/1/05,53005,1,2005,82019,76241,1,5778,7.00%
Benton,2/1/05,53005,2,2005,83126,77639,1,5487,6.60%
Benton,3/1/05,53005,3,2005,83493,78866,1,4627,5.50%
Benton,4/1/05,53005,4,2005,84453,79786,1,4667,5.50%
Benton,5/1/05,53005,5,2005,85956,81263,1,4693,5.50%
Benton,6/1/05,53005,6,2005,92120,87200,1,4920,5.30%
Benton,7/1/05,53005,7,2005,85883,81016,1,4867,5.70%
Benton,8/1/05,53005,8,2005,86199,80988,1,5211,6.00%
Benton,9/1/05,53005,9,2005,86247,81301,1,4946,5.70%
Benton,10/1/05,53005,10,2005,85811,80870,1,4941,5.80%
Benton,11/1/05,53005,11,2005,82995,77580,1,5415,6.50%
Benton,12/1/05,53005,12,2005,82029,76244,1,5785,7.10%
Benton,1/1/06,53005,1,2006,81212,74872,1,6340,7.80%
Benton,2/1/06,53005,2,2006,81528,75248,1,6280,7.70%
Benton,3/1/06,53005,3,2006,81641,76150,1,5491,6.70%
Benton,4/1/06,53005,4,2006,82124,76880,1,5244,6.40%
Benton,5/1/06,53005,5,2006,83746,78646,1,5100,6.10%
Benton,6/1/06,53005,6,2006,86378,81388,1,4990,5.80%
Benton,7/1/06,53005,7,2006,84666,79811,1,4855,5.70%
Benton,8/1/06,53005,8,2006,83383,78542,1,4841,5.80%
Benton,9/1/06,53005,9,2006,84143,79748,1,4395,5.20%
Benton,10/1/06,53005,10,2006,84601,80304,1,4297,5.10%
Benton,11/1/06,53005,11,2006,83136,78324,1,4812,5.80%
Benton,12/1/06,53005,12,2006,82062,76811,1,5251,6.40%
Benton,1/1/07,53005,1,2007,81786,76019,1,5767,7.10%
Benton,2/1/07,53005,2,2007,81892,76505,1,5387,6.60%
Benton,3/1/07,53005,3,2007,82986,78213,1,4773,5.80%
Benton,4/1/07,53005,4,2007,83937,79315,1,4622,5.50%
Benton,5/1/07,53005,5,2007,85978,81567,1,4411,5.10%
Benton,6/1/07,53005,6,2007,91554,87141,1,4413,4.80%
Benton,7/1/07,53005,7,2007,86548,81883,1,4665,5.40%
Benton,8/1/07,53005,8,2007,88043,83594,1,4449,5.10%
Benton,9/1/07,53005,9,2007,88983,84694,1,4289,4.80%
Benton,10/1/07,53005,10,2007,88448,84408,1,4040,4.60%
Benton,11/1/07,53005,11,2007,87031,82361,1,4670,5.40%
Benton,12/1/07,53005,12,2007,85693,80721,1,4972,5.80%
Benton,1/1/08,53005,1,2008,85458,79812,1,5646,6.60%
Benton,2/1/08,53005,2,2008,85613,80195,1,5418,6.30%
Benton,3/1/08,53005,3,2008,86244,81490,1,4754,5.50%
Benton,4/1/08,53005,4,2008,86097,81653,1,4444,5.20%
Benton,5/1/08,53005,5,2008,88204,83522,1,4682,5.30%
Benton,6/1/08,53005,6,2008,91986,87537,1,4449,4.80%
Benton,7/1/08,53005,7,2008,90929,86386,1,4543,5.00%
Benton,8/1/08,53005,8,2008,90166,85605,1,4561,5.10%
Benton,9/1/08,53005,9,2008,91007,86758,1,4249,4.70%
Benton,10/1/08,53005,10,2008,91652,87169,1,4483,4.90%
Benton,11/1/08,53005,11,2008,89732,84847,1,4885,5.40%
Benton,12/1/08,53005,12,2008,88377,82885,1,5492,6.20%
Benton,1/1/09,53005,1,2009,89019,82211,1,6808,7.60%
Benton,2/1/09,53005,2,2009,89257,82411,1,6846,7.70%
Benton,3/1/09,53005,3,2009,89289,82675,1,6614,7.40%
Benton,4/1/09,53005,4,2009,89182,83177,1,6005,6.70%
Benton,5/1/09,53005,5,2009,92289,86098,1,6191,6.70%
Benton,6/1/09,53005,6,2009,97540,91033,1,6507,6.70%
Benton,7/1/09,53005,7,2009,97342,90847,1,6495,6.70%
Benton,8/1/09,53005,8,2009,96241,89467,1,6774,7.00%
Benton,9/1/09,53005,9,2009,95464,88773,1,6691,7.00%
Benton,10/1/09,53005,10,2009,95193,88474,1,6719,7.10%
Benton,11/1/09,53005,11,2009,92137,85173,1,6964,7.60%
Benton,12/1/09,53005,12,2009,90991,83117,1,7874,8.70%
Benton,1/1/10,53005,1,2010,92189,83218,1,8971,9.70%
Benton,2/1/10,53005,2,2010,91858,83089,1,8769,9.50%
Benton,3/1/10,53005,3,2010,92839,84706,1,8133,8.80%
Benton,4/1/10,53005,4,2010,93170,85824,1,7346,7.90%
Benton,5/1/10,53005,5,2010,93861,86574,1,7287,7.80%
Benton,6/1/10,53005,6,2010,96683,89775,1,6908,7.10%
Benton,7/1/10,53005,7,2010,96783,89888,1,6895,7.10%
Benton,8/1/10,53005,8,2010,95785,88812,1,6973,7.30%
Benton,9/1/10,53005,9,2010,94602,87987,1,6615,7.00%
Benton,10/1/10,53005,10,2010,95632,89117,1,6515,6.80%
Benton,11/1/10,53005,11,2010,94426,87402,1,7024,7.40%
Benton,12/1/10,53005,12,2010,93204,85757,1,7447,8.00%
Benton,1/1/11,53005,1,2011,92555,84161,1,8394,9.10%
Benton,2/1/11,53005,2,2011,92282,84179,1,8103,8.80%
Benton,3/1/11,53005,3,2011,93018,85434,1,7584,8.20%
Benton,4/1/11,53005,4,2011,92121,85137,1,6984,7.60%
Benton,5/1/11,53005,5,2011,92686,85412,1,7274,7.80%
Benton,6/1/11,53005,6,2011,94224,87032,1,7192,7.60%
Benton,7/1/11,53005,7,2011,95033,87973,1,7060,7.40%
Benton,8/1/11,53005,8,2011,93629,86574,1,7055,7.50%
Benton,9/1/11,53005,9,2011,92366,85540,1,6826,7.40%
Benton,10/1/11,53005,10,2011,93303,85494,1,7809,8.40%
Benton,11/1/11,53005,11,2011,92178,84026,1,8152,8.80%
Benton,12/1/11,53005,12,2011,91438,82337,1,9101,10.00%
Benton,1/1/12,53005,1,2012,92193,82360,1,9833,10.70%
Benton,2/1/12,53005,2,2012,92096,82271,1,9825,10.70%
Benton,3/1/12,53005,3,2012,92301,83270,1,9031,9.80%
Benton,4/1/12,53005,4,2012,91254,82831,1,8423,9.20%
Benton,5/1/12,53005,5,2012,92630,84151,1,8479,9.20%
Benton,6/1/12,53005,6,2012,95187,86710,1,8477,8.90%
Benton,7/1/12,53005,7,2012,94248,85910,1,8338,8.80%
Benton,8/1/12,53005,8,2012,91972,83710,1,8262,9.00%
Benton,9/1/12,53005,9,2012,90298,82694,1,7604,8.40%
Benton,10/1/12,53005,10,2012,92189,84358,1,7831,8.50%
Benton,11/1/12,53005,11,2012,90255,82338,1,7917,8.80%
Benton,12/1/12,53005,12,2012,89864,80998,1,8866,9.90%
Benton,1/1/13,53005,1,2013,90198,80195,1,10003,11.10%
Benton,2/1/13,53005,2,2013,89873,80405,1,9468,10.50%
Benton,3/1/13,53005,3,2013,89892,81280,1,8612,9.60%
Benton,4/1/13,53005,4,2013,89689,81507,1,8182,9.10%
Benton,5/1/13,53005,5,2013,90297,82253,1,8044,8.90%
Benton,6/1/13,53005,6,2013,93578,85731,1,7847,8.40%
Benton,7/1/13,53005,7,2013,91425,83722,1,7703,8.40%
Benton,8/1/13,53005,8,2013,90967,83447,1,7520,8.30%
Benton,9/1/13,53005,9,2013,90187,83306,1,6881,7.60%
Benton,10/1/13,53005,10,2013,90337,83177,1,7160,7.90%
Benton,11/1/13,53005,11,2013,89045,81680,1,7365,8.30%
Benton,12/1/13,53005,12,2013,88117,80246,1,7871,8.90%
Benton,1/1/14,53005,1,2014,88373,80020,1,8353,9.50%
Benton,2/1/14,53005,2,2014,87880,79713,1,8167,9.30%
Benton,3/1/14,53005,3,2014,88522,80884,1,7638,8.60%
Benton,4/1/14,53005,4,2014,87880,81417,1,6463,7.40%
Benton,5/1/14,53005,5,2014,88478,81992,1,6486,7.30%
Benton,6/1/14,53005,6,2014,93853,87799,1,6054,6.50%
Benton,7/1/14,53005,7,2014,91145,84987,1,6158,6.80%
Benton,8/1/14,53005,8,2014,90625,84346,1,6279,6.90%
Benton,9/1/14,53005,9,2014,89877,84195,1,5682,6.30%
Benton,10/1/14,53005,10,2014,90719,84845,1,5874,6.50%
Benton,11/1/14,53005,11,2014,90295,83780,1,6515,7.20%
Benton,12/1/14,53005,12,2014,89712,82678,1,7034,7.80%
Benton,1/1/15,53005,1,2015,89652,82042,1,7610,8.50%
Benton,2/1/15,53005,2,2015,89618,82214,1,7404,8.30%
Benton,3/1/15,53005,3,2015,90094,83389,1,6705,7.40%
Benton,4/1/15,53005,4,2015,90399,84253,1,6146,6.80%
Benton,5/1/15,53005,5,2015,91602,85593,1,6009,6.60%
Benton,6/1/15,53005,6,2015,95842,89981,1,5861,6.10%
Benton,7/1/15,53005,7,2015,92605,86729,1,5876,6.30%
Benton,8/1/15,53005,8,2015,91974,86213,1,5761,6.30%
Benton,9/1/15,53005,9,2015,91477,86335,1,5142,5.60%
Benton,10/1/15,53005,10,2015,92139,86718,1,5421,5.90%
Benton,11/1/15,53005,11,2015,91849,85686,1,6163,6.70%
Benton,12/1/15,53005,12,2015,91751,85116,1,6635,7.20%
Benton,1/1/16,53005,1,2016,91673,84517,1,7156,7.80%
Benton,2/1/16,53005,2,2016,92292,85153,1,7139,7.70%
Benton,3/1/16,53005,3,2016,93001,86482,1,6519,7.00%
Benton,4/1/16,53005,4,2016,93222,87051,1,6171,6.60%
Benton,5/1/16,53005,5,2016,93894,88317,1,5577,5.90%
Benton,6/1/16,53005,6,2016,97344,91576,1,5768,5.90%
Benton,7/1/16,53005,7,2016,95390,89882,1,5508,5.80%
Benton,8/1/16,53005,8,2016,94442,88730,1,5712,6.00%
Benton,9/1/16,53005,9,2016,94178,89036,1,5142,5.50%
Benton,10/1/16,53005,10,2016,95555,90426,1,5129,5.40%
Benton,11/1/16,53005,11,2016,94502,88952,1,5550,5.90%
Benton,12/1/16,53005,12,2016,94074,88065,1,6009,6.40%
Benton,1/1/17,53005,1,2017,93596,86379,1,7217,7.70%
Benton,2/1/17,53005,2,2017,94290,87404,1,6886,7.30%
Benton,3/1/17,53005,3,2017,95028,89141,1,5887,6.20%
Benton,4/1/17,53005,4,2017,96028,90776,1,5252,5.50%
Benton,5/1/17,53005,5,2017,96491,91564,1,4927,5.10%
Benton,6/1/17,53005,6,2017,101679,96645,1,5034,5.00%
Benton,7/1/17,53005,7,2017,100403,95566,1,4837,4.80%
Benton,8/1/17,53005,8,2017,97795,92746,1,5049,5.20%
Benton,9/1/17,53005,9,2017,97370,92899,1,4471,4.60%
Benton,10/1/17,53005,10,2017,97521,93004,1,4517,4.60%
Benton,11/1/17,53005,11,2017,96148,91036,1,5112,5.30%
Benton,12/1/17,53005,12,2017,96220,90390,1,5830,6.10%
Benton,1/1/18,53005,1,2018,95615,89021,1,6594,6.90%
Benton,2/1/18,53005,2,2018,96655,90107,1,6548,6.80%
Benton,3/1/18,53005,3,2018,97640,91873,1,5767,5.90%
Benton,4/1/18,53005,4,2018,97977,92725,1,5252,5.40%
Benton,5/1/18,53005,5,2018,98567,93799,1,4768,4.80%
Benton,6/1/18,53005,6,2018,103381,98238,1,5143,5.00%
Benton,7/1/18,53005,7,2018,100409,95567,1,4842,4.80%
Benton,8/1/18,53005,8,2018,99423,94567,1,4856,4.90%
Benton,9/1/18,53005,9,2018,98880,94613,1,4267,4.30%
Benton,10/1/18,53005,10,2018,100337,95721,1,4616,4.60%
Benton,11/1/18,53005,11,2018,99422,94195,1,5227,5.30%
Benton,12/1/18,53005,12,2018,99961,93993,1,5968,6.00%
Benton,1/1/19,53005,1,2019,99909,93061,1,6848,6.90%
Benton,2/1/19,53005,2,2019,99233,92050,1,7183,7.20%
Benton,3/1/19,53005,3,2019,100731,94258,1,6473,6.40%
Benton,4/1/19,53005,4,2019,101508,96145,1,5363,5.30%
Benton,5/1/19,53005,5,2019,103049,98038,1,5011,4.90%
Benton,6/1/19,53005,6,2019,106329,101209,1,5120,4.80%
Benton,7/1/19,53005,7,2019,105715,100769,1,4946,4.70%
Benton,8/1/19,53005,8,2019,104121,99190,1,4931,4.70%
Benton,9/1/19,53005,9,2019,104357,100156,1,4201,4.00%
Benton,10/1/19,53005,10,2019,104670,100330,1,4340,4.10%
Benton,11/1/19,53005,11,2019,103890,99040,1,4850,4.70%
Benton,12/1/19,53005,12,2019,104514,99030,1,5484,5.20%
Benton,1/1/20,53005,1,2020,104938,98912,1,6026,5.70%
Benton,2/1/20,53005,2,2020,105195,99430,1,5765,5.50%
Benton,3/1/20,53005,3,2020,103923,98678,1,5245,5.00%
Benton,4/1/20,53005,4,2020,105445,90994,1,14451,13.70%
Benton,5/1/20,53005,5,2020,105404,92425,1,12979,12.30%
Chelan,1/1/90,53007,1,1990,28914,25965,1,2949,10.20%
Chelan,2/1/90,53007,2,1990,29063,26012,1,3051,10.50%
Chelan,3/1/90,53007,3,1990,29863,26858,1,3005,10.10%
Chelan,4/1/90,53007,4,1990,29296,26171,1,3125,10.70%
Chelan,5/1/90,53007,5,1990,29705,26413,1,3292,11.10%
Chelan,6/1/90,53007,6,1990,34865,32126,1,2739,7.90%
Chelan,7/1/90,53007,7,1990,37507,34711,1,2796,7.50%
Chelan,8/1/90,53007,8,1990,33542,30118,1,3424,10.20%
Chelan,9/1/90,53007,9,1990,35847,33747,1,2100,5.90%
Chelan,10/1/90,53007,10,1990,34312,32513,1,1799,5.20%
Chelan,11/1/90,53007,11,1990,29028,26258,1,2770,9.50%
Chelan,12/1/90,53007,12,1990,29230,26247,1,2983,10.20%
Chelan,1/1/91,53007,1,1991,29269,25379,1,3890,13.30%
Chelan,2/1/91,53007,2,1991,29583,25764,1,3819,12.90%
Chelan,3/1/91,53007,3,1991,29408,25809,1,3599,12.20%
Chelan,4/1/91,53007,4,1991,29467,25504,1,3963,13.40%
Chelan,5/1/91,53007,5,1991,29642,25641,1,4001,13.50%
Chelan,6/1/91,53007,6,1991,32774,29610,1,3164,9.70%
Chelan,7/1/91,53007,7,1991,37704,35027,1,2677,7.10%
Chelan,8/1/91,53007,8,1991,33214,28783,1,4431,13.30%
Chelan,9/1/91,53007,9,1991,35248,32440,1,2808,8.00%
Chelan,10/1/91,53007,10,1991,34945,32848,1,2097,6.00%
Chelan,11/1/91,53007,11,1991,29703,26451,1,3252,10.90%
Chelan,12/1/91,53007,12,1991,29422,26023,1,3399,11.60%
Chelan,1/1/92,53007,1,1992,29166,25205,1,3961,13.60%
Chelan,2/1/92,53007,2,1992,29606,25604,1,4002,13.50%
Chelan,3/1/92,53007,3,1992,30101,26074,1,4027,13.40%
Chelan,4/1/92,53007,4,1992,30387,26262,1,4125,13.60%
Chelan,5/1/92,53007,5,1992,31098,27149,1,3949,12.70%
Chelan,6/1/92,53007,6,1992,36351,32981,1,3370,9.30%
Chelan,7/1/92,53007,7,1992,36377,32703,1,3674,10.10%
Chelan,8/1/92,53007,8,1992,34324,30589,1,3735,10.90%
Chelan,9/1/92,53007,9,1992,36868,34395,1,2473,6.70%
Chelan,10/1/92,53007,10,1992,32881,29740,1,3141,9.60%
Chelan,11/1/92,53007,11,1992,30091,26489,1,3602,12.00%
Chelan,12/1/92,53007,12,1992,30227,26166,1,4061,13.40%
Chelan,1/1/93,53007,1,1993,29579,24645,1,4934,16.70%
Chelan,2/1/93,53007,2,1993,30256,25869,1,4387,14.50%
Chelan,3/1/93,53007,3,1993,30394,26466,1,3928,12.90%
Chelan,4/1/93,53007,4,1993,30024,26602,1,3422,11.40%
Chelan,5/1/93,53007,5,1993,30664,27226,1,3438,11.20%
Chelan,6/1/93,53007,6,1993,35937,32385,1,3552,9.90%
Chelan,7/1/93,53007,7,1993,38482,35559,1,2923,7.60%
Chelan,8/1/93,53007,8,1993,34937,31105,1,3832,11.00%
Chelan,9/1/93,53007,9,1993,37800,35195,1,2605,6.90%
Chelan,10/1/93,53007,10,1993,35828,33326,1,2502,7.00%
Chelan,11/1/93,53007,11,1993,30998,27931,1,3067,9.90%
Chelan,12/1/93,53007,12,1993,30923,27543,1,3380,10.90%
Chelan,1/1/94,53007,1,1994,30660,26853,1,3807,12.40%
Chelan,2/1/94,53007,2,1994,31427,27384,1,4043,12.90%
Chelan,3/1/94,53007,3,1994,31201,27612,1,3589,11.50%
Chelan,4/1/94,53007,4,1994,31104,27589,1,3515,11.30%
Chelan,5/1/94,53007,5,1994,31816,28565,1,3251,10.20%
Chelan,6/1/94,53007,6,1994,38173,35690,1,2483,6.50%
Chelan,7/1/94,53007,7,1994,38379,35694,1,2685,7.00%
Chelan,8/1/94,53007,8,1994,35491,31812,1,3679,10.40%
Chelan,9/1/94,53007,9,1994,39608,37481,1,2127,5.40%
Chelan,10/1/94,53007,10,1994,37331,34912,1,2419,6.50%
Chelan,11/1/94,53007,11,1994,32523,29477,1,3046,9.40%
Chelan,12/1/94,53007,12,1994,32076,28683,1,3393,10.60%
Chelan,1/1/95,53007,1,1995,31019,26954,1,4065,13.10%
Chelan,2/1/95,53007,2,1995,31766,27680,1,4086,12.90%
Chelan,3/1/95,53007,3,1995,31674,28097,1,3577,11.30%
Chelan,4/1/95,53007,4,1995,31713,28032,1,3681,11.60%
Chelan,5/1/95,53007,5,1995,31782,28185,1,3597,11.30%
Chelan,6/1/95,53007,6,1995,36514,33314,1,3200,8.80%
Chelan,7/1/95,53007,7,1995,39532,36300,1,3232,8.20%
Chelan,8/1/95,53007,8,1995,35561,30895,1,4666,13.10%
Chelan,9/1/95,53007,9,1995,38615,35785,1,2830,7.30%
Chelan,10/1/95,53007,10,1995,37067,34282,1,2785,7.50%
Chelan,11/1/95,53007,11,1995,32124,28266,1,3858,12.00%
Chelan,12/1/95,53007,12,1995,31460,27640,1,3820,12.10%
Chelan,1/1/96,53007,1,1996,31905,27414,1,4491,14.10%
Chelan,2/1/96,53007,2,1996,32293,28195,1,4098,12.70%
Chelan,3/1/96,53007,3,1996,32947,29118,1,3829,11.60%
Chelan,4/1/96,53007,4,1996,33119,29424,1,3695,11.20%
Chelan,5/1/96,53007,5,1996,33672,29559,1,4113,12.20%
Chelan,6/1/96,53007,6,1996,36886,33432,1,3454,9.40%
Chelan,7/1/96,53007,7,1996,41384,38222,1,3162,7.60%
Chelan,8/1/96,53007,8,1996,36838,32587,1,4251,11.50%
Chelan,9/1/96,53007,9,1996,38515,35955,1,2560,6.60%
Chelan,10/1/96,53007,10,1996,39635,37330,1,2305,5.80%
Chelan,11/1/96,53007,11,1996,33072,30057,1,3015,9.10%
Chelan,12/1/96,53007,12,1996,32485,29010,1,3475,10.70%
Chelan,1/1/97,53007,1,1997,33197,28946,1,4251,12.80%
Chelan,2/1/97,53007,2,1997,33281,29494,1,3787,11.40%
Chelan,3/1/97,53007,3,1997,33879,30607,1,3272,9.70%
Chelan,4/1/97,53007,4,1997,33834,30856,1,2978,8.80%
Chelan,5/1/97,53007,5,1997,33727,30832,1,2895,8.60%
Chelan,6/1/97,53007,6,1997,37250,34725,1,2525,6.80%
Chelan,7/1/97,53007,7,1997,40960,38647,1,2313,5.60%
Chelan,8/1/97,53007,8,1997,36547,34401,1,2146,5.90%
Chelan,9/1/97,53007,9,1997,38362,36423,1,1939,5.10%
Chelan,10/1/97,53007,10,1997,38059,36137,1,1922,5.10%
Chelan,11/1/97,53007,11,1997,33713,31073,1,2640,7.80%
Chelan,12/1/97,53007,12,1997,33491,30640,1,2851,8.50%
Chelan,1/1/98,53007,1,1998,33365,29476,1,3889,11.70%
Chelan,2/1/98,53007,2,1998,33652,30068,1,3584,10.70%
Chelan,3/1/98,53007,3,1998,34109,30711,1,3398,10.00%
Chelan,4/1/98,53007,4,1998,34006,31057,1,2949,8.70%
Chelan,5/1/98,53007,5,1998,34519,31602,1,2917,8.50%
Chelan,6/1/98,53007,6,1998,39491,36826,1,2665,6.70%
Chelan,7/1/98,53007,7,1998,43071,40245,1,2826,6.60%
Chelan,8/1/98,53007,8,1998,39556,35916,1,3640,9.20%
Chelan,9/1/98,53007,9,1998,41765,39509,1,2256,5.40%
Chelan,10/1/98,53007,10,1998,39875,37580,1,2295,5.80%
Chelan,11/1/98,53007,11,1998,34569,31553,1,3016,8.70%
Chelan,12/1/98,53007,12,1998,33999,30516,1,3483,10.20%
Chelan,1/1/99,53007,1,1999,34155,30086,1,4069,11.90%
Chelan,2/1/99,53007,2,1999,34294,30256,1,4038,11.80%
Chelan,3/1/99,53007,3,1999,34351,30757,1,3594,10.50%
Chelan,4/1/99,53007,4,1999,34471,30970,1,3501,10.20%
Chelan,5/1/99,53007,5,1999,34737,31251,1,3486,10.00%
Chelan,6/1/99,53007,6,1999,38005,34609,1,3396,8.90%
Chelan,7/1/99,53007,7,1999,41127,38450,1,2677,6.50%
Chelan,8/1/99,53007,8,1999,37287,33777,1,3510,9.40%
Chelan,9/1/99,53007,9,1999,38589,36484,1,2105,5.50%
Chelan,10/1/99,53007,10,1999,38657,36700,1,1957,5.10%
Chelan,11/1/99,53007,11,1999,33829,31136,1,2693,8.00%
Chelan,12/1/99,53007,12,1999,33282,30388,1,2894,8.70%
Chelan,1/1/00,53007,1,2000,34395,30866,1,3529,10.30%
Chelan,2/1/00,53007,2,2000,34841,31355,1,3486,10.00%
Chelan,3/1/00,53007,3,2000,35236,32336,1,2900,8.20%
Chelan,4/1/00,53007,4,2000,35120,32496,1,2624,7.50%
Chelan,5/1/00,53007,5,2000,34919,32243,1,2676,7.70%
Chelan,6/1/00,53007,6,2000,39502,37261,1,2241,5.70%
Chelan,7/1/00,53007,7,2000,41519,39359,1,2160,5.20%
Chelan,8/1/00,53007,8,2000,37649,34753,1,2896,7.70%
Chelan,9/1/00,53007,9,2000,39862,37993,1,1869,4.70%
Chelan,10/1/00,53007,10,2000,38565,36748,1,1817,4.70%
Chelan,11/1/00,53007,11,2000,34432,31910,1,2522,7.30%
Chelan,12/1/00,53007,12,2000,33419,30595,1,2824,8.50%
Chelan,1/1/01,53007,1,2001,32899,29256,1,3643,11.10%
Chelan,2/1/01,53007,2,2001,32788,29248,1,3540,10.80%
Chelan,3/1/01,53007,3,2001,33204,29974,1,3230,9.70%
Chelan,4/1/01,53007,4,2001,32996,29977,1,3019,9.10%
Chelan,5/1/01,53007,5,2001,33024,30177,1,2847,8.60%
Chelan,6/1/01,53007,6,2001,36323,33784,1,2539,7.00%
Chelan,7/1/01,53007,7,2001,40661,38421,1,2240,5.50%
Chelan,8/1/01,53007,8,2001,36150,32800,1,3350,9.30%
Chelan,9/1/01,53007,9,2001,37732,35479,1,2253,6.00%
Chelan,10/1/01,53007,10,2001,36379,34137,1,2242,6.20%
Chelan,11/1/01,53007,11,2001,32912,29704,1,3208,9.70%
Chelan,12/1/01,53007,12,2001,32803,29166,1,3637,11.10%
Chelan,1/1/02,53007,1,2002,32655,28813,1,3842,11.80%
Chelan,2/1/02,53007,2,2002,33229,29471,1,3758,11.30%
Chelan,3/1/02,53007,3,2002,33465,29848,1,3617,10.80%
Chelan,4/1/02,53007,4,2002,33816,30346,1,3470,10.30%
Chelan,5/1/02,53007,5,2002,33799,30517,1,3282,9.70%
Chelan,6/1/02,53007,6,2002,36911,33930,1,2981,8.10%
Chelan,7/1/02,53007,7,2002,40628,38097,1,2531,6.20%
Chelan,8/1/02,53007,8,2002,37112,33836,1,3276,8.80%
Chelan,9/1/02,53007,9,2002,38951,36708,1,2243,5.80%
Chelan,10/1/02,53007,10,2002,38768,36643,1,2125,5.50%
Chelan,11/1/02,53007,11,2002,34391,31372,1,3019,8.80%
Chelan,12/1/02,53007,12,2002,33983,30690,1,3293,9.70%
Chelan,1/1/03,53007,1,2003,34490,30863,1,3627,10.50%
Chelan,2/1/03,53007,2,2003,34579,30896,1,3683,10.70%
Chelan,3/1/03,53007,3,2003,34617,31290,1,3327,9.60%
Chelan,4/1/03,53007,4,2003,34557,31097,1,3460,10.00%
Chelan,5/1/03,53007,5,2003,34549,31464,1,3085,8.90%
Chelan,6/1/03,53007,6,2003,38209,35143,1,3066,8.00%
Chelan,7/1/03,53007,7,2003,42251,39656,1,2595,6.10%
Chelan,8/1/03,53007,8,2003,37590,34318,1,3272,8.70%
Chelan,9/1/03,53007,9,2003,39637,37215,1,2422,6.10%
Chelan,10/1/03,53007,10,2003,39180,36724,1,2456,6.30%
Chelan,11/1/03,53007,11,2003,35809,32737,1,3072,8.60%
Chelan,12/1/03,53007,12,2003,35349,32054,1,3295,9.30%
Chelan,1/1/04,53007,1,2004,35158,31516,1,3642,10.40%
Chelan,2/1/04,53007,2,2004,35420,31897,1,3523,9.90%
Chelan,3/1/04,53007,3,2004,36005,32765,1,3240,9.00%
Chelan,4/1/04,53007,4,2004,35869,33059,1,2810,7.80%
Chelan,5/1/04,53007,5,2004,36483,33701,1,2782,7.60%
Chelan,6/1/04,53007,6,2004,42525,40188,1,2337,5.50%
Chelan,7/1/04,53007,7,2004,43970,41806,1,2164,4.90%
Chelan,8/1/04,53007,8,2004,40157,37328,1,2829,7.00%
Chelan,9/1/04,53007,9,2004,42055,40168,1,1887,4.50%
Chelan,10/1/04,53007,10,2004,40636,38638,1,1998,4.90%
Chelan,11/1/04,53007,11,2004,36657,34087,1,2570,7.00%
Chelan,12/1/04,53007,12,2004,36587,33695,1,2892,7.90%
Chelan,1/1/05,53007,1,2005,36214,32876,1,3338,9.20%
Chelan,2/1/05,53007,2,2005,36855,33562,1,3293,8.90%
Chelan,3/1/05,53007,3,2005,37154,34481,1,2673,7.20%
Chelan,4/1/05,53007,4,2005,36902,34323,1,2579,7.00%
Chelan,5/1/05,53007,5,2005,37475,35014,1,2461,6.60%
Chelan,6/1/05,53007,6,2005,42588,40636,1,1952,4.60%
Chelan,7/1/05,53007,7,2005,45345,43460,1,1885,4.20%
Chelan,8/1/05,53007,8,2005,41210,38676,1,2534,6.10%
Chelan,9/1/05,53007,9,2005,42942,41117,1,1825,4.20%
Chelan,10/1/05,53007,10,2005,41765,39973,1,1792,4.30%
Chelan,11/1/05,53007,11,2005,37806,35526,1,2280,6.00%
Chelan,12/1/05,53007,12,2005,37139,34525,1,2614,7.00%
Chelan,1/1/06,53007,1,2006,36595,33764,1,2831,7.70%
Chelan,2/1/06,53007,2,2006,36779,34049,1,2730,7.40%
Chelan,3/1/06,53007,3,2006,37250,34932,1,2318,6.20%
Chelan,4/1/06,53007,4,2006,36836,34610,1,2226,6.00%
Chelan,5/1/06,53007,5,2006,37036,34834,1,2202,5.90%
Chelan,6/1/06,53007,6,2006,42443,40537,1,1906,4.50%
Chelan,7/1/06,53007,7,2006,47698,45876,1,1822,3.80%
Chelan,8/1/06,53007,8,2006,41642,39188,1,2454,5.90%
Chelan,9/1/06,53007,9,2006,41701,39924,1,1777,4.30%
Chelan,10/1/06,53007,10,2006,41053,39416,1,1637,4.00%
Chelan,11/1/06,53007,11,2006,37385,35234,1,2151,5.80%
Chelan,12/1/06,53007,12,2006,37137,34663,1,2474,6.70%
Chelan,1/1/07,53007,1,2007,37264,34351,1,2913,7.80%
Chelan,2/1/07,53007,2,2007,37712,34944,1,2768,7.30%
Chelan,3/1/07,53007,3,2007,38119,35682,1,2437,6.40%
Chelan,4/1/07,53007,4,2007,37804,35447,1,2357,6.20%
Chelan,5/1/07,53007,5,2007,38255,35953,1,2302,6.00%
Chelan,6/1/07,53007,6,2007,43693,41845,1,1848,4.20%
Chelan,7/1/07,53007,7,2007,49000,47077,1,1923,3.90%
Chelan,8/1/07,53007,8,2007,43138,40984,1,2154,5.00%
Chelan,9/1/07,53007,9,2007,43348,41638,1,1710,3.90%
Chelan,10/1/07,53007,10,2007,42357,40639,1,1718,4.10%
Chelan,11/1/07,53007,11,2007,38550,36376,1,2174,5.60%
Chelan,12/1/07,53007,12,2007,38234,35749,1,2485,6.50%
Chelan,1/1/08,53007,1,2008,38075,35102,1,2973,7.80%
Chelan,2/1/08,53007,2,2008,38443,35463,1,2980,7.80%
Chelan,3/1/08,53007,3,2008,38895,36327,1,2568,6.60%
Chelan,4/1/08,53007,4,2008,38587,36163,1,2424,6.30%
Chelan,5/1/08,53007,5,2008,38779,36141,1,2638,6.80%
Chelan,6/1/08,53007,6,2008,42324,39858,1,2466,5.80%
Chelan,7/1/08,53007,7,2008,47036,45036,1,2000,4.30%
Chelan,8/1/08,53007,8,2008,42995,40466,1,2529,5.90%
Chelan,9/1/08,53007,9,2008,43631,41825,1,1806,4.10%
Chelan,10/1/08,53007,10,2008,43472,41651,1,1821,4.20%
Chelan,11/1/08,53007,11,2008,39314,37025,1,2289,5.80%
Chelan,12/1/08,53007,12,2008,38907,36284,1,2623,6.70%
Chelan,1/1/09,53007,1,2009,38890,35651,1,3239,8.30%
Chelan,2/1/09,53007,2,2009,39130,35606,1,3524,9.00%
Chelan,3/1/09,53007,3,2009,39033,35551,1,3482,8.90%
Chelan,4/1/09,53007,4,2009,38907,35622,1,3285,8.40%
Chelan,5/1/09,53007,5,2009,39218,35908,1,3310,8.40%
Chelan,6/1/09,53007,6,2009,44083,40862,1,3221,7.30%
Chelan,7/1/09,53007,7,2009,53727,50745,1,2982,5.60%
Chelan,8/1/09,53007,8,2009,45005,41280,1,3725,8.30%
Chelan,9/1/09,53007,9,2009,45729,42453,1,3276,7.20%
Chelan,10/1/09,53007,10,2009,43493,40357,1,3136,7.20%
Chelan,11/1/09,53007,11,2009,39504,35942,1,3562,9.00%
Chelan,12/1/09,53007,12,2009,38717,34625,1,4092,10.60%
Chelan,1/1/10,53007,1,2010,39999,35439,1,4560,11.40%
Chelan,2/1/10,53007,2,2010,40099,35524,1,4575,11.40%
Chelan,3/1/10,53007,3,2010,40467,36141,1,4326,10.70%
Chelan,4/1/10,53007,4,2010,39456,35553,1,3903,9.90%
Chelan,5/1/10,53007,5,2010,39723,35725,1,3998,10.10%
Chelan,6/1/10,53007,6,2010,44596,41144,1,3452,7.70%
Chelan,7/1/10,53007,7,2010,49092,46012,1,3080,6.30%
Chelan,8/1/10,53007,8,2010,45011,41411,1,3600,8.00%
Chelan,9/1/10,53007,9,2010,44555,41479,1,3076,6.90%
Chelan,10/1/10,53007,10,2010,44060,41044,1,3016,6.80%
Chelan,11/1/10,53007,11,2010,39678,36062,1,3616,9.10%
Chelan,12/1/10,53007,12,2010,38488,34706,1,3782,9.80%
Chelan,1/1/11,53007,1,2011,39153,34887,1,4266,10.90%
Chelan,2/1/11,53007,2,2011,38875,34700,1,4175,10.70%
Chelan,3/1/11,53007,3,2011,38586,34740,1,3846,10.00%
Chelan,4/1/11,53007,4,2011,38254,34664,1,3590,9.40%
Chelan,5/1/11,53007,5,2011,38238,34529,1,3709,9.70%
Chelan,6/1/11,53007,6,2011,41156,37761,1,3395,8.20%
Chelan,7/1/11,53007,7,2011,48279,45273,1,3006,6.20%
Chelan,8/1/11,53007,8,2011,46429,43289,1,3140,6.80%
Chelan,9/1/11,53007,9,2011,43743,40784,1,2959,6.80%
Chelan,10/1/11,53007,10,2011,44327,41436,1,2891,6.50%
Chelan,11/1/11,53007,11,2011,40890,37632,1,3258,8.00%
Chelan,12/1/11,53007,12,2011,38898,35242,1,3656,9.40%
Chelan,1/1/12,53007,1,2012,38934,34928,1,4006,10.30%
Chelan,2/1/12,53007,2,2012,38826,34697,1,4129,10.60%
Chelan,3/1/12,53007,3,2012,38563,34834,1,3729,9.70%
Chelan,4/1/12,53007,4,2012,38160,34582,1,3578,9.40%
Chelan,5/1/12,53007,5,2012,38550,34877,1,3673,9.50%
Chelan,6/1/12,53007,6,2012,43973,40809,1,3164,7.20%
Chelan,7/1/12,53007,7,2012,49399,46484,1,2915,5.90%
Chelan,8/1/12,53007,8,2012,46483,43391,1,3092,6.70%
Chelan,9/1/12,53007,9,2012,43031,40420,1,2611,6.10%
Chelan,10/1/12,53007,10,2012,43586,40945,1,2641,6.10%
Chelan,11/1/12,53007,11,2012,38851,35969,1,2882,7.40%
Chelan,12/1/12,53007,12,2012,38383,35071,1,3312,8.60%
Chelan,1/1/13,53007,1,2013,38319,34495,1,3824,10.00%
Chelan,2/1/13,53007,2,2013,38095,34424,1,3671,9.60%
Chelan,3/1/13,53007,3,2013,38042,34801,1,3241,8.50%
Chelan,4/1/13,53007,4,2013,37679,34548,1,3131,8.30%
Chelan,5/1/13,53007,5,2013,37918,34796,1,3122,8.20%
Chelan,6/1/13,53007,6,2013,43517,40813,1,2704,6.20%
Chelan,7/1/13,53007,7,2013,48276,45819,1,2457,5.10%
Chelan,8/1/13,53007,8,2013,42772,39985,1,2787,6.50%
Chelan,9/1/13,53007,9,2013,42253,39962,1,2291,5.40%
Chelan,10/1/13,53007,10,2013,41773,39368,1,2405,5.80%
Chelan,11/1/13,53007,11,2013,38108,35390,1,2718,7.10%
Chelan,12/1/13,53007,12,2013,38029,35125,1,2904,7.60%
Chelan,1/1/14,53007,1,2014,37976,34846,1,3130,8.20%
Chelan,2/1/14,53007,2,2014,37657,34484,1,3173,8.40%
Chelan,3/1/14,53007,3,2014,38001,35079,1,2922,7.70%
Chelan,4/1/14,53007,4,2014,37490,34938,1,2552,6.80%
Chelan,5/1/14,53007,5,2014,38271,35538,1,2733,7.10%
Chelan,6/1/14,53007,6,2014,43402,41322,1,2080,4.80%
Chelan,7/1/14,53007,7,2014,49464,47381,1,2083,4.20%
Chelan,8/1/14,53007,8,2014,43270,40836,1,2434,5.60%
Chelan,9/1/14,53007,9,2014,43908,41941,1,1967,4.50%
Chelan,10/1/14,53007,10,2014,43450,41390,1,2060,4.70%
Chelan,11/1/14,53007,11,2014,40832,38351,1,2481,6.10%
Chelan,12/1/14,53007,12,2014,39651,36881,1,2770,7.00%
Chelan,1/1/15,53007,1,2015,39553,36523,1,3030,7.70%
Chelan,2/1/15,53007,2,2015,39589,36612,1,2977,7.50%
Chelan,3/1/15,53007,3,2015,39929,37240,1,2689,6.70%
Chelan,4/1/15,53007,4,2015,40271,37824,1,2447,6.10%
Chelan,5/1/15,53007,5,2015,41050,38642,1,2408,5.90%
Chelan,6/1/15,53007,6,2015,46313,44264,1,2049,4.40%
Chelan,7/1/15,53007,7,2015,50183,48084,1,2099,4.20%
Chelan,8/1/15,53007,8,2015,44471,42301,1,2170,4.90%
Chelan,9/1/15,53007,9,2015,44899,43040,1,1859,4.10%
Chelan,10/1/15,53007,10,2015,42794,40688,1,2106,4.90%
Chelan,11/1/15,53007,11,2015,40905,38397,1,2508,6.10%
Chelan,12/1/15,53007,12,2015,40673,38018,1,2655,6.50%
Chelan,1/1/16,53007,1,2016,40593,37369,1,3224,7.90%
Chelan,2/1/16,53007,2,2016,40560,37244,1,3316,8.20%
Chelan,3/1/16,53007,3,2016,41220,38180,1,3040,7.40%
Chelan,4/1/16,53007,4,2016,41140,38368,1,2772,6.70%
Chelan,5/1/16,53007,5,2016,41658,39152,1,2506,6.00%
Chelan,6/1/16,53007,6,2016,47842,45644,1,2198,4.60%
Chelan,7/1/16,53007,7,2016,48182,46057,1,2125,4.40%
Chelan,8/1/16,53007,8,2016,45765,43600,1,2165,4.70%
Chelan,9/1/16,53007,9,2016,45372,43535,1,1837,4.00%
Chelan,10/1/16,53007,10,2016,43512,41559,1,1953,4.50%
Chelan,11/1/16,53007,11,2016,41883,39646,1,2237,5.30%
Chelan,12/1/16,53007,12,2016,40859,38458,1,2401,5.90%
Chelan,1/1/17,53007,1,2017,40381,37438,1,2943,7.30%
Chelan,2/1/17,53007,2,2017,40879,37929,1,2950,7.20%
Chelan,3/1/17,53007,3,2017,42505,39932,1,2573,6.10%
Chelan,4/1/17,53007,4,2017,42286,40135,1,2151,5.10%
Chelan,5/1/17,53007,5,2017,41959,39825,1,2134,5.10%
Chelan,6/1/17,53007,6,2017,46410,44454,1,1956,4.20%
Chelan,7/1/17,53007,7,2017,52765,51030,1,1735,3.30%
Chelan,8/1/17,53007,8,2017,48033,46048,1,1985,4.10%
Chelan,9/1/17,53007,9,2017,45729,44133,1,1596,3.50%
Chelan,10/1/17,53007,10,2017,45377,43710,1,1667,3.70%
Chelan,11/1/17,53007,11,2017,42721,40649,1,2072,4.90%
Chelan,12/1/17,53007,12,2017,41912,39581,1,2331,5.60%
Chelan,1/1/18,53007,1,2018,41468,38736,1,2732,6.60%
Chelan,2/1/18,53007,2,2018,41807,39034,1,2773,6.60%
Chelan,3/1/18,53007,3,2018,42810,40301,1,2509,5.90%
Chelan,4/1/18,53007,4,2018,42563,40447,1,2116,5.00%
Chelan,5/1/18,53007,5,2018,43153,41202,1,1951,4.50%
Chelan,6/1/18,53007,6,2018,48485,46653,1,1832,3.80%
Chelan,7/1/18,53007,7,2018,53667,52021,1,1646,3.10%
Chelan,8/1/18,53007,8,2018,48751,46860,1,1891,3.90%
Chelan,9/1/18,53007,9,2018,46886,45348,1,1538,3.30%
Chelan,10/1/18,53007,10,2018,45700,43921,1,1779,3.90%
Chelan,11/1/18,53007,11,2018,42981,40827,1,2154,5.00%
Chelan,12/1/18,53007,12,2018,43235,40685,1,2550,5.90%
Chelan,1/1/19,53007,1,2019,42559,39558,1,3001,7.10%
Chelan,2/1/19,53007,2,2019,42347,39380,1,2967,7.00%
Chelan,3/1/19,53007,3,2019,42708,40003,1,2705,6.30%
Chelan,4/1/19,53007,4,2019,43038,40824,1,2214,5.10%
Chelan,5/1/19,53007,5,2019,43412,41294,1,2118,4.90%
Chelan,6/1/19,53007,6,2019,47914,45937,1,1977,4.10%
Chelan,7/1/19,53007,7,2019,51952,50099,1,1853,3.60%
Chelan,8/1/19,53007,8,2019,47696,45644,1,2052,4.30%
Chelan,9/1/19,53007,9,2019,46573,44974,1,1599,3.40%
Chelan,10/1/19,53007,10,2019,45754,44107,1,1647,3.60%
Chelan,11/1/19,53007,11,2019,43665,41648,1,2017,4.60%
Chelan,12/1/19,53007,12,2019,43733,41462,1,2271,5.20%
Chelan,1/1/20,53007,1,2020,43223,40638,1,2585,6.00%
Chelan,2/1/20,53007,2,2020,43045,40507,1,2538,5.90%
Chelan,3/1/20,53007,3,2020,42624,40402,1,2222,5.20%
Chelan,4/1/20,53007,4,2020,44043,36912,1,7131,16.20%
Chelan,5/1/20,53007,5,2020,44012,37576,1,6436,14.60%
Clark,1/1/90,53011,1,1990,129583,123172,1,6411,4.90%
Clark,2/1/90,53011,2,1990,130398,122860,1,7538,5.80%
Clark,3/1/90,53011,3,1990,130031,123314,1,6717,5.20%
Clark,4/1/90,53011,4,1990,127695,121509,1,6186,4.80%
Clark,5/1/90,53011,5,1990,127076,121224,1,5852,4.60%
Clark,6/1/90,53011,6,1990,127183,121380,1,5803,4.60%
Clark,7/1/90,53011,7,1990,128666,122961,1,5705,4.40%
Clark,8/1/90,53011,8,1990,128741,123036,1,5705,4.40%
Clark,9/1/90,53011,9,1990,125316,119940,1,5376,4.30%
Clark,10/1/90,53011,10,1990,128061,121483,1,6578,5.10%
Clark,11/1/90,53011,11,1990,129607,123497,1,6110,4.70%
Clark,12/1/90,53011,12,1990,130552,123428,1,7124,5.50%
Clark,1/1/91,53011,1,1991,129141,121056,1,8085,6.30%
Clark,2/1/91,53011,2,1991,128705,120523,1,8182,6.40%
Clark,3/1/91,53011,3,1991,128388,119966,1,8422,6.60%
Clark,4/1/91,53011,4,1991,126811,119083,1,7728,6.10%
Clark,5/1/91,53011,5,1991,126255,118193,1,8062,6.40%
Clark,6/1/91,53011,6,1991,128154,120344,1,7810,6.10%
Clark,7/1/91,53011,7,1991,128945,120835,1,8110,6.30%
Clark,8/1/91,53011,8,1991,128142,119582,1,8560,6.70%
Clark,9/1/91,53011,9,1991,125491,117806,1,7685,6.10%
Clark,10/1/91,53011,10,1991,127624,119405,1,8219,6.40%
Clark,11/1/91,53011,11,1991,129053,120442,1,8611,6.70%
Clark,12/1/91,53011,12,1991,130517,121500,1,9017,6.90%
Clark,1/1/92,53011,1,1992,130549,120492,1,10057,7.70%
Clark,2/1/92,53011,2,1992,131673,120801,1,10872,8.30%
Clark,3/1/92,53011,3,1992,130337,120463,1,9874,7.60%
Clark,4/1/92,53011,4,1992,129869,120921,1,8948,6.90%
Clark,5/1/92,53011,5,1992,129172,120347,1,8825,6.80%
Clark,6/1/92,53011,6,1992,128040,119240,1,8800,6.90%
Clark,7/1/92,53011,7,1992,132111,123281,1,8830,6.70%
Clark,8/1/92,53011,8,1992,130551,121976,1,8575,6.60%
Clark,9/1/92,53011,9,1992,127896,119700,1,8196,6.40%
Clark,10/1/92,53011,10,1992,133731,125290,1,8441,6.30%
Clark,11/1/92,53011,11,1992,135658,126360,1,9298,6.90%
Clark,12/1/92,53011,12,1992,135955,126629,1,9326,6.90%
Clark,1/1/93,53011,1,1993,134716,125775,1,8941,6.60%
Clark,2/1/93,53011,2,1993,135180,125770,1,9410,7.00%
Clark,3/1/93,53011,3,1993,133854,125137,1,8717,6.50%
Clark,4/1/93,53011,4,1993,133176,125165,1,8011,6.00%
Clark,5/1/93,53011,5,1993,132966,125345,1,7621,5.70%
Clark,6/1/93,53011,6,1993,132892,125693,1,7199,5.40%
Clark,7/1/93,53011,7,1993,135580,128159,1,7421,5.50%
Clark,8/1/93,53011,8,1993,135676,128202,1,7474,5.50%
Clark,9/1/93,53011,9,1993,132400,125648,1,6752,5.10%
Clark,10/1/93,53011,10,1993,138140,130715,1,7425,5.40%
Clark,11/1/93,53011,11,1993,140736,133504,1,7232,5.10%
Clark,12/1/93,53011,12,1993,142870,135630,1,7240,5.10%
Clark,1/1/94,53011,1,1994,142601,134285,1,8316,5.80%
Clark,2/1/94,53011,2,1994,142738,134364,1,8374,5.90%
Clark,3/1/94,53011,3,1994,140395,132554,1,7841,5.60%
Clark,4/1/94,53011,4,1994,139492,132377,1,7115,5.10%
Clark,5/1/94,53011,5,1994,138106,132166,1,5940,4.30%
Clark,6/1/94,53011,6,1994,139244,132181,1,7063,5.10%
Clark,7/1/94,53011,7,1994,141301,135176,1,6125,4.30%
Clark,8/1/94,53011,8,1994,143769,137613,1,6156,4.30%
Clark,9/1/94,53011,9,1994,140211,134813,1,5398,3.80%
Clark,10/1/94,53011,10,1994,145596,140014,1,5582,3.80%
Clark,11/1/94,53011,11,1994,149415,143178,1,6237,4.20%
Clark,12/1/94,53011,12,1994,151501,144999,1,6502,4.30%
Clark,1/1/95,53011,1,1995,151979,144424,1,7555,5.00%
Clark,2/1/95,53011,2,1995,153802,145760,1,8042,5.20%
Clark,3/1/95,53011,3,1995,150506,143432,1,7074,4.70%
Clark,4/1/95,53011,4,1995,152084,144951,1,7133,4.70%
Clark,5/1/95,53011,5,1995,150959,144512,1,6447,4.30%
Clark,6/1/95,53011,6,1995,150977,144914,1,6063,4.00%
Clark,7/1/95,53011,7,1995,153216,146721,1,6495,4.20%
Clark,8/1/95,53011,8,1995,154268,147541,1,6727,4.40%
Clark,9/1/95,53011,9,1995,150725,145010,1,5715,3.80%
Clark,10/1/95,53011,10,1995,154935,149014,1,5921,3.80%
Clark,11/1/95,53011,11,1995,158464,152569,1,5895,3.70%
Clark,12/1/95,53011,12,1995,160311,153985,1,6326,3.90%
Clark,1/1/96,53011,1,1996,162394,155033,1,7361,4.50%
Clark,2/1/96,53011,2,1996,163273,156014,1,7259,4.40%
Clark,3/1/96,53011,3,1996,162468,155564,1,6904,4.20%
Clark,4/1/96,53011,4,1996,163289,155690,1,7599,4.70%
Clark,5/1/96,53011,5,1996,163331,155572,1,7759,4.80%
Clark,6/1/96,53011,6,1996,164857,158169,1,6688,4.10%
Clark,7/1/96,53011,7,1996,165883,158808,1,7075,4.30%
Clark,8/1/96,53011,8,1996,165652,158869,1,6783,4.10%
Clark,9/1/96,53011,9,1996,162476,156548,1,5928,3.60%
Clark,10/1/96,53011,10,1996,164133,158098,1,6035,3.70%
Clark,11/1/96,53011,11,1996,169650,163722,1,5928,3.50%
Clark,12/1/96,53011,12,1996,172221,166014,1,6207,3.60%
Clark,1/1/97,53011,1,1997,174674,167560,1,7114,4.10%
Clark,2/1/97,53011,2,1997,175251,167894,1,7357,4.20%
Clark,3/1/97,53011,3,1997,174704,167683,1,7021,4.00%
Clark,4/1/97,53011,4,1997,174835,168052,1,6783,3.90%
Clark,5/1/97,53011,5,1997,174152,168457,1,5695,3.30%
Clark,6/1/97,53011,6,1997,175225,169651,1,5574,3.20%
Clark,7/1/97,53011,7,1997,177080,171417,1,5663,3.20%
Clark,8/1/97,53011,8,1997,179468,172700,1,6768,3.80%
Clark,9/1/97,53011,9,1997,175964,170520,1,5444,3.10%
Clark,10/1/97,53011,10,1997,177091,171818,1,5273,3.00%
Clark,11/1/97,53011,11,1997,181972,176629,1,5343,2.90%
Clark,12/1/97,53011,12,1997,183250,177485,1,5765,3.10%
Clark,1/1/98,53011,1,1998,186116,177504,1,8612,4.60%
Clark,2/1/98,53011,2,1998,186539,178093,1,8446,4.50%
Clark,3/1/98,53011,3,1998,185641,177505,1,8136,4.40%
Clark,4/1/98,53011,4,1998,184461,177020,1,7441,4.00%
Clark,5/1/98,53011,5,1998,184122,176639,1,7483,4.10%
Clark,6/1/98,53011,6,1998,183616,175979,1,7637,4.20%
Clark,7/1/98,53011,7,1998,185128,177106,1,8022,4.30%
Clark,8/1/98,53011,8,1998,185237,176812,1,8425,4.50%
Clark,9/1/98,53011,9,1998,183234,175148,1,8086,4.40%
Clark,10/1/98,53011,10,1998,184543,176612,1,7931,4.30%
Clark,11/1/98,53011,11,1998,189392,181293,1,8099,4.30%
Clark,12/1/98,53011,12,1998,190005,182010,1,7995,4.20%
Clark,1/1/99,53011,1,1999,191216,181960,1,9256,4.80%
Clark,2/1/99,53011,2,1999,190897,181707,1,9190,4.80%
Clark,3/1/99,53011,3,1999,188611,180704,1,7907,4.20%
Clark,4/1/99,53011,4,1999,187814,179973,1,7841,4.20%
Clark,5/1/99,53011,5,1999,187109,179557,1,7552,4.00%
Clark,6/1/99,53011,6,1999,189202,181605,1,7597,4.00%
Clark,7/1/99,53011,7,1999,188311,180868,1,7443,4.00%
Clark,8/1/99,53011,8,1999,189117,181503,1,7614,4.00%
Clark,9/1/99,53011,9,1999,184314,177512,1,6802,3.70%
Clark,10/1/99,53011,10,1999,185910,179513,1,6397,3.40%
Clark,11/1/99,53011,11,1999,190477,184065,1,6412,3.40%
Clark,12/1/99,53011,12,1999,190665,183932,1,6733,3.50%
Clark,1/1/00,53011,1,2000,182285,172335,1,9950,5.50%
Clark,2/1/00,53011,2,2000,183078,172750,1,10328,5.60%
Clark,3/1/00,53011,3,2000,180739,170734,1,10005,5.50%
Clark,4/1/00,53011,4,2000,178447,170122,1,8325,4.70%
Clark,5/1/00,53011,5,2000,176566,168041,1,8525,4.80%
Clark,6/1/00,53011,6,2000,176404,167871,1,8533,4.80%
Clark,7/1/00,53011,7,2000,179469,169606,1,9863,5.50%
Clark,8/1/00,53011,8,2000,180804,169348,1,11456,6.30%
Clark,9/1/00,53011,9,2000,176184,167845,1,8339,4.70%
Clark,10/1/00,53011,10,2000,178982,168948,1,10034,5.60%
Clark,11/1/00,53011,11,2000,180621,171464,1,9157,5.10%
Clark,12/1/00,53011,12,2000,182489,173041,1,9448,5.20%
Clark,1/1/01,53011,1,2001,184703,173235,1,11468,6.20%
Clark,2/1/01,53011,2,2001,183635,172201,1,11434,6.20%
Clark,3/1/01,53011,3,2001,181415,169740,1,11675,6.40%
Clark,4/1/01,53011,4,2001,179044,167543,1,11501,6.40%
Clark,5/1/01,53011,5,2001,178442,166091,1,12351,6.90%
Clark,6/1/01,53011,6,2001,176294,164843,1,11451,6.50%
Clark,7/1/01,53011,7,2001,177900,164093,1,13807,7.80%
Clark,8/1/01,53011,8,2001,178437,163411,1,15026,8.40%
Clark,9/1/01,53011,9,2001,177412,163906,1,13506,7.60%
Clark,10/1/01,53011,10,2001,178593,164707,1,13886,7.80%
Clark,11/1/01,53011,11,2001,180851,166617,1,14234,7.90%
Clark,12/1/01,53011,12,2001,182162,167693,1,14469,7.90%
Clark,1/1/02,53011,1,2002,185071,166101,1,18970,10.30%
Clark,2/1/02,53011,2,2002,187636,167965,1,19671,10.50%
Clark,3/1/02,53011,3,2002,185262,167665,1,17597,9.50%
Clark,4/1/02,53011,4,2002,186049,166543,1,19506,10.50%
Clark,5/1/02,53011,5,2002,184082,166854,1,17228,9.40%
Clark,6/1/02,53011,6,2002,184089,167357,1,16732,9.10%
Clark,7/1/02,53011,7,2002,182910,165937,1,16973,9.30%
Clark,8/1/02,53011,8,2002,185608,167937,1,17671,9.50%
Clark,9/1/02,53011,9,2002,183563,168741,1,14822,8.10%
Clark,10/1/02,53011,10,2002,185924,170019,1,15905,8.60%
Clark,11/1/02,53011,11,2002,186924,170776,1,16148,8.60%
Clark,12/1/02,53011,12,2002,187185,171535,1,15650,8.40%
Clark,1/1/03,53011,1,2003,189968,170296,1,19672,10.40%
Clark,2/1/03,53011,2,2003,189302,169720,1,19582,10.30%
Clark,3/1/03,53011,3,2003,187942,168525,1,19417,10.30%
Clark,4/1/03,53011,4,2003,186581,167400,1,19181,10.30%
Clark,5/1/03,53011,5,2003,184045,166453,1,17592,9.60%
Clark,6/1/03,53011,6,2003,183193,165769,1,17424,9.50%
Clark,7/1/03,53011,7,2003,184446,166827,1,17619,9.60%
Clark,8/1/03,53011,8,2003,187360,168360,1,19000,10.10%
Clark,9/1/03,53011,9,2003,185448,168167,1,17281,9.30%
Clark,10/1/03,53011,10,2003,187925,171527,1,16398,8.70%
Clark,11/1/03,53011,11,2003,190721,174411,1,16310,8.60%
Clark,12/1/03,53011,12,2003,192967,175427,1,17540,9.10%
Clark,1/1/04,53011,1,2004,196060,177207,1,18853,9.60%
Clark,2/1/04,53011,2,2004,197739,178320,1,19419,9.80%
Clark,3/1/04,53011,3,2004,196016,178122,1,17894,9.10%
Clark,4/1/04,53011,4,2004,193069,178272,1,14797,7.70%
Clark,5/1/04,53011,5,2004,192412,178950,1,13462,7.00%
Clark,6/1/04,53011,6,2004,191309,177882,1,13427,7.00%
Clark,7/1/04,53011,7,2004,194304,180641,1,13663,7.00%
Clark,8/1/04,53011,8,2004,196681,181417,1,15264,7.80%
Clark,9/1/04,53011,9,2004,194059,180576,1,13483,6.90%
Clark,10/1/04,53011,10,2004,196072,183594,1,12478,6.40%
Clark,11/1/04,53011,11,2004,198991,186507,1,12484,6.30%
Clark,12/1/04,53011,12,2004,200577,187322,1,13255,6.60%
Clark,1/1/05,53011,1,2005,202778,187584,1,15194,7.50%
Clark,2/1/05,53011,2,2005,203925,187840,1,16085,7.90%
Clark,3/1/05,53011,3,2005,203387,187764,1,15623,7.70%
Clark,4/1/05,53011,4,2005,199596,186671,1,12925,6.50%
Clark,5/1/05,53011,5,2005,200066,187118,1,12948,6.50%
Clark,6/1/05,53011,6,2005,198919,185467,1,13452,6.80%
Clark,7/1/05,53011,7,2005,201044,188349,1,12695,6.30%
Clark,8/1/05,53011,8,2005,203574,189896,1,13678,6.70%
Clark,9/1/05,53011,9,2005,202762,188684,1,14078,6.90%
Clark,10/1/05,53011,10,2005,203425,191568,1,11857,5.80%
Clark,11/1/05,53011,11,2005,206369,193736,1,12633,6.10%
Clark,12/1/05,53011,12,2005,206022,194618,1,11404,5.50%
Clark,1/1/06,53011,1,2006,207747,192227,1,15520,7.50%
Clark,2/1/06,53011,2,2006,208097,191783,1,16314,7.80%
Clark,3/1/06,53011,3,2006,207361,192077,1,15284,7.40%
Clark,4/1/06,53011,4,2006,202152,190998,1,11154,5.50%
Clark,5/1/06,53011,5,2006,202674,190795,1,11879,5.90%
Clark,6/1/06,53011,6,2006,201471,189485,1,11986,5.90%
Clark,7/1/06,53011,7,2006,203532,190336,1,13196,6.50%
Clark,8/1/06,53011,8,2006,206416,192072,1,14344,6.90%
Clark,9/1/06,53011,9,2006,203617,191790,1,11827,5.80%
Clark,10/1/06,53011,10,2006,206654,195555,1,11099,5.40%
Clark,11/1/06,53011,11,2006,210431,198819,1,11612,5.50%
Clark,12/1/06,53011,12,2006,210606,199827,1,10779,5.10%
Clark,1/1/07,53011,1,2007,210021,195826,1,14195,6.80%
Clark,2/1/07,53011,2,2007,210877,195598,1,15279,7.20%
Clark,3/1/07,53011,3,2007,211240,196604,1,14636,6.90%
Clark,4/1/07,53011,4,2007,207295,194281,1,13014,6.30%
Clark,5/1/07,53011,5,2007,207576,195135,1,12441,6.00%
Clark,6/1/07,53011,6,2007,205703,193640,1,12063,5.90%
Clark,7/1/07,53011,7,2007,207715,194988,1,12727,6.10%
Clark,8/1/07,53011,8,2007,211919,196812,1,15107,7.10%
Clark,9/1/07,53011,9,2007,208665,196578,1,12087,5.80%
Clark,10/1/07,53011,10,2007,210407,199145,1,11262,5.40%
Clark,11/1/07,53011,11,2007,214074,201737,1,12337,5.80%
Clark,12/1/07,53011,12,2007,214331,201160,1,13171,6.10%
Clark,1/1/08,53011,1,2008,216225,200443,1,15782,7.30%
Clark,2/1/08,53011,2,2008,214901,199126,1,15775,7.30%
Clark,3/1/08,53011,3,2008,214603,199536,1,15067,7.00%
Clark,4/1/08,53011,4,2008,212915,198704,1,14211,6.70%
Clark,5/1/08,53011,5,2008,212124,198031,1,14093,6.60%
Clark,6/1/08,53011,6,2008,210900,197125,1,13775,6.50%
Clark,7/1/08,53011,7,2008,212615,197440,1,15175,7.10%
Clark,8/1/08,53011,8,2008,217353,199510,1,17843,8.20%
Clark,9/1/08,53011,9,2008,212885,197990,1,14895,7.00%
Clark,10/1/08,53011,10,2008,215772,199377,1,16395,7.60%
Clark,11/1/08,53011,11,2008,218756,200889,1,17867,8.20%
Clark,12/1/08,53011,12,2008,222611,199492,1,23119,10.40%
Clark,1/1/09,53011,1,2009,221525,195930,1,25595,11.60%
Clark,2/1/09,53011,2,2009,221504,194149,1,27355,12.30%
Clark,3/1/09,53011,3,2009,219402,192574,1,26828,12.20%
Clark,4/1/09,53011,4,2009,217747,190299,1,27448,12.60%
Clark,5/1/09,53011,5,2009,217191,189858,1,27333,12.60%
Clark,6/1/09,53011,6,2009,214509,188026,1,26483,12.30%
Clark,7/1/09,53011,7,2009,216875,186378,1,30497,14.10%
Clark,8/1/09,53011,8,2009,221309,189836,1,31473,14.20%
Clark,9/1/09,53011,9,2009,215753,186159,1,29594,13.70%
Clark,10/1/09,53011,10,2009,219963,188265,1,31698,14.40%
Clark,11/1/09,53011,11,2009,223533,190614,1,32919,14.70%
Clark,12/1/09,53011,12,2009,224423,190127,1,34296,15.30%
Clark,1/1/10,53011,1,2010,221078,188520,1,32558,14.70%
Clark,2/1/10,53011,2,2010,219114,187537,1,31577,14.40%
Clark,3/1/10,53011,3,2010,220090,188592,1,31498,14.30%
Clark,4/1/10,53011,4,2010,218252,188797,1,29455,13.50%
Clark,5/1/10,53011,5,2010,216896,188691,1,28205,13.00%
Clark,6/1/10,53011,6,2010,215008,187960,1,27048,12.60%
Clark,7/1/10,53011,7,2010,212357,186230,1,26127,12.30%
Clark,8/1/10,53011,8,2010,216658,189539,1,27119,12.50%
Clark,9/1/10,53011,9,2010,212420,186749,1,25671,12.10%
Clark,10/1/10,53011,10,2010,214144,189316,1,24828,11.60%
Clark,11/1/10,53011,11,2010,217052,190921,1,26131,12.00%
Clark,12/1/10,53011,12,2010,216373,190681,1,25692,11.90%
Clark,1/1/11,53011,1,2011,215783,187657,1,28126,13.00%
Clark,2/1/11,53011,2,2011,214358,186432,1,27926,13.00%
Clark,3/1/11,53011,3,2011,213310,187322,1,25988,12.20%
Clark,4/1/11,53011,4,2011,211378,186396,1,24982,11.80%
Clark,5/1/11,53011,5,2011,212610,186567,1,26043,12.20%
Clark,6/1/11,53011,6,2011,210980,186431,1,24549,11.60%
Clark,7/1/11,53011,7,2011,207122,182938,1,24184,11.70%
Clark,8/1/11,53011,8,2011,209840,185359,1,24481,11.70%
Clark,9/1/11,53011,9,2011,207607,184310,1,23297,11.20%
Clark,10/1/11,53011,10,2011,210796,187762,1,23034,10.90%
Clark,11/1/11,53011,11,2011,212361,189583,1,22778,10.70%
Clark,12/1/11,53011,12,2011,211631,191033,1,20598,9.70%
Clark,1/1/12,53011,1,2012,213137,191309,1,21828,10.20%
Clark,2/1/12,53011,2,2012,213185,190954,1,22231,10.40%
Clark,3/1/12,53011,3,2012,212340,191084,1,21256,10.00%
Clark,4/1/12,53011,4,2012,209455,189822,1,19633,9.40%
Clark,5/1/12,53011,5,2012,209878,190030,1,19848,9.50%
Clark,6/1/12,53011,6,2012,208059,188527,1,19532,9.40%
Adams,1/1/90,53001,1,1990,6788,5710,1,1078,15.90%
Asotin,1/1/90,53003,1,1990,9462,8866,1,596,6.30%
Clallam,1/1/90,53009,1,1990,23226,21143,1,2083,9.00%
Columbia,1/1/90,53013,1,1990,1440,1184,1,256,17.80%
Cowlitz,1/1/90,53015,1,1990,39018,35865,1,3153,8.10%
Douglas,1/1/90,53017,1,1990,14547,13236,1,1311,9.00%
Ferry,1/1/90,53019,1,1990,2868,2427,1,441,15.40%
Franklin,1/1/90,53021,1,1990,18381,15835,1,2546,13.90%
Garfield,1/1/90,53023,1,1990,1055,994,1,61,5.80%
Grant,1/1/90,53025,1,1990,24449,21710,1,2739,11.20%
Grays Harbor,1/1/90,53027,1,1990,28138,24840,1,3298,11.70%
Island,1/1/90,53029,1,1990,23445,22517,1,928,4.00%
Jefferson,1/1/90,53031,1,1990,8226,7681,1,545,6.60%
King,1/1/90,53033,1,1990,850846,813031,1,37815,4.40%
Kitsap,1/1/90,53035,1,1990,86084,82517,1,3567,4.10%
Kittitas,1/1/90,53037,1,1990,13419,12228,1,1191,8.90%
Klickitat,1/1/90,53039,1,1990,7806,6362,1,1444,18.50%
Lewis,1/1/90,53041,1,1990,26575,23789,1,2786,10.50%
Lincoln,1/1/90,53043,1,1990,3913,3708,1,205,5.20%
Mason,1/1/90,53045,1,1990,15470,14395,1,1075,6.90%
Okanogan,1/1/90,53047,1,1990,17017,14964,1,2053,12.10%
Pacific,1/1/90,53049,1,1990,7521,6727,1,794,10.60%
Pend Oreille,1/1/90,53051,1,1990,3643,3019,1,624,17.10%
Pierce,1/1/90,53053,1,1990,278579,264462,1,14117,5.10%
San Juan,1/1/90,53055,1,1990,4408,4191,1,217,4.90%
Skagit,1/1/90,53057,1,1990,38429,35032,1,3397,8.80%
Skamania,1/1/90,53059,1,1990,3955,3314,1,641,16.20%
Snohomish,1/1/90,53061,1,1990,248824,235636,1,13188,5.30%
Spokane,1/1/90,53063,1,1990,175480,163672,1,11808,6.70%
Stevens,1/1/90,53065,1,1990,13419,12163,1,1256,9.40%
Thurston,1/1/90,53067,1,1990,82455,77859,1,4596,5.60%
Wahkiakum,1/1/90,53069,1,1990,1555,1416,1,139,8.90%
Walla Walla,1/1/90,53071,1,1990,23880,21422,1,2458,10.30%
Whatcom,1/1/90,53073,1,1990,66592,62282,1,4310,6.50%
Whitman,1/1/90,53075,1,1990,17854,17520,1,334,1.90%
Yakima,1/1/90,53077,1,1990,94779,79586,1,15193,16.00%
Adams,1/1/91,53001,1,1991,7405,5924,1,1481,20.00%
Asotin,1/1/91,53003,1,1991,9594,8871,1,723,7.50%
Clallam,1/1/91,53009,1,1991,23156,20562,1,2594,11.20%
Columbia,1/1/91,53013,1,1991,1215,978,1,237,19.50%
Cowlitz,1/1/91,53015,1,1991,39267,35538,1,3729,9.50%
Douglas,1/1/91,53017,1,1991,15131,13380,1,1751,11.60%
Ferry,1/1/91,53019,1,1991,2720,2388,1,332,12.20%
Franklin,1/1/91,53021,1,1991,19870,16098,1,3772,19.00%
Garfield,1/1/91,53023,1,1991,955,899,1,56,5.90%
Grant,1/1/91,53025,1,1991,26370,22514,1,3856,14.60%
Grays Harbor,1/1/91,53027,1,1991,28050,23377,1,4673,16.70%
Island,1/1/91,53029,1,1991,23173,22133,1,1040,4.50%
Jefferson,1/1/91,53031,1,1991,8079,7376,1,703,8.70%
King,1/1/91,53033,1,1991,844809,810752,1,34057,4.00%
Kitsap,1/1/91,53035,1,1991,86987,82486,1,4501,5.20%
Kittitas,1/1/91,53037,1,1991,13126,11800,1,1326,10.10%
Klickitat,1/1/91,53039,1,1991,7614,6136,1,1478,19.40%
Lewis,1/1/91,53041,1,1991,26880,23078,1,3802,14.10%
Lincoln,1/1/91,53043,1,1991,3839,3591,1,248,6.50%
Mason,1/1/91,53045,1,1991,15360,13950,1,1410,9.20%
Okanogan,1/1/91,53047,1,1991,17945,14904,1,3041,16.90%
Pacific,1/1/91,53049,1,1991,7802,6645,1,1157,14.80%
Pend Oreille,1/1/91,53051,1,1991,3406,2761,1,645,18.90%
Pierce,1/1/91,53053,1,1991,279849,262156,1,17693,6.30%
San Juan,1/1/91,53055,1,1991,4671,4437,1,234,5.00%
Skagit,1/1/91,53057,1,1991,39500,34862,1,4638,11.70%
Skamania,1/1/91,53059,1,1991,3832,3187,1,645,16.80%
Snohomish,1/1/91,53061,1,1991,251894,238758,1,13136,5.20%
Spokane,1/1/91,53063,1,1991,177286,163967,1,13319,7.50%
Stevens,1/1/91,53065,1,1991,13938,12363,1,1575,11.30%
Thurston,1/1/91,53067,1,1991,83235,77739,1,5496,6.60%
Wahkiakum,1/1/91,53069,1,1991,1528,1346,1,182,11.90%
Walla Walla,1/1/91,53071,1,1991,23240,20546,1,2694,11.60%
Whatcom,1/1/91,53073,1,1991,69993,63510,1,6483,9.30%
Whitman,1/1/91,53075,1,1991,17699,17300,1,399,2.30%
Yakima,1/1/91,53077,1,1991,97688,80340,1,17348,17.80%
Adams,1/1/92,53001,1,1992,7174,5595,1,1579,22.00%
Asotin,1/1/92,53003,1,1992,9616,9025,1,591,6.10%
Clallam,1/1/92,53009,1,1992,22966,20456,1,2510,10.90%
Columbia,1/1/92,53013,1,1992,1259,984,1,275,21.80%
Cowlitz,1/1/92,53015,1,1992,38327,33913,1,4414,11.50%
Douglas,1/1/92,53017,1,1992,15057,13464,1,1593,10.60%
Ferry,1/1/92,53019,1,1992,2773,2297,1,476,17.20%
Franklin,1/1/92,53021,1,1992,19826,16571,1,3255,16.40%
Garfield,1/1/92,53023,1,1992,974,917,1,57,5.90%
Grant,1/1/92,53025,1,1992,27217,23014,1,4203,15.40%
Grays Harbor,1/1/92,53027,1,1992,27561,23712,1,3849,14.00%
Island,1/1/92,53029,1,1992,23986,22585,1,1401,5.80%
Jefferson,1/1/92,53031,1,1992,8257,7391,1,866,10.50%
King,1/1/92,53033,1,1992,873432,825499,1,47933,5.50%
Kitsap,1/1/92,53035,1,1992,87805,82405,1,5400,6.10%
Kittitas,1/1/92,53037,1,1992,13467,11714,1,1753,13.00%
Klickitat,1/1/92,53039,1,1992,7643,6339,1,1304,17.10%
Lewis,1/1/92,53041,1,1992,27269,23567,1,3702,13.60%
Lincoln,1/1/92,53043,1,1992,3969,3649,1,320,8.10%
Mason,1/1/92,53045,1,1992,15455,13905,1,1550,10.00%
Okanogan,1/1/92,53047,1,1992,18573,15698,1,2875,15.50%
Pacific,1/1/92,53049,1,1992,7670,6589,1,1081,14.10%
Pend Oreille,1/1/92,53051,1,1992,3651,2979,1,672,18.40%
Pierce,1/1/92,53053,1,1992,284113,262108,1,22005,7.70%
San Juan,1/1/92,53055,1,1992,4787,4362,1,425,8.90%
Skagit,1/1/92,53057,1,1992,40586,35387,1,5199,12.80%
Skamania,1/1/92,53059,1,1992,3783,2985,1,798,21.10%
Snohomish,1/1/92,53061,1,1992,264447,247205,1,17242,6.50%
Spokane,1/1/92,53063,1,1992,179515,164685,1,14830,8.30%
Stevens,1/1/92,53065,1,1992,14253,12288,1,1965,13.80%
Thurston,1/1/92,53067,1,1992,86149,80135,1,6014,7.00%
Wahkiakum,1/1/92,53069,1,1992,1538,1410,1,128,8.30%
Walla Walla,1/1/92,53071,1,1992,23795,20758,1,3037,12.80%
Whatcom,1/1/92,53073,1,1992,72693,66112,1,6581,9.10%
Whitman,1/1/92,53075,1,1992,17373,16858,1,515,3.00%
Yakima,1/1/92,53077,1,1992,100239,81772,1,18467,18.40%
Adams,1/1/93,53001,1,1993,7688,5621,1,2067,26.90%
Asotin,1/1/93,53003,1,1993,10028,9265,1,763,7.60%
Clallam,1/1/93,53009,1,1993,23118,20157,1,2961,12.80%
Columbia,1/1/93,53013,1,1993,1290,1004,1,286,22.20%
Cowlitz,1/1/93,53015,1,1993,38808,33819,1,4989,12.90%
Douglas,1/1/93,53017,1,1993,15251,13415,1,1836,12.00%
Ferry,1/1/93,53019,1,1993,2746,2270,1,476,17.30%
Franklin,1/1/93,53021,1,1993,21169,17375,1,3794,17.90%
Garfield,1/1/93,53023,1,1993,1013,912,1,101,10.00%
Grant,1/1/93,53025,1,1993,27894,23180,1,4714,16.90%
Grays Harbor,1/1/93,53027,1,1993,28931,23758,1,5173,17.90%
Island,1/1/93,53029,1,1993,24397,22863,1,1534,6.30%
Jefferson,1/1/93,53031,1,1993,9026,8011,1,1015,11.20%
King,1/1/93,53033,1,1993,887616,832143,1,55473,6.20%
Kitsap,1/1/93,53035,1,1993,90692,84630,1,6062,6.70%
Kittitas,1/1/93,53037,1,1993,13933,11999,1,1934,13.90%
Klickitat,1/1/93,53039,1,1993,7795,6239,1,1556,20.00%
Lewis,1/1/93,53041,1,1993,27371,23180,1,4191,15.30%
Lincoln,1/1/93,53043,1,1993,4131,3769,1,362,8.80%
Mason,1/1/93,53045,1,1993,15924,14162,1,1762,11.10%
Okanogan,1/1/93,53047,1,1993,19171,15610,1,3561,18.60%
Pacific,1/1/93,53049,1,1993,7994,6543,1,1451,18.20%
Pend Oreille,1/1/93,53051,1,1993,3752,3092,1,660,17.60%
Pierce,1/1/93,53053,1,1993,295254,272268,1,22986,7.80%
San Juan,1/1/93,53055,1,1993,4830,4200,1,630,13.00%
Skagit,1/1/93,53057,1,1993,42317,36080,1,6237,14.70%
Skamania,1/1/93,53059,1,1993,3556,2705,1,851,23.90%
Snohomish,1/1/93,53061,1,1993,273678,252945,1,20733,7.60%
Spokane,1/1/93,53063,1,1993,183054,168679,1,14375,7.90%
Stevens,1/1/93,53065,1,1993,15433,13464,1,1969,12.80%
Thurston,1/1/93,53067,1,1993,88437,81671,1,6766,7.70%
Wahkiakum,1/1/93,53069,1,1993,1650,1455,1,195,11.80%
Walla Walla,1/1/93,53071,1,1993,23948,21347,1,2601,10.90%
Whatcom,1/1/93,53073,1,1993,74265,66836,1,7429,10.00%
Whitman,1/1/93,53075,1,1993,17883,17358,1,525,2.90%
Yakima,1/1/93,53077,1,1993,103325,81253,1,22072,21.40%
Adams,1/1/94,53001,1,1994,7714,6114,1,1600,20.70%
Asotin,1/1/94,53003,1,1994,11018,10407,1,611,5.50%
Clallam,1/1/94,53009,1,1994,23429,20537,1,2892,12.30%
Columbia,1/1/94,53013,1,1994,1304,1043,1,261,20.00%
Cowlitz,1/1/94,53015,1,1994,39823,35048,1,4775,12.00%
Douglas,1/1/94,53017,1,1994,16374,14709,1,1665,10.20%
Ferry,1/1/94,53019,1,1994,2892,2360,1,532,18.40%
Franklin,1/1/94,53021,1,1994,22016,19119,1,2897,13.20%
Garfield,1/1/94,53023,1,1994,1015,926,1,89,8.80%
Grant,1/1/94,53025,1,1994,29680,25443,1,4237,14.30%
Grays Harbor,1/1/94,53027,1,1994,27751,23185,1,4566,16.50%
Island,1/1/94,53029,1,1994,25184,23653,1,1531,6.10%
Jefferson,1/1/94,53031,1,1994,9054,7967,1,1087,12.00%
King,1/1/94,53033,1,1994,894512,843962,1,50550,5.70%
Kitsap,1/1/94,53035,1,1994,91523,84787,1,6736,7.40%
Kittitas,1/1/94,53037,1,1994,14562,12752,1,1810,12.40%
Klickitat,1/1/94,53039,1,1994,8138,6682,1,1456,17.90%
Lewis,1/1/94,53041,1,1994,28442,25112,1,3330,11.70%
Lincoln,1/1/94,53043,1,1994,4168,3796,1,372,8.90%
Mason,1/1/94,53045,1,1994,17482,15738,1,1744,10.00%
Okanogan,1/1/94,53047,1,1994,20112,17103,1,3009,15.00%
Pacific,1/1/94,53049,1,1994,7852,6842,1,1010,12.90%
Pend Oreille,1/1/94,53051,1,1994,3799,3208,1,591,15.60%
Pierce,1/1/94,53053,1,1994,309427,284013,1,25414,8.20%
San Juan,1/1/94,53055,1,1994,4815,4268,1,547,11.40%
Skagit,1/1/94,53057,1,1994,44962,39119,1,5843,13.00%
Skamania,1/1/94,53059,1,1994,3844,3166,1,678,17.60%
Snohomish,1/1/94,53061,1,1994,279433,260355,1,19078,6.80%
Spokane,1/1/94,53063,1,1994,192866,179654,1,13212,6.90%
Stevens,1/1/94,53065,1,1994,16374,14346,1,2028,12.40%
Thurston,1/1/94,53067,1,1994,92501,85302,1,7199,7.80%
Wahkiakum,1/1/94,53069,1,1994,1669,1529,1,140,8.40%
Walla Walla,1/1/94,53071,1,1994,24902,22469,1,2433,9.80%
Whatcom,1/1/94,53073,1,1994,74464,67641,1,6823,9.20%
Whitman,1/1/94,53075,1,1994,18320,17769,1,551,3.00%
Yakima,1/1/94,53077,1,1994,106732,88153,1,18579,17.40%
Adams,1/1/95,53001,1,1995,8158,6569,1,1589,19.50%
Asotin,1/1/95,53003,1,1995,11492,10855,1,637,5.50%
Clallam,1/1/95,53009,1,1995,24019,21187,1,2832,11.80%
Columbia,1/1/95,53013,1,1995,1369,1105,1,264,19.30%
Cowlitz,1/1/95,53015,1,1995,40644,37057,1,3587,8.80%
Douglas,1/1/95,53017,1,1995,16733,15027,1,1706,10.20%
Ferry,1/1/95,53019,1,1995,3006,2498,1,508,16.90%
Franklin,1/1/95,53021,1,1995,22896,19962,1,2934,12.80%
Garfield,1/1/95,53023,1,1995,1004,917,1,87,8.70%
Grant,1/1/95,53025,1,1995,31034,26548,1,4486,14.50%
Grays Harbor,1/1/95,53027,1,1995,28365,24720,1,3645,12.90%
Island,1/1/95,53029,1,1995,25970,24594,1,1376,5.30%
Jefferson,1/1/95,53031,1,1995,9824,8883,1,941,9.60%
King,1/1/95,53033,1,1995,887765,847969,1,39796,4.50%
Kitsap,1/1/95,53035,1,1995,92254,85728,1,6526,7.10%
Kittitas,1/1/95,53037,1,1995,15873,14174,1,1699,10.70%
Klickitat,1/1/95,53039,1,1995,8532,7164,1,1368,16.00%
Lewis,1/1/95,53041,1,1995,29749,26615,1,3134,10.50%
Lincoln,1/1/95,53043,1,1995,4452,4070,1,382,8.60%
Mason,1/1/95,53045,1,1995,18642,16876,1,1766,9.50%
Okanogan,1/1/95,53047,1,1995,20396,17319,1,3077,15.10%
Pacific,1/1/95,53049,1,1995,8115,7164,1,951,11.70%
Pend Oreille,1/1/95,53051,1,1995,4049,3411,1,638,15.80%
Pierce,1/1/95,53053,1,1995,319338,297377,1,21961,6.90%
San Juan,1/1/95,53055,1,1995,5023,4484,1,539,10.70%
Skagit,1/1/95,53057,1,1995,46657,40952,1,5705,12.20%
Skamania,1/1/95,53059,1,1995,3957,3362,1,595,15.00%
Snohomish,1/1/95,53061,1,1995,278626,263843,1,14783,5.30%
Spokane,1/1/95,53063,1,1995,200186,186786,1,13400,6.70%
Stevens,1/1/95,53065,1,1995,16673,14752,1,1921,11.50%
Thurston,1/1/95,53067,1,1995,95840,89132,1,6708,7.00%
Wahkiakum,1/1/95,53069,1,1995,1711,1571,1,140,8.20%
Walla Walla,1/1/95,53071,1,1995,25457,23132,1,2325,9.10%
Whatcom,1/1/95,53073,1,1995,78475,71033,1,7442,9.50%
Whitman,1/1/95,53075,1,1995,18270,17764,1,506,2.80%
Yakima,1/1/95,53077,1,1995,108867,89510,1,19357,17.80%
Adams,1/1/96,53001,1,1996,8060,6218,1,1842,22.90%
Asotin,1/1/96,53003,1,1996,11689,11021,1,668,5.70%
Clallam,1/1/96,53009,1,1996,24742,21945,1,2797,11.30%
Columbia,1/1/96,53013,1,1996,1392,1069,1,323,23.20%
Cowlitz,1/1/96,53015,1,1996,41818,38073,1,3745,9.00%
Douglas,1/1/96,53017,1,1996,17168,15251,1,1917,11.20%
Ferry,1/1/96,53019,1,1996,2903,2441,1,462,15.90%
Franklin,1/1/96,53021,1,1996,22752,19008,1,3744,16.50%
Garfield,1/1/96,53023,1,1996,1024,940,1,84,8.20%
Grant,1/1/96,53025,1,1996,32158,27367,1,4791,14.90%
Grays Harbor,1/1/96,53027,1,1996,27662,24102,1,3560,12.90%
Island,1/1/96,53029,1,1996,26200,24802,1,1398,5.30%
Jefferson,1/1/96,53031,1,1996,9812,8850,1,962,9.80%
King,1/1/96,53033,1,1996,903266,857432,1,45834,5.10%
Kitsap,1/1/96,53035,1,1996,95164,88252,1,6912,7.30%
Kittitas,1/1/96,53037,1,1996,15639,13843,1,1796,11.50%
Klickitat,1/1/96,53039,1,1996,8489,7181,1,1308,15.40%
Lewis,1/1/96,53041,1,1996,30669,27355,1,3314,10.80%
Lincoln,1/1/96,53043,1,1996,4726,4334,1,392,8.30%
Mason,1/1/96,53045,1,1996,19754,17923,1,1831,9.30%
Okanogan,1/1/96,53047,1,1996,20716,17443,1,3273,15.80%
Pacific,1/1/96,53049,1,1996,8292,7276,1,1016,12.30%
Pend Oreille,1/1/96,53051,1,1996,4051,3352,1,699,17.30%
Pierce,1/1/96,53053,1,1996,322796,300684,1,22112,6.90%
San Juan,1/1/96,53055,1,1996,4974,4401,1,573,11.50%
Skagit,1/1/96,53057,1,1996,46240,40437,1,5803,12.50%
Skamania,1/1/96,53059,1,1996,3823,3298,1,525,13.70%
Snohomish,1/1/96,53061,1,1996,287020,269870,1,17150,6.00%
Spokane,1/1/96,53063,1,1996,203272,188771,1,14501,7.10%
Stevens,1/1/96,53065,1,1996,17077,14996,1,2081,12.20%
Thurston,1/1/96,53067,1,1996,98339,91215,1,7124,7.20%
Wahkiakum,1/1/96,53069,1,1996,1640,1522,1,118,7.20%
Walla Walla,1/1/96,53071,1,1996,25688,23138,1,2550,9.90%
Whatcom,1/1/96,53073,1,1996,79096,72238,1,6858,8.70%
Whitman,1/1/96,53075,1,1996,18806,18217,1,589,3.10%
Yakima,1/1/96,53077,1,1996,109239,89473,1,19766,18.10%
Adams,1/1/97,53001,1,1997,7879,6629,1,1250,15.90%
Asotin,1/1/97,53003,1,1997,12279,11603,1,676,5.50%
Clallam,1/1/97,53009,1,1997,24775,22451,1,2324,9.40%
Columbia,1/1/97,53013,1,1997,1327,1084,1,243,18.30%
Cowlitz,1/1/97,53015,1,1997,42467,39298,1,3169,7.50%
Douglas,1/1/97,53017,1,1997,17983,16211,1,1772,9.90%
Ferry,1/1/97,53019,1,1997,2817,2446,1,371,13.20%
Franklin,1/1/97,53021,1,1997,22700,19241,1,3459,15.20%
Garfield,1/1/97,53023,1,1997,1076,1023,1,53,4.90%
Grant,1/1/97,53025,1,1997,33547,29080,1,4467,13.30%
Grays Harbor,1/1/97,53027,1,1997,28342,25244,1,3098,10.90%
Island,1/1/97,53029,1,1997,27961,26784,1,1177,4.20%
Jefferson,1/1/97,53031,1,1997,9734,8851,1,883,9.10%
King,1/1/97,53033,1,1997,934123,895683,1,38440,4.10%
Kitsap,1/1/97,53035,1,1997,95259,89415,1,5844,6.10%
Kittitas,1/1/97,53037,1,1997,16061,14889,1,1172,7.30%
Klickitat,1/1/97,53039,1,1997,8928,7621,1,1307,14.60%
Lewis,1/1/97,53041,1,1997,31304,28382,1,2922,9.30%
Lincoln,1/1/97,53043,1,1997,4711,4377,1,334,7.10%
Mason,1/1/97,53045,1,1997,20105,18461,1,1644,8.20%
Okanogan,1/1/97,53047,1,1997,21028,18133,1,2895,13.80%
Pacific,1/1/97,53049,1,1997,8538,7582,1,956,11.20%
Pend Oreille,1/1/97,53051,1,1997,4287,3465,1,822,19.20%
Pierce,1/1/97,53053,1,1997,333578,316897,1,16681,5.00%
San Juan,1/1/97,53055,1,1997,5033,4527,1,506,10.10%
Skagit,1/1/97,53057,1,1997,46914,42511,1,4403,9.40%
Skamania,1/1/97,53059,1,1997,3903,3394,1,509,13.00%
Snohomish,1/1/97,53061,1,1997,303271,289824,1,13447,4.40%
Spokane,1/1/97,53063,1,1997,208498,196052,1,12446,6.00%
Stevens,1/1/97,53065,1,1997,17655,15549,1,2106,11.90%
Thurston,1/1/97,53067,1,1997,101386,95312,1,6074,6.00%
Wahkiakum,1/1/97,53069,1,1997,1797,1664,1,133,7.40%
Walla Walla,1/1/97,53071,1,1997,26269,23749,1,2520,9.60%
Whatcom,1/1/97,53073,1,1997,78858,73007,1,5851,7.40%
Whitman,1/1/97,53075,1,1997,19528,19051,1,477,2.40%
Yakima,1/1/97,53077,1,1997,109615,92850,1,16765,15.30%
Adams,1/1/98,53001,1,1998,8753,6956,1,1797,20.50%
Asotin,1/1/98,53003,1,1998,12970,12260,1,710,5.50%
Clallam,1/1/98,53009,1,1998,25549,23086,1,2463,9.60%
Columbia,1/1/98,53013,1,1998,1342,1102,1,240,17.90%
Cowlitz,1/1/98,53015,1,1998,43774,40109,1,3665,8.40%
Douglas,1/1/98,53017,1,1998,18344,16642,1,1702,9.30%
Ferry,1/1/98,53019,1,1998,2810,2458,1,352,12.50%
Franklin,1/1/98,53021,1,1998,23334,19951,1,3383,14.50%
Garfield,1/1/98,53023,1,1998,1060,987,1,73,6.90%
Grant,1/1/98,53025,1,1998,34619,30095,1,4524,13.10%
Grays Harbor,1/1/98,53027,1,1998,28276,24938,1,3338,11.80%
Island,1/1/98,53029,1,1998,29935,28677,1,1258,4.20%
Jefferson,1/1/98,53031,1,1998,10027,9200,1,827,8.20%
King,1/1/98,53033,1,1998,963683,934047,1,29636,3.10%
Kitsap,1/1/98,53035,1,1998,95750,90213,1,5537,5.80%
Kittitas,1/1/98,53037,1,1998,15537,14228,1,1309,8.40%
Klickitat,1/1/98,53039,1,1998,9187,7628,1,1559,17.00%
Lewis,1/1/98,53041,1,1998,31502,28120,1,3382,10.70%
Lincoln,1/1/98,53043,1,1998,4934,4611,1,323,6.50%
Mason,1/1/98,53045,1,1998,21049,19320,1,1729,8.20%
Okanogan,1/1/98,53047,1,1998,21311,18198,1,3113,14.60%
Pacific,1/1/98,53049,1,1998,8514,7444,1,1070,12.60%
Pend Oreille,1/1/98,53051,1,1998,4329,3699,1,630,14.60%
Pierce,1/1/98,53053,1,1998,345154,328153,1,17001,4.90%
San Juan,1/1/98,53055,1,1998,5401,4974,1,427,7.90%
Skagit,1/1/98,53057,1,1998,48057,43720,1,4337,9.00%
Skamania,1/1/98,53059,1,1998,4205,3584,1,621,14.80%
Snohomish,1/1/98,53061,1,1998,318734,308286,1,10448,3.30%
Spokane,1/1/98,53063,1,1998,216052,204054,1,11998,5.60%
Stevens,1/1/98,53065,1,1998,18055,16100,1,1955,10.80%
Thurston,1/1/98,53067,1,1998,106215,100250,1,5965,5.60%
Wahkiakum,1/1/98,53069,1,1998,1895,1727,1,168,8.90%
Walla Walla,1/1/98,53071,1,1998,26820,24299,1,2521,9.40%
Whatcom,1/1/98,53073,1,1998,81146,75547,1,5599,6.90%
Whitman,1/1/98,53075,1,1998,20018,19522,1,496,2.50%
Yakima,1/1/98,53077,1,1998,111976,95175,1,16801,15.00%
Adams,1/1/99,53001,1,1999,8296,6836,1,1460,17.60%
Asotin,1/1/99,53003,1,1999,13007,12341,1,666,5.10%
Clallam,1/1/99,53009,1,1999,26842,24438,1,2404,9.00%
Columbia,1/1/99,53013,1,1999,1416,1156,1,260,18.40%
Cowlitz,1/1/99,53015,1,1999,44419,40605,1,3814,8.60%
Douglas,1/1/99,53017,1,1999,18878,17095,1,1783,9.40%
Ferry,1/1/99,53019,1,1999,2775,2370,1,405,14.60%
Franklin,1/1/99,53021,1,1999,23920,20538,1,3382,14.10%
Garfield,1/1/99,53023,1,1999,1083,1011,1,72,6.60%
Grant,1/1/99,53025,1,1999,37241,32166,1,5075,13.60%
Grays Harbor,1/1/99,53027,1,1999,28323,25434,1,2889,10.20%
Island,1/1/99,53029,1,1999,31379,30244,1,1135,3.60%
Jefferson,1/1/99,53031,1,1999,11123,10290,1,833,7.50%
King,1/1/99,53033,1,1999,974669,944910,1,29759,3.10%
Kitsap,1/1/99,53035,1,1999,99816,94604,1,5212,5.20%
Kittitas,1/1/99,53037,1,1999,15776,14541,1,1235,7.80%
Klickitat,1/1/99,53039,1,1999,8866,7625,1,1241,14.00%
Lewis,1/1/99,53041,1,1999,31838,28567,1,3271,10.30%
Lincoln,1/1/99,53043,1,1999,4767,4389,1,378,7.90%
Mason,1/1/99,53045,1,1999,20501,18889,1,1612,7.90%
Okanogan,1/1/99,53047,1,1999,20859,18000,1,2859,13.70%
Pacific,1/1/99,53049,1,1999,8199,7255,1,944,11.50%
Pend Oreille,1/1/99,53051,1,1999,4468,3860,1,608,13.60%
Pierce,1/1/99,53053,1,1999,353487,336480,1,17007,4.80%
San Juan,1/1/99,53055,1,1999,6157,5713,1,444,7.20%
Skagit,1/1/99,53057,1,1999,51741,47499,1,4242,8.20%
Skamania,1/1/99,53059,1,1999,4235,3710,1,525,12.40%
Snohomish,1/1/99,53061,1,1999,327160,315783,1,11377,3.50%
Spokane,1/1/99,53063,1,1999,224763,210101,1,14662,6.50%
Stevens,1/1/99,53065,1,1999,17895,15941,1,1954,10.90%
Thurston,1/1/99,53067,1,1999,108037,102434,1,5603,5.20%
Wahkiakum,1/1/99,53069,1,1999,1886,1726,1,160,8.50%
Walla Walla,1/1/99,53071,1,1999,27778,24889,1,2889,10.40%
Whatcom,1/1/99,53073,1,1999,86446,80903,1,5543,6.40%
Whitman,1/1/99,53075,1,1999,20196,19708,1,488,2.40%
Yakima,1/1/99,53077,1,1999,113895,97553,1,16342,14.30%
Adams,1/1/00,53001,1,2000,7319,6301,1,1018,13.90%
Asotin,1/1/00,53003,1,2000,9830,9191,1,639,6.50%
Clallam,1/1/00,53009,1,2000,26479,24073,1,2406,9.10%
Columbia,1/1/00,53013,1,2000,1606,1383,1,223,13.90%
Cowlitz,1/1/00,53015,1,2000,44692,41167,1,3525,7.90%
Douglas,1/1/00,53017,1,2000,16905,15331,1,1574,9.30%
Ferry,1/1/00,53019,1,2000,3076,2724,1,352,11.40%
Franklin,1/1/00,53021,1,2000,23046,20271,1,2775,12.00%
Garfield,1/1/00,53023,1,2000,982,920,1,62,6.30%
Grant,1/1/00,53025,1,2000,33774,29786,1,3988,11.80%
Grays Harbor,1/1/00,53027,1,2000,29638,27041,1,2597,8.80%
Island,1/1/00,53029,1,2000,29844,28083,1,1761,5.90%
Jefferson,1/1/00,53031,1,2000,11703,10843,1,860,7.30%
King,1/1/00,53033,1,2000,986660,951491,1,35169,3.60%
Kitsap,1/1/00,53035,1,2000,109211,102807,1,6404,5.90%
Kittitas,1/1/00,53037,1,2000,17265,16063,1,1202,7.00%
Klickitat,1/1/00,53039,1,2000,9012,8003,1,1009,11.20%
Lewis,1/1/00,53041,1,2000,30725,27780,1,2945,9.60%
Lincoln,1/1/00,53043,1,2000,4437,4132,1,305,6.90%
Mason,1/1/00,53045,1,2000,21307,19619,1,1688,7.90%
Okanogan,1/1/00,53047,1,2000,19048,16825,1,2223,11.70%
Pacific,1/1/00,53049,1,2000,8352,7584,1,768,9.20%
Pend Oreille,1/1/00,53051,1,2000,4585,4124,1,461,10.10%
Pierce,1/1/00,53053,1,2000,346872,327045,1,19827,5.70%
San Juan,1/1/00,53055,1,2000,6920,6497,1,423,6.10%
Skagit,1/1/00,53057,1,2000,52155,48220,1,3935,7.50%
Skamania,1/1/00,53059,1,2000,5002,4555,1,447,8.90%
Snohomish,1/1/00,53061,1,2000,324942,310577,1,14365,4.40%
Spokane,1/1/00,53063,1,2000,214883,200469,1,14414,6.70%
Stevens,1/1/00,53065,1,2000,17981,16274,1,1707,9.50%
Thurston,1/1/00,53067,1,2000,111234,105306,1,5928,5.30%
Wahkiakum,1/1/00,53069,1,2000,1646,1497,1,149,9.10%
Walla Walla,1/1/00,53071,1,2000,26281,24048,1,2233,8.50%
Whatcom,1/1/00,53073,1,2000,90548,84996,1,5552,6.10%
Whitman,1/1/00,53075,1,2000,19627,18801,1,826,4.20%
Yakima,1/1/00,53077,1,2000,108635,96203,1,12432,11.40%
Adams,1/1/01,53001,1,2001,7175,6038,1,1137,15.80%
Asotin,1/1/01,53003,1,2001,10128,9365,1,763,7.50%
Clallam,1/1/01,53009,1,2001,26136,23584,1,2552,9.80%
Columbia,1/1/01,53013,1,2001,1549,1334,1,215,13.90%
Cowlitz,1/1/01,53015,1,2001,43252,39493,1,3759,8.70%
Douglas,1/1/01,53017,1,2001,16226,14594,1,1632,10.10%
Ferry,1/1/01,53019,1,2001,2944,2540,1,404,13.70%
Franklin,1/1/01,53021,1,2001,23343,20263,1,3080,13.20%
Garfield,1/1/01,53023,1,2001,999,922,1,77,7.70%
Grant,1/1/01,53025,1,2001,33465,29059,1,4406,13.20%
Grays Harbor,1/1/01,53027,1,2001,29254,26151,1,3103,10.60%
Island,1/1/01,53029,1,2001,29290,27427,1,1863,6.40%
Jefferson,1/1/01,53031,1,2001,11860,10981,1,879,7.40%
King,1/1/01,53033,1,2001,981787,943280,1,38507,3.90%
Kitsap,1/1/01,53035,1,2001,106843,99928,1,6915,6.50%
Kittitas,1/1/01,53037,1,2001,17102,15684,1,1418,8.30%
Klickitat,1/1/01,53039,1,2001,9034,7849,1,1185,13.10%
Lewis,1/1/01,53041,1,2001,29274,26324,1,2950,10.10%
Lincoln,1/1/01,53043,1,2001,4368,4027,1,341,7.80%
Mason,1/1/01,53045,1,2001,20661,18758,1,1903,9.20%
Okanogan,1/1/01,53047,1,2001,17605,14974,1,2631,14.90%
Pacific,1/1/01,53049,1,2001,8607,7771,1,836,9.70%
Pend Oreille,1/1/01,53051,1,2001,4632,4130,1,502,10.80%
Pierce,1/1/01,53053,1,2001,341583,318898,1,22685,6.60%
San Juan,1/1/01,53055,1,2001,6878,6405,1,473,6.90%
Skagit,1/1/01,53057,1,2001,51378,47121,1,4257,8.30%
Skamania,1/1/01,53059,1,2001,4968,4464,1,504,10.10%
Snohomish,1/1/01,53061,1,2001,326044,312128,1,13916,4.30%
Spokane,1/1/01,53063,1,2001,215032,198968,1,16064,7.50%
Stevens,1/1/01,53065,1,2001,17379,15524,1,1855,10.70%
Thurston,1/1/01,53067,1,2001,109055,102198,1,6857,6.30%
Wahkiakum,1/1/01,53069,1,2001,1631,1494,1,137,8.40%
Walla Walla,1/1/01,53071,1,2001,27027,24569,1,2458,9.10%
Whatcom,1/1/01,53073,1,2001,88683,82118,1,6565,7.40%
Whitman,1/1/01,53075,1,2001,19217,18220,1,997,5.20%
Yakima,1/1/01,53077,1,2001,106242,92448,1,13794,13.00%
Adams,1/1/02,53001,1,2002,7346,6244,1,1102,15.00%
Asotin,1/1/02,53003,1,2002,9831,9056,1,775,7.90%
Clallam,1/1/02,53009,1,2002,26091,23321,1,2770,10.60%
Columbia,1/1/02,53013,1,2002,1551,1340,1,211,13.60%
Cowlitz,1/1/02,53015,1,2002,42126,36869,1,5257,12.50%
Douglas,1/1/02,53017,1,2002,16173,14476,1,1697,10.50%
Ferry,1/1/02,53019,1,2002,2877,2487,1,390,13.60%
Franklin,1/1/02,53021,1,2002,23722,20736,1,2986,12.60%
Garfield,1/1/02,53023,1,2002,967,873,1,94,9.70%
Grant,1/1/02,53025,1,2002,32748,28094,1,4654,14.20%
Grays Harbor,1/1/02,53027,1,2002,28344,24979,1,3365,11.90%
Island,1/1/02,53029,1,2002,29652,27129,1,2523,8.50%
Jefferson,1/1/02,53031,1,2002,11995,10834,1,1161,9.70%
King,1/1/02,53033,1,2002,982749,922708,1,60041,6.10%
Kitsap,1/1/02,53035,1,2002,108385,99919,1,8466,7.80%
Kittitas,1/1/02,53037,1,2002,17523,15932,1,1591,9.10%
Klickitat,1/1/02,53039,1,2002,8934,7579,1,1355,15.20%
Lewis,1/1/02,53041,1,2002,28717,25626,1,3091,10.80%
Lincoln,1/1/02,53043,1,2002,4310,3927,1,383,8.90%
Mason,1/1/02,53045,1,2002,21108,18908,1,2200,10.40%
Okanogan,1/1/02,53047,1,2002,16598,14046,1,2552,15.40%
Pacific,1/1/02,53049,1,2002,8323,7417,1,906,10.90%
Pend Oreille,1/1/02,53051,1,2002,4555,4015,1,540,11.90%
Pierce,1/1/02,53053,1,2002,338690,308323,1,30367,9.00%
San Juan,1/1/02,53055,1,2002,6666,6092,1,574,8.60%
Skagit,1/1/02,53057,1,2002,50703,45619,1,5084,10.00%
Skamania,1/1/02,53059,1,2002,4799,4192,1,607,12.60%
Snohomish,1/1/02,53061,1,2002,331903,308842,1,23061,6.90%
Spokane,1/1/02,53063,1,2002,209510,189280,1,20230,9.70%
Stevens,1/1/02,53065,1,2002,17395,15178,1,2217,12.70%
Thurston,1/1/02,53067,1,2002,109797,101590,1,8207,7.50%
Wahkiakum,1/1/02,53069,1,2002,1555,1360,1,195,12.50%
Walla Walla,1/1/02,53071,1,2002,26876,24249,1,2627,9.80%
Whatcom,1/1/02,53073,1,2002,89580,81884,1,7696,8.60%
Whitman,1/1/02,53075,1,2002,18714,17625,1,1089,5.80%
Yakima,1/1/02,53077,1,2002,104627,89952,1,14675,14.00%
Adams,1/1/03,53001,1,2003,7436,6350,1,1086,14.60%
Asotin,1/1/03,53003,1,2003,9937,9010,1,927,9.30%
Clallam,1/1/03,53009,1,2003,27072,24248,1,2824,10.40%
Columbia,1/1/03,53013,1,2003,1552,1352,1,200,12.90%
Cowlitz,1/1/03,53015,1,2003,43180,38403,1,4777,11.10%
Douglas,1/1/03,53017,1,2003,17241,15565,1,1676,9.70%
Ferry,1/1/03,53019,1,2003,2935,2499,1,436,14.90%
Franklin,1/1/03,53021,1,2003,25887,22593,1,3294,12.70%
Garfield,1/1/03,53023,1,2003,1014,911,1,103,10.20%
Grant,1/1/03,53025,1,2003,33449,29074,1,4375,13.10%
Grays Harbor,1/1/03,53027,1,2003,29780,26669,1,3111,10.40%
Island,1/1/03,53029,1,2003,30525,28119,1,2406,7.90%
Jefferson,1/1/03,53031,1,2003,12527,11378,1,1149,9.20%
King,1/1/03,53033,1,2003,975587,913824,1,61763,6.30%
Kitsap,1/1/03,53035,1,2003,113829,105250,1,8579,7.50%
Kittitas,1/1/03,53037,1,2003,18173,16513,1,1660,9.10%
Klickitat,1/1/03,53039,1,2003,8947,7640,1,1307,14.60%
Lewis,1/1/03,53041,1,2003,30030,26843,1,3187,10.60%
Lincoln,1/1/03,53043,1,2003,4431,4049,1,382,8.60%
Mason,1/1/03,53045,1,2003,22496,20337,1,2159,9.60%
Okanogan,1/1/03,53047,1,2003,17297,14871,1,2426,14.00%
Pacific,1/1/03,53049,1,2003,8962,8043,1,919,10.30%
Pend Oreille,1/1/03,53051,1,2003,4684,4101,1,583,12.40%
Pierce,1/1/03,53053,1,2003,350019,319455,1,30564,8.70%
San Juan,1/1/03,53055,1,2003,7053,6469,1,584,8.30%
Skagit,1/1/03,53057,1,2003,52275,47409,1,4866,9.30%
Skamania,1/1/03,53059,1,2003,4876,4278,1,598,12.30%
Snohomish,1/1/03,53061,1,2003,330565,307093,1,23472,7.10%
Spokane,1/1/03,53063,1,2003,214897,196142,1,18755,8.70%
Stevens,1/1/03,53065,1,2003,17563,15539,1,2024,11.50%
Thurston,1/1/03,53067,1,2003,115517,107473,1,8044,7.00%
Wahkiakum,1/1/03,53069,1,2003,1606,1418,1,188,11.70%
Walla Walla,1/1/03,53071,1,2003,27973,25414,1,2559,9.10%
Whatcom,1/1/03,53073,1,2003,94366,87409,1,6957,7.40%
Whitman,1/1/03,53075,1,2003,19200,18162,1,1038,5.40%
Yakima,1/1/03,53077,1,2003,108339,94931,1,13408,12.40%
Adams,1/1/04,53001,1,2004,7420,6378,1,1042,14.00%
Asotin,1/1/04,53003,1,2004,10243,9388,1,855,8.30%
Clallam,1/1/04,53009,1,2004,27735,25130,1,2605,9.40%
Columbia,1/1/04,53013,1,2004,1559,1376,1,183,11.70%
Cowlitz,1/1/04,53015,1,2004,43478,38836,1,4642,10.70%
Douglas,1/1/04,53017,1,2004,17728,15980,1,1748,9.90%
Ferry,1/1/04,53019,1,2004,2939,2503,1,436,14.80%
Franklin,1/1/04,53021,1,2004,27277,23822,1,3455,12.70%
Garfield,1/1/04,53023,1,2004,1031,955,1,76,7.40%
Grant,1/1/04,53025,1,2004,34658,30092,1,4566,13.20%
Grays Harbor,1/1/04,53027,1,2004,30597,27474,1,3123,10.20%
Island,1/1/04,53029,1,2004,31496,28921,1,2575,8.20%
Jefferson,1/1/04,53031,1,2004,13254,12223,1,1031,7.80%
King,1/1/04,53033,1,2004,981761,928531,1,53230,5.40%
Kitsap,1/1/04,53035,1,2004,118537,110574,1,7963,6.70%
Kittitas,1/1/04,53037,1,2004,19041,17235,1,1806,9.50%
Klickitat,1/1/04,53039,1,2004,8728,7427,1,1301,14.90%
Lewis,1/1/04,53041,1,2004,30749,27491,1,3258,10.60%
Lincoln,1/1/04,53043,1,2004,4729,4294,1,435,9.20%
Mason,1/1/04,53045,1,2004,23276,21071,1,2205,9.50%
Okanogan,1/1/04,53047,1,2004,18597,16311,1,2286,12.30%
Pacific,1/1/04,53049,1,2004,9153,8288,1,865,9.50%
Pend Oreille,1/1/04,53051,1,2004,5045,4439,1,606,12.00%
Pierce,1/1/04,53053,1,2004,361626,330827,1,30799,8.50%
San Juan,1/1/04,53055,1,2004,7366,6816,1,550,7.50%
Skagit,1/1/04,53057,1,2004,53898,48926,1,4972,9.20%
Skamania,1/1/04,53059,1,2004,5140,4423,1,717,13.90%
Snohomish,1/1/04,53061,1,2004,335306,313501,1,21805,6.50%
Spokane,1/1/04,53063,1,2004,220497,201269,1,19228,8.70%
Stevens,1/1/04,53065,1,2004,18216,16194,1,2022,11.10%
Thurston,1/1/04,53067,1,2004,119679,111514,1,8165,6.80%
Wahkiakum,1/1/04,53069,1,2004,1682,1510,1,172,10.20%
Walla Walla,1/1/04,53071,1,2004,28174,25597,1,2577,9.10%
Whatcom,1/1/04,53073,1,2004,98297,91222,1,7075,7.20%
Whitman,1/1/04,53075,1,2004,20153,19115,1,1038,5.20%
Yakima,1/1/04,53077,1,2004,110498,95939,1,14559,13.20%
Adams,1/1/05,53001,1,2005,7528,6641,1,887,11.80%
Asotin,1/1/05,53003,1,2005,10727,9838,1,889,8.30%
Clallam,1/1/05,53009,1,2005,29465,26994,1,2471,8.40%
Columbia,1/1/05,53013,1,2005,1519,1349,1,170,11.20%
Cowlitz,1/1/05,53015,1,2005,43081,39262,1,3819,8.90%
Douglas,1/1/05,53017,1,2005,18241,16720,1,1521,8.30%
Ferry,1/1/05,53019,1,2005,3003,2641,1,362,12.10%
Franklin,1/1/05,53021,1,2005,28818,25871,1,2947,10.20%
Garfield,1/1/05,53023,1,2005,1035,958,1,77,7.40%
Grant,1/1/05,53025,1,2005,35148,31080,1,4068,11.60%
Grays Harbor,1/1/05,53027,1,2005,31636,28751,1,2885,9.10%
Island,1/1/05,53029,1,2005,31457,29310,1,2147,6.80%
Jefferson,1/1/05,53031,1,2005,13534,12574,1,960,7.10%
King,1/1/05,53033,1,2005,989768,945819,1,43949,4.40%
Kitsap,1/1/05,53035,1,2005,120573,113440,1,7133,5.90%
Kittitas,1/1/05,53037,1,2005,18865,17350,1,1515,8.00%
Klickitat,1/1/05,53039,1,2005,8887,7867,1,1020,11.50%
Lewis,1/1/05,53041,1,2005,30506,27612,1,2894,9.50%
Lincoln,1/1/05,53043,1,2005,4636,4255,1,381,8.20%
Mason,1/1/05,53045,1,2005,23670,21788,1,1882,8.00%
Okanogan,1/1/05,53047,1,2005,18656,16465,1,2191,11.70%
Pacific,1/1/05,53049,1,2005,9251,8506,1,745,8.10%
Pend Oreille,1/1/05,53051,1,2005,5035,4488,1,547,10.90%
Pierce,1/1/05,53053,1,2005,369874,343992,1,25882,7.00%
San Juan,1/1/05,53055,1,2005,7587,7100,1,487,6.40%
Skagit,1/1/05,53057,1,2005,55402,50962,1,4440,8.00%
Skamania,1/1/05,53059,1,2005,5140,4595,1,545,10.60%
Snohomish,1/1/05,53061,1,2005,339766,322286,1,17480,5.10%
Spokane,1/1/05,53063,1,2005,225143,208390,1,16753,7.40%
Stevens,1/1/05,53065,1,2005,18157,16314,1,1843,10.20%
Thurston,1/1/05,53067,1,2005,122391,115100,1,7291,6.00%
Wahkiakum,1/1/05,53069,1,2005,1659,1507,1,152,9.20%
Walla Walla,1/1/05,53071,1,2005,27959,25725,1,2234,8.00%
Whatcom,1/1/05,53073,1,2005,102443,95947,1,6496,6.30%
Whitman,1/1/05,53075,1,2005,20519,19549,1,970,4.70%
Yakima,1/1/05,53077,1,2005,112252,99956,1,12296,11.00%
Adams,1/1/06,53001,1,2006,7704,6734,1,970,12.60%
Asotin,1/1/06,53003,1,2006,10181,9821,1,360,3.50%
Clallam,1/1/06,53009,1,2006,29701,27548,1,2153,7.20%
Columbia,1/1/06,53013,1,2006,1565,1370,1,195,12.50%
Cowlitz,1/1/06,53015,1,2006,43397,39945,1,3452,8.00%
Douglas,1/1/06,53017,1,2006,18669,17254,1,1415,7.60%
Ferry,1/1/06,53019,1,2006,2949,2556,1,393,13.30%
Franklin,1/1/06,53021,1,2006,29663,26587,1,3076,10.40%
Garfield,1/1/06,53023,1,2006,1000,916,1,84,8.40%
Grant,1/1/06,53025,1,2006,36164,32248,1,3916,10.80%
Grays Harbor,1/1/06,53027,1,2006,31398,28632,1,2766,8.80%
Island,1/1/06,53029,1,2006,32597,30662,1,1935,5.90%
Jefferson,1/1/06,53031,1,2006,13707,12879,1,828,6.00%
King,1/1/06,53033,1,2006,1018356,982889,1,35467,3.50%
Kitsap,1/1/06,53035,1,2006,123159,116647,1,6512,5.30%
Kittitas,1/1/06,53037,1,2006,19360,17937,1,1423,7.40%
Klickitat,1/1/06,53039,1,2006,9078,8038,1,1040,11.50%
Lewis,1/1/06,53041,1,2006,31550,28773,1,2777,8.80%
Lincoln,1/1/06,53043,1,2006,4548,4184,1,364,8.00%
Mason,1/1/06,53045,1,2006,24347,22600,1,1747,7.20%
Okanogan,1/1/06,53047,1,2006,18584,16649,1,1935,10.40%
Pacific,1/1/06,53049,1,2006,9078,8348,1,730,8.00%
Pend Oreille,1/1/06,53051,1,2006,5117,4586,1,531,10.40%
Pierce,1/1/06,53053,1,2006,375288,352558,1,22730,6.10%
San Juan,1/1/06,53055,1,2006,7672,7248,1,424,5.50%
Skagit,1/1/06,53057,1,2006,56113,52316,1,3797,6.80%
Skamania,1/1/06,53059,1,2006,5272,4677,1,595,11.30%
Snohomish,1/1/06,53061,1,2006,349477,335829,1,13648,3.90%
Spokane,1/1/06,53063,1,2006,227816,212922,1,14894,6.50%
Stevens,1/1/06,53065,1,2006,18196,16423,1,1773,9.70%
Thurston,1/1/06,53067,1,2006,124231,117405,1,6826,5.50%
Wahkiakum,1/1/06,53069,1,2006,1625,1487,1,138,8.50%
Walla Walla,1/1/06,53071,1,2006,28128,25894,1,2234,7.90%
Whatcom,1/1/06,53073,1,2006,103198,97588,1,5610,5.40%
Whitman,1/1/06,53075,1,2006,20735,19840,1,895,4.30%
Yakima,1/1/06,53077,1,2006,113424,101474,1,11950,10.50%
Adams,1/1/07,53001,1,2007,7373,6532,1,841,11.40%
Asotin,1/1/07,53003,1,2007,10267,9609,1,658,6.40%
Clallam,1/1/07,53009,1,2007,29751,27494,1,2257,7.60%
Columbia,1/1/07,53013,1,2007,1554,1399,1,155,10.00%
Cowlitz,1/1/07,53015,1,2007,43787,40378,1,3409,7.80%
Douglas,1/1/07,53017,1,2007,19178,17764,1,1414,7.40%
Ferry,1/1/07,53019,1,2007,2934,2593,1,341,11.60%
Franklin,1/1/07,53021,1,2007,31495,28222,1,3273,10.40%
Garfield,1/1/07,53023,1,2007,988,919,1,69,7.00%
Grant,1/1/07,53025,1,2007,37517,33636,1,3881,10.30%
Grays Harbor,1/1/07,53027,1,2007,31271,28407,1,2864,9.20%
Island,1/1/07,53029,1,2007,32740,30793,1,1947,5.90%
Jefferson,1/1/07,53031,1,2007,13497,12672,1,825,6.10%
King,1/1/07,53033,1,2007,1047310,1009943,1,37367,3.60%
Kitsap,1/1/07,53035,1,2007,122810,116129,1,6681,5.40%
Kittitas,1/1/07,53037,1,2007,19978,18598,1,1380,6.90%
Klickitat,1/1/07,53039,1,2007,9216,8244,1,972,10.50%
Lewis,1/1/07,53041,1,2007,32069,28962,1,3107,9.70%
Lincoln,1/1/07,53043,1,2007,4619,4267,1,352,7.60%
Mason,1/1/07,53045,1,2007,25127,23177,1,1950,7.80%
Okanogan,1/1/07,53047,1,2007,18334,16374,1,1960,10.70%
Pacific,1/1/07,53049,1,2007,9117,8376,1,741,8.10%
Pend Oreille,1/1/07,53051,1,2007,5284,4736,1,548,10.40%
Pierce,1/1/07,53053,1,2007,385169,362653,1,22516,5.80%
San Juan,1/1/07,53055,1,2007,7711,7286,1,425,5.50%
Skagit,1/1/07,53057,1,2007,56965,53309,1,3656,6.40%
Skamania,1/1/07,53059,1,2007,5140,4659,1,481,9.40%
Snohomish,1/1/07,53061,1,2007,357301,342581,1,14720,4.10%
Spokane,1/1/07,53063,1,2007,233700,218733,1,14967,6.40%
Stevens,1/1/07,53065,1,2007,18675,16663,1,2012,10.80%
Thurston,1/1/07,53067,1,2007,127209,120246,1,6963,5.50%
Wahkiakum,1/1/07,53069,1,2007,1660,1528,1,132,8.00%
Walla Walla,1/1/07,53071,1,2007,28469,26431,1,2038,7.20%
Whatcom,1/1/07,53073,1,2007,105005,99190,1,5815,5.50%
Whitman,1/1/07,53075,1,2007,20713,19784,1,929,4.50%
Yakima,1/1/07,53077,1,2007,115070,103857,1,11213,9.70%
Adams,1/1/08,53001,1,2008,7562,6785,1,777,10.30%
Asotin,1/1/08,53003,1,2008,10576,9807,1,769,7.30%
Clallam,1/1/08,53009,1,2008,30360,27859,1,2501,8.20%
Columbia,1/1/08,53013,1,2008,1607,1472,1,135,8.40%
Cowlitz,1/1/08,53015,1,2008,44895,40973,1,3922,8.70%
Douglas,1/1/08,53017,1,2008,19761,18249,1,1512,7.70%
Ferry,1/1/08,53019,1,2008,2984,2639,1,345,11.60%
Franklin,1/1/08,53021,1,2008,33319,30302,1,3017,9.10%
Garfield,1/1/08,53023,1,2008,938,884,1,54,5.80%
Grant,1/1/08,53025,1,2008,37740,33972,1,3768,10.00%
Grays Harbor,1/1/08,53027,1,2008,32117,29180,1,2937,9.10%
Island,1/1/08,53029,1,2008,33034,30969,1,2065,6.30%
Jefferson,1/1/08,53031,1,2008,13675,12865,1,810,5.90%
King,1/1/08,53033,1,2008,1072912,1041356,1,31556,2.90%
Kitsap,1/1/08,53035,1,2008,125639,119164,1,6475,5.20%
Kittitas,1/1/08,53037,1,2008,20814,19311,1,1503,7.20%
Klickitat,1/1/08,53039,1,2008,9614,8616,1,998,10.40%
Lewis,1/1/08,53041,1,2008,32003,28909,1,3094,9.70%
Lincoln,1/1/08,53043,1,2008,4655,4305,1,350,7.50%
Mason,1/1/08,53045,1,2008,25420,23535,1,1885,7.40%
Okanogan,1/1/08,53047,1,2008,18865,16945,1,1920,10.20%
Pacific,1/1/08,53049,1,2008,9166,8411,1,755,8.20%
Pend Oreille,1/1/08,53051,1,2008,5484,4920,1,564,10.30%
Pierce,1/1/08,53053,1,2008,397222,373788,1,23434,5.90%
San Juan,1/1/08,53055,1,2008,8005,7631,1,374,4.70%
Skagit,1/1/08,53057,1,2008,58774,55047,1,3727,6.30%
Skamania,1/1/08,53059,1,2008,5252,4726,1,526,10.00%
Snohomish,1/1/08,53061,1,2008,366325,353672,1,12653,3.50%
Spokane,1/1/08,53063,1,2008,241003,224966,1,16037,6.70%
Stevens,1/1/08,53065,1,2008,18918,17134,1,1784,9.40%
Thurston,1/1/08,53067,1,2008,132074,124817,1,7257,5.50%
Wahkiakum,1/1/08,53069,1,2008,1808,1654,1,154,8.50%
Walla Walla,1/1/08,53071,1,2008,28809,26858,1,1951,6.80%
Whatcom,1/1/08,53073,1,2008,109326,103358,1,5968,5.50%
Whitman,1/1/08,53075,1,2008,21282,20325,1,957,4.50%
Yakima,1/1/08,53077,1,2008,117846,106498,1,11348,9.60%
Adams,1/1/09,53001,1,2009,7782,6912,1,870,11.20%
Asotin,1/1/09,53003,1,2009,10374,9307,1,1067,10.30%
Clallam,1/1/09,53009,1,2009,30309,27295,1,3014,9.90%
Columbia,1/1/09,53013,1,2009,1591,1408,1,183,11.50%
Cowlitz,1/1/09,53015,1,2009,45577,40002,1,5575,12.20%
Douglas,1/1/09,53017,1,2009,20593,18778,1,1815,8.80%
Ferry,1/1/09,53019,1,2009,3034,2644,1,390,12.90%
Franklin,1/1/09,53021,1,2009,35603,32142,1,3461,9.70%
Garfield,1/1/09,53023,1,2009,971,897,1,74,7.60%
Grant,1/1/09,53025,1,2009,39099,34638,1,4461,11.40%
Grays Harbor,1/1/09,53027,1,2009,31925,27938,1,3987,12.50%
Island,1/1/09,53029,1,2009,32955,30430,1,2525,7.70%
Jefferson,1/1/09,53031,1,2009,13093,11908,1,1185,9.10%
King,1/1/09,53033,1,2009,1090479,1026488,1,63991,5.90%
Kitsap,1/1/09,53035,1,2009,127099,118541,1,8558,6.70%
Kittitas,1/1/09,53037,1,2009,20909,18970,1,1939,9.30%
Klickitat,1/1/09,53039,1,2009,10003,8820,1,1183,11.80%
Lewis,1/1/09,53041,1,2009,31765,27911,1,3854,12.10%
Lincoln,1/1/09,53043,1,2009,4731,4328,1,403,8.50%
Mason,1/1/09,53045,1,2009,25400,22650,1,2750,10.80%
Okanogan,1/1/09,53047,1,2009,19855,17687,1,2168,10.90%
Pacific,1/1/09,53049,1,2009,9160,8085,1,1075,11.70%
Pend Oreille,1/1/09,53051,1,2009,5794,5006,1,788,13.60%
Pierce,1/1/09,53053,1,2009,402961,369805,1,33156,8.20%
San Juan,1/1/09,53055,1,2009,7907,7293,1,614,7.80%
Skagit,1/1/09,53057,1,2009,58490,53257,1,5233,8.90%
Skamania,1/1/09,53059,1,2009,5312,4583,1,729,13.70%
Snohomish,1/1/09,53061,1,2009,374364,346625,1,27739,7.40%
Spokane,1/1/09,53063,1,2009,244770,223331,1,21439,8.80%
Stevens,1/1/09,53065,1,2009,19159,16659,1,2500,13.00%
Thurston,1/1/09,53067,1,2009,133996,124501,1,9495,7.10%
Wahkiakum,1/1/09,53069,1,2009,1691,1472,1,219,13.00%
Walla Walla,1/1/09,53071,1,2009,30037,27801,1,2236,7.40%
Whatcom,1/1/09,53073,1,2009,108578,100479,1,8099,7.50%
Whitman,1/1/09,53075,1,2009,21995,20974,1,1021,4.60%
Yakima,1/1/09,53077,1,2009,120138,108245,1,11893,9.90%
Adams,1/1/10,53001,1,2010,7968,6763,1,1205,15.10%
Asotin,1/1/10,53003,1,2010,10638,9371,1,1267,11.90%
Clallam,1/1/10,53009,1,2010,29865,25958,1,3907,13.10%
Columbia,1/1/10,53013,1,2010,1939,1722,1,217,11.20%
Cowlitz,1/1/10,53015,1,2010,47314,40199,1,7115,15.00%
Douglas,1/1/10,53017,1,2010,18969,16534,1,2435,12.80%
Ferry,1/1/10,53019,1,2010,2662,2085,1,577,21.70%
Franklin,1/1/10,53021,1,2010,36566,32220,1,4346,11.90%
Garfield,1/1/10,53023,1,2010,1015,889,1,126,12.40%
Grant,1/1/10,53025,1,2010,40846,34666,1,6180,15.10%
Grays Harbor,1/1/10,53027,1,2010,31967,26756,1,5211,16.30%
Island,1/1/10,53029,1,2010,34308,30616,1,3692,10.80%
Jefferson,1/1/10,53031,1,2010,12886,11323,1,1563,12.10%
King,1/1/10,53033,1,2010,1100575,996078,1,104497,9.50%
Kitsap,1/1/10,53035,1,2010,123224,111544,1,11680,9.50%
Kittitas,1/1/10,53037,1,2010,21364,18840,1,2524,11.80%
Klickitat,1/1/10,53039,1,2010,10115,8466,1,1649,16.30%
Lewis,1/1/10,53041,1,2010,34555,29238,1,5317,15.40%
Lincoln,1/1/10,53043,1,2010,5159,4606,1,553,10.70%
Mason,1/1/10,53045,1,2010,25254,21756,1,3498,13.90%
Okanogan,1/1/10,53047,1,2010,19989,16905,1,3084,15.40%
Pacific,1/1/10,53049,1,2010,8857,7397,1,1460,16.50%
Pend Oreille,1/1/10,53051,1,2010,5356,4342,1,1014,18.90%
Pierce,1/1/10,53053,1,2010,403979,356609,1,47370,11.70%
San Juan,1/1/10,53055,1,2010,8011,7217,1,794,9.90%
Skagit,1/1/10,53057,1,2010,59403,51710,1,7693,13.00%
Skamania,1/1/10,53059,1,2010,5342,4511,1,831,15.60%
Snohomish,1/1/10,53061,1,2010,384893,341770,1,43123,11.20%
Spokane,1/1/10,53063,1,2010,243571,214472,1,29099,11.90%
Stevens,1/1/10,53065,1,2010,19628,16487,1,3141,16.00%
Thurston,1/1/10,53067,1,2010,129352,116356,1,12996,10.00%
Wahkiakum,1/1/10,53069,1,2010,1459,1195,1,264,18.10%
Walla Walla,1/1/10,53071,1,2010,29665,26768,1,2897,9.80%
Whatcom,1/1/10,53073,1,2010,105592,94102,1,11490,10.90%
Whitman,1/1/10,53075,1,2010,22707,21165,1,1542,6.80%
Yakima,1/1/10,53077,1,2010,118527,102678,1,15849,13.40%
Adams,1/1/11,53001,1,2011,7922,6551,1,1371,17.30%
Asotin,1/1/11,53003,1,2011,10194,9098,1,1096,10.80%
Clallam,1/1/11,53009,1,2011,29102,25478,1,3624,12.50%
Columbia,1/1/11,53013,1,2011,1842,1629,1,213,11.60%
Cowlitz,1/1/11,53015,1,2011,45737,39634,1,6103,13.30%
Douglas,1/1/11,53017,1,2011,18197,15989,1,2208,12.10%
Ferry,1/1/11,53019,1,2011,2619,2117,1,502,19.20%
Franklin,1/1/11,53021,1,2011,37642,33428,1,4214,11.20%
Garfield,1/1/11,53023,1,2011,992,889,1,103,10.40%
Grant,1/1/11,53025,1,2011,40449,34845,1,5604,13.90%
Grays Harbor,1/1/11,53027,1,2011,30272,25779,1,4493,14.80%
Island,1/1/11,53029,1,2011,33178,29906,1,3272,9.90%
Jefferson,1/1/11,53031,1,2011,12366,10938,1,1428,11.50%
King,1/1/11,53033,1,2011,1094623,999002,1,95621,8.70%
Kitsap,1/1/11,53035,1,2011,119794,108953,1,10841,9.00%
Kittitas,1/1/11,53037,1,2011,21076,18764,1,2312,11.00%
Klickitat,1/1/11,53039,1,2011,9693,8222,1,1471,15.20%
Lewis,1/1/11,53041,1,2011,33260,28456,1,4804,14.40%
Lincoln,1/1/11,53043,1,2011,5190,4659,1,531,10.20%
Mason,1/1/11,53045,1,2011,24293,21147,1,3146,13.00%
Okanogan,1/1/11,53047,1,2011,19618,16872,1,2746,14.00%
Pacific,1/1/11,53049,1,2011,8428,7131,1,1297,15.40%
Pend Oreille,1/1/11,53051,1,2011,5032,4204,1,828,16.50%
Pierce,1/1/11,53053,1,2011,393649,350623,1,43026,10.90%
San Juan,1/1/11,53055,1,2011,7693,6939,1,754,9.80%
Skagit,1/1/11,53057,1,2011,57650,50640,1,7010,12.20%
Skamania,1/1/11,53059,1,2011,5217,4464,1,753,14.40%
Snohomish,1/1/11,53061,1,2011,380271,339939,1,40332,10.60%
Spokane,1/1/11,53063,1,2011,236269,209866,1,26403,11.20%
Stevens,1/1/11,53065,1,2011,18751,16062,1,2689,14.30%
Thurston,1/1/11,53067,1,2011,126090,114042,1,12048,9.60%
Wahkiakum,1/1/11,53069,1,2011,1477,1205,1,272,18.40%
Walla Walla,1/1/11,53071,1,2011,29174,26356,1,2818,9.70%
Whatcom,1/1/11,53073,1,2011,104041,93292,1,10749,10.30%
Whitman,1/1/11,53075,1,2011,22871,21370,1,1501,6.60%
Yakima,1/1/11,53077,1,2011,115846,100590,1,15256,13.20%
Adams,1/1/12,53001,1,2012,7722,6689,1,1033,13.40%
Asotin,1/1/12,53003,1,2012,9897,9031,1,866,8.80%
Clallam,1/1/12,53009,1,2012,28768,25257,1,3511,12.20%
Columbia,1/1/12,53013,1,2012,1807,1629,1,178,9.90%
Cowlitz,1/1/12,53015,1,2012,45729,40303,1,5426,11.90%
Douglas,1/1/12,53017,1,2012,18259,16096,1,2163,11.80%
Ferry,1/1/12,53019,1,2012,2497,2006,1,491,19.70%
Franklin,1/1/12,53021,1,2012,38181,33523,1,4658,12.20%
Garfield,1/1/12,53023,1,2012,971,884,1,87,9.00%
Grant,1/1/12,53025,1,2012,41021,35391,1,5630,13.70%
Grays Harbor,1/1/12,53027,1,2012,29776,25315,1,4461,15.00%
Island,1/1/12,53029,1,2012,33248,30128,1,3120,9.40%
Jefferson,1/1/12,53031,1,2012,12177,10769,1,1408,11.60%
King,1/1/12,53033,1,2012,1101793,1021762,1,80031,7.30%
Kitsap,1/1/12,53035,1,2012,119006,108642,1,10364,8.70%
Kittitas,1/1/12,53037,1,2012,20955,18713,1,2242,10.70%
Klickitat,1/1/12,53039,1,2012,9403,8214,1,1189,12.60%
Lewis,1/1/12,53041,1,2012,32801,28280,1,4521,13.80%
Lincoln,1/1/12,53043,1,2012,5177,4718,1,459,8.90%
Mason,1/1/12,53045,1,2012,23954,20963,1,2991,12.50%
Okanogan,1/1/12,53047,1,2012,18880,16357,1,2523,13.40%
Pacific,1/1/12,53049,1,2012,8255,7120,1,1135,13.70%
Pend Oreille,1/1/12,53051,1,2012,4933,4203,1,730,14.80%
Pierce,1/1/12,53053,1,2012,393838,353278,1,40560,10.30%
San Juan,1/1/12,53055,1,2012,7712,7026,1,686,8.90%
Skagit,1/1/12,53057,1,2012,57206,50637,1,6569,11.50%
Skamania,1/1/12,53059,1,2012,5130,4518,1,612,11.90%
Snohomish,1/1/12,53061,1,2012,379154,346239,1,32915,8.70%
Spokane,1/1/12,53063,1,2012,234439,209908,1,24531,10.50%
Stevens,1/1/12,53065,1,2012,18537,16036,1,2501,13.50%
Thurston,1/1/12,53067,1,2012,125282,113513,1,11769,9.40%
Wahkiakum,1/1/12,53069,1,2012,1421,1224,1,197,13.90%
Walla Walla,1/1/12,53071,1,2012,28994,26390,1,2604,9.00%
Whatcom,1/1/12,53073,1,2012,103719,93987,1,9732,9.40%
Whitman,1/1/12,53075,1,2012,22761,21321,1,1440,6.30%
Yakima,1/1/12,53077,1,2012,116556,100742,1,15814,13.60%
Adams,1/1/13,53001,1,2013,7799,6769,1,1030,13.20%
Asotin,1/1/13,53003,1,2013,9888,9041,1,847,8.60%
Clallam,1/1/13,53009,1,2013,28045,24856,1,3189,11.40%
Clark,1/1/13,53011,1,2013,211531,190305,1,21226,10.00%
Columbia,1/1/13,53013,1,2013,1777,1593,1,184,10.40%
Cowlitz,1/1/13,53015,1,2013,44414,39188,1,5226,11.80%
Douglas,1/1/13,53017,1,2013,17999,15916,1,2083,11.60%
Ferry,1/1/13,53019,1,2013,2544,2118,1,426,16.70%
Franklin,1/1/13,53021,1,2013,37167,32458,1,4709,12.70%
Garfield,1/1/13,53023,1,2013,971,876,1,95,9.80%
Grant,1/1/13,53025,1,2013,41459,36249,1,5210,12.60%
Grays Harbor,1/1/13,53027,1,2013,28646,24650,1,3996,13.90%
Island,1/1/13,53029,1,2013,32555,29711,1,2844,8.70%
Jefferson,1/1/13,53031,1,2013,11883,10556,1,1327,11.20%
King,1/1/13,53033,1,2013,1122169,1059273,1,62896,5.60%
Kitsap,1/1/13,53035,1,2013,116309,106594,1,9715,8.40%
Kittitas,1/1/13,53037,1,2013,20397,18414,1,1983,9.70%
Klickitat,1/1/13,53039,1,2013,9542,8329,1,1213,12.70%
Lewis,1/1/13,53041,1,2013,31915,27856,1,4059,12.70%
Lincoln,1/1/13,53043,1,2013,5004,4543,1,461,9.20%
Mason,1/1/13,53045,1,2013,23788,21024,1,2764,11.60%
Okanogan,1/1/13,53047,1,2013,19363,16915,1,2448,12.60%
Pacific,1/1/13,53049,1,2013,8130,7041,1,1089,13.40%
Pend Oreille,1/1/13,53051,1,2013,4859,4119,1,740,15.20%
Pierce,1/1/13,53053,1,2013,390342,352527,1,37815,9.70%
San Juan,1/1/13,53055,1,2013,7458,6791,1,667,8.90%
Skagit,1/1/13,53057,1,2013,57221,51154,1,6067,10.60%
Skamania,1/1/13,53059,1,2013,5111,4470,1,641,12.50%
Snohomish,1/1/13,53061,1,2013,383698,358683,1,25015,6.50%
Spokane,1/1/13,53063,1,2013,231998,208331,1,23667,10.20%
Stevens,1/1/13,53065,1,2013,18242,15751,1,2491,13.70%
Thurston,1/1/13,53067,1,2013,125794,114688,1,11106,8.80%
Wahkiakum,1/1/13,53069,1,2013,1320,1123,1,197,14.90%
Walla Walla,1/1/13,53071,1,2013,28156,25600,1,2556,9.10%
Whatcom,1/1/13,53073,1,2013,103441,94105,1,9336,9.00%
Whitman,1/1/13,53075,1,2013,22498,21166,1,1332,5.90%
Yakima,1/1/13,53077,1,2013,115233,99565,1,15668,13.60%
Adams,1/1/14,53001,1,2014,7741,6897,1,844,10.90%
Asotin,1/1/14,53003,1,2014,9644,9018,1,626,6.50%
Clallam,1/1/14,53009,1,2014,26789,24122,1,2667,10.00%
Clark,1/1/14,53011,1,2014,209028,192404,1,16624,8.00%
Columbia,1/1/14,53013,1,2014,1682,1541,1,141,8.40%
Cowlitz,1/1/14,53015,1,2014,43219,39186,1,4033,9.30%
Douglas,1/1/14,53017,1,2014,17862,16119,1,1743,9.80%
Ferry,1/1/14,53019,1,2014,2478,2114,1,364,14.70%
Franklin,1/1/14,53021,1,2014,36252,32036,1,4216,11.60%
Garfield,1/1/14,53023,1,2014,921,839,1,82,8.90%
Grant,1/1/14,53025,1,2014,40986,36532,1,4454,10.90%
Grays Harbor,1/1/14,53027,1,2014,27272,24004,1,3268,12.00%
Island,1/1/14,53029,1,2014,31804,29439,1,2365,7.40%
Jefferson,1/1/14,53031,1,2014,11345,10282,1,1063,9.40%
King,1/1/14,53033,1,2014,1145870,1087868,1,58002,5.10%
Kitsap,1/1/14,53035,1,2014,113544,105758,1,7786,6.90%
Kittitas,1/1/14,53037,1,2014,19773,18099,1,1674,8.50%
Klickitat,1/1/14,53039,1,2014,9045,8093,1,952,10.50%
Lewis,1/1/14,53041,1,2014,30930,27706,1,3224,10.40%
Lincoln,1/1/14,53043,1,2014,4945,4587,1,358,7.20%
Mason,1/1/14,53045,1,2014,23244,20980,1,2264,9.70%
Okanogan,1/1/14,53047,1,2014,19009,17034,1,1975,10.40%
Pacific,1/1/14,53049,1,2014,7832,6922,1,910,11.60%
Pend Oreille,1/1/14,53051,1,2014,4656,4074,1,582,12.50%
Pierce,1/1/14,53053,1,2014,385346,354454,1,30892,8.00%
San Juan,1/1/14,53055,1,2014,7187,6679,1,508,7.10%
Skagit,1/1/14,53057,1,2014,55851,50926,1,4925,8.80%
Skamania,1/1/14,53059,1,2014,4987,4476,1,511,10.20%
Snohomish,1/1/14,53061,1,2014,391725,368952,1,22773,5.80%
Spokane,1/1/14,53063,1,2014,226502,207400,1,19102,8.40%
Stevens,1/1/14,53065,1,2014,17580,15540,1,2040,11.60%
Thurston,1/1/14,53067,1,2014,123612,114456,1,9156,7.40%
Wahkiakum,1/1/14,53069,1,2014,1278,1126,1,152,11.90%
Walla Walla,1/1/14,53071,1,2014,27468,25326,1,2142,7.80%
Whatcom,1/1/14,53073,1,2014,101831,94142,1,7689,7.60%
Whitman,1/1/14,53075,1,2014,21905,20714,1,1191,5.40%
Yakima,1/1/14,53077,1,2014,112193,98741,1,13452,12.00%
Adams,1/1/15,53001,1,2015,7881,7010,1,871,11.10%
Asotin,1/1/15,53003,1,2015,9645,9107,1,538,5.60%
Clallam,1/1/15,53009,1,2015,26877,24265,1,2612,9.70%
Clark,1/1/15,53011,1,2015,214054,198322,1,15732,7.30%
Columbia,1/1/15,53013,1,2015,1681,1535,1,146,8.70%
Cowlitz,1/1/15,53015,1,2015,44449,40599,1,3850,8.70%
Douglas,1/1/15,53017,1,2015,18522,16878,1,1644,8.90%
Ferry,1/1/15,53019,1,2015,2370,2063,1,307,13.00%
Franklin,1/1/15,53021,1,2015,37052,32992,1,4060,11.00%
Garfield,1/1/15,53023,1,2015,919,840,1,79,8.60%
Grant,1/1/15,53025,1,2015,41799,37285,1,4514,10.80%
Grays Harbor,1/1/15,53027,1,2015,27066,24190,1,2876,10.60%
Island,1/1/15,53029,1,2015,32009,29674,1,2335,7.30%
Jefferson,1/1/15,53031,1,2015,11385,10395,1,990,8.70%
King,1/1/15,53033,1,2015,1169561,1116408,1,53153,4.50%
Kitsap,1/1/15,53035,1,2015,115232,107781,1,7451,6.50%
Kittitas,1/1/15,53037,1,2015,20647,19029,1,1618,7.80%
Klickitat,1/1/15,53039,1,2015,8971,8157,1,814,9.10%
Lewis,1/1/15,53041,1,2015,31198,28114,1,3084,9.90%
Lincoln,1/1/15,53043,1,2015,4810,4450,1,360,7.50%
Mason,1/1/15,53045,1,2015,23107,21035,1,2072,9.00%
Okanogan,1/1/15,53047,1,2015,19616,17667,1,1949,9.90%
Pacific,1/1/15,53049,1,2015,7998,7121,1,877,11.00%
Pend Oreille,1/1/15,53051,1,2015,4674,4117,1,557,11.90%
Pierce,1/1/15,53053,1,2015,392675,364110,1,28565,7.30%
San Juan,1/1/15,53055,1,2015,7316,6808,1,508,6.90%
Skagit,1/1/15,53057,1,2015,56291,51834,1,4457,7.90%
Skamania,1/1/15,53059,1,2015,4984,4525,1,459,9.20%
Snohomish,1/1/15,53061,1,2015,398288,378473,1,19815,5.00%
Spokane,1/1/15,53063,1,2015,229255,210735,1,18520,8.10%
Stevens,1/1/15,53065,1,2015,17631,15660,1,1971,11.20%
Thurston,1/1/15,53067,1,2015,126089,117407,1,8682,6.90%
Wahkiakum,1/1/15,53069,1,2015,1303,1177,1,126,9.70%
Walla Walla,1/1/15,53071,1,2015,27481,25362,1,2119,7.70%
Whatcom,1/1/15,53073,1,2015,104254,97067,1,7187,6.90%
Whitman,1/1/15,53075,1,2015,22660,21477,1,1183,5.20%
Yakima,1/1/15,53077,1,2015,116557,103504,1,13053,11.20%
Adams,1/1/16,53001,1,2016,7847,6995,1,852,10.90%
Asotin,1/1/16,53003,1,2016,9807,9220,1,587,6.00%
Clallam,1/1/16,53009,1,2016,27085,24596,1,2489,9.20%
Clark,1/1/16,53011,1,2016,219476,204866,1,14610,6.70%
Columbia,1/1/16,53013,1,2016,1688,1556,1,132,7.80%
Cowlitz,1/1/16,53015,1,2016,44504,40883,1,3621,8.10%
Douglas,1/1/16,53017,1,2016,19145,17335,1,1810,9.50%
Ferry,1/1/16,53019,1,2016,2433,2106,1,327,13.40%
Franklin,1/1/16,53021,1,2016,37574,33688,1,3886,10.30%
Garfield,1/1/16,53023,1,2016,885,814,1,71,8.00%
Grant,1/1/16,53025,1,2016,41613,37076,1,4537,10.90%
Grays Harbor,1/1/16,53027,1,2016,27059,24392,1,2667,9.90%
Island,1/1/16,53029,1,2016,32165,29976,1,2189,6.80%
Jefferson,1/1/16,53031,1,2016,11303,10386,1,917,8.10%
King,1/1/16,53033,1,2016,1193463,1142707,1,50756,4.30%
Kitsap,1/1/16,53035,1,2016,118120,111056,1,7064,6.00%
Kittitas,1/1/16,53037,1,2016,21206,19615,1,1591,7.50%
Klickitat,1/1/16,53039,1,2016,9113,8323,1,790,8.70%
Lewis,1/1/16,53041,1,2016,31510,28679,1,2831,9.00%
Lincoln,1/1/16,53043,1,2016,4730,4373,1,357,7.50%
Mason,1/1/16,53045,1,2016,23315,21315,1,2000,8.60%
Okanogan,1/1/16,53047,1,2016,19166,17265,1,1901,9.90%
Pacific,1/1/16,53049,1,2016,8251,7468,1,783,9.50%
Pend Oreille,1/1/16,53051,1,2016,4700,4184,1,516,11.00%
Pierce,1/1/16,53053,1,2016,400365,373241,1,27124,6.80%
San Juan,1/1/16,53055,1,2016,7215,6733,1,482,6.70%
Skagit,1/1/16,53057,1,2016,57049,52664,1,4385,7.70%
Skamania,1/1/16,53059,1,2016,5084,4653,1,431,8.50%
Snohomish,1/1/16,53061,1,2016,408325,389247,1,19078,4.70%
Spokane,1/1/16,53063,1,2016,235257,217835,1,17422,7.40%
Stevens,1/1/16,53065,1,2016,17973,16127,1,1846,10.30%
Thurston,1/1/16,53067,1,2016,128558,120391,1,8167,6.40%
Wahkiakum,1/1/16,53069,1,2016,1308,1166,1,142,10.90%
Walla Walla,1/1/16,53071,1,2016,27917,25951,1,1966,7.00%
Whatcom,1/1/16,53073,1,2016,106538,99451,1,7087,6.70%
Whitman,1/1/16,53075,1,2016,23164,21960,1,1204,5.20%
Yakima,1/1/16,53077,1,2016,117795,104974,1,12821,10.90%
Adams,1/1/17,53001,1,2017,7838,7011,1,827,10.60%
Asotin,1/1/17,53003,1,2017,10225,9681,1,544,5.30%
Clallam,1/1/17,53009,1,2017,27764,25489,1,2275,8.20%
Clark,1/1/17,53011,1,2017,226357,212739,1,13618,6.00%
Columbia,1/1/17,53013,1,2017,1729,1582,1,147,8.50%
Cowlitz,1/1/17,53015,1,2017,45954,42627,1,3327,7.20%
Douglas,1/1/17,53017,1,2017,19578,17920,1,1658,8.50%
Ferry,1/1/17,53019,1,2017,2490,2183,1,307,12.30%
Franklin,1/1/17,53021,1,2017,38047,34191,1,3856,10.10%
Garfield,1/1/17,53023,1,2017,852,793,1,59,6.90%
Grant,1/1/17,53025,1,2017,41465,37265,1,4200,10.10%
Grays Harbor,1/1/17,53027,1,2017,27800,25412,1,2388,8.60%
Island,1/1/17,53029,1,2017,33662,31645,1,2017,6.00%
Jefferson,1/1/17,53031,1,2017,11724,10880,1,844,7.20%
King,1/1/17,53033,1,2017,1221334,1175648,1,45686,3.70%
Kitsap,1/1/17,53035,1,2017,120245,113567,1,6678,5.60%
Kittitas,1/1/17,53037,1,2017,22099,20560,1,1539,7.00%
Klickitat,1/1/17,53039,1,2017,9227,8469,1,758,8.20%
Lewis,1/1/17,53041,1,2017,33024,30409,1,2615,7.90%
Lincoln,1/1/17,53043,1,2017,4737,4412,1,325,6.90%
Mason,1/1/17,53045,1,2017,23747,21827,1,1920,8.10%
Okanogan,1/1/17,53047,1,2017,19223,17460,1,1763,9.20%
Pacific,1/1/17,53049,1,2017,8394,7739,1,655,7.80%
Pend Oreille,1/1/17,53051,1,2017,4751,4307,1,444,9.30%
Pierce,1/1/17,53053,1,2017,416031,390900,1,25131,6.00%
San Juan,1/1/17,53055,1,2017,7490,7044,1,446,6.00%
Skagit,1/1/17,53057,1,2017,58804,54808,1,3996,6.80%
Skamania,1/1/17,53059,1,2017,5309,4868,1,441,8.30%
Snohomish,1/1/17,53061,1,2017,418040,400514,1,17526,4.20%
Spokane,1/1/17,53063,1,2017,239615,223803,1,15812,6.60%
Stevens,1/1/17,53065,1,2017,18112,16439,1,1673,9.20%
Thurston,1/1/17,53067,1,2017,134018,126358,1,7660,5.70%
Wahkiakum,1/1/17,53069,1,2017,1298,1184,1,114,8.80%
Walla Walla,1/1/17,53071,1,2017,27146,25222,1,1924,7.10%
Whatcom,1/1/17,53073,1,2017,109506,102975,1,6531,6.00%
Whitman,1/1/17,53075,1,2017,23696,22485,1,1211,5.10%
Yakima,1/1/17,53077,1,2017,116481,103567,1,12914,11.10%
Adams,1/1/18,53001,1,2018,8309,7481,1,828,10.00%
Asotin,1/1/18,53003,1,2018,10213,9666,1,547,5.40%
Clallam,1/1/18,53009,1,2018,27763,25526,1,2237,8.10%
Clark,1/1/18,53011,1,2018,230482,217855,1,12627,5.50%
Columbia,1/1/18,53013,1,2018,1689,1572,1,117,6.90%
Cowlitz,1/1/18,53015,1,2018,45981,42748,1,3233,7.00%
Douglas,1/1/18,53017,1,2018,20397,18846,1,1551,7.60%
Ferry,1/1/18,53019,1,2018,2510,2107,1,403,16.10%
Franklin,1/1/18,53021,1,2018,39442,35966,1,3476,8.80%
Garfield,1/1/18,53023,1,2018,861,794,1,67,7.80%
Grant,1/1/18,53025,1,2018,42921,38879,1,4042,9.40%
Grays Harbor,1/1/18,53027,1,2018,27912,25618,1,2294,8.20%
Island,1/1/18,53029,1,2018,34333,32249,1,2084,6.10%
Jefferson,1/1/18,53031,1,2018,12012,11149,1,863,7.20%
King,1/1/18,53033,1,2018,1252730,1207510,1,45220,3.60%
Kitsap,1/1/18,53035,1,2018,122115,115436,1,6679,5.50%
Kittitas,1/1/18,53037,1,2018,21569,20067,1,1502,7.00%
Klickitat,1/1/18,53039,1,2018,9492,8792,1,700,7.40%
Lewis,1/1/18,53041,1,2018,33695,31177,1,2518,7.50%
Lincoln,1/1/18,53043,1,2018,4822,4518,1,304,6.30%
Mason,1/1/18,53045,1,2018,24092,22297,1,1795,7.50%
Okanogan,1/1/18,53047,1,2018,18846,17056,1,1790,9.50%
Pacific,1/1/18,53049,1,2018,8198,7485,1,713,8.70%
Pend Oreille,1/1/18,53051,1,2018,4842,4392,1,450,9.30%
Pierce,1/1/18,53053,1,2018,421894,396579,1,25315,6.00%
San Juan,1/1/18,53055,1,2018,7613,7194,1,419,5.50%
Skagit,1/1/18,53057,1,2018,58957,55262,1,3695,6.30%
Skamania,1/1/18,53059,1,2018,5329,4949,1,380,7.10%
Snohomish,1/1/18,53061,1,2018,427050,409808,1,17242,4.00%
Spokane,1/1/18,53063,1,2018,243483,227638,1,15845,6.50%
Stevens,1/1/18,53065,1,2018,18301,16609,1,1692,9.20%
Thurston,1/1/18,53067,1,2018,136675,128980,1,7695,5.60%
Wahkiakum,1/1/18,53069,1,2018,1318,1215,1,103,7.80%
Walla Walla,1/1/18,53071,1,2018,27612,25822,1,1790,6.50%
Whatcom,1/1/18,53073,1,2018,110658,104363,1,6295,5.70%
Whitman,1/1/18,53075,1,2018,23641,22495,1,1146,4.80%
Yakima,1/1/18,53077,1,2018,121479,110246,1,11233,9.20%
Adams,1/1/19,53001,1,2019,8454,7636,1,818,9.70%
Asotin,1/1/19,53003,1,2019,10299,9733,1,566,5.50%
Clallam,1/1/19,53009,1,2019,28610,26220,1,2390,8.40%
Clark,1/1/19,53011,1,2019,240815,227477,1,13338,5.50%
Columbia,1/1/19,53013,1,2019,1797,1661,1,136,7.60%
Cowlitz,1/1/19,53015,1,2019,48008,44614,1,3394,7.10%
Douglas,1/1/19,53017,1,2019,20745,19044,1,1701,8.20%
Ferry,1/1/19,53019,1,2019,2578,2181,1,397,15.40%
Franklin,1/1/19,53021,1,2019,40780,37071,1,3709,9.10%
Garfield,1/1/19,53023,1,2019,888,816,1,72,8.10%
Grant,1/1/19,53025,1,2019,44597,40086,1,4511,10.10%
Grays Harbor,1/1/19,53027,1,2019,28833,26382,1,2451,8.50%
Island,1/1/19,53029,1,2019,35430,33255,1,2175,6.10%
Jefferson,1/1/19,53031,1,2019,12618,11757,1,861,6.80%
King,1/1/19,53033,1,2019,1277413,1234136,1,43277,3.40%
Kitsap,1/1/19,53035,1,2019,127679,120656,1,7023,5.50%
Kittitas,1/1/19,53037,1,2019,22512,20870,1,1642,7.30%
Klickitat,1/1/19,53039,1,2019,9757,8978,1,779,8.00%
Lewis,1/1/19,53041,1,2019,34739,32073,1,2666,7.70%
Lincoln,1/1/19,53043,1,2019,4865,4530,1,335,6.90%
Mason,1/1/19,53045,1,2019,24951,23042,1,1909,7.70%
Okanogan,1/1/19,53047,1,2019,19025,17034,1,1991,10.50%
Pacific,1/1/19,53049,1,2019,8526,7789,1,737,8.60%
Pend Oreille,1/1/19,53051,1,2019,5064,4559,1,505,10.00%
Pierce,1/1/19,53053,1,2019,438772,412163,1,26609,6.10%
San Juan,1/1/19,53055,1,2019,7903,7477,1,426,5.40%
Skagit,1/1/19,53057,1,2019,61932,57902,1,4030,6.50%
Skamania,1/1/19,53059,1,2019,5567,5177,1,390,7.00%
Snohomish,1/1/19,53061,1,2019,434773,418843,1,15930,3.70%
Spokane,1/1/19,53063,1,2019,253648,236406,1,17242,6.80%
Stevens,1/1/19,53065,1,2019,19100,17224,1,1876,9.80%
Thurston,1/1/19,53067,1,2019,141588,133440,1,8148,5.80%
Wahkiakum,1/1/19,53069,1,2019,1370,1255,1,115,8.40%
Walla Walla,1/1/19,53071,1,2019,29091,27192,1,1899,6.50%
Whatcom,1/1/19,53073,1,2019,114759,108154,1,6605,5.80%
Whitman,1/1/19,53075,1,2019,24405,23198,1,1207,4.90%
Yakima,1/1/19,53077,1,2019,125892,113066,1,12826,10.20%
Adams,1/1/20,53001,1,2020,8521,7860,1,661,7.80%
Asotin,1/1/20,53003,1,2020,10636,10187,1,449,4.20%
Clallam,1/1/20,53009,1,2020,29854,27637,1,2217,7.40%
Clark,1/1/20,53011,1,2020,247962,236675,1,11287,4.60%
Columbia,1/1/20,53013,1,2020,1757,1643,1,114,6.50%
Cowlitz,1/1/20,53015,1,2020,48962,46069,1,2893,5.90%
Douglas,1/1/20,53017,1,2020,20982,19514,1,1468,7.00%
Ferry,1/1/20,53019,1,2020,2472,2173,1,299,12.10%
Franklin,1/1/20,53021,1,2020,42102,38934,1,3168,7.50%
Garfield,1/1/20,53023,1,2020,838,775,1,63,7.50%
Grant,1/1/20,53025,1,2020,44885,40834,1,4051,9.00%
Grays Harbor,1/1/20,53027,1,2020,29736,27483,1,2253,7.60%
Island,1/1/20,53029,1,2020,37251,35364,1,1887,5.10%
Jefferson,1/1/20,53031,1,2020,13500,12725,1,775,5.70%
King,1/1/20,53033,1,2020,1302826,1267790,1,35036,2.70%
Kitsap,1/1/20,53035,1,2020,132386,126528,1,5858,4.40%
Kittitas,1/1/20,53037,1,2020,24354,22924,1,1430,5.90%
Klickitat,1/1/20,53039,1,2020,9774,9125,1,649,6.60%
Lewis,1/1/20,53041,1,2020,35516,33159,1,2357,6.60%
Lincoln,1/1/20,53043,1,2020,4729,4447,1,282,6.00%
Mason,1/1/20,53045,1,2020,26592,24905,1,1687,6.30%
Okanogan,1/1/20,53047,1,2020,18778,17048,1,1730,9.20%
Pacific,1/1/20,53049,1,2020,8587,8009,1,578,6.70%
Pend Oreille,1/1/20,53051,1,2020,5178,4702,1,476,9.20%
Pierce,1/1/20,53053,1,2020,454960,431793,1,23167,5.10%
San Juan,1/1/20,53055,1,2020,8886,8480,1,406,4.60%
Skagit,1/1/20,53057,1,2020,63887,59954,1,3933,6.20%
Skamania,1/1/20,53059,1,2020,5668,5335,1,333,5.90%
Snohomish,1/1/20,53061,1,2020,443958,430141,1,13817,3.10%
Spokane,1/1/20,53063,1,2020,261965,247355,1,14610,5.60%
Stevens,1/1/20,53065,1,2020,19266,17678,1,1588,8.20%
Thurston,1/1/20,53067,1,2020,147321,140249,1,7072,4.80%
Wahkiakum,1/1/20,53069,1,2020,1383,1287,1,96,6.90%
Walla Walla,1/1/20,53071,1,2020,29704,28130,1,1574,5.30%
Whatcom,1/1/20,53073,1,2020,118389,111841,1,6548,5.50%
Whitman,1/1/20,53075,1,2020,24258,23303,1,955,3.90%
Yakima,1/1/20,53077,1,2020,128105,117324,1,10781,8.40%
Adams,2/1/90,53001,2,1990,6603,5785,1,818,12.40%
Asotin,2/1/90,53003,2,1990,9481,8860,1,621,6.50%
Clallam,2/1/90,53009,2,1990,23642,21098,1,2544,10.80%
Columbia,2/1/90,53013,2,1990,1469,1207,1,262,17.80%
Cowlitz,2/1/90,53015,2,1990,39153,35498,1,3655,9.30%
Douglas,2/1/90,53017,2,1990,14755,13260,1,1495,10.10%
Ferry,2/1/90,53019,2,1990,2883,2429,1,454,15.70%
Franklin,2/1/90,53021,2,1990,18634,16090,1,2544,13.70%
Garfield,2/1/90,53023,2,1990,1081,1015,1,66,6.10%
Grant,2/1/90,53025,2,1990,25148,21946,1,3202,12.70%
Grays Harbor,2/1/90,53027,2,1990,28610,24739,1,3871,13.50%
Island,2/1/90,53029,2,1990,23599,22555,1,1044,4.40%
Jefferson,2/1/90,53031,2,1990,8269,7683,1,586,7.10%
King,2/1/90,53033,2,1990,851678,814957,1,36721,4.30%
Kitsap,2/1/90,53035,2,1990,86345,82658,1,3687,4.30%
Kittitas,2/1/90,53037,2,1990,13517,12285,1,1232,9.10%
Klickitat,2/1/90,53039,2,1990,7816,6410,1,1406,18.00%
Lewis,2/1/90,53041,2,1990,27428,23529,1,3899,14.20%
Lincoln,2/1/90,53043,2,1990,4071,3849,1,222,5.50%
Mason,2/1/90,53045,2,1990,15573,14330,1,1243,8.00%
Okanogan,2/1/90,53047,2,1990,17426,15197,1,2229,12.80%
Pacific,2/1/90,53049,2,1990,7641,6645,1,996,13.00%
Pend Oreille,2/1/90,53051,2,1990,3650,3008,1,642,17.60%
Pierce,2/1/90,53053,2,1990,280696,265928,1,14768,5.30%
San Juan,2/1/90,53055,2,1990,4417,4170,1,247,5.60%
Skagit,2/1/90,53057,2,1990,38620,34940,1,3680,9.50%
Skamania,2/1/90,53059,2,1990,4081,3359,1,722,17.70%
Snohomish,2/1/90,53061,2,1990,249727,236192,1,13535,5.40%
Spokane,2/1/90,53063,2,1990,175910,163654,1,12256,7.00%
Stevens,2/1/90,53065,2,1990,13455,12135,1,1320,9.80%
Thurston,2/1/90,53067,2,1990,83551,78476,1,5075,6.10%
Wahkiakum,2/1/90,53069,2,1990,1655,1426,1,229,13.80%
Walla Walla,2/1/90,53071,2,1990,24254,21706,1,2548,10.50%
Whatcom,2/1/90,53073,2,1990,67008,62525,1,4483,6.70%
Whitman,2/1/90,53075,2,1990,18375,18056,1,319,1.70%
Yakima,2/1/90,53077,2,1990,95854,81036,1,14818,15.50%
Adams,2/1/91,53001,2,1991,7496,6157,1,1339,17.90%
Asotin,2/1/91,53003,2,1991,9527,8650,1,877,9.20%
Clallam,2/1/91,53009,2,1991,23002,20683,1,2319,10.10%
Columbia,2/1/91,53013,2,1991,1248,991,1,257,20.60%
Cowlitz,2/1/91,53015,2,1991,39667,36357,1,3310,8.30%
Douglas,2/1/91,53017,2,1991,15217,13583,1,1634,10.70%
Ferry,2/1/91,53019,2,1991,2877,2350,1,527,18.30%
Franklin,2/1/91,53021,2,1991,19596,16330,1,3266,16.70%
Garfield,2/1/91,53023,2,1991,979,929,1,50,5.10%
Grant,2/1/91,53025,2,1991,27146,23266,1,3880,14.30%
Grays Harbor,2/1/91,53027,2,1991,27742,23912,1,3830,13.80%
Island,2/1/91,53029,2,1991,23094,21967,1,1127,4.90%
Jefferson,2/1/91,53031,2,1991,8150,7440,1,710,8.70%
King,2/1/91,53033,2,1991,846265,808734,1,37531,4.40%
Kitsap,2/1/91,53035,2,1991,86744,81953,1,4791,5.50%
Kittitas,2/1/91,53037,2,1991,13379,11886,1,1493,11.20%
Klickitat,2/1/91,53039,2,1991,7834,6259,1,1575,20.10%
Lewis,2/1/91,53041,2,1991,26516,23230,1,3286,12.40%
Lincoln,2/1/91,53043,2,1991,4024,3755,1,269,6.70%
Mason,2/1/91,53045,2,1991,15603,14151,1,1452,9.30%
Okanogan,2/1/91,53047,2,1991,18155,15163,1,2992,16.50%
Pacific,2/1/91,53049,2,1991,7656,6787,1,869,11.40%
Pend Oreille,2/1/91,53051,2,1991,3401,2709,1,692,20.30%
Pierce,2/1/91,53053,2,1991,280264,260538,1,19726,7.00%
San Juan,2/1/91,53055,2,1991,4711,4460,1,251,5.30%
Skagit,2/1/91,53057,2,1991,39372,34979,1,4393,11.20%
Skamania,2/1/91,53059,2,1991,3980,3283,1,697,17.50%
Snohomish,2/1/91,53061,2,1991,252016,238165,1,13851,5.50%
Spokane,2/1/91,53063,2,1991,178199,163793,1,14406,8.10%
Stevens,2/1/91,53065,2,1991,14102,12121,1,1981,14.00%
Thurston,2/1/91,53067,2,1991,83654,78210,1,5444,6.50%
Wahkiakum,2/1/91,53069,2,1991,1455,1358,1,97,6.70%
Walla Walla,2/1/91,53071,2,1991,23670,20735,1,2935,12.40%
Whatcom,2/1/91,53073,2,1991,69612,63763,1,5849,8.40%
Whitman,2/1/91,53075,2,1991,18257,17826,1,431,2.40%
Yakima,2/1/91,53077,2,1991,98760,82344,1,16416,16.60%
Adams,2/1/92,53001,2,1992,7423,5955,1,1468,19.80%
Asotin,2/1/92,53003,2,1992,9804,9104,1,700,7.10%
Clallam,2/1/92,53009,2,1992,22998,20332,1,2666,11.60%
Columbia,2/1/92,53013,2,1992,1312,1001,1,311,23.70%
Cowlitz,2/1/92,53015,2,1992,38607,33819,1,4788,12.40%
Douglas,2/1/92,53017,2,1992,15252,13678,1,1574,10.30%
Ferry,2/1/92,53019,2,1992,2900,2286,1,614,21.20%
Franklin,2/1/92,53021,2,1992,19766,16743,1,3023,15.30%
Garfield,2/1/92,53023,2,1992,995,944,1,51,5.10%
Grant,2/1/92,53025,2,1992,27874,23699,1,4175,15.00%
Grays Harbor,2/1/92,53027,2,1992,27981,24110,1,3871,13.80%
Island,2/1/92,53029,2,1992,24182,22639,1,1543,6.40%
Jefferson,2/1/92,53031,2,1992,8239,7283,1,956,11.60%
King,2/1/92,53033,2,1992,875953,825534,1,50419,5.80%
Kitsap,2/1/92,53035,2,1992,88123,82276,1,5847,6.60%
Kittitas,2/1/92,53037,2,1992,13998,12114,1,1884,13.50%
Klickitat,2/1/92,53039,2,1992,7916,6422,1,1494,18.90%
Lewis,2/1/92,53041,2,1992,27441,23586,1,3855,14.00%
Lincoln,2/1/92,53043,2,1992,4107,3765,1,342,8.30%
Mason,2/1/92,53045,2,1992,15508,13911,1,1597,10.30%
Okanogan,2/1/92,53047,2,1992,18706,15766,1,2940,15.70%
Pacific,2/1/92,53049,2,1992,7482,6390,1,1092,14.60%
Pend Oreille,2/1/92,53051,2,1992,3704,2969,1,735,19.80%
Pierce,2/1/92,53053,2,1992,286742,263318,1,23424,8.20%
San Juan,2/1/92,53055,2,1992,4778,4331,1,447,9.40%
Skagit,2/1/92,53057,2,1992,40958,35689,1,5269,12.90%
Skamania,2/1/92,53059,2,1992,3962,3041,1,921,23.20%
Snohomish,2/1/92,53061,2,1992,264766,247215,1,17551,6.60%
Spokane,2/1/92,53063,2,1992,180133,164517,1,15616,8.70%
Stevens,2/1/92,53065,2,1992,14831,12531,1,2300,15.50%
Thurston,2/1/92,53067,2,1992,86699,80294,1,6405,7.40%
Wahkiakum,2/1/92,53069,2,1992,1568,1441,1,127,8.10%
Walla Walla,2/1/92,53071,2,1992,24217,21207,1,3010,12.40%
Whatcom,2/1/92,53073,2,1992,72806,65926,1,6880,9.40%
Whitman,2/1/92,53075,2,1992,17841,17312,1,529,3.00%
Yakima,2/1/92,53077,2,1992,100788,83588,1,17200,17.10%
Adams,2/1/93,53001,2,1993,7858,5966,1,1892,24.10%
Asotin,2/1/93,53003,2,1993,10027,9263,1,764,7.60%
Clallam,2/1/93,53009,2,1993,23236,20465,1,2771,11.90%
Columbia,2/1/93,53013,2,1993,1331,1039,1,292,21.90%
Cowlitz,2/1/93,53015,2,1993,38750,33769,1,4981,12.90%
Douglas,2/1/93,53017,2,1993,15847,14081,1,1766,11.10%
Ferry,2/1/93,53019,2,1993,2779,2244,1,535,19.30%
Franklin,2/1/93,53021,2,1993,21146,17791,1,3355,15.90%
Garfield,2/1/93,53023,2,1993,1039,932,1,107,10.30%
Grant,2/1/93,53025,2,1993,28912,24359,1,4553,15.70%
Grays Harbor,2/1/93,53027,2,1993,28561,23685,1,4876,17.10%
Island,2/1/93,53029,2,1993,24334,22762,1,1572,6.50%
Jefferson,2/1/93,53031,2,1993,9013,8080,1,933,10.40%
King,2/1/93,53033,2,1993,890838,834383,1,56455,6.30%
Kitsap,2/1/93,53035,2,1993,90953,84465,1,6488,7.10%
Kittitas,2/1/93,53037,2,1993,14457,12461,1,1996,13.80%
Klickitat,2/1/93,53039,2,1993,8096,6305,1,1791,22.10%
Lewis,2/1/93,53041,2,1993,27401,23647,1,3754,13.70%
Lincoln,2/1/93,53043,2,1993,4212,3866,1,346,8.20%
Mason,2/1/93,53045,2,1993,16022,14221,1,1801,11.20%
Okanogan,2/1/93,53047,2,1993,19735,16326,1,3409,17.30%
Pacific,2/1/93,53049,2,1993,7830,6686,1,1144,14.60%
Pend Oreille,2/1/93,53051,2,1993,3796,3083,1,713,18.80%
Pierce,2/1/93,53053,2,1993,296358,271523,1,24835,8.40%
San Juan,2/1/93,53055,2,1993,4860,4230,1,630,13.00%
Skagit,2/1/93,53057,2,1993,42394,36365,1,6029,14.20%
Skamania,2/1/93,53059,2,1993,3934,3044,1,890,22.60%
Snohomish,2/1/93,53061,2,1993,273828,253627,1,20201,7.40%
Spokane,2/1/93,53063,2,1993,183797,168413,1,15384,8.40%
Stevens,2/1/93,53065,2,1993,15390,13275,1,2115,13.70%
Thurston,2/1/93,53067,2,1993,88417,81711,1,6706,7.60%
Wahkiakum,2/1/93,53069,2,1993,1575,1438,1,137,8.70%
Walla Walla,2/1/93,53071,2,1993,24262,21666,1,2596,10.70%
Whatcom,2/1/93,53073,2,1993,74584,67163,1,7421,9.90%
Whitman,2/1/93,53075,2,1993,18125,17587,1,538,3.00%
Yakima,2/1/93,53077,2,1993,104915,84637,1,20278,19.30%
Adams,2/1/94,53001,2,1994,7490,6162,1,1328,17.70%
Asotin,2/1/94,53003,2,1994,11036,10411,1,625,5.70%
Clallam,2/1/94,53009,2,1994,23270,20277,1,2993,12.90%
Columbia,2/1/94,53013,2,1994,1342,1063,1,279,20.80%
Cowlitz,2/1/94,53015,2,1994,39627,35012,1,4615,11.60%
Douglas,2/1/94,53017,2,1994,16676,14999,1,1677,10.10%
Ferry,2/1/94,53019,2,1994,2896,2359,1,537,18.50%
Franklin,2/1/94,53021,2,1994,22123,19213,1,2910,13.20%
Garfield,2/1/94,53023,2,1994,1029,936,1,93,9.00%
Grant,2/1/94,53025,2,1994,30818,26064,1,4754,15.40%
Grays Harbor,2/1/94,53027,2,1994,27952,23431,1,4521,16.20%
Island,2/1/94,53029,2,1994,25457,23597,1,1860,7.30%
Jefferson,2/1/94,53031,2,1994,9130,8004,1,1126,12.30%
King,2/1/94,53033,2,1994,894285,844037,1,50248,5.60%
Kitsap,2/1/94,53035,2,1994,91207,84173,1,7034,7.70%
Kittitas,2/1/94,53037,2,1994,14991,13141,1,1850,12.30%
Klickitat,2/1/94,53039,2,1994,8042,6707,1,1335,16.60%
Lewis,2/1/94,53041,2,1994,28540,25256,1,3284,11.50%
Lincoln,2/1/94,53043,2,1994,4327,3960,1,367,8.50%
Mason,2/1/94,53045,2,1994,16941,15125,1,1816,10.70%
Okanogan,2/1/94,53047,2,1994,20368,17455,1,2913,14.30%
Pacific,2/1/94,53049,2,1994,7893,6935,1,958,12.10%
Pend Oreille,2/1/94,53051,2,1994,3892,3258,1,634,16.30%
Pierce,2/1/94,53053,2,1994,309227,283127,1,26100,8.40%
San Juan,2/1/94,53055,2,1994,4879,4309,1,570,11.70%
Skagit,2/1/94,53057,2,1994,46331,40477,1,5854,12.60%
Skamania,2/1/94,53059,2,1994,3913,3235,1,678,17.30%
Snohomish,2/1/94,53061,2,1994,279405,260377,1,19028,6.80%
Spokane,2/1/94,53063,2,1994,194178,180101,1,14077,7.20%
Stevens,2/1/94,53065,2,1994,16452,14320,1,2132,13.00%
Thurston,2/1/94,53067,2,1994,92170,84982,1,7188,7.80%
Wahkiakum,2/1/94,53069,2,1994,1681,1542,1,139,8.30%
Walla Walla,2/1/94,53071,2,1994,25371,22932,1,2439,9.60%
Whatcom,2/1/94,53073,2,1994,74310,67321,1,6989,9.40%
Whitman,2/1/94,53075,2,1994,18503,17974,1,529,2.90%
Yakima,2/1/94,53077,2,1994,107799,88476,1,19323,17.90%
Adams,2/1/95,53001,2,1995,8418,6877,1,1541,18.30%
Asotin,2/1/95,53003,2,1995,11712,11050,1,662,5.70%
Clallam,2/1/95,53009,2,1995,24508,21672,1,2836,11.60%
Columbia,2/1/95,53013,2,1995,1404,1078,1,326,23.20%
Cowlitz,2/1/95,53015,2,1995,41354,37654,1,3700,8.90%
Douglas,2/1/95,53017,2,1995,17176,15431,1,1745,10.20%
Ferry,2/1/95,53019,2,1995,3090,2447,1,643,20.80%
Franklin,2/1/95,53021,2,1995,23213,20231,1,2982,12.80%
Garfield,2/1/95,53023,2,1995,1045,941,1,104,10.00%
Grant,2/1/95,53025,2,1995,32001,27443,1,4558,14.20%
Grays Harbor,2/1/95,53027,2,1995,28754,24870,1,3884,13.50%
Island,2/1/95,53029,2,1995,26109,24737,1,1372,5.30%
Jefferson,2/1/95,53031,2,1995,9918,8951,1,967,9.70%
King,2/1/95,53033,2,1995,889248,847037,1,42211,4.70%
Kitsap,2/1/95,53035,2,1995,92512,85501,1,7011,7.60%
Kittitas,2/1/95,53037,2,1995,16588,14827,1,1761,10.60%
Klickitat,2/1/95,53039,2,1995,8586,7196,1,1390,16.20%
Lewis,2/1/95,53041,2,1995,30291,26949,1,3342,11.00%
Lincoln,2/1/95,53043,2,1995,4550,4154,1,396,8.70%
Mason,2/1/95,53045,2,1995,18281,16332,1,1949,10.70%
Okanogan,2/1/95,53047,2,1995,21267,18170,1,3097,14.60%
Pacific,2/1/95,53049,2,1995,8352,7277,1,1075,12.90%
Pend Oreille,2/1/95,53051,2,1995,4109,3409,1,700,17.00%
Pierce,2/1/95,53053,2,1995,322065,298880,1,23185,7.20%
San Juan,2/1/95,53055,2,1995,5028,4480,1,548,10.90%
Skagit,2/1/95,53057,2,1995,47749,42063,1,5686,11.90%
Skamania,2/1/95,53059,2,1995,4075,3498,1,577,14.20%
Snohomish,2/1/95,53061,2,1995,278831,263552,1,15279,5.50%
Spokane,2/1/95,53063,2,1995,203164,188699,1,14465,7.10%
Stevens,2/1/95,53065,2,1995,16904,14673,1,2231,13.20%
Thurston,2/1/95,53067,2,1995,96894,89904,1,6990,7.20%
Wahkiakum,2/1/95,53069,2,1995,1725,1582,1,143,8.30%
Walla Walla,2/1/95,53071,2,1995,26165,23709,1,2456,9.40%
Whatcom,2/1/95,53073,2,1995,78680,71415,1,7265,9.20%
Whitman,2/1/95,53075,2,1995,18881,18360,1,521,2.80%
Yakima,2/1/95,53077,2,1995,110461,91544,1,18917,17.10%
Adams,2/1/96,53001,2,1996,7829,6545,1,1284,16.40%
Asotin,2/1/96,53003,2,1996,11832,11156,1,676,5.70%
Clallam,2/1/96,53009,2,1996,24343,21693,1,2650,10.90%
Columbia,2/1/96,53013,2,1996,1378,1075,1,303,22.00%
Cowlitz,2/1/96,53015,2,1996,41852,37999,1,3853,9.20%
Douglas,2/1/96,53017,2,1996,17387,15686,1,1701,9.80%
Ferry,2/1/96,53019,2,1996,2931,2403,1,528,18.00%
Franklin,2/1/96,53021,2,1996,22891,19187,1,3704,16.20%
Garfield,2/1/96,53023,2,1996,1063,974,1,89,8.40%
Grant,2/1/96,53025,2,1996,32559,27840,1,4719,14.50%
Grays Harbor,2/1/96,53027,2,1996,27778,24446,1,3332,12.00%
Island,2/1/96,53029,2,1996,26440,25068,1,1372,5.20%
Jefferson,2/1/96,53031,2,1996,9881,8962,1,919,9.30%
King,2/1/96,53033,2,1996,908754,864966,1,43788,4.80%
Kitsap,2/1/96,53035,2,1996,94993,88351,1,6642,7.00%
Kittitas,2/1/96,53037,2,1996,16667,14802,1,1865,11.20%
Klickitat,2/1/96,53039,2,1996,8555,7178,1,1377,16.10%
Lewis,2/1/96,53041,2,1996,30590,27433,1,3157,10.30%
Lincoln,2/1/96,53043,2,1996,4837,4458,1,379,7.80%
Mason,2/1/96,53045,2,1996,18991,17164,1,1827,9.60%
Okanogan,2/1/96,53047,2,1996,21122,17901,1,3221,15.20%
Pacific,2/1/96,53049,2,1996,8226,7294,1,932,11.30%
Pend Oreille,2/1/96,53051,2,1996,4108,3353,1,755,18.40%
Pierce,2/1/96,53053,2,1996,324798,302746,1,22052,6.80%
San Juan,2/1/96,53055,2,1996,4992,4409,1,583,11.70%
Skagit,2/1/96,53057,2,1996,46227,40844,1,5383,11.60%
Skamania,2/1/96,53059,2,1996,3908,3302,1,606,15.50%
Snohomish,2/1/96,53061,2,1996,288116,272242,1,15874,5.50%
Spokane,2/1/96,53063,2,1996,204886,190160,1,14726,7.20%
Stevens,2/1/96,53065,2,1996,17233,14963,1,2270,13.20%
Thurston,2/1/96,53067,2,1996,98959,92170,1,6789,6.90%
Wahkiakum,2/1/96,53069,2,1996,1710,1569,1,141,8.20%
Walla Walla,2/1/96,53071,2,1996,26272,23696,1,2576,9.80%
Whatcom,2/1/96,53073,2,1996,79471,72778,1,6693,8.40%
Whitman,2/1/96,53075,2,1996,19530,18973,1,557,2.90%
Yakima,2/1/96,53077,2,1996,109981,90877,1,19104,17.40%
Adams,2/1/97,53001,2,1997,7968,6789,1,1179,14.80%
Asotin,2/1/97,53003,2,1997,12230,11578,1,652,5.30%
Clallam,2/1/97,53009,2,1997,24788,22502,1,2286,9.20%
Columbia,2/1/97,53013,2,1997,1379,1114,1,265,19.20%
Cowlitz,2/1/97,53015,2,1997,42419,39089,1,3330,7.90%
Douglas,2/1/97,53017,2,1997,18235,16518,1,1717,9.40%
Ferry,2/1/97,53019,2,1997,2880,2471,1,409,14.20%
Franklin,2/1/97,53021,2,1997,22515,19424,1,3091,13.70%
Garfield,2/1/97,53023,2,1997,1088,1032,1,56,5.10%
Grant,2/1/97,53025,2,1997,33925,29410,1,4515,13.30%
Grays Harbor,2/1/97,53027,2,1997,28477,25279,1,3198,11.20%
Island,2/1/97,53029,2,1997,28007,26848,1,1159,4.10%
Jefferson,2/1/97,53031,2,1997,9751,8854,1,897,9.20%
King,2/1/97,53033,2,1997,939000,899914,1,39086,4.20%
Kitsap,2/1/97,53035,2,1997,95575,89504,1,6071,6.40%
Kittitas,2/1/97,53037,2,1997,16449,15138,1,1311,8.00%
Klickitat,2/1/97,53039,2,1997,9160,7748,1,1412,15.40%
Lewis,2/1/97,53041,2,1997,31722,28813,1,2909,9.20%
Lincoln,2/1/97,53043,2,1997,4842,4479,1,363,7.50%
Mason,2/1/97,53045,2,1997,19536,17822,1,1714,8.80%
Okanogan,2/1/97,53047,2,1997,21822,19106,1,2716,12.40%
Pacific,2/1/97,53049,2,1997,8632,7679,1,953,11.00%
Pend Oreille,2/1/97,53051,2,1997,4244,3436,1,808,19.00%
Pierce,2/1/97,53053,2,1997,334692,317437,1,17255,5.20%
San Juan,2/1/97,53055,2,1997,5050,4563,1,487,9.60%
Skagit,2/1/97,53057,2,1997,47298,43138,1,4160,8.80%
Skamania,2/1/97,53059,2,1997,3929,3373,1,556,14.20%
Snohomish,2/1/97,53061,2,1997,304795,291194,1,13601,4.50%
Spokane,2/1/97,53063,2,1997,210368,197149,1,13219,6.30%
Stevens,2/1/97,53065,2,1997,17637,15429,1,2208,12.50%
Thurston,2/1/97,53067,2,1997,101635,95668,1,5967,5.90%
Wahkiakum,2/1/97,53069,2,1997,1874,1746,1,128,6.80%
Walla Walla,2/1/97,53071,2,1997,26943,24416,1,2527,9.40%
Whatcom,2/1/97,53073,2,1997,79032,73230,1,5802,7.30%
Whitman,2/1/97,53075,2,1997,20014,19512,1,502,2.50%
Yakima,2/1/97,53077,2,1997,111767,95829,1,15938,14.30%
Adams,2/1/98,53001,2,1998,8513,7191,1,1322,15.50%
Asotin,2/1/98,53003,2,1998,12927,12252,1,675,5.20%
Clallam,2/1/98,53009,2,1998,25363,23091,1,2272,9.00%
Columbia,2/1/98,53013,2,1998,1390,1165,1,225,16.20%
Cowlitz,2/1/98,53015,2,1998,43349,39886,1,3463,8.00%
Douglas,2/1/98,53017,2,1998,18511,16976,1,1535,8.30%
Ferry,2/1/98,53019,2,1998,2857,2390,1,467,16.30%
Franklin,2/1/98,53021,2,1998,23254,20258,1,2996,12.90%
Garfield,2/1/98,53023,2,1998,1086,1017,1,69,6.40%
Grant,2/1/98,53025,2,1998,35609,31218,1,4391,12.30%
Grays Harbor,2/1/98,53027,2,1998,28122,25037,1,3085,11.00%
Island,2/1/98,53029,2,1998,30062,28811,1,1251,4.20%
Jefferson,2/1/98,53031,2,1998,9981,9183,1,798,8.00%
King,2/1/98,53033,2,1998,969413,938951,1,30462,3.10%
Kitsap,2/1/98,53035,2,1998,95011,89559,1,5452,5.70%
Kittitas,2/1/98,53037,2,1998,15582,14204,1,1378,8.80%
Klickitat,2/1/98,53039,2,1998,9232,7838,1,1394,15.10%
Lewis,2/1/98,53041,2,1998,31450,28294,1,3156,10.00%
Lincoln,2/1/98,53043,2,1998,5070,4720,1,350,6.90%
Mason,2/1/98,53045,2,1998,20192,18588,1,1604,7.90%
Okanogan,2/1/98,53047,2,1998,21841,18685,1,3156,14.40%
Pacific,2/1/98,53049,2,1998,8553,7578,1,975,11.40%
Pend Oreille,2/1/98,53051,2,1998,4358,3658,1,700,16.10%
Pierce,2/1/98,53053,2,1998,344884,328096,1,16788,4.90%
San Juan,2/1/98,53055,2,1998,5515,5106,1,409,7.40%
Skagit,2/1/98,53057,2,1998,48045,43952,1,4093,8.50%
Skamania,2/1/98,53059,2,1998,4142,3600,1,542,13.10%
Snohomish,2/1/98,53061,2,1998,320579,309906,1,10673,3.30%
Spokane,2/1/98,53063,2,1998,216513,204439,1,12074,5.60%
Stevens,2/1/98,53065,2,1998,18083,15777,1,2306,12.80%
Thurston,2/1/98,53067,2,1998,106206,100525,1,5681,5.30%
Wahkiakum,2/1/98,53069,2,1998,1963,1841,1,122,6.20%
Walla Walla,2/1/98,53071,2,1998,27383,24966,1,2417,8.80%
Whatcom,2/1/98,53073,2,1998,81144,75674,1,5470,6.70%
Whitman,2/1/98,53075,2,1998,20472,19978,1,494,2.40%
Yakima,2/1/98,53077,2,1998,112658,97051,1,15607,13.90%
Adams,2/1/99,53001,2,1999,8449,7011,1,1438,17.00%
Asotin,2/1/99,53003,2,1999,13005,12324,1,681,5.20%
Clallam,2/1/99,53009,2,1999,27962,25350,1,2612,9.30%
Columbia,2/1/99,53013,2,1999,1458,1187,1,271,18.60%
Cowlitz,2/1/99,53015,2,1999,44395,40465,1,3930,8.90%
Douglas,2/1/99,53017,2,1999,18933,17192,1,1741,9.20%
Ferry,2/1/99,53019,2,1999,2827,2356,1,471,16.70%
Franklin,2/1/99,53021,2,1999,23933,20701,1,3232,13.50%
Garfield,2/1/99,53023,2,1999,1111,1036,1,75,6.80%
Grant,2/1/99,53025,2,1999,38003,32883,1,5120,13.50%
Grays Harbor,2/1/99,53027,2,1999,28313,25140,1,3173,11.20%
Island,2/1/99,53029,2,1999,31287,30103,1,1184,3.80%
Jefferson,2/1/99,53031,2,1999,11272,10419,1,853,7.60%
King,2/1/99,53033,2,1999,977477,945274,1,32203,3.30%
Kitsap,2/1/99,53035,2,1999,100101,94697,1,5404,5.40%
Kittitas,2/1/99,53037,2,1999,15815,14534,1,1281,8.10%
Klickitat,2/1/99,53039,2,1999,8957,7731,1,1226,13.70%
Lewis,2/1/99,53041,2,1999,32230,28595,1,3635,11.30%
Lincoln,2/1/99,53043,2,1999,4893,4492,1,401,8.20%
Mason,2/1/99,53045,2,1999,20029,18338,1,1691,8.40%
Okanogan,2/1/99,53047,2,1999,21484,18657,1,2827,13.20%
Pacific,2/1/99,53049,2,1999,8338,7178,1,1160,13.90%
Pend Oreille,2/1/99,53051,2,1999,4497,3826,1,671,14.90%
Pierce,2/1/99,53053,2,1999,353359,335190,1,18169,5.10%
San Juan,2/1/99,53055,2,1999,6236,5785,1,451,7.20%
Skagit,2/1/99,53057,2,1999,51624,47331,1,4293,8.30%
Skamania,2/1/99,53059,2,1999,4145,3643,1,502,12.10%
Snohomish,2/1/99,53061,2,1999,328543,315905,1,12638,3.80%
Spokane,2/1/99,53063,2,1999,224073,208965,1,15108,6.70%
Stevens,2/1/99,53065,2,1999,18008,15846,1,2162,12.00%
Thurston,2/1/99,53067,2,1999,108244,102515,1,5729,5.30%
Wahkiakum,2/1/99,53069,2,1999,2062,1872,1,190,9.20%
Walla Walla,2/1/99,53071,2,1999,27863,25136,1,2727,9.80%
Whatcom,2/1/99,53073,2,1999,87463,81388,1,6075,6.90%
Whitman,2/1/99,53075,2,1999,20721,20194,1,527,2.50%
Yakima,2/1/99,53077,2,1999,114042,98150,1,15892,13.90%
Adams,2/1/00,53001,2,2000,7391,6402,1,989,13.40%
Asotin,2/1/00,53003,2,2000,9813,9178,1,635,6.50%
Clallam,2/1/00,53009,2,2000,26499,24131,1,2368,8.90%
Columbia,2/1/00,53013,2,2000,1615,1389,1,226,14.00%
Cowlitz,2/1/00,53015,2,2000,44662,41073,1,3589,8.00%
Douglas,2/1/00,53017,2,2000,17167,15574,1,1593,9.30%
Ferry,2/1/00,53019,2,2000,3102,2701,1,401,12.90%
Franklin,2/1/00,53021,2,2000,22911,20514,1,2397,10.50%
Garfield,2/1/00,53023,2,2000,990,923,1,67,6.80%
Grant,2/1/00,53025,2,2000,33962,29826,1,4136,12.20%
Grays Harbor,2/1/00,53027,2,2000,29679,27077,1,2602,8.80%
Island,2/1/00,53029,2,2000,29932,27979,1,1953,6.50%
Jefferson,2/1/00,53031,2,2000,11766,10886,1,880,7.50%
King,2/1/00,53033,2,2000,988321,950432,1,37889,3.80%
Kitsap,2/1/00,53035,2,2000,109384,102473,1,6911,6.30%
Kittitas,2/1/00,53037,2,2000,17624,16241,1,1383,7.80%
Klickitat,2/1/00,53039,2,2000,9031,7990,1,1041,11.50%
Lewis,2/1/00,53041,2,2000,30646,27884,1,2762,9.00%
Lincoln,2/1/00,53043,2,2000,4520,4198,1,322,7.10%
Mason,2/1/00,53045,2,2000,21415,19713,1,1702,7.90%
Okanogan,2/1/00,53047,2,2000,19315,16920,1,2395,12.40%
Pacific,2/1/00,53049,2,2000,8365,7590,1,775,9.30%
Pend Oreille,2/1/00,53051,2,2000,4663,4147,1,516,11.10%
Pierce,2/1/00,53053,2,2000,347975,326600,1,21375,6.10%
San Juan,2/1/00,53055,2,2000,6997,6558,1,439,6.30%
Skagit,2/1/00,53057,2,2000,52073,48201,1,3872,7.40%
Skamania,2/1/00,53059,2,2000,4983,4565,1,418,8.40%
Snohomish,2/1/00,53061,2,2000,325004,310232,1,14772,4.50%
Spokane,2/1/00,53063,2,2000,216622,201289,1,15333,7.10%
Stevens,2/1/00,53065,2,2000,18025,16153,1,1872,10.40%
Thurston,2/1/00,53067,2,2000,111302,104989,1,6313,5.70%
Wahkiakum,2/1/00,53069,2,2000,1670,1525,1,145,8.70%
Walla Walla,2/1/00,53071,2,2000,26888,24611,1,2277,8.50%
Whatcom,2/1/00,53073,2,2000,90906,85267,1,5639,6.20%
Whitman,2/1/00,53075,2,2000,20196,19256,1,940,4.70%
Yakima,2/1/00,53077,2,2000,109120,96770,1,12350,11.30%
Adams,2/1/01,53001,2,2001,7195,6123,1,1072,14.90%
Asotin,2/1/01,53003,2,2001,9975,9235,1,740,7.40%
Clallam,2/1/01,53009,2,2001,25914,23382,1,2532,9.80%
Columbia,2/1/01,53013,2,2001,1582,1374,1,208,13.10%
Cowlitz,2/1/01,53015,2,2001,42783,38934,1,3849,9.00%
Douglas,2/1/01,53017,2,2001,16175,14590,1,1585,9.80%
Ferry,2/1/01,53019,2,2001,2996,2521,1,475,15.90%
Franklin,2/1/01,53021,2,2001,23015,20483,1,2532,11.00%
Garfield,2/1/01,53023,2,2001,1018,935,1,83,8.20%
Grant,2/1/01,53025,2,2001,33474,28988,1,4486,13.40%
Grays Harbor,2/1/01,53027,2,2001,28952,25882,1,3070,10.60%
Island,2/1/01,53029,2,2001,29240,27272,1,1968,6.70%
Jefferson,2/1/01,53031,2,2001,11886,10976,1,910,7.70%
King,2/1/01,53033,2,2001,991163,948333,1,42830,4.30%
Kitsap,2/1/01,53035,2,2001,106448,99155,1,7293,6.90%
Kittitas,2/1/01,53037,2,2001,17149,15620,1,1529,8.90%
Klickitat,2/1/01,53039,2,2001,9206,7842,1,1364,14.80%
Lewis,2/1/01,53041,2,2001,29306,26322,1,2984,10.20%
Lincoln,2/1/01,53043,2,2001,4417,4094,1,323,7.30%
Mason,2/1/01,53045,2,2001,20593,18682,1,1911,9.30%
Okanogan,2/1/01,53047,2,2001,17443,14788,1,2655,15.20%
Pacific,2/1/01,53049,2,2001,8416,7593,1,823,9.80%
Pend Oreille,2/1/01,53051,2,2001,4685,4118,1,567,12.10%
Pierce,2/1/01,53053,2,2001,340388,316225,1,24163,7.10%
San Juan,2/1/01,53055,2,2001,6973,6487,1,486,7.00%
Skagit,2/1/01,53057,2,2001,50842,46455,1,4387,8.60%
Skamania,2/1/01,53059,2,2001,4945,4437,1,508,10.30%
Snohomish,2/1/01,53061,2,2001,329015,313799,1,15216,4.60%
Spokane,2/1/01,53063,2,2001,214689,197715,1,16974,7.90%
Stevens,2/1/01,53065,2,2001,17331,15370,1,1961,11.30%
Thurston,2/1/01,53067,2,2001,109103,101931,1,7172,6.60%
Wahkiakum,2/1/01,53069,2,2001,1658,1512,1,146,8.80%
Walla Walla,2/1/01,53071,2,2001,27390,25032,1,2358,8.60%
Whatcom,2/1/01,53073,2,2001,87782,81190,1,6592,7.50%
Whitman,2/1/01,53075,2,2001,18862,17815,1,1047,5.60%
Yakima,2/1/01,53077,2,2001,106106,92366,1,13740,12.90%
Adams,2/1/02,53001,2,2002,7444,6439,1,1005,13.50%
Asotin,2/1/02,53003,2,2002,10108,9261,1,847,8.40%
Clallam,2/1/02,53009,2,2002,26190,23478,1,2712,10.40%
Columbia,2/1/02,53013,2,2002,1577,1366,1,211,13.40%
Cowlitz,2/1/02,53015,2,2002,42193,37168,1,5025,11.90%
Douglas,2/1/02,53017,2,2002,16453,14805,1,1648,10.00%
Ferry,2/1/02,53019,2,2002,2847,2462,1,385,13.50%
Franklin,2/1/02,53021,2,2002,24164,21304,1,2860,11.80%
Garfield,2/1/02,53023,2,2002,987,903,1,84,8.50%
Grant,2/1/02,53025,2,2002,33502,29096,1,4406,13.20%
Grays Harbor,2/1/02,53027,2,2002,28582,25362,1,3220,11.30%
Island,2/1/02,53029,2,2002,29961,27463,1,2498,8.30%
Jefferson,2/1/02,53031,2,2002,12013,10907,1,1106,9.20%
King,2/1/02,53033,2,2002,986446,926279,1,60167,6.10%
Kitsap,2/1/02,53035,2,2002,109515,101178,1,8337,7.60%
Kittitas,2/1/02,53037,2,2002,17680,16076,1,1604,9.10%
Klickitat,2/1/02,53039,2,2002,9139,7819,1,1320,14.40%
Lewis,2/1/02,53041,2,2002,29167,26051,1,3116,10.70%
Lincoln,2/1/02,53043,2,2002,4429,4043,1,386,8.70%
Mason,2/1/02,53045,2,2002,21205,19121,1,2084,9.80%
Okanogan,2/1/02,53047,2,2002,16850,14349,1,2501,14.80%
Pacific,2/1/02,53049,2,2002,8353,7440,1,913,10.90%
Pend Oreille,2/1/02,53051,2,2002,4622,4048,1,574,12.40%
Pierce,2/1/02,53053,2,2002,343048,312377,1,30671,8.90%
San Juan,2/1/02,53055,2,2002,6748,6186,1,562,8.30%
Skagit,2/1/02,53057,2,2002,51575,46654,1,4921,9.50%
Skamania,2/1/02,53059,2,2002,4859,4239,1,620,12.80%
Snohomish,2/1/02,53061,2,2002,333519,310037,1,23482,7.00%
Spokane,2/1/02,53063,2,2002,211656,191698,1,19958,9.40%
Stevens,2/1/02,53065,2,2002,17537,15306,1,2231,12.70%
Thurston,2/1/02,53067,2,2002,111089,102987,1,8102,7.30%
Wahkiakum,2/1/02,53069,2,2002,1555,1377,1,178,11.40%
Walla Walla,2/1/02,53071,2,2002,27725,25238,1,2487,9.00%
Whatcom,2/1/02,53073,2,2002,89911,82560,1,7351,8.20%
Whitman,2/1/02,53075,2,2002,19367,18313,1,1054,5.40%
Yakima,2/1/02,53077,2,2002,104992,92081,1,12911,12.30%
Adams,2/1/03,53001,2,2003,7462,6497,1,965,12.90%
Asotin,2/1/03,53003,2,2003,9883,8990,1,893,9.00%
Clallam,2/1/03,53009,2,2003,27029,24286,1,2743,10.10%
Columbia,2/1/03,53013,2,2003,1545,1346,1,199,12.90%
Cowlitz,2/1/03,53015,2,2003,42968,38173,1,4795,11.20%
Douglas,2/1/03,53017,2,2003,17208,15581,1,1627,9.50%
Ferry,2/1/03,53019,2,2003,2990,2473,1,517,17.30%
Franklin,2/1/03,53021,2,2003,25703,22912,1,2791,10.90%
Garfield,2/1/03,53023,2,2003,1041,936,1,105,10.10%
Grant,2/1/03,53025,2,2003,34053,29794,1,4259,12.50%
Grays Harbor,2/1/03,53027,2,2003,29802,26642,1,3160,10.60%
Island,2/1/03,53029,2,2003,30499,28061,1,2438,8.00%
Jefferson,2/1/03,53031,2,2003,12569,11431,1,1138,9.10%
King,2/1/03,53033,2,2003,982718,918073,1,64645,6.60%
Kitsap,2/1/03,53035,2,2003,113723,104955,1,8768,7.70%
Kittitas,2/1/03,53037,2,2003,18291,16552,1,1739,9.50%
Klickitat,2/1/03,53039,2,2003,9032,7752,1,1280,14.20%
Lewis,2/1/03,53041,2,2003,29919,26759,1,3160,10.60%
Lincoln,2/1/03,53043,2,2003,4520,4133,1,387,8.60%
Mason,2/1/03,53045,2,2003,22572,20354,1,2218,9.80%
Okanogan,2/1/03,53047,2,2003,17542,15071,1,2471,14.10%
Pacific,2/1/03,53049,2,2003,8852,7925,1,927,10.50%
Pend Oreille,2/1/03,53051,2,2003,4700,4075,1,625,13.30%
Pierce,2/1/03,53053,2,2003,350265,319264,1,31001,8.90%
San Juan,2/1/03,53055,2,2003,7073,6476,1,597,8.40%
Skagit,2/1/03,53057,2,2003,52399,47596,1,4803,9.20%
Skamania,2/1/03,53059,2,2003,4836,4263,1,573,11.80%
Snohomish,2/1/03,53061,2,2003,333106,308521,1,24585,7.40%
Spokane,2/1/03,53063,2,2003,214901,196082,1,18819,8.80%
Stevens,2/1/03,53065,2,2003,17471,15372,1,2099,12.00%
Thurston,2/1/03,53067,2,2003,115991,107865,1,8126,7.00%
Wahkiakum,2/1/03,53069,2,2003,1581,1414,1,167,10.60%
Walla Walla,2/1/03,53071,2,2003,28411,25866,1,2545,9.00%
Whatcom,2/1/03,53073,2,2003,94508,87593,1,6915,7.30%
Whitman,2/1/03,53075,2,2003,19613,18578,1,1035,5.30%
Yakima,2/1/03,53077,2,2003,108882,96092,1,12790,11.70%
Adams,2/1/04,53001,2,2004,7658,6725,1,933,12.20%
Asotin,2/1/04,53003,2,2004,10172,9387,1,785,7.70%
Clallam,2/1/04,53009,2,2004,27846,25366,1,2480,8.90%
Columbia,2/1/04,53013,2,2004,1569,1394,1,175,11.20%
Cowlitz,2/1/04,53015,2,2004,43501,38975,1,4526,10.40%
Douglas,2/1/04,53017,2,2004,17813,16174,1,1639,9.20%
Ferry,2/1/04,53019,2,2004,2956,2509,1,447,15.10%
Franklin,2/1/04,53021,2,2004,27217,24307,1,2910,10.70%
Garfield,2/1/04,53023,2,2004,1024,949,1,75,7.30%
Grant,2/1/04,53025,2,2004,34937,30604,1,4333,12.40%
Grays Harbor,2/1/04,53027,2,2004,30727,27728,1,2999,9.80%
Island,2/1/04,53029,2,2004,31502,28941,1,2561,8.10%
Jefferson,2/1/04,53031,2,2004,13276,12255,1,1021,7.70%
King,2/1/04,53033,2,2004,987541,934191,1,53350,5.40%
Kitsap,2/1/04,53035,2,2004,118403,110438,1,7965,6.70%
Kittitas,2/1/04,53037,2,2004,19042,17272,1,1770,9.30%
Klickitat,2/1/04,53039,2,2004,8950,7640,1,1310,14.60%
Lewis,2/1/04,53041,2,2004,30779,27649,1,3130,10.20%
Lincoln,2/1/04,53043,2,2004,4776,4332,1,444,9.30%
Mason,2/1/04,53045,2,2004,23315,21196,1,2119,9.10%
Okanogan,2/1/04,53047,2,2004,18896,16731,1,2165,11.50%
Pacific,2/1/04,53049,2,2004,9010,8136,1,874,9.70%
Pend Oreille,2/1/04,53051,2,2004,5022,4408,1,614,12.20%
Pierce,2/1/04,53053,2,2004,362001,331705,1,30296,8.40%
San Juan,2/1/04,53055,2,2004,7471,6963,1,508,6.80%
Skagit,2/1/04,53057,2,2004,54089,49330,1,4759,8.80%
Skamania,2/1/04,53059,2,2004,5071,4451,1,620,12.20%
Snohomish,2/1/04,53061,2,2004,337049,315411,1,21638,6.40%
Spokane,2/1/04,53063,2,2004,220661,201801,1,18860,8.50%
Stevens,2/1/04,53065,2,2004,18083,16050,1,2033,11.20%
Thurston,2/1/04,53067,2,2004,119801,111711,1,8090,6.80%
Wahkiakum,2/1/04,53069,2,2004,1642,1491,1,151,9.20%
Walla Walla,2/1/04,53071,2,2004,29000,26458,1,2542,8.80%
Whatcom,2/1/04,53073,2,2004,98400,91498,1,6902,7.00%
Whitman,2/1/04,53075,2,2004,20464,19394,1,1070,5.20%
Yakima,2/1/04,53077,2,2004,111390,98269,1,13121,11.80%
Adams,2/1/05,53001,2,2005,7655,6827,1,828,10.80%
Asotin,2/1/05,53003,2,2005,10584,9671,1,913,8.60%
Clallam,2/1/05,53009,2,2005,29569,27152,1,2417,8.20%
Columbia,2/1/05,53013,2,2005,1483,1314,1,169,11.40%
Cowlitz,2/1/05,53015,2,2005,43262,39401,1,3861,8.90%
Douglas,2/1/05,53017,2,2005,18525,17069,1,1456,7.90%
Ferry,2/1/05,53019,2,2005,3032,2640,1,392,12.90%
Franklin,2/1/05,53021,2,2005,29265,26346,1,2919,10.00%
Garfield,2/1/05,53023,2,2005,1040,965,1,75,7.20%
Grant,2/1/05,53025,2,2005,35655,31717,1,3938,11.00%
Grays Harbor,2/1/05,53027,2,2005,31442,28602,1,2840,9.00%
Island,2/1/05,53029,2,2005,31543,29260,1,2283,7.20%
Jefferson,2/1/05,53031,2,2005,13560,12562,1,998,7.40%
King,2/1/05,53033,2,2005,994778,947090,1,47688,4.80%
Kitsap,2/1/05,53035,2,2005,120463,113057,1,7406,6.10%
Kittitas,2/1/05,53037,2,2005,19176,17572,1,1604,8.40%
Klickitat,2/1/05,53039,2,2005,9165,8125,1,1040,11.30%
Lewis,2/1/05,53041,2,2005,30625,27670,1,2955,9.60%
Lincoln,2/1/05,53043,2,2005,4684,4316,1,368,7.90%
Mason,2/1/05,53045,2,2005,23764,21793,1,1971,8.30%
Okanogan,2/1/05,53047,2,2005,18811,16646,1,2165,11.50%
Pacific,2/1/05,53049,2,2005,9123,8389,1,734,8.00%
Pend Oreille,2/1/05,53051,2,2005,5055,4491,1,564,11.20%
Pierce,2/1/05,53053,2,2005,369932,343180,1,26752,7.20%
San Juan,2/1/05,53055,2,2005,7641,7175,1,466,6.10%
Skagit,2/1/05,53057,2,2005,55676,51490,1,4186,7.50%
Skamania,2/1/05,53059,2,2005,5144,4602,1,542,10.50%
Snohomish,2/1/05,53061,2,2005,341305,322718,1,18587,5.40%
Spokane,2/1/05,53063,2,2005,225390,208691,1,16699,7.40%
Stevens,2/1/05,53065,2,2005,18248,16261,1,1987,10.90%
Thurston,2/1/05,53067,2,2005,122596,114954,1,7642,6.20%
Wahkiakum,2/1/05,53069,2,2005,1677,1529,1,148,8.80%
Walla Walla,2/1/05,53071,2,2005,28726,26472,1,2254,7.80%
Whatcom,2/1/05,53073,2,2005,102847,96458,1,6389,6.20%
Whitman,2/1/05,53075,2,2005,20964,19919,1,1045,5.00%
Yakima,2/1/05,53077,2,2005,113129,101529,1,11600,10.30%
Adams,2/1/06,53001,2,2006,7550,6823,1,727,9.60%
Asotin,2/1/06,53003,2,2006,9995,9590,1,405,4.10%
Clallam,2/1/06,53009,2,2006,29622,27471,1,2151,7.30%
Columbia,2/1/06,53013,2,2006,1576,1382,1,194,12.30%
Cowlitz,2/1/06,53015,2,2006,43381,39953,1,3428,7.90%
Douglas,2/1/06,53017,2,2006,18764,17399,1,1365,7.30%
Ferry,2/1/06,53019,2,2006,2934,2514,1,420,14.30%
Franklin,2/1/06,53021,2,2006,29587,26720,1,2867,9.70%
Garfield,2/1/06,53023,2,2006,1003,921,1,82,8.20%
Grant,2/1/06,53025,2,2006,36610,32823,1,3787,10.30%
Grays Harbor,2/1/06,53027,2,2006,31319,28690,1,2629,8.40%
Island,2/1/06,53029,2,2006,32359,30310,1,2049,6.30%
Jefferson,2/1/06,53031,2,2006,13615,12768,1,847,6.20%
King,2/1/06,53033,2,2006,1031070,991770,1,39300,3.80%
Kitsap,2/1/06,53035,2,2006,122458,115506,1,6952,5.70%
Kittitas,2/1/06,53037,2,2006,19448,17999,1,1449,7.50%
Klickitat,2/1/06,53039,2,2006,9061,8119,1,942,10.40%
Lewis,2/1/06,53041,2,2006,31333,28598,1,2735,8.70%
Lincoln,2/1/06,53043,2,2006,4599,4244,1,355,7.70%
Mason,2/1/06,53045,2,2006,24133,22402,1,1731,7.20%
Okanogan,2/1/06,53047,2,2006,18830,16935,1,1895,10.10%
Pacific,2/1/06,53049,2,2006,9106,8393,1,713,7.80%
Pend Oreille,2/1/06,53051,2,2006,5112,4562,1,550,10.80%
Pierce,2/1/06,53053,2,2006,374262,350618,1,23644,6.30%
San Juan,2/1/06,53055,2,2006,7606,7207,1,399,5.20%
Skagit,2/1/06,53057,2,2006,55793,52006,1,3787,6.80%
Skamania,2/1/06,53059,2,2006,5221,4667,1,554,10.60%
Snohomish,2/1/06,53061,2,2006,354071,338864,1,15207,4.30%
Spokane,2/1/06,53063,2,2006,228390,213181,1,15209,6.70%
Stevens,2/1/06,53065,2,2006,17947,16220,1,1727,9.60%
Thurston,2/1/06,53067,2,2006,124145,117183,1,6962,5.60%
Wahkiakum,2/1/06,53069,2,2006,1626,1493,1,133,8.20%
Walla Walla,2/1/06,53071,2,2006,28444,26248,1,2196,7.70%
Whatcom,2/1/06,53073,2,2006,102882,97109,1,5773,5.60%
Whitman,2/1/06,53075,2,2006,20966,19997,1,969,4.60%
Yakima,2/1/06,53077,2,2006,113520,102820,1,10700,9.40%
Adams,2/1/07,53001,2,2007,7372,6602,1,770,10.40%
Asotin,2/1/07,53003,2,2007,10274,9555,1,719,7.00%
Clallam,2/1/07,53009,2,2007,29761,27552,1,2209,7.40%
Columbia,2/1/07,53013,2,2007,1547,1406,1,141,9.10%
Cowlitz,2/1/07,53015,2,2007,43623,40246,1,3377,7.70%
Douglas,2/1/07,53017,2,2007,19444,18070,1,1374,7.10%
Ferry,2/1/07,53019,2,2007,2958,2599,1,359,12.10%
Franklin,2/1/07,53021,2,2007,31369,28402,1,2967,9.50%
Garfield,2/1/07,53023,2,2007,994,925,1,69,6.90%
Grant,2/1/07,53025,2,2007,37846,34319,1,3527,9.30%
Grays Harbor,2/1/07,53027,2,2007,31061,28340,1,2721,8.80%
Island,2/1/07,53029,2,2007,32757,30815,1,1942,5.90%
Jefferson,2/1/07,53031,2,2007,13584,12750,1,834,6.10%
King,2/1/07,53033,2,2007,1056743,1018805,1,37938,3.60%
Kitsap,2/1/07,53035,2,2007,122556,115939,1,6617,5.40%
Kittitas,2/1/07,53037,2,2007,20125,18764,1,1361,6.80%
Klickitat,2/1/07,53039,2,2007,9498,8520,1,978,10.30%
Lewis,2/1/07,53041,2,2007,31248,28413,1,2835,9.10%
Lincoln,2/1/07,53043,2,2007,4634,4287,1,347,7.50%
Mason,2/1/07,53045,2,2007,24929,23142,1,1787,7.20%
Okanogan,2/1/07,53047,2,2007,18642,16713,1,1929,10.30%
Pacific,2/1/07,53049,2,2007,8989,8228,1,761,8.50%
Pend Oreille,2/1/07,53051,2,2007,5269,4718,1,551,10.50%
Pierce,2/1/07,53053,2,2007,384118,361874,1,22244,5.80%
San Juan,2/1/07,53055,2,2007,7745,7360,1,385,5.00%
Skagit,2/1/07,53057,2,2007,56911,53507,1,3404,6.00%
Skamania,2/1/07,53059,2,2007,5151,4653,1,498,9.70%
Snohomish,2/1/07,53061,2,2007,360175,345586,1,14589,4.10%
Spokane,2/1/07,53063,2,2007,234020,218923,1,15097,6.50%
Stevens,2/1/07,53065,2,2007,18593,16618,1,1975,10.60%
Thurston,2/1/07,53067,2,2007,127021,120165,1,6856,5.40%
Wahkiakum,2/1/07,53069,2,2007,1653,1518,1,135,8.20%
Walla Walla,2/1/07,53071,2,2007,28563,26574,1,1989,7.00%
Whatcom,2/1/07,53073,2,2007,105285,99828,1,5457,5.20%
Whitman,2/1/07,53075,2,2007,20937,20002,1,935,4.50%
Yakima,2/1/07,53077,2,2007,115241,104828,1,10413,9.00%
Adams,2/1/08,53001,2,2008,7623,6859,1,764,10.00%
Asotin,2/1/08,53003,2,2008,10675,9829,1,846,7.90%
Clallam,2/1/08,53009,2,2008,30217,27538,1,2679,8.90%
Columbia,2/1/08,53013,2,2008,1583,1446,1,137,8.70%
Cowlitz,2/1/08,53015,2,2008,44389,40420,1,3969,8.90%
Douglas,2/1/08,53017,2,2008,19896,18438,1,1458,7.30%
Ferry,2/1/08,53019,2,2008,2979,2596,1,383,12.90%
Franklin,2/1/08,53021,2,2008,33258,30449,1,2809,8.40%
Garfield,2/1/08,53023,2,2008,952,886,1,66,6.90%
Grant,2/1/08,53025,2,2008,38463,34786,1,3677,9.60%
Grays Harbor,2/1/08,53027,2,2008,31698,28898,1,2800,8.80%
Island,2/1/08,53029,2,2008,32956,30909,1,2047,6.20%
Jefferson,2/1/08,53031,2,2008,13731,12848,1,883,6.40%
King,2/1/08,53033,2,2008,1080473,1046848,1,33625,3.10%
Kitsap,2/1/08,53035,2,2008,124807,117979,1,6828,5.50%
Kittitas,2/1/08,53037,2,2008,20885,19275,1,1610,7.70%
Klickitat,2/1/08,53039,2,2008,9726,8702,1,1024,10.50%
Lewis,2/1/08,53041,2,2008,32196,28836,1,3360,10.40%
Lincoln,2/1/08,53043,2,2008,4644,4291,1,353,7.60%
Mason,2/1/08,53045,2,2008,25603,23351,1,2252,8.80%
Okanogan,2/1/08,53047,2,2008,19250,17371,1,1879,9.80%
Pacific,2/1/08,53049,2,2008,9045,8274,1,771,8.50%
Pend Oreille,2/1/08,53051,2,2008,5485,4861,1,624,11.40%
Pierce,2/1/08,53053,2,2008,394824,370397,1,24427,6.20%
San Juan,2/1/08,53055,2,2008,7978,7610,1,368,4.60%
Skagit,2/1/08,53057,2,2008,58812,54949,1,3863,6.60%
Skamania,2/1/08,53059,2,2008,5261,4694,1,567,10.80%
Snohomish,2/1/08,53061,2,2008,369235,355538,1,13697,3.70%
Spokane,2/1/08,53063,2,2008,240083,223173,1,16910,7.00%
Stevens,2/1/08,53065,2,2008,18904,17016,1,1888,10.00%
Thurston,2/1/08,53067,2,2008,131643,124202,1,7441,5.70%
Wahkiakum,2/1/08,53069,2,2008,1742,1601,1,141,8.10%
Walla Walla,2/1/08,53071,2,2008,29213,27284,1,1929,6.60%
Whatcom,2/1/08,53073,2,2008,108450,102272,1,6178,5.70%
Whitman,2/1/08,53075,2,2008,21545,20532,1,1013,4.70%
Yakima,2/1/08,53077,2,2008,119013,108188,1,10825,9.10%
Adams,2/1/09,53001,2,2009,7855,6967,1,888,11.30%
Asotin,2/1/09,53003,2,2009,10436,9309,1,1127,10.80%
Clallam,2/1/09,53009,2,2009,30363,27264,1,3099,10.20%
Columbia,2/1/09,53013,2,2009,1645,1433,1,212,12.90%
Cowlitz,2/1/09,53015,2,2009,45721,39587,1,6134,13.40%
Douglas,2/1/09,53017,2,2009,20699,18756,1,1943,9.40%
Ferry,2/1/09,53019,2,2009,3060,2624,1,436,14.20%
Franklin,2/1/09,53021,2,2009,35617,32219,1,3398,9.50%
Garfield,2/1/09,53023,2,2009,983,908,1,75,7.60%
Grant,2/1/09,53025,2,2009,39748,35010,1,4738,11.90%
Grays Harbor,2/1/09,53027,2,2009,31906,27678,1,4228,13.30%
Island,2/1/09,53029,2,2009,33098,30406,1,2692,8.10%
Jefferson,2/1/09,53031,2,2009,13085,11863,1,1222,9.30%
King,2/1/09,53033,2,2009,1104350,1031573,1,72777,6.60%
Kitsap,2/1/09,53035,2,2009,127120,117812,1,9308,7.30%
Kittitas,2/1/09,53037,2,2009,20874,18873,1,2001,9.60%
Klickitat,2/1/09,53039,2,2009,10217,9020,1,1197,11.70%
Lewis,2/1/09,53041,2,2009,32096,27776,1,4320,13.50%
Lincoln,2/1/09,53043,2,2009,4745,4290,1,455,9.60%
Mason,2/1/09,53045,2,2009,25406,22636,1,2770,10.90%
Okanogan,2/1/09,53047,2,2009,19939,17518,1,2421,12.10%
Pacific,2/1/09,53049,2,2009,9382,8034,1,1348,14.40%
Pend Oreille,2/1/09,53051,2,2009,5748,4955,1,793,13.80%
Pierce,2/1/09,53053,2,2009,402398,365883,1,36515,9.10%
San Juan,2/1/09,53055,2,2009,8001,7385,1,616,7.70%
Skagit,2/1/09,53057,2,2009,58233,52789,1,5444,9.30%
Skamania,2/1/09,53059,2,2009,5272,4541,1,731,13.90%
Snohomish,2/1/09,53061,2,2009,378870,348344,1,30526,8.10%
Spokane,2/1/09,53063,2,2009,243993,221255,1,22738,9.30%
Stevens,2/1/09,53065,2,2009,19115,16397,1,2718,14.20%
Thurston,2/1/09,53067,2,2009,133695,123612,1,10083,7.50%
Wahkiakum,2/1/09,53069,2,2009,1637,1385,1,252,15.40%
Walla Walla,2/1/09,53071,2,2009,30602,28285,1,2317,7.60%
Whatcom,2/1/09,53073,2,2009,108543,99940,1,8603,7.90%
Whitman,2/1/09,53075,2,2009,22336,21198,1,1138,5.10%
Yakima,2/1/09,53077,2,2009,120230,108402,1,11828,9.80%
Adams,2/1/10,53001,2,2010,7924,6770,1,1154,14.60%
Asotin,2/1/10,53003,2,2010,10644,9362,1,1282,12.00%
Clallam,2/1/10,53009,2,2010,29758,25931,1,3827,12.90%
Columbia,2/1/10,53013,2,2010,1963,1749,1,214,10.90%
Cowlitz,2/1/10,53015,2,2010,47067,40199,1,6868,14.60%
Douglas,2/1/10,53017,2,2010,19063,16673,1,2390,12.50%
Ferry,2/1/10,53019,2,2010,2657,2061,1,596,22.40%
Franklin,2/1/10,53021,2,2010,36406,32192,1,4214,11.60%
Garfield,2/1/10,53023,2,2010,1022,898,1,124,12.10%
Grant,2/1/10,53025,2,2010,40932,34965,1,5967,14.60%
Grays Harbor,2/1/10,53027,2,2010,31633,26566,1,5067,16.00%
Island,2/1/10,53029,2,2010,34154,30481,1,3673,10.80%
Jefferson,2/1/10,53031,2,2010,12799,11265,1,1534,12.00%
King,2/1/10,53033,2,2010,1110613,1005646,1,104967,9.50%
Kitsap,2/1/10,53035,2,2010,122038,110176,1,11862,9.70%
Kittitas,2/1/10,53037,2,2010,21395,18784,1,2611,12.20%
Klickitat,2/1/10,53039,2,2010,10089,8664,1,1425,14.10%
Lewis,2/1/10,53041,2,2010,34425,29190,1,5235,15.20%
Lincoln,2/1/10,53043,2,2010,5185,4632,1,553,10.70%
Mason,2/1/10,53045,2,2010,25072,21624,1,3448,13.80%
Okanogan,2/1/10,53047,2,2010,20247,17145,1,3102,15.30%
Pacific,2/1/10,53049,2,2010,8668,7276,1,1392,16.10%
Pend Oreille,2/1/10,53051,2,2010,5406,4336,1,1070,19.80%
Pierce,2/1/10,53053,2,2010,401178,353441,1,47737,11.90%
San Juan,2/1/10,53055,2,2010,7984,7206,1,778,9.70%
Skagit,2/1/10,53057,2,2010,59329,51722,1,7607,12.80%
Skamania,2/1/10,53059,2,2010,5255,4490,1,765,14.60%
Snohomish,2/1/10,53061,2,2010,388465,345046,1,43419,11.20%
Spokane,2/1/10,53063,2,2010,242872,213553,1,29319,12.10%
Stevens,2/1/10,53065,2,2010,19650,16476,1,3174,16.20%
Thurston,2/1/10,53067,2,2010,128992,115939,1,13053,10.10%
Wahkiakum,2/1/10,53069,2,2010,1437,1192,1,245,17.00%
Walla Walla,2/1/10,53071,2,2010,29897,27018,1,2879,9.60%
Whatcom,2/1/10,53073,2,2010,104898,93256,1,11642,11.10%
Whitman,2/1/10,53075,2,2010,23028,21328,1,1700,7.40%
Yakima,2/1/10,53077,2,2010,119203,103644,1,15559,13.10%
Adams,2/1/11,53001,2,2011,7766,6683,1,1083,13.90%
Asotin,2/1/11,53003,2,2011,10198,9124,1,1074,10.50%
Clallam,2/1/11,53009,2,2011,28710,25193,1,3517,12.30%
Columbia,2/1/11,53013,2,2011,1850,1648,1,202,10.90%
Cowlitz,2/1/11,53015,2,2011,45228,39167,1,6061,13.40%
Douglas,2/1/11,53017,2,2011,18268,16105,1,2163,11.80%
Ferry,2/1/11,53019,2,2011,2597,2069,1,528,20.30%
Franklin,2/1/11,53021,2,2011,37325,33386,1,3939,10.60%
Garfield,2/1/11,53023,2,2011,998,902,1,96,9.60%
Grant,2/1/11,53025,2,2011,40581,35358,1,5223,12.90%
Grays Harbor,2/1/11,53027,2,2011,29963,25607,1,4356,14.50%
Island,2/1/11,53029,2,2011,32944,29666,1,3278,10.00%
Jefferson,2/1/11,53031,2,2011,12283,10859,1,1424,11.60%
King,2/1/11,53033,2,2011,1106590,1010970,1,95620,8.60%
Kitsap,2/1/11,53035,2,2011,118457,107626,1,10831,9.10%
Kittitas,2/1/11,53037,2,2011,20954,18703,1,2251,10.70%
Klickitat,2/1/11,53039,2,2011,9820,8400,1,1420,14.50%
Lewis,2/1/11,53041,2,2011,32969,28285,1,4684,14.20%
Lincoln,2/1/11,53043,2,2011,5261,4758,1,503,9.60%
Mason,2/1/11,53045,2,2011,24168,20903,1,3265,13.50%
Okanogan,2/1/11,53047,2,2011,19403,16695,1,2708,14.00%
Pacific,2/1/11,53049,2,2011,8241,6990,1,1251,15.20%
Pend Oreille,2/1/11,53051,2,2011,4997,4173,1,824,16.50%
Pierce,2/1/11,53053,2,2011,390406,347265,1,43141,11.10%
San Juan,2/1/11,53055,2,2011,7635,6938,1,697,9.10%
Skagit,2/1/11,53057,2,2011,57206,50344,1,6862,12.00%
Skamania,2/1/11,53059,2,2011,5195,4443,1,752,14.50%
Snohomish,2/1/11,53061,2,2011,384428,344049,1,40379,10.50%
Spokane,2/1/11,53063,2,2011,234232,207904,1,26328,11.20%
Stevens,2/1/11,53065,2,2011,18669,15954,1,2715,14.50%
Thurston,2/1/11,53067,2,2011,125102,112965,1,12137,9.70%
Wahkiakum,2/1/11,53069,2,2011,1452,1212,1,240,16.50%
Walla Walla,2/1/11,53071,2,2011,29286,26496,1,2790,9.50%
Whatcom,2/1/11,53073,2,2011,103171,92585,1,10586,10.30%
Whitman,2/1/11,53075,2,2011,22986,21402,1,1584,6.90%
Yakima,2/1/11,53077,2,2011,116319,101726,1,14593,12.50%
Adams,2/1/12,53001,2,2012,7724,6759,1,965,12.50%
Asotin,2/1/12,53003,2,2012,9927,9004,1,923,9.30%
Clallam,2/1/12,53009,2,2012,28550,25083,1,3467,12.10%
Columbia,2/1/12,53013,2,2012,1839,1654,1,185,10.10%
Cowlitz,2/1/12,53015,2,2012,45447,39999,1,5448,12.00%
Douglas,2/1/12,53017,2,2012,18459,16258,1,2201,11.90%
Ferry,2/1/12,53019,2,2012,2451,1954,1,497,20.30%
Franklin,2/1/12,53021,2,2012,37989,33371,1,4618,12.20%
Garfield,2/1/12,53023,2,2012,980,894,1,86,8.80%
Grant,2/1/12,53025,2,2012,41338,35943,1,5395,13.10%
Grays Harbor,2/1/12,53027,2,2012,29558,25246,1,4312,14.60%
Island,2/1/12,53029,2,2012,33191,30075,1,3116,9.40%
Jefferson,2/1/12,53031,2,2012,12132,10732,1,1400,11.50%
King,2/1/12,53033,2,2012,1118905,1038455,1,80450,7.20%
Kitsap,2/1/12,53035,2,2012,118334,107709,1,10625,9.00%
Kittitas,2/1/12,53037,2,2012,20749,18438,1,2311,11.10%
Klickitat,2/1/12,53039,2,2012,9704,8505,1,1199,12.40%
Lewis,2/1/12,53041,2,2012,32627,28181,1,4446,13.60%
Lincoln,2/1/12,53043,2,2012,5218,4762,1,456,8.70%
Mason,2/1/12,53045,2,2012,23779,20803,1,2976,12.50%
Okanogan,2/1/12,53047,2,2012,19117,16635,1,2482,13.00%
Pacific,2/1/12,53049,2,2012,8228,7152,1,1076,13.10%
Pend Oreille,2/1/12,53051,2,2012,4958,4219,1,739,14.90%
Pierce,2/1/12,53053,2,2012,393043,352129,1,40914,10.40%
San Juan,2/1/12,53055,2,2012,7796,7136,1,660,8.50%
Skagit,2/1/12,53057,2,2012,57087,50568,1,6519,11.40%
Skamania,2/1/12,53059,2,2012,5131,4523,1,608,11.80%
Snohomish,2/1/12,53061,2,2012,384698,351885,1,32813,8.50%
Spokane,2/1/12,53063,2,2012,235183,210298,1,24885,10.60%
Stevens,2/1/12,53065,2,2012,18679,16115,1,2564,13.70%
Thurston,2/1/12,53067,2,2012,125065,113085,1,11980,9.60%
Wahkiakum,2/1/12,53069,2,2012,1390,1197,1,193,13.90%
Walla Walla,2/1/12,53071,2,2012,29421,26768,1,2653,9.00%
Whatcom,2/1/12,53073,2,2012,103679,93964,1,9715,9.40%
Whitman,2/1/12,53075,2,2012,22931,21286,1,1645,7.20%
Yakima,2/1/12,53077,2,2012,116661,101098,1,15563,13.30%
Adams,2/1/13,53001,2,2013,7783,6804,1,979,12.60%
Asotin,2/1/13,53003,2,2013,9873,9045,1,828,8.40%
Clallam,2/1/13,53009,2,2013,27834,24776,1,3058,11.00%
Clark,2/1/13,53011,2,2013,210556,189990,1,20566,9.80%
Columbia,2/1/13,53013,2,2013,1773,1598,1,175,9.90%
Cowlitz,2/1/13,53015,2,2013,43869,38881,1,4988,11.40%
Douglas,2/1/13,53017,2,2013,17919,15953,1,1966,11.00%
Ferry,2/1/13,53019,2,2013,2529,2112,1,417,16.50%
Franklin,2/1/13,53021,2,2013,37108,32648,1,4460,12.00%
Garfield,2/1/13,53023,2,2013,973,872,1,101,10.40%
Grant,2/1/13,53025,2,2013,41924,36819,1,5105,12.20%
Grays Harbor,2/1/13,53027,2,2013,28391,24617,1,3774,13.30%
Island,2/1/13,53029,2,2013,32137,29420,1,2717,8.50%
Jefferson,2/1/13,53031,2,2013,11654,10360,1,1294,11.10%
King,2/1/13,53033,2,2013,1134220,1074455,1,59765,5.30%
Kitsap,2/1/13,53035,2,2013,115068,105530,1,9538,8.30%
Kittitas,2/1/13,53037,2,2013,20438,18456,1,1982,9.70%
Klickitat,2/1/13,53039,2,2013,9630,8449,1,1181,12.30%
Lewis,2/1/13,53041,2,2013,31647,27758,1,3889,12.30%
Lincoln,2/1/13,53043,2,2013,5028,4585,1,443,8.80%
Mason,2/1/13,53045,2,2013,23486,20814,1,2672,11.40%
Okanogan,2/1/13,53047,2,2013,19326,16956,1,2370,12.30%
Pacific,2/1/13,53049,2,2013,8035,7021,1,1014,12.60%
Pend Oreille,2/1/13,53051,2,2013,4833,4116,1,717,14.80%
Pierce,2/1/13,53053,2,2013,387486,350676,1,36810,9.50%
San Juan,2/1/13,53055,2,2013,7413,6799,1,614,8.30%
Skagit,2/1/13,53057,2,2013,56345,50593,1,5752,10.20%
Skamania,2/1/13,53059,2,2013,5073,4474,1,599,11.80%
Snohomish,2/1/13,53061,2,2013,387632,363968,1,23664,6.10%
Spokane,2/1/13,53063,2,2013,230852,208083,1,22769,9.90%
Stevens,2/1/13,53065,2,2013,18162,15753,1,2409,13.30%
Thurston,2/1/13,53067,2,2013,124347,113599,1,10748,8.60%
Wahkiakum,2/1/13,53069,2,2013,1293,1107,1,186,14.40%
Walla Walla,2/1/13,53071,2,2013,28178,25730,1,2448,8.70%
Whatcom,2/1/13,53073,2,2013,103065,94125,1,8940,8.70%
Whitman,2/1/13,53075,2,2013,23045,21584,1,1461,6.30%
Yakima,2/1/13,53077,2,2013,115867,101408,1,14459,12.50%
Adams,2/1/14,53001,2,2014,7749,6917,1,832,10.70%
Asotin,2/1/14,53003,2,2014,9644,8983,1,661,6.90%
Clallam,2/1/14,53009,2,2014,26667,24036,1,2631,9.90%
Clark,2/1/14,53011,2,2014,208552,191591,1,16961,8.10%
Columbia,2/1/14,53013,2,2014,1715,1563,1,152,8.90%
Cowlitz,2/1/14,53015,2,2014,43022,38873,1,4149,9.60%
Douglas,2/1/14,53017,2,2014,17783,16017,1,1766,9.90%
Ferry,2/1/14,53019,2,2014,2401,2039,1,362,15.10%
Franklin,2/1/14,53021,2,2014,36268,32141,1,4127,11.40%
Garfield,2/1/14,53023,2,2014,934,854,1,80,8.60%
Grant,2/1/14,53025,2,2014,40993,36599,1,4394,10.70%
Grays Harbor,2/1/14,53027,2,2014,27316,24085,1,3231,11.80%
Island,2/1/14,53029,2,2014,31765,29365,1,2400,7.60%
Jefferson,2/1/14,53031,2,2014,11296,10254,1,1042,9.20%
King,2/1/14,53033,2,2014,1160894,1102869,1,58025,5.00%
Kitsap,2/1/14,53035,2,2014,113159,105216,1,7943,7.00%
Kittitas,2/1/14,53037,2,2014,19869,18059,1,1810,9.10%
Klickitat,2/1/14,53039,2,2014,9266,8310,1,956,10.30%
Lewis,2/1/14,53041,2,2014,30887,27628,1,3259,10.60%
Lincoln,2/1/14,53043,2,2014,4959,4586,1,373,7.50%
Mason,2/1/14,53045,2,2014,23163,20875,1,2288,9.90%
Okanogan,2/1/14,53047,2,2014,19056,17085,1,1971,10.30%
Pacific,2/1/14,53049,2,2014,7694,6763,1,931,12.10%
Pend Oreille,2/1/14,53051,2,2014,4658,4068,1,590,12.70%
Pierce,2/1/14,53053,2,2014,383798,352697,1,31101,8.10%
San Juan,2/1/14,53055,2,2014,7187,6711,1,476,6.60%
Skagit,2/1/14,53057,2,2014,55814,50982,1,4832,8.70%
Skamania,2/1/14,53059,2,2014,4974,4469,1,505,10.20%
Snohomish,2/1/14,53061,2,2014,396862,374094,1,22768,5.70%
Spokane,2/1/14,53063,2,2014,225953,206718,1,19235,8.50%
Stevens,2/1/14,53065,2,2014,17546,15527,1,2019,11.50%
Thurston,2/1/14,53067,2,2014,123339,114034,1,9305,7.50%
Wahkiakum,2/1/14,53069,2,2014,1276,1127,1,149,11.70%
Walla Walla,2/1/14,53071,2,2014,27849,25634,1,2215,8.00%
Whatcom,2/1/14,53073,2,2014,101382,93451,1,7931,7.80%
Whitman,2/1/14,53075,2,2014,22307,20914,1,1393,6.20%
Yakima,2/1/14,53077,2,2014,111907,98639,1,13268,11.90%
Adams,2/1/15,53001,2,2015,7919,7081,1,838,10.60%
Asotin,2/1/15,53003,2,2015,9658,9096,1,562,5.80%
Clallam,2/1/15,53009,2,2015,26638,24037,1,2601,9.80%
Clark,2/1/15,53011,2,2015,213590,197646,1,15944,7.50%
Columbia,2/1/15,53013,2,2015,1700,1559,1,141,8.30%
Cowlitz,2/1/15,53015,2,2015,44210,40357,1,3853,8.70%
Douglas,2/1/15,53017,2,2015,18518,16866,1,1652,8.90%
Ferry,2/1/15,53019,2,2015,2381,2046,1,335,14.10%
Franklin,2/1/15,53021,2,2015,37149,33339,1,3810,10.30%
Garfield,2/1/15,53023,2,2015,917,842,1,75,8.20%
Grant,2/1/15,53025,2,2015,42259,37985,1,4274,10.10%
Grays Harbor,2/1/15,53027,2,2015,26911,24040,1,2871,10.70%
Island,2/1/15,53029,2,2015,31548,29286,1,2262,7.20%
Jefferson,2/1/15,53031,2,2015,11185,10236,1,949,8.50%
King,2/1/15,53033,2,2015,1183718,1133223,1,50495,4.30%
Kitsap,2/1/15,53035,2,2015,114156,106822,1,7334,6.40%
Kittitas,2/1/15,53037,2,2015,20609,18935,1,1674,8.10%
Klickitat,2/1/15,53039,2,2015,9012,8171,1,841,9.30%
Lewis,2/1/15,53041,2,2015,31172,28084,1,3088,9.90%
Lincoln,2/1/15,53043,2,2015,4832,4453,1,379,7.80%
Mason,2/1/15,53045,2,2015,22915,20860,1,2055,9.00%
Okanogan,2/1/15,53047,2,2015,19651,17668,1,1983,10.10%
Pacific,2/1/15,53049,2,2015,7935,7054,1,881,11.10%
Pend Oreille,2/1/15,53051,2,2015,4679,4108,1,571,12.20%
Pierce,2/1/15,53053,2,2015,389656,361023,1,28633,7.30%
San Juan,2/1/15,53055,2,2015,7187,6726,1,461,6.40%
Skagit,2/1/15,53057,2,2015,56274,51770,1,4504,8.00%
Skamania,2/1/15,53059,2,2015,4983,4517,1,466,9.40%
Snohomish,2/1/15,53061,2,2015,403236,384384,1,18852,4.70%
Spokane,2/1/15,53063,2,2015,228561,210353,1,18208,8.00%
Stevens,2/1/15,53065,2,2015,17700,15614,1,2086,11.80%
Thurston,2/1/15,53067,2,2015,125452,116723,1,8729,7.00%
Wahkiakum,2/1/15,53069,2,2015,1287,1164,1,123,9.60%
Walla Walla,2/1/15,53071,2,2015,27764,25756,1,2008,7.20%
Whatcom,2/1/15,53073,2,2015,103644,96387,1,7257,7.00%
Whitman,2/1/15,53075,2,2015,22921,21672,1,1249,5.40%
Yakima,2/1/15,53077,2,2015,116744,104364,1,12380,10.60%
Adams,2/1/16,53001,2,2016,8024,7190,1,834,10.40%
Asotin,2/1/16,53003,2,2016,9912,9269,1,643,6.50%
Clallam,2/1/16,53009,2,2016,26957,24503,1,2454,9.10%
Clark,2/1/16,53011,2,2016,220074,204940,1,15134,6.90%
Columbia,2/1/16,53013,2,2016,1711,1575,1,136,7.90%
Cowlitz,2/1/16,53015,2,2016,44491,40792,1,3699,8.30%
Douglas,2/1/16,53017,2,2016,19326,17461,1,1865,9.70%
Ferry,2/1/16,53019,2,2016,2437,2086,1,351,14.40%
Franklin,2/1/16,53021,2,2016,38021,34161,1,3860,10.20%
Garfield,2/1/16,53023,2,2016,884,812,1,72,8.10%
Grant,2/1/16,53025,2,2016,42447,37961,1,4486,10.60%
Grays Harbor,2/1/16,53027,2,2016,27079,24380,1,2699,10.00%
Island,2/1/16,53029,2,2016,32194,29978,1,2216,6.90%
Jefferson,2/1/16,53031,2,2016,11343,10418,1,925,8.20%
King,2/1/16,53033,2,2016,1213797,1164611,1,49186,4.10%
Kitsap,2/1/16,53035,2,2016,117778,110556,1,7222,6.10%
Kittitas,2/1/16,53037,2,2016,21353,19686,1,1667,7.80%
Klickitat,2/1/16,53039,2,2016,9314,8494,1,820,8.80%
Lewis,2/1/16,53041,2,2016,31536,28590,1,2946,9.30%
Lincoln,2/1/16,53043,2,2016,4759,4382,1,377,7.90%
Mason,2/1/16,53045,2,2016,23200,21171,1,2029,8.70%
Okanogan,2/1/16,53047,2,2016,19641,17661,1,1980,10.10%
Pacific,2/1/16,53049,2,2016,8053,7248,1,805,10.00%
Pend Oreille,2/1/16,53051,2,2016,4716,4158,1,558,11.80%
Pierce,2/1/16,53053,2,2016,400186,372575,1,27611,6.90%
San Juan,2/1/16,53055,2,2016,7255,6810,1,445,6.10%
Skagit,2/1/16,53057,2,2016,57334,52814,1,4520,7.90%
Skamania,2/1/16,53059,2,2016,5104,4665,1,439,8.60%
Snohomish,2/1/16,53061,2,2016,415310,396687,1,18623,4.50%
Spokane,2/1/16,53063,2,2016,233651,215898,1,17753,7.60%
Stevens,2/1/16,53065,2,2016,17990,16036,1,1954,10.90%
Thurston,2/1/16,53067,2,2016,128781,120340,1,8441,6.60%
Wahkiakum,2/1/16,53069,2,2016,1298,1163,1,135,10.40%
Walla Walla,2/1/16,53071,2,2016,28222,26268,1,1954,6.90%
Whatcom,2/1/16,53073,2,2016,106508,99184,1,7324,6.90%
Whitman,2/1/16,53075,2,2016,23381,22062,1,1319,5.60%
Yakima,2/1/16,53077,2,2016,119903,107366,1,12537,10.50%
Adams,2/1/17,53001,2,2017,7997,7198,1,799,10.00%
Asotin,2/1/17,53003,2,2017,10243,9708,1,535,5.20%
Clallam,2/1/17,53009,2,2017,27582,25304,1,2278,8.30%
Clark,2/1/17,53011,2,2017,227050,213481,1,13569,6.00%
Columbia,2/1/17,53013,2,2017,1750,1617,1,133,7.60%
Cowlitz,2/1/17,53015,2,2017,45846,42536,1,3310,7.20%
Douglas,2/1/17,53017,2,2017,19770,18051,1,1719,8.70%
Ferry,2/1/17,53019,2,2017,2481,2157,1,324,13.10%
Franklin,2/1/17,53021,2,2017,38557,34941,1,3616,9.40%
Garfield,2/1/17,53023,2,2017,852,794,1,58,6.80%
Grant,2/1/17,53025,2,2017,42388,38251,1,4137,9.80%
Grays Harbor,2/1/17,53027,2,2017,27477,25135,1,2342,8.50%
Island,2/1/17,53029,2,2017,33366,31429,1,1937,5.80%
Jefferson,2/1/17,53031,2,2017,11710,10855,1,855,7.30%
King,2/1/17,53033,2,2017,1238746,1194317,1,44429,3.60%
Kitsap,2/1/17,53035,2,2017,119421,112760,1,6661,5.60%
Kittitas,2/1/17,53037,2,2017,22037,20503,1,1534,7.00%
Klickitat,2/1/17,53039,2,2017,9629,8868,1,761,7.90%
Lewis,2/1/17,53041,2,2017,33108,30453,1,2655,8.00%
Lincoln,2/1/17,53043,2,2017,4791,4467,1,324,6.80%
Mason,2/1/17,53045,2,2017,23536,21611,1,1925,8.20%
Okanogan,2/1/17,53047,2,2017,19644,17671,1,1973,10.00%
Pacific,2/1/17,53049,2,2017,8308,7628,1,680,8.20%
Pend Oreille,2/1/17,53051,2,2017,4779,4304,1,475,9.90%
Pierce,2/1/17,53053,2,2017,413814,388293,1,25521,6.20%
San Juan,2/1/17,53055,2,2017,7472,7069,1,403,5.40%
Skagit,2/1/17,53057,2,2017,58588,54632,1,3956,6.80%
Skamania,2/1/17,53059,2,2017,5317,4889,1,428,8.00%
Snohomish,2/1/17,53061,2,2017,424002,406911,1,17091,4.00%
Spokane,2/1/17,53063,2,2017,238983,222518,1,16465,6.90%
Stevens,2/1/17,53065,2,2017,18141,16393,1,1748,9.60%
Thurston,2/1/17,53067,2,2017,133616,125843,1,7773,5.80%
Wahkiakum,2/1/17,53069,2,2017,1313,1188,1,125,9.50%
Walla Walla,2/1/17,53071,2,2017,28213,26416,1,1797,6.40%
Whatcom,2/1/17,53073,2,2017,108841,102332,1,6509,6.00%
Whitman,2/1/17,53075,2,2017,23772,22636,1,1136,4.80%
Yakima,2/1/17,53077,2,2017,120317,107877,1,12440,10.30%
Adams,2/1/18,53001,2,2018,8681,7892,1,789,9.10%
Asotin,2/1/18,53003,2,2018,10210,9668,1,542,5.30%
Clallam,2/1/18,53009,2,2018,27861,25609,1,2252,8.10%
Clark,2/1/18,53011,2,2018,230978,217958,1,13020,5.60%
Columbia,2/1/18,53013,2,2018,1757,1621,1,136,7.70%
Cowlitz,2/1/18,53015,2,2018,45757,42506,1,3251,7.10%
Douglas,2/1/18,53017,2,2018,20410,18841,1,1569,7.70%
Ferry,2/1/18,53019,2,2018,2498,2060,1,438,17.50%
Franklin,2/1/18,53021,2,2018,40070,36647,1,3423,8.50%
Garfield,2/1/18,53023,2,2018,851,788,1,63,7.40%
Grant,2/1/18,53025,2,2018,43980,40057,1,3923,8.90%
Grays Harbor,2/1/18,53027,2,2018,28147,25893,1,2254,8.00%
Island,2/1/18,53029,2,2018,34341,32205,1,2136,6.20%
Jefferson,2/1/18,53031,2,2018,12053,11146,1,907,7.50%
King,2/1/18,53033,2,2018,1272719,1229565,1,43154,3.40%
Kitsap,2/1/18,53035,2,2018,121995,115231,1,6764,5.50%
Kittitas,2/1/18,53037,2,2018,21750,20217,1,1533,7.00%
Klickitat,2/1/18,53039,2,2018,9796,9063,1,733,7.50%
Lewis,2/1/18,53041,2,2018,33868,31251,1,2617,7.70%
Lincoln,2/1/18,53043,2,2018,4890,4565,1,325,6.60%
Mason,2/1/18,53045,2,2018,24110,22262,1,1848,7.70%
Okanogan,2/1/18,53047,2,2018,19384,17510,1,1874,9.70%
Pacific,2/1/18,53049,2,2018,8380,7698,1,682,8.10%
Pend Oreille,2/1/18,53051,2,2018,4867,4396,1,471,9.70%
Pierce,2/1/18,53053,2,2018,422096,396131,1,25965,6.20%
San Juan,2/1/18,53055,2,2018,7579,7183,1,396,5.20%
Skagit,2/1/18,53057,2,2018,59080,55300,1,3780,6.40%
Skamania,2/1/18,53059,2,2018,5359,4961,1,398,7.40%
Snohomish,2/1/18,53061,2,2018,433850,417448,1,16402,3.80%
Spokane,2/1/18,53063,2,2018,244038,227699,1,16339,6.70%
Stevens,2/1/18,53065,2,2018,18533,16647,1,1886,10.20%
Thurston,2/1/18,53067,2,2018,137503,129641,1,7862,5.70%
Wahkiakum,2/1/18,53069,2,2018,1316,1210,1,106,8.10%
Walla Walla,2/1/18,53071,2,2018,28272,26526,1,1746,6.20%
Whatcom,2/1/18,53073,2,2018,110714,104353,1,6361,5.70%
Whitman,2/1/18,53075,2,2018,23837,22669,1,1168,4.90%
Yakima,2/1/18,53077,2,2018,124195,113623,1,10572,8.50%
Adams,2/1/19,53001,2,2019,8457,7686,1,771,9.10%
Asotin,2/1/19,53003,2,2019,10356,9855,1,501,4.80%
Clallam,2/1/19,53009,2,2019,28786,26189,1,2597,9.00%
Clark,2/1/19,53011,2,2019,241192,228836,1,12356,5.10%
Columbia,2/1/19,53013,2,2019,1816,1688,1,128,7.00%
Cowlitz,2/1/19,53015,2,2019,47884,44701,1,3183,6.60%
Douglas,2/1/19,53017,2,2019,20700,19002,1,1698,8.20%
Ferry,2/1/19,53019,2,2019,2514,2133,1,381,15.20%
Franklin,2/1/19,53021,2,2019,40707,36844,1,3863,9.50%
Garfield,2/1/19,53023,2,2019,884,819,1,65,7.40%
Grant,2/1/19,53025,2,2019,44980,40618,1,4362,9.70%
Grays Harbor,2/1/19,53027,2,2019,29085,26533,1,2552,8.80%
Island,2/1/19,53029,2,2019,35370,33282,1,2088,5.90%
Jefferson,2/1/19,53031,2,2019,12530,11639,1,891,7.10%
King,2/1/19,53033,2,2019,1290113,1251418,1,38695,3.00%
Kitsap,2/1/19,53035,2,2019,127585,120681,1,6904,5.40%
Kittitas,2/1/19,53037,2,2019,22755,21106,1,1649,7.20%
Klickitat,2/1/19,53039,2,2019,9900,9104,1,796,8.00%
Lewis,2/1/19,53041,2,2019,34804,32109,1,2695,7.70%
Lincoln,2/1/19,53043,2,2019,4902,4584,1,318,6.50%
Mason,2/1/19,53045,2,2019,25078,23046,1,2032,8.10%
Okanogan,2/1/19,53047,2,2019,19552,17653,1,1899,9.70%
Pacific,2/1/19,53049,2,2019,8399,7719,1,680,8.10%
Pend Oreille,2/1/19,53051,2,2019,5080,4594,1,486,9.60%
Pierce,2/1/19,53053,2,2019,438949,412240,1,26709,6.10%
San Juan,2/1/19,53055,2,2019,7854,7469,1,385,4.90%
Skagit,2/1/19,53057,2,2019,62138,57821,1,4317,6.90%
Skamania,2/1/19,53059,2,2019,5594,5209,1,385,6.90%
Snohomish,2/1/19,53061,2,2019,440431,424843,1,15588,3.50%
Spokane,2/1/19,53063,2,2019,254303,237962,1,16341,6.40%
Stevens,2/1/19,53065,2,2019,19109,17361,1,1748,9.10%
Thurston,2/1/19,53067,2,2019,142026,133997,1,8029,5.70%
Wahkiakum,2/1/19,53069,2,2019,1374,1270,1,104,7.60%
Walla Walla,2/1/19,53071,2,2019,29160,27337,1,1823,6.30%
Whatcom,2/1/19,53073,2,2019,115073,108038,1,7035,6.10%
Whitman,2/1/19,53075,2,2019,24566,23501,1,1065,4.30%
Yakima,2/1/19,53077,2,2019,124686,111637,1,13049,10.50%
Adams,2/1/20,53001,2,2020,8492,7877,1,615,7.20%
Asotin,2/1/20,53003,2,2020,10651,10212,1,439,4.10%
Clallam,2/1/20,53009,2,2020,29302,27410,1,1892,6.50%
Clark,2/1/20,53011,2,2020,248872,237565,1,11307,4.50%
Columbia,2/1/20,53013,2,2020,1780,1673,1,107,6.00%
Cowlitz,2/1/20,53015,2,2020,49047,46176,1,2871,5.90%
Douglas,2/1/20,53017,2,2020,20992,19575,1,1417,6.80%
Ferry,2/1/20,53019,2,2020,2502,2170,1,332,13.30%
Franklin,2/1/20,53021,2,2020,42448,39385,1,3063,7.20%
Garfield,2/1/20,53023,2,2020,814,757,1,57,7.00%
Grant,2/1/20,53025,2,2020,44955,41109,1,3846,8.60%
Grays Harbor,2/1/20,53027,2,2020,29442,27366,1,2076,7.10%
Island,2/1/20,53029,2,2020,37080,35273,1,1807,4.90%
Jefferson,2/1/20,53031,2,2020,13319,12582,1,737,5.50%
King,2/1/20,53033,2,2020,1310239,1278267,1,31972,2.40%
Kitsap,2/1/20,53035,2,2020,133434,127812,1,5622,4.20%
Kittitas,2/1/20,53037,2,2020,24185,22819,1,1366,5.60%
Klickitat,2/1/20,53039,2,2020,9839,9193,1,646,6.60%
Lewis,2/1/20,53041,2,2020,35364,33121,1,2243,6.30%
Lincoln,2/1/20,53043,2,2020,4753,4465,1,288,6.10%
Mason,2/1/20,53045,2,2020,26576,24931,1,1645,6.20%
Okanogan,2/1/20,53047,2,2020,18929,17265,1,1664,8.80%
Pacific,2/1/20,53049,2,2020,8554,7988,1,566,6.60%
Pend Oreille,2/1/20,53051,2,2020,5183,4711,1,472,9.10%
Pierce,2/1/20,53053,2,2020,456345,433701,1,22644,5.00%
San Juan,2/1/20,53055,2,2020,8485,8124,1,361,4.30%
Skagit,2/1/20,53057,2,2020,63484,59855,1,3629,5.70%
Skamania,2/1/20,53059,2,2020,5667,5355,1,312,5.50%
Snohomish,2/1/20,53061,2,2020,446145,433844,1,12301,2.80%
Spokane,2/1/20,53063,2,2020,262904,248229,1,14675,5.60%
Stevens,2/1/20,53065,2,2020,19367,17706,1,1661,8.60%
Thurston,2/1/20,53067,2,2020,148241,141303,1,6938,4.70%
Wahkiakum,2/1/20,53069,2,2020,1361,1268,1,93,6.80%
Walla Walla,2/1/20,53071,2,2020,30292,28821,1,1471,4.90%
Whatcom,2/1/20,53073,2,2020,118175,112296,1,5879,5.00%
Whitman,2/1/20,53075,2,2020,24585,23645,1,940,3.80%
Yakima,2/1/20,53077,2,2020,130037,119652,1,10385,8.00%
Adams,3/1/90,53001,3,1990,7150,6314,1,836,11.70%
Asotin,3/1/90,53003,3,1990,9445,8881,1,564,6.00%
Clallam,3/1/90,53009,3,1990,23240,21350,1,1890,8.10%
Columbia,3/1/90,53013,3,1990,1488,1221,1,267,17.90%
Cowlitz,3/1/90,53015,3,1990,38658,35806,1,2852,7.40%
Douglas,3/1/90,53017,3,1990,14966,13692,1,1274,8.50%
Ferry,3/1/90,53019,3,1990,2867,2335,1,532,18.60%
Franklin,3/1/90,53021,3,1990,18811,16586,1,2225,11.80%
Garfield,3/1/90,53023,3,1990,1092,1046,1,46,4.20%
Grant,3/1/90,53025,3,1990,25813,23108,1,2705,10.50%
Grays Harbor,3/1/90,53027,3,1990,27999,25038,1,2961,10.60%
Island,3/1/90,53029,3,1990,23414,22491,1,923,3.90%
Jefferson,3/1/90,53031,3,1990,8257,7804,1,453,5.50%
King,3/1/90,53033,3,1990,859249,824890,1,34359,4.00%
Kitsap,3/1/90,53035,3,1990,86087,82439,1,3648,4.20%
Kittitas,3/1/90,53037,3,1990,13910,12649,1,1261,9.10%
Klickitat,3/1/90,53039,3,1990,8019,6617,1,1402,17.50%
Lewis,3/1/90,53041,3,1990,26411,24001,1,2410,9.10%
Lincoln,3/1/90,53043,3,1990,4201,3975,1,226,5.40%
Mason,3/1/90,53045,3,1990,15611,14575,1,1036,6.60%
Okanogan,3/1/90,53047,3,1990,17856,15603,1,2253,12.60%
Pacific,3/1/90,53049,3,1990,7496,6794,1,702,9.40%
Pend Oreille,3/1/90,53051,3,1990,3610,2974,1,636,17.60%
Pierce,3/1/90,53053,3,1990,279573,265212,1,14361,5.10%
San Juan,3/1/90,53055,3,1990,4596,4418,1,178,3.90%
Skagit,3/1/90,53057,3,1990,39139,36046,1,3093,7.90%
Skamania,3/1/90,53059,3,1990,3905,3383,1,522,13.40%
Snohomish,3/1/90,53061,3,1990,250738,239071,1,11667,4.70%
Spokane,3/1/90,53063,3,1990,176251,164685,1,11566,6.60%
Stevens,3/1/90,53065,3,1990,13832,12188,1,1644,11.90%
Thurston,3/1/90,53067,3,1990,82218,77873,1,4345,5.30%
Wahkiakum,3/1/90,53069,3,1990,1511,1402,1,109,7.20%
Walla Walla,3/1/90,53071,3,1990,24545,22108,1,2437,9.90%
Whatcom,3/1/90,53073,3,1990,67530,63398,1,4132,6.10%
Whitman,3/1/90,53075,3,1990,18320,18011,1,309,1.70%
Yakima,3/1/90,53077,3,1990,98689,84735,1,13954,14.10%
Adams,3/1/91,53001,3,1991,7520,6606,1,914,12.20%
Asotin,3/1/91,53003,3,1991,9427,8688,1,739,7.80%
Clallam,3/1/91,53009,3,1991,22892,20791,1,2101,9.20%
Columbia,3/1/91,53013,3,1991,1270,1021,1,249,19.60%
Cowlitz,3/1/91,53015,3,1991,39408,36214,1,3194,8.10%
Douglas,3/1/91,53017,3,1991,15170,13607,1,1563,10.30%
Ferry,3/1/91,53019,3,1991,2778,2256,1,522,18.80%
Franklin,3/1/91,53021,3,1991,19280,16720,1,2560,13.30%
Garfield,3/1/91,53023,3,1991,1008,960,1,48,4.80%
Grant,3/1/91,53025,3,1991,27170,23986,1,3184,11.70%
Grays Harbor,3/1/91,53027,3,1991,27604,24023,1,3581,13.00%
Island,3/1/91,53029,3,1991,22987,21869,1,1118,4.90%
Jefferson,3/1/91,53031,3,1991,8085,7486,1,599,7.40%
King,3/1/91,53033,3,1991,855809,819030,1,36779,4.30%
Kitsap,3/1/91,53035,3,1991,86463,81801,1,4662,5.40%
Kittitas,3/1/91,53037,3,1991,13661,12215,1,1446,10.60%
Klickitat,3/1/91,53039,3,1991,7487,6229,1,1258,16.80%
Lewis,3/1/91,53041,3,1991,26302,23064,1,3238,12.30%
Lincoln,3/1/91,53043,3,1991,4088,3863,1,225,5.50%
Mason,3/1/91,53045,3,1991,15757,14094,1,1663,10.60%
Okanogan,3/1/91,53047,3,1991,18463,15693,1,2770,15.00%
Pacific,3/1/91,53049,3,1991,7643,6781,1,862,11.30%
Pend Oreille,3/1/91,53051,3,1991,3438,2761,1,677,19.70%
Pierce,3/1/91,53053,3,1991,278507,259460,1,19047,6.80%
San Juan,3/1/91,53055,3,1991,4781,4565,1,216,4.50%
Skagit,3/1/91,53057,3,1991,39611,35898,1,3713,9.40%
Skamania,3/1/91,53059,3,1991,3983,3489,1,494,12.40%
Snohomish,3/1/91,53061,3,1991,254968,241197,1,13771,5.40%
Spokane,3/1/91,53063,3,1991,176557,163850,1,12707,7.20%
Stevens,3/1/91,53065,3,1991,13755,11887,1,1868,13.60%
Thurston,3/1/91,53067,3,1991,83226,78039,1,5187,6.20%
Wahkiakum,3/1/91,53069,3,1991,1492,1410,1,82,5.50%
Walla Walla,3/1/91,53071,3,1991,23491,20913,1,2578,11.00%
Whatcom,3/1/91,53073,3,1991,69085,63997,1,5088,7.40%
Whitman,3/1/91,53075,3,1991,18093,17734,1,359,2.00%
Yakima,3/1/91,53077,3,1991,98983,84024,1,14959,15.10%
Adams,3/1/92,53001,3,1992,7477,6305,1,1172,15.70%
Asotin,3/1/92,53003,3,1992,9865,9213,1,652,6.60%
Clallam,3/1/92,53009,3,1992,23142,20939,1,2203,9.50%
Columbia,3/1/92,53013,3,1992,1390,1072,1,318,22.90%
Cowlitz,3/1/92,53015,3,1992,37970,33860,1,4110,10.80%
Douglas,3/1/92,53017,3,1992,15425,13928,1,1497,9.70%
Ferry,3/1/92,53019,3,1992,2878,2237,1,641,22.30%
Franklin,3/1/92,53021,3,1992,19691,17194,1,2497,12.70%
Garfield,3/1/92,53023,3,1992,1050,1000,1,50,4.80%
Grant,3/1/92,53025,3,1992,28250,24646,1,3604,12.80%
Grays Harbor,3/1/92,53027,3,1992,27572,24080,1,3492,12.70%
Island,3/1/92,53029,3,1992,24124,22565,1,1559,6.50%
Jefferson,3/1/92,53031,3,1992,8349,7470,1,879,10.50%
King,3/1/92,53033,3,1992,886578,837293,1,49285,5.60%
Kitsap,3/1/92,53035,3,1992,87619,82081,1,5538,6.30%
Kittitas,3/1/92,53037,3,1992,13881,12055,1,1826,13.20%
Klickitat,3/1/92,53039,3,1992,7855,6435,1,1420,18.10%
Lewis,3/1/92,53041,3,1992,27143,23799,1,3344,12.30%
Lincoln,3/1/92,53043,3,1992,4179,3899,1,280,6.70%
Mason,3/1/92,53045,3,1992,15494,14094,1,1400,9.00%
Okanogan,3/1/92,53047,3,1992,18939,16225,1,2714,14.30%
Pacific,3/1/92,53049,3,1992,7900,7010,1,890,11.30%
Pend Oreille,3/1/92,53051,3,1992,3701,2966,1,735,19.90%
Pierce,3/1/92,53053,3,1992,285639,263434,1,22205,7.80%
San Juan,3/1/92,53055,3,1992,4932,4529,1,403,8.20%
Skagit,3/1/92,53057,3,1992,40854,36224,1,4630,11.30%
Skamania,3/1/92,53059,3,1992,3762,3070,1,692,18.40%
Snohomish,3/1/92,53061,3,1992,267480,250737,1,16743,6.30%
Spokane,3/1/92,53063,3,1992,179723,165905,1,13818,7.70%
Stevens,3/1/92,53065,3,1992,14547,12439,1,2108,14.50%
Thurston,3/1/92,53067,3,1992,85988,80031,1,5957,6.90%
Wahkiakum,3/1/92,53069,3,1992,1578,1472,1,106,6.70%
Walla Walla,3/1/92,53071,3,1992,24229,21563,1,2666,11.00%
Whatcom,3/1/92,53073,3,1992,72669,66601,1,6068,8.40%
Whitman,3/1/92,53075,3,1992,17826,17398,1,428,2.40%
Yakima,3/1/92,53077,3,1992,102081,86048,1,16033,15.70%
Adams,3/1/93,53001,3,1993,8077,6344,1,1733,21.50%
Asotin,3/1/93,53003,3,1993,9857,9193,1,664,6.70%
Clallam,3/1/93,53009,3,1993,22991,20595,1,2396,10.40%
Columbia,3/1/93,53013,3,1993,1376,1070,1,306,22.20%
Cowlitz,3/1/93,53015,3,1993,38572,34067,1,4505,11.70%
Douglas,3/1/93,53017,3,1993,16081,14406,1,1675,10.40%
Ferry,3/1/93,53019,3,1993,2795,2185,1,610,21.80%
Franklin,3/1/93,53021,3,1993,21721,18201,1,3520,16.20%
Garfield,3/1/93,53023,3,1993,1067,966,1,101,9.50%
Grant,3/1/93,53025,3,1993,29807,24882,1,4925,16.50%
Grays Harbor,3/1/93,53027,3,1993,27886,23638,1,4248,15.20%
Island,3/1/93,53029,3,1993,23988,22597,1,1391,5.80%
Jefferson,3/1/93,53031,3,1993,9101,8270,1,831,9.10%
King,3/1/93,53033,3,1993,901884,848230,1,53654,5.90%
Kitsap,3/1/93,53035,3,1993,89892,83884,1,6008,6.70%
Kittitas,3/1/93,53037,3,1993,14434,12578,1,1856,12.90%
Klickitat,3/1/93,53039,3,1993,8101,6469,1,1632,20.10%
Lewis,3/1/93,53041,3,1993,27037,23837,1,3200,11.80%
Lincoln,3/1/93,53043,3,1993,4243,3928,1,315,7.40%
Mason,3/1/93,53045,3,1993,15994,14293,1,1701,10.60%
Okanogan,3/1/93,53047,3,1993,19759,16672,1,3087,15.60%
Pacific,3/1/93,53049,3,1993,7713,6683,1,1030,13.40%
Pend Oreille,3/1/93,53051,3,1993,3805,3112,1,693,18.20%
Pierce,3/1/93,53053,3,1993,293582,270735,1,22847,7.80%
San Juan,3/1/93,53055,3,1993,4850,4320,1,530,10.90%
Skagit,3/1/93,53057,3,1993,42679,37330,1,5349,12.50%
Skamania,3/1/93,53059,3,1993,3936,3111,1,825,21.00%
Snohomish,3/1/93,53061,3,1993,276605,257836,1,18769,6.80%
Spokane,3/1/93,53063,3,1993,182588,169037,1,13551,7.40%
Stevens,3/1/93,53065,3,1993,15076,13127,1,1949,12.90%
Thurston,3/1/93,53067,3,1993,87854,81615,1,6239,7.10%
Wahkiakum,3/1/93,53069,3,1993,1626,1492,1,134,8.20%
Walla Walla,3/1/93,53071,3,1993,24526,22040,1,2486,10.10%
Whatcom,3/1/93,53073,3,1993,74020,67668,1,6352,8.60%
Whitman,3/1/93,53075,3,1993,18144,17612,1,532,2.90%
Yakima,3/1/93,53077,3,1993,105576,86552,1,19024,18.00%
Adams,3/1/94,53001,3,1994,8043,6713,1,1330,16.50%
Asotin,3/1/94,53003,3,1994,10924,10377,1,547,5.00%
Clallam,3/1/94,53009,3,1994,23046,20242,1,2804,12.20%
Columbia,3/1/94,53013,3,1994,1333,1069,1,264,19.80%
Cowlitz,3/1/94,53015,3,1994,39005,34626,1,4379,11.20%
Douglas,3/1/94,53017,3,1994,16733,15125,1,1608,9.60%
Ferry,3/1/94,53019,3,1994,2886,2286,1,600,20.80%
Franklin,3/1/94,53021,3,1994,22090,19543,1,2547,11.50%
Garfield,3/1/94,53023,3,1994,1056,979,1,77,7.30%
Grant,3/1/94,53025,3,1994,30956,27000,1,3956,12.80%
Grays Harbor,3/1/94,53027,3,1994,27581,23244,1,4337,15.70%
Island,3/1/94,53029,3,1994,24547,23062,1,1485,6.00%
Jefferson,3/1/94,53031,3,1994,9007,7966,1,1041,11.60%
King,3/1/94,53033,3,1994,898850,851501,1,47349,5.30%
Kitsap,3/1/94,53035,3,1994,89626,82810,1,6816,7.60%
Kittitas,3/1/94,53037,3,1994,14864,13019,1,1845,12.40%
Klickitat,3/1/94,53039,3,1994,8099,6658,1,1441,17.80%
Lewis,3/1/94,53041,3,1994,28206,25173,1,3033,10.80%
Lincoln,3/1/94,53043,3,1994,4324,3983,1,341,7.90%
Mason,3/1/94,53045,3,1994,16604,14781,1,1823,11.00%
Okanogan,3/1/94,53047,3,1994,20312,17511,1,2801,13.80%
Pacific,3/1/94,53049,3,1994,7731,6788,1,943,12.20%
Pend Oreille,3/1/94,53051,3,1994,3889,3233,1,656,16.90%
Pierce,3/1/94,53053,3,1994,304322,279112,1,25210,8.30%
San Juan,3/1/94,53055,3,1994,4943,4427,1,516,10.40%
Skagit,3/1/94,53057,3,1994,46787,41467,1,5320,11.40%
Skamania,3/1/94,53059,3,1994,3988,3358,1,630,15.80%
Snohomish,3/1/94,53061,3,1994,280582,262681,1,17901,6.40%
Spokane,3/1/94,53063,3,1994,191361,178720,1,12641,6.60%
Stevens,3/1/94,53065,3,1994,16407,14239,1,2168,13.20%
Thurston,3/1/94,53067,3,1994,90036,83358,1,6678,7.40%
Wahkiakum,3/1/94,53069,3,1994,1706,1571,1,135,7.90%
Walla Walla,3/1/94,53071,3,1994,25327,23134,1,2193,8.70%
Whatcom,3/1/94,53073,3,1994,73878,67450,1,6428,8.70%
Whitman,3/1/94,53075,3,1994,18464,17983,1,481,2.60%
Yakima,3/1/94,53077,3,1994,106986,89731,1,17255,16.10%
Adams,3/1/95,53001,3,1995,8317,7140,1,1177,14.20%
Asotin,3/1/95,53003,3,1995,11603,11014,1,589,5.10%
Clallam,3/1/95,53009,3,1995,24151,21705,1,2446,10.10%
Columbia,3/1/95,53013,3,1995,1346,1089,1,257,19.10%
Cowlitz,3/1/95,53015,3,1995,41110,37847,1,3263,7.90%
Douglas,3/1/95,53017,3,1995,17072,15663,1,1409,8.30%
Ferry,3/1/95,53019,3,1995,2987,2375,1,612,20.50%
Franklin,3/1/95,53021,3,1995,23109,20517,1,2592,11.20%
Garfield,3/1/95,53023,3,1995,1025,962,1,63,6.10%
Grant,3/1/95,53025,3,1995,32262,28535,1,3727,11.60%
Grays Harbor,3/1/95,53027,3,1995,28185,24806,1,3379,12.00%
Island,3/1/95,53029,3,1995,25877,24614,1,1263,4.90%
Jefferson,3/1/95,53031,3,1995,9912,9068,1,844,8.50%
King,3/1/95,53033,3,1995,903364,861817,1,41547,4.60%
Kitsap,3/1/95,53035,3,1995,92005,85401,1,6604,7.20%
Kittitas,3/1/95,53037,3,1995,16688,15014,1,1674,10.00%
Klickitat,3/1/95,53039,3,1995,8750,7473,1,1277,14.60%
Lewis,3/1/95,53041,3,1995,29784,27023,1,2761,9.30%
Lincoln,3/1/95,53043,3,1995,4646,4290,1,356,7.70%
Mason,3/1/95,53045,3,1995,17888,16210,1,1678,9.40%
Okanogan,3/1/95,53047,3,1995,21619,18735,1,2884,13.30%
Pacific,3/1/95,53049,3,1995,8160,7317,1,843,10.30%
Pend Oreille,3/1/95,53051,3,1995,4126,3379,1,747,18.10%
Pierce,3/1/95,53053,3,1995,320282,298477,1,21805,6.80%
San Juan,3/1/95,53055,3,1995,5143,4656,1,487,9.50%
Skagit,3/1/95,53057,3,1995,48623,43726,1,4897,10.10%
Skamania,3/1/95,53059,3,1995,4151,3649,1,502,12.10%
Snohomish,3/1/95,53061,3,1995,283176,268152,1,15024,5.30%
Spokane,3/1/95,53063,3,1995,201515,188668,1,12847,6.40%
Stevens,3/1/95,53065,3,1995,16719,14532,1,2187,13.10%
Thurston,3/1/95,53067,3,1995,95239,89016,1,6223,6.50%
Wahkiakum,3/1/95,53069,3,1995,1748,1632,1,116,6.60%
Walla Walla,3/1/95,53071,3,1995,26510,24280,1,2230,8.40%
Whatcom,3/1/95,53073,3,1995,78432,72041,1,6391,8.10%
Whitman,3/1/95,53075,3,1995,18983,18539,1,444,2.30%
Yakima,3/1/95,53077,3,1995,110445,93634,1,16811,15.20%
Adams,3/1/96,53001,3,1996,8249,7198,1,1051,12.70%
Asotin,3/1/96,53003,3,1996,11944,11232,1,712,6.00%
Clallam,3/1/96,53009,3,1996,24591,22008,1,2583,10.50%
Columbia,3/1/96,53013,3,1996,1401,1143,1,258,18.40%
Cowlitz,3/1/96,53015,3,1996,42152,38419,1,3733,8.90%
Douglas,3/1/96,53017,3,1996,17679,16200,1,1479,8.40%
Ferry,3/1/96,53019,3,1996,2963,2371,1,592,20.00%
Franklin,3/1/96,53021,3,1996,22820,19621,1,3199,14.00%
Garfield,3/1/96,53023,3,1996,1099,1029,1,70,6.40%
Grant,3/1/96,53025,3,1996,33139,29193,1,3946,11.90%
Grays Harbor,3/1/96,53027,3,1996,27835,24549,1,3286,11.80%
Island,3/1/96,53029,3,1996,26231,24981,1,1250,4.80%
Jefferson,3/1/96,53031,3,1996,9871,9039,1,832,8.40%
King,3/1/96,53033,3,1996,922414,880414,1,42000,4.60%
Kitsap,3/1/96,53035,3,1996,94544,87802,1,6742,7.10%
Kittitas,3/1/96,53037,3,1996,16217,14517,1,1700,10.50%
Klickitat,3/1/96,53039,3,1996,8721,7463,1,1258,14.40%
Lewis,3/1/96,53041,3,1996,30700,27589,1,3111,10.10%
Lincoln,3/1/96,53043,3,1996,4897,4506,1,391,8.00%
Mason,3/1/96,53045,3,1996,19046,17296,1,1750,9.20%
Okanogan,3/1/96,53047,3,1996,21447,18410,1,3037,14.20%
Pacific,3/1/96,53049,3,1996,8282,7403,1,879,10.60%
Pend Oreille,3/1/96,53051,3,1996,4104,3326,1,778,19.00%
Pierce,3/1/96,53053,3,1996,323209,301599,1,21610,6.70%
San Juan,3/1/96,53055,3,1996,5149,4679,1,470,9.10%
Skagit,3/1/96,53057,3,1996,46832,41895,1,4937,10.50%
Skamania,3/1/96,53059,3,1996,3982,3484,1,498,12.50%
Snohomish,3/1/96,53061,3,1996,292240,277103,1,15137,5.20%
Spokane,3/1/96,53063,3,1996,204247,190775,1,13472,6.60%
Stevens,3/1/96,53065,3,1996,17248,14880,1,2368,13.70%
Thurston,3/1/96,53067,3,1996,98224,91689,1,6535,6.70%
Wahkiakum,3/1/96,53069,3,1996,1682,1567,1,115,6.80%
Walla Walla,3/1/96,53071,3,1996,26563,24220,1,2343,8.80%
Whatcom,3/1/96,53073,3,1996,80069,73749,1,6320,7.90%
Whitman,3/1/96,53075,3,1996,19720,19203,1,517,2.60%
Yakima,3/1/96,53077,3,1996,111160,93446,1,17714,15.90%
Adams,3/1/97,53001,3,1997,8046,7118,1,928,11.50%
Asotin,3/1/97,53003,3,1997,12241,11656,1,585,4.80%
Clallam,3/1/97,53009,3,1997,25112,22850,1,2262,9.00%
Columbia,3/1/97,53013,3,1997,1362,1142,1,220,16.20%
Cowlitz,3/1/97,53015,3,1997,42850,39327,1,3523,8.20%
Douglas,3/1/97,53017,3,1997,18548,17141,1,1407,7.60%
Ferry,3/1/97,53019,3,1997,2896,2430,1,466,16.10%
Franklin,3/1/97,53021,3,1997,22333,19849,1,2484,11.10%
Garfield,3/1/97,53023,3,1997,1141,1092,1,49,4.30%
Grant,3/1/97,53025,3,1997,34549,30714,1,3835,11.10%
Grays Harbor,3/1/97,53027,3,1997,28339,25244,1,3095,10.90%
Island,3/1/97,53029,3,1997,27905,26858,1,1047,3.80%
Jefferson,3/1/97,53031,3,1997,9859,9081,1,778,7.90%
King,3/1/97,53033,3,1997,956926,918141,1,38785,4.10%
Kitsap,3/1/97,53035,3,1997,94942,89272,1,5670,6.00%
Kittitas,3/1/97,53037,3,1997,16791,15544,1,1247,7.40%
Klickitat,3/1/97,53039,3,1997,9089,7892,1,1197,13.20%
Lewis,3/1/97,53041,3,1997,32167,29236,1,2931,9.10%
Lincoln,3/1/97,53043,3,1997,4931,4590,1,341,6.90%
Mason,3/1/97,53045,3,1997,19556,17965,1,1591,8.10%
Okanogan,3/1/97,53047,3,1997,22299,19571,1,2728,12.20%
Pacific,3/1/97,53049,3,1997,8659,7778,1,881,10.20%
Pend Oreille,3/1/97,53051,3,1997,4209,3417,1,792,18.80%
Pierce,3/1/97,53053,3,1997,334815,318070,1,16745,5.00%
San Juan,3/1/97,53055,3,1997,5264,4843,1,421,8.00%
Skagit,3/1/97,53057,3,1997,48082,44089,1,3993,8.30%
Skamania,3/1/97,53059,3,1997,4028,3567,1,461,11.40%
Snohomish,3/1/97,53061,3,1997,310282,297091,1,13191,4.30%
Spokane,3/1/97,53063,3,1997,209441,197540,1,11901,5.70%
Stevens,3/1/97,53065,3,1997,17576,15308,1,2268,12.90%
Thurston,3/1/97,53067,3,1997,100883,95303,1,5580,5.50%
Wahkiakum,3/1/97,53069,3,1997,1857,1733,1,124,6.70%
Walla Walla,3/1/97,53071,3,1997,27190,25059,1,2131,7.80%
Whatcom,3/1/97,53073,3,1997,79458,74022,1,5436,6.80%
Whitman,3/1/97,53075,3,1997,20096,19698,1,398,2.00%
Yakima,3/1/97,53077,3,1997,112371,98751,1,13620,12.10%
Adams,3/1/98,53001,3,1998,8829,7784,1,1045,11.80%
Asotin,3/1/98,53003,3,1998,12851,12251,1,600,4.70%
Clallam,3/1/98,53009,3,1998,25295,23138,1,2157,8.50%
Columbia,3/1/98,53013,3,1998,1397,1176,1,221,15.80%
Cowlitz,3/1/98,53015,3,1998,43199,39880,1,3319,7.70%
Douglas,3/1/98,53017,3,1998,18723,17340,1,1383,7.40%
Ferry,3/1/98,53019,3,1998,2828,2374,1,454,16.10%
Franklin,3/1/98,53021,3,1998,23284,20698,1,2586,11.10%
Garfield,3/1/98,53023,3,1998,1107,1060,1,47,4.20%
Grant,3/1/98,53025,3,1998,36234,32417,1,3817,10.50%
Grays Harbor,3/1/98,53027,3,1998,28114,25148,1,2966,10.50%
Island,3/1/98,53029,3,1998,29930,28706,1,1224,4.10%
Jefferson,3/1/98,53031,3,1998,10036,9292,1,744,7.40%
King,3/1/98,53033,3,1998,979975,946815,1,33160,3.40%
Kitsap,3/1/98,53035,3,1998,94800,89765,1,5035,5.30%
Kittitas,3/1/98,53037,3,1998,16115,14881,1,1234,7.70%
Klickitat,3/1/98,53039,3,1998,8938,7748,1,1190,13.30%
Lewis,3/1/98,53041,3,1998,31197,28218,1,2979,9.50%
Lincoln,3/1/98,53043,3,1998,5166,4827,1,339,6.60%
Mason,3/1/98,53045,3,1998,20150,18664,1,1486,7.40%
Okanogan,3/1/98,53047,3,1998,21802,18836,1,2966,13.60%
Pacific,3/1/98,53049,3,1998,8606,7758,1,848,9.90%
Pend Oreille,3/1/98,53051,3,1998,4313,3642,1,671,15.60%
Pierce,3/1/98,53053,3,1998,343807,327504,1,16303,4.70%
San Juan,3/1/98,53055,3,1998,5572,5223,1,349,6.30%
Skagit,3/1/98,53057,3,1998,48296,44440,1,3856,8.00%
Skamania,3/1/98,53059,3,1998,4354,3841,1,513,11.80%
Snohomish,3/1/98,53061,3,1998,323673,312502,1,11171,3.50%
Spokane,3/1/98,53063,3,1998,215691,204575,1,11116,5.20%
Stevens,3/1/98,53065,3,1998,18158,15975,1,2183,12.00%
Thurston,3/1/98,53067,3,1998,105496,100078,1,5418,5.10%
Wahkiakum,3/1/98,53069,3,1998,2018,1882,1,136,6.70%
Walla Walla,3/1/98,53071,3,1998,27801,25504,1,2297,8.30%
Whatcom,3/1/98,53073,3,1998,81391,76226,1,5165,6.30%
Whitman,3/1/98,53075,3,1998,20669,20229,1,440,2.10%
Yakima,3/1/98,53077,3,1998,113820,99547,1,14273,12.50%
Adams,3/1/99,53001,3,1999,8726,7625,1,1101,12.60%
Asotin,3/1/99,53003,3,1999,12988,12371,1,617,4.80%
Clallam,3/1/99,53009,3,1999,26307,24058,1,2249,8.50%
Columbia,3/1/99,53013,3,1999,1434,1198,1,236,16.50%
Cowlitz,3/1/99,53015,3,1999,43607,40107,1,3500,8.00%
Douglas,3/1/99,53017,3,1999,18989,17476,1,1513,8.00%
Ferry,3/1/99,53019,3,1999,2798,2332,1,466,16.70%
Franklin,3/1/99,53021,3,1999,23682,20948,1,2734,11.50%
Garfield,3/1/99,53023,3,1999,1124,1064,1,60,5.30%
Grant,3/1/99,53025,3,1999,38264,33848,1,4416,11.50%
Grays Harbor,3/1/99,53027,3,1999,27805,25272,1,2533,9.10%
Island,3/1/99,53029,3,1999,31031,29898,1,1133,3.70%
Jefferson,3/1/99,53031,3,1999,11400,10581,1,819,7.20%
King,3/1/99,53033,3,1999,985638,954125,1,31513,3.20%
Kitsap,3/1/99,53035,3,1999,99722,94569,1,5153,5.20%
Kittitas,3/1/99,53037,3,1999,16182,14966,1,1216,7.50%
Klickitat,3/1/99,53039,3,1999,8924,7852,1,1072,12.00%
Lewis,3/1/99,53041,3,1999,31641,28704,1,2937,9.30%
Lincoln,3/1/99,53043,3,1999,4975,4643,1,332,6.70%
Mason,3/1/99,53045,3,1999,19624,18190,1,1434,7.30%
Okanogan,3/1/99,53047,3,1999,21202,18547,1,2655,12.50%
Pacific,3/1/99,53049,3,1999,8137,7356,1,781,9.60%
Pend Oreille,3/1/99,53051,3,1999,4338,3720,1,618,14.20%
Pierce,3/1/99,53053,3,1999,351442,334947,1,16495,4.70%
San Juan,3/1/99,53055,3,1999,6344,5988,1,356,5.60%
Skagit,3/1/99,53057,3,1999,51577,48141,1,3436,6.70%
Skamania,3/1/99,53059,3,1999,4197,3765,1,432,10.30%
Snohomish,3/1/99,53061,3,1999,331279,318864,1,12415,3.70%
Spokane,3/1/99,53063,3,1999,222375,209127,1,13248,6.00%
Stevens,3/1/99,53065,3,1999,17758,15759,1,1999,11.30%
Thurston,3/1/99,53067,3,1999,107298,102239,1,5059,4.70%
Wahkiakum,3/1/99,53069,3,1999,2024,1881,1,143,7.10%
Walla Walla,3/1/99,53071,3,1999,27821,25456,1,2365,8.50%
Whatcom,3/1/99,53073,3,1999,86523,81642,1,4881,5.60%
Whitman,3/1/99,53075,3,1999,20809,20381,1,428,2.10%
Yakima,3/1/99,53077,3,1999,114021,100133,1,13888,12.20%
Adams,3/1/00,53001,3,2000,7547,6749,1,798,10.60%
Asotin,3/1/00,53003,3,2000,9857,9255,1,602,6.10%
Clallam,3/1/00,53009,3,2000,26265,24155,1,2110,8.00%
Columbia,3/1/00,53013,3,2000,1579,1386,1,193,12.20%
Cowlitz,3/1/00,53015,3,2000,44226,40975,1,3251,7.40%
Douglas,3/1/00,53017,3,2000,17363,16062,1,1301,7.50%
Ferry,3/1/00,53019,3,2000,3079,2634,1,445,14.50%
Franklin,3/1/00,53021,3,2000,22568,20586,1,1982,8.80%
Garfield,3/1/00,53023,3,2000,1004,945,1,59,5.90%
Grant,3/1/00,53025,3,2000,34092,30430,1,3662,10.70%
Grays Harbor,3/1/00,53027,3,2000,29312,26926,1,2386,8.10%
Island,3/1/00,53029,3,2000,29880,28155,1,1725,5.80%
Jefferson,3/1/00,53031,3,2000,11728,10963,1,765,6.50%
King,3/1/00,53033,3,2000,1000509,963344,1,37165,3.70%
Kitsap,3/1/00,53035,3,2000,107892,101747,1,6145,5.70%
Kittitas,3/1/00,53037,3,2000,17841,16570,1,1271,7.10%
Klickitat,3/1/00,53039,3,2000,8994,7970,1,1024,11.40%
Lewis,3/1/00,53041,3,2000,30431,27822,1,2609,8.60%
Lincoln,3/1/00,53043,3,2000,4491,4214,1,277,6.20%
Mason,3/1/00,53045,3,2000,21078,19578,1,1500,7.10%
Okanogan,3/1/00,53047,3,2000,19694,17452,1,2242,11.40%
Pacific,3/1/00,53049,3,2000,8424,7705,1,719,8.50%
Pend Oreille,3/1/00,53051,3,2000,4641,4130,1,511,11.00%
Pierce,3/1/00,53053,3,2000,345708,326304,1,19404,5.60%
San Juan,3/1/00,53055,3,2000,7086,6706,1,380,5.40%
Skagit,3/1/00,53057,3,2000,51782,48053,1,3729,7.20%
Skamania,3/1/00,53059,3,2000,4933,4512,1,421,8.50%
Snohomish,3/1/00,53061,3,2000,329085,314446,1,14639,4.40%
Spokane,3/1/00,53063,3,2000,213727,200364,1,13363,6.30%
Stevens,3/1/00,53065,3,2000,17884,15982,1,1902,10.60%
Thurston,3/1/00,53067,3,2000,110269,104536,1,5733,5.20%
Wahkiakum,3/1/00,53069,3,2000,1648,1515,1,133,8.10%
Walla Walla,3/1/00,53071,3,2000,27175,25070,1,2105,7.70%
Whatcom,3/1/00,53073,3,2000,89645,84288,1,5357,6.00%
Whitman,3/1/00,53075,3,2000,19929,19182,1,747,3.70%
Yakima,3/1/00,53077,3,2000,109835,98488,1,11347,10.30%
Adams,3/1/01,53001,3,2001,7268,6432,1,836,11.50%
Asotin,3/1/01,53003,3,2001,9840,9181,1,659,6.70%
Clallam,3/1/01,53009,3,2001,25665,23314,1,2351,9.20%
Columbia,3/1/01,53013,3,2001,1565,1370,1,195,12.50%
Cowlitz,3/1/01,53015,3,2001,42574,38245,1,4329,10.20%
Douglas,3/1/01,53017,3,2001,16325,14953,1,1372,8.40%
Ferry,3/1/01,53019,3,2001,2873,2390,1,483,16.80%
Franklin,3/1/01,53021,3,2001,22771,20562,1,2209,9.70%
Garfield,3/1/01,53023,3,2001,1025,958,1,67,6.50%
Grant,3/1/01,53025,3,2001,33686,29725,1,3961,11.80%
Grays Harbor,3/1/01,53027,3,2001,28783,25774,1,3009,10.50%
Island,3/1/01,53029,3,2001,28842,27037,1,1805,6.30%
Jefferson,3/1/01,53031,3,2001,11762,10934,1,828,7.00%
King,3/1/01,53033,3,2001,1005840,960922,1,44918,4.50%
Kitsap,3/1/01,53035,3,2001,105136,98335,1,6801,6.50%
Kittitas,3/1/01,53037,3,2001,17107,15703,1,1404,8.20%
Klickitat,3/1/01,53039,3,2001,9280,7903,1,1377,14.80%
Lewis,3/1/01,53041,3,2001,29183,26172,1,3011,10.30%
Lincoln,3/1/01,53043,3,2001,4456,4156,1,300,6.70%
Mason,3/1/01,53045,3,2001,20400,18617,1,1783,8.70%
Okanogan,3/1/01,53047,3,2001,17898,15441,1,2457,13.70%
Pacific,3/1/01,53049,3,2001,8530,7685,1,845,9.90%
Pend Oreille,3/1/01,53051,3,2001,4619,4066,1,553,12.00%
Pierce,3/1/01,53053,3,2001,336103,313008,1,23095,6.90%
San Juan,3/1/01,53055,3,2001,6976,6550,1,426,6.10%
Skagit,3/1/01,53057,3,2001,50855,46816,1,4039,7.90%
Skamania,3/1/01,53059,3,2001,4951,4373,1,578,11.70%
Snohomish,3/1/01,53061,3,2001,333979,317966,1,16013,4.80%
Spokane,3/1/01,53063,3,2001,211934,196121,1,15813,7.50%
Stevens,3/1/01,53065,3,2001,17277,15194,1,2083,12.10%
Thurston,3/1/01,53067,3,2001,107511,100766,1,6745,6.30%
Wahkiakum,3/1/01,53069,3,2001,1600,1440,1,160,10.00%
Walla Walla,3/1/01,53071,3,2001,27103,24896,1,2207,8.10%
Whatcom,3/1/01,53073,3,2001,87049,80856,1,6193,7.10%
Whitman,3/1/01,53075,3,2001,19028,18172,1,856,4.50%
Yakima,3/1/01,53077,3,2001,105805,93243,1,12562,11.90%
Adams,3/1/02,53001,3,2002,7526,6689,1,837,11.10%
Asotin,3/1/02,53003,3,2002,9961,9248,1,713,7.20%
Clallam,3/1/02,53009,3,2002,26309,23661,1,2648,10.10%
Columbia,3/1/02,53013,3,2002,1582,1381,1,201,12.70%
Cowlitz,3/1/02,53015,3,2002,42046,37070,1,4976,11.80%
Douglas,3/1/02,53017,3,2002,16523,14994,1,1529,9.30%
Ferry,3/1/02,53019,3,2002,2875,2435,1,440,15.30%
Franklin,3/1/02,53021,3,2002,23899,21576,1,2323,9.70%
Garfield,3/1/02,53023,3,2002,1013,934,1,79,7.80%
Grant,3/1/02,53025,3,2002,34301,30302,1,3999,11.70%
Grays Harbor,3/1/02,53027,3,2002,28618,25491,1,3127,10.90%
Island,3/1/02,53029,3,2002,29832,27431,1,2401,8.00%
Jefferson,3/1/02,53031,3,2002,12021,10972,1,1049,8.70%
King,3/1/02,53033,3,2002,990166,928136,1,62030,6.30%
Kitsap,3/1/02,53035,3,2002,109197,101106,1,8091,7.40%
Kittitas,3/1/02,53037,3,2002,17653,16044,1,1609,9.10%
Klickitat,3/1/02,53039,3,2002,9268,7992,1,1276,13.80%
Lewis,3/1/02,53041,3,2002,29473,26274,1,3199,10.90%
Lincoln,3/1/02,53043,3,2002,4513,4150,1,363,8.00%
Mason,3/1/02,53045,3,2002,21184,19170,1,2014,9.50%
Okanogan,3/1/02,53047,3,2002,17235,14849,1,2386,13.80%
Pacific,3/1/02,53049,3,2002,8384,7480,1,904,10.80%
Pend Oreille,3/1/02,53051,3,2002,4695,4090,1,605,12.90%
Pierce,3/1/02,53053,3,2002,342050,311732,1,30318,8.90%
San Juan,3/1/02,53055,3,2002,6847,6342,1,505,7.40%
Skagit,3/1/02,53057,3,2002,51652,46874,1,4778,9.30%
Skamania,3/1/02,53059,3,2002,4808,4232,1,576,12.00%
Snohomish,3/1/02,53061,3,2002,335218,310658,1,24560,7.30%
Spokane,3/1/02,53063,3,2002,210896,191821,1,19075,9.00%
Stevens,3/1/02,53065,3,2002,17556,15194,1,2362,13.50%
Thurston,3/1/02,53067,3,2002,110818,102876,1,7942,7.20%
Wahkiakum,3/1/02,53069,3,2002,1579,1388,1,191,12.10%
Walla Walla,3/1/02,53071,3,2002,27604,25297,1,2307,8.40%
Whatcom,3/1/02,53073,3,2002,90045,82890,1,7155,7.90%
Whitman,3/1/02,53075,3,2002,19376,18393,1,983,5.10%
Yakima,3/1/02,53077,3,2002,106617,93819,1,12798,12.00%
Adams,3/1/03,53001,3,2003,7552,6763,1,789,10.40%
Asotin,3/1/03,53003,3,2003,9802,8993,1,809,8.30%
Clallam,3/1/03,53009,3,2003,26815,24242,1,2573,9.60%
Columbia,3/1/03,53013,3,2003,1536,1348,1,188,12.20%
Cowlitz,3/1/03,53015,3,2003,42575,38077,1,4498,10.60%
Douglas,3/1/03,53017,3,2003,17203,15781,1,1422,8.30%
Ferry,3/1/03,53019,3,2003,2876,2370,1,506,17.60%
Franklin,3/1/03,53021,3,2003,25364,22982,1,2382,9.40%
Garfield,3/1/03,53023,3,2003,1066,969,1,97,9.10%
Grant,3/1/03,53025,3,2003,34242,30579,1,3663,10.70%
Grays Harbor,3/1/03,53027,3,2003,29593,26459,1,3134,10.60%
Island,3/1/03,53029,3,2003,30185,27844,1,2341,7.80%
Jefferson,3/1/03,53031,3,2003,12479,11430,1,1049,8.40%
King,3/1/03,53033,3,2003,993085,927699,1,65386,6.60%
Kitsap,3/1/03,53035,3,2003,112317,104086,1,8231,7.30%
Kittitas,3/1/03,53037,3,2003,18183,16567,1,1616,8.90%
Klickitat,3/1/03,53039,3,2003,9109,7915,1,1194,13.10%
Lewis,3/1/03,53041,3,2003,29730,26563,1,3167,10.70%
Lincoln,3/1/03,53043,3,2003,4548,4199,1,349,7.70%
Mason,3/1/03,53045,3,2003,22373,20224,1,2149,9.60%
Okanogan,3/1/03,53047,3,2003,17577,15311,1,2266,12.90%
Pacific,3/1/03,53049,3,2003,8839,7883,1,956,10.80%
Pend Oreille,3/1/03,53051,3,2003,4677,4061,1,616,13.20%
Pierce,3/1/03,53053,3,2003,347569,317629,1,29940,8.60%
San Juan,3/1/03,53055,3,2003,7132,6619,1,513,7.20%
Skagit,3/1/03,53057,3,2003,52292,47623,1,4669,8.90%
Skamania,3/1/03,53059,3,2003,4762,4234,1,528,11.10%
Snohomish,3/1/03,53061,3,2003,336635,311756,1,24879,7.40%
Spokane,3/1/03,53063,3,2003,212919,195489,1,17430,8.20%
Stevens,3/1/03,53065,3,2003,17452,15401,1,2051,11.80%
Thurston,3/1/03,53067,3,2003,114975,107173,1,7802,6.80%
Wahkiakum,3/1/03,53069,3,2003,1600,1425,1,175,10.90%
Walla Walla,3/1/03,53071,3,2003,28558,26237,1,2321,8.10%
Whatcom,3/1/03,53073,3,2003,93731,86892,1,6839,7.30%
Whitman,3/1/03,53075,3,2003,19600,18597,1,1003,5.10%
Yakima,3/1/03,53077,3,2003,108702,97039,1,11663,10.70%
Adams,3/1/04,53001,3,2004,7781,7036,1,745,9.60%
Asotin,3/1/04,53003,3,2004,10202,9449,1,753,7.40%
Clallam,3/1/04,53009,3,2004,27706,25393,1,2313,8.30%
Columbia,3/1/04,53013,3,2004,1588,1425,1,163,10.30%
Cowlitz,3/1/04,53015,3,2004,43491,39355,1,4136,9.50%
Douglas,3/1/04,53017,3,2004,18034,16614,1,1420,7.90%
Ferry,3/1/04,53019,3,2004,2917,2452,1,465,15.90%
Franklin,3/1/04,53021,3,2004,27379,24859,1,2520,9.20%
Garfield,3/1/04,53023,3,2004,1041,963,1,78,7.50%
Grant,3/1/04,53025,3,2004,35570,31722,1,3848,10.80%
Grays Harbor,3/1/04,53027,3,2004,30617,27677,1,2940,9.60%
Island,3/1/04,53029,3,2004,31405,28977,1,2428,7.70%
Jefferson,3/1/04,53031,3,2004,13235,12287,1,948,7.20%
King,3/1/04,53033,3,2004,997411,943054,1,54357,5.40%
Kitsap,3/1/04,53035,3,2004,117933,110268,1,7665,6.50%
Kittitas,3/1/04,53037,3,2004,18960,17352,1,1608,8.50%
Klickitat,3/1/04,53039,3,2004,8984,7796,1,1188,13.20%
Lewis,3/1/04,53041,3,2004,30672,27719,1,2953,9.60%
Lincoln,3/1/04,53043,3,2004,4794,4408,1,386,8.10%
Mason,3/1/04,53045,3,2004,23230,21195,1,2035,8.80%
Okanogan,3/1/04,53047,3,2004,18775,16723,1,2052,10.90%
Pacific,3/1/04,53049,3,2004,9043,8207,1,836,9.20%
Pend Oreille,3/1/04,53051,3,2004,4987,4388,1,599,12.00%
Pierce,3/1/04,53053,3,2004,359835,330695,1,29140,8.10%
San Juan,3/1/04,53055,3,2004,7583,7126,1,457,6.00%
Skagit,3/1/04,53057,3,2004,54209,49834,1,4375,8.10%
Skamania,3/1/04,53059,3,2004,4999,4445,1,554,11.10%
Snohomish,3/1/04,53061,3,2004,340163,318403,1,21760,6.40%
Spokane,3/1/04,53063,3,2004,219713,202563,1,17150,7.80%
Stevens,3/1/04,53065,3,2004,18000,16018,1,1982,11.00%
Thurston,3/1/04,53067,3,2004,119162,111417,1,7745,6.50%
Wahkiakum,3/1/04,53069,3,2004,1654,1496,1,158,9.60%
Walla Walla,3/1/04,53071,3,2004,28994,26740,1,2254,7.80%
Whatcom,3/1/04,53073,3,2004,98103,91671,1,6432,6.60%
Whitman,3/1/04,53075,3,2004,20451,19483,1,968,4.70%
Yakima,3/1/04,53077,3,2004,112142,100222,1,11920,10.60%
Adams,3/1/05,53001,3,2005,7785,7180,1,605,7.80%
Asotin,3/1/05,53003,3,2005,10567,9744,1,823,7.80%
Clallam,3/1/05,53009,3,2005,29304,27181,1,2123,7.20%
Columbia,3/1/05,53013,3,2005,1482,1330,1,152,10.30%
Cowlitz,3/1/05,53015,3,2005,43055,39708,1,3347,7.80%
Douglas,3/1/05,53017,3,2005,18730,17536,1,1194,6.40%
Ferry,3/1/05,53019,3,2005,3021,2676,1,345,11.40%
Franklin,3/1/05,53021,3,2005,29042,26762,1,2280,7.90%
Garfield,3/1/05,53023,3,2005,1058,985,1,73,6.90%
Grant,3/1/05,53025,3,2005,36300,33070,1,3230,8.90%
Grays Harbor,3/1/05,53027,3,2005,31222,28555,1,2667,8.50%
Island,3/1/05,53029,3,2005,31303,29292,1,2011,6.40%
Jefferson,3/1/05,53031,3,2005,13535,12686,1,849,6.30%
King,3/1/05,53033,3,2005,1001237,954302,1,46935,4.70%
Kitsap,3/1/05,53035,3,2005,119665,113040,1,6625,5.50%
Kittitas,3/1/05,53037,3,2005,19339,17971,1,1368,7.10%
Klickitat,3/1/05,53039,3,2005,9127,8242,1,885,9.70%
Lewis,3/1/05,53041,3,2005,30545,27887,1,2658,8.70%
Lincoln,3/1/05,53043,3,2005,4702,4398,1,304,6.50%
Mason,3/1/05,53045,3,2005,23593,21831,1,1762,7.50%
Okanogan,3/1/05,53047,3,2005,18728,16930,1,1798,9.60%
Pacific,3/1/05,53049,3,2005,9097,8382,1,715,7.90%
Pend Oreille,3/1/05,53051,3,2005,5028,4493,1,535,10.60%
Pierce,3/1/05,53053,3,2005,367864,343725,1,24139,6.60%
San Juan,3/1/05,53055,3,2005,7767,7363,1,404,5.20%
Skagit,3/1/05,53057,3,2005,55550,51853,1,3697,6.70%
Skamania,3/1/05,53059,3,2005,5110,4600,1,510,10.00%
Snohomish,3/1/05,53061,3,2005,343360,325176,1,18184,5.30%
Spokane,3/1/05,53063,3,2005,223993,209788,1,14205,6.30%
Stevens,3/1/05,53065,3,2005,17973,16197,1,1776,9.90%
Thurston,3/1/05,53067,3,2005,121981,115217,1,6764,5.50%
Wahkiakum,3/1/05,53069,3,2005,1655,1521,1,134,8.10%
Walla Walla,3/1/05,53071,3,2005,29075,27140,1,1935,6.70%
Whatcom,3/1/05,53073,3,2005,102402,96646,1,5756,5.60%
Whitman,3/1/05,53075,3,2005,20993,20059,1,934,4.40%
Yakima,3/1/05,53077,3,2005,113828,103851,1,9977,8.80%
Adams,3/1/06,53001,3,2006,7636,7096,1,540,7.10%
Asotin,3/1/06,53003,3,2006,10289,9625,1,664,6.50%
Clallam,3/1/06,53009,3,2006,29484,27627,1,1857,6.30%
Columbia,3/1/06,53013,3,2006,1553,1394,1,159,10.20%
Cowlitz,3/1/06,53015,3,2006,43037,40035,1,3002,7.00%
Douglas,3/1/06,53017,3,2006,18951,17850,1,1101,5.80%
Ferry,3/1/06,53019,3,2006,2931,2537,1,394,13.40%
Franklin,3/1/06,53021,3,2006,29466,27040,1,2426,8.20%
Garfield,3/1/06,53023,3,2006,1010,947,1,63,6.20%
Grant,3/1/06,53025,3,2006,36725,33566,1,3159,8.60%
Grays Harbor,3/1/06,53027,3,2006,31169,28721,1,2448,7.90%
Island,3/1/06,53029,3,2006,32203,30463,1,1740,5.40%
Jefferson,3/1/06,53031,3,2006,13568,12822,1,746,5.50%
King,3/1/06,53033,3,2006,1039788,1000346,1,39442,3.80%
Kitsap,3/1/06,53035,3,2006,121795,115644,1,6151,5.10%
Kittitas,3/1/06,53037,3,2006,19337,18147,1,1190,6.20%
Klickitat,3/1/06,53039,3,2006,9193,8341,1,852,9.30%
Lewis,3/1/06,53041,3,2006,31139,28730,1,2409,7.70%
Lincoln,3/1/06,53043,3,2006,4657,4351,1,306,6.60%
Mason,3/1/06,53045,3,2006,24151,22582,1,1569,6.50%
Okanogan,3/1/06,53047,3,2006,18911,17249,1,1662,8.80%
Pacific,3/1/06,53049,3,2006,9014,8365,1,649,7.20%
Pend Oreille,3/1/06,53051,3,2006,5078,4581,1,497,9.80%
Pierce,3/1/06,53053,3,2006,372295,351025,1,21270,5.70%
San Juan,3/1/06,53055,3,2006,7704,7373,1,331,4.30%
Skagit,3/1/06,53057,3,2006,55969,52664,1,3305,5.90%
Skamania,3/1/06,53059,3,2006,5148,4673,1,475,9.20%
Snohomish,3/1/06,53061,3,2006,357183,341793,1,15390,4.30%
Spokane,3/1/06,53063,3,2006,227408,214259,1,13149,5.80%
Stevens,3/1/06,53065,3,2006,17986,16357,1,1629,9.10%
Thurston,3/1/06,53067,3,2006,123496,117319,1,6177,5.00%
Wahkiakum,3/1/06,53069,3,2006,1615,1496,1,119,7.40%
Walla Walla,3/1/06,53071,3,2006,28707,26763,1,1944,6.80%
Whatcom,3/1/06,53073,3,2006,102429,97259,1,5170,5.00%
Whitman,3/1/06,53075,3,2006,20843,20000,1,843,4.00%
Yakima,3/1/06,53077,3,2006,114142,104585,1,9557,8.40%
Adams,3/1/07,53001,3,2007,7536,6988,1,548,7.30%
Asotin,3/1/07,53003,3,2007,10355,9756,1,599,5.80%
Clallam,3/1/07,53009,3,2007,29630,27663,1,1967,6.60%
Columbia,3/1/07,53013,3,2007,1561,1438,1,123,7.90%
Cowlitz,3/1/07,53015,3,2007,43688,40705,1,2983,6.80%
Douglas,3/1/07,53017,3,2007,19605,18452,1,1153,5.90%
Ferry,3/1/07,53019,3,2007,2940,2590,1,350,11.90%
Franklin,3/1/07,53021,3,2007,31461,29037,1,2424,7.70%
Garfield,3/1/07,53023,3,2007,1011,952,1,59,5.80%
Grant,3/1/07,53025,3,2007,38436,35603,1,2833,7.40%
Grays Harbor,3/1/07,53027,3,2007,31055,28487,1,2568,8.30%
Island,3/1/07,53029,3,2007,32805,30995,1,1810,5.50%
Jefferson,3/1/07,53031,3,2007,13571,12788,1,783,5.80%
King,3/1/07,53033,3,2007,1061054,1025166,1,35888,3.40%
Kitsap,3/1/07,53035,3,2007,122831,116718,1,6113,5.00%
Kittitas,3/1/07,53037,3,2007,20377,19213,1,1164,5.70%
Klickitat,3/1/07,53039,3,2007,9524,8626,1,898,9.40%
Lewis,3/1/07,53041,3,2007,31164,28586,1,2578,8.30%
Lincoln,3/1/07,53043,3,2007,4726,4443,1,283,6.00%
Mason,3/1/07,53045,3,2007,24970,23114,1,1856,7.40%
Okanogan,3/1/07,53047,3,2007,19106,17418,1,1688,8.80%
Pacific,3/1/07,53049,3,2007,8934,8235,1,699,7.80%
Pend Oreille,3/1/07,53051,3,2007,5266,4746,1,520,9.90%
Pierce,3/1/07,53053,3,2007,384919,364167,1,20752,5.40%
San Juan,3/1/07,53055,3,2007,7826,7499,1,327,4.20%
Skagit,3/1/07,53057,3,2007,57348,54255,1,3093,5.40%
Skamania,3/1/07,53059,3,2007,5126,4678,1,448,8.70%
Snohomish,3/1/07,53061,3,2007,361544,347743,1,13801,3.80%
Spokane,3/1/07,53063,3,2007,233822,220822,1,13000,5.60%
Stevens,3/1/07,53065,3,2007,18627,16778,1,1849,9.90%
Thurston,3/1/07,53067,3,2007,127484,121115,1,6369,5.00%
Wahkiakum,3/1/07,53069,3,2007,1679,1539,1,140,8.30%
Walla Walla,3/1/07,53071,3,2007,28820,27094,1,1726,6.00%
Whatcom,3/1/07,53073,3,2007,105620,100630,1,4990,4.70%
Whitman,3/1/07,53075,3,2007,20910,20091,1,819,3.90%
Yakima,3/1/07,53077,3,2007,116438,107124,1,9314,8.00%
Adams,3/1/08,53001,3,2008,7791,7291,1,500,6.40%
Asotin,3/1/08,53003,3,2008,10584,9840,1,744,7.00%
Clallam,3/1/08,53009,3,2008,30108,27677,1,2431,8.10%
Columbia,3/1/08,53013,3,2008,1561,1434,1,127,8.10%
Cowlitz,3/1/08,53015,3,2008,44614,40888,1,3726,8.40%
Douglas,3/1/08,53017,3,2008,20087,18887,1,1200,6.00%
Ferry,3/1/08,53019,3,2008,3012,2624,1,388,12.90%
Franklin,3/1/08,53021,3,2008,33236,30940,1,2296,6.90%
Garfield,3/1/08,53023,3,2008,968,917,1,51,5.30%
Grant,3/1/08,53025,3,2008,38874,35853,1,3021,7.80%
Grays Harbor,3/1/08,53027,3,2008,31614,28953,1,2661,8.40%
Island,3/1/08,53029,3,2008,33057,31097,1,1960,5.90%
Jefferson,3/1/08,53031,3,2008,13721,12865,1,856,6.20%
King,3/1/08,53033,3,2008,1081967,1046993,1,34974,3.20%
Kitsap,3/1/08,53035,3,2008,124888,118134,1,6754,5.40%
Kittitas,3/1/08,53037,3,2008,21132,19670,1,1462,6.90%
Klickitat,3/1/08,53039,3,2008,9889,8900,1,989,10.00%
Lewis,3/1/08,53041,3,2008,31662,28897,1,2765,8.70%
Lincoln,3/1/08,53043,3,2008,4767,4456,1,311,6.50%
Mason,3/1/08,53045,3,2008,25601,23456,1,2145,8.40%
Okanogan,3/1/08,53047,3,2008,19980,18275,1,1705,8.50%
Pacific,3/1/08,53049,3,2008,9088,8320,1,768,8.50%
Pend Oreille,3/1/08,53051,3,2008,5486,4894,1,592,10.80%
Pierce,3/1/08,53053,3,2008,395087,370951,1,24136,6.10%
San Juan,3/1/08,53055,3,2008,8096,7742,1,354,4.40%
Skagit,3/1/08,53057,3,2008,59075,55465,1,3610,6.10%
Skamania,3/1/08,53059,3,2008,5204,4704,1,500,9.60%
Snohomish,3/1/08,53061,3,2008,369519,355587,1,13932,3.80%
Spokane,3/1/08,53063,3,2008,240584,225351,1,15233,6.30%
Stevens,3/1/08,53065,3,2008,18981,17040,1,1941,10.20%
Thurston,3/1/08,53067,3,2008,132088,124830,1,7258,5.50%
Wahkiakum,3/1/08,53069,3,2008,1793,1653,1,140,7.80%
Walla Walla,3/1/08,53071,3,2008,29613,27893,1,1720,5.80%
Whatcom,3/1/08,53073,3,2008,109009,103184,1,5825,5.30%
Whitman,3/1/08,53075,3,2008,21545,20607,1,938,4.40%
Yakima,3/1/08,53077,3,2008,121438,111959,1,9479,7.80%
Adams,3/1/09,53001,3,2009,7895,7154,1,741,9.40%
Asotin,3/1/09,53003,3,2009,10785,9715,1,1070,9.90%
Clallam,3/1/09,53009,3,2009,30283,27266,1,3017,10.00%
Columbia,3/1/09,53013,3,2009,1640,1440,1,200,12.20%
Cowlitz,3/1/09,53015,3,2009,45256,39470,1,5786,12.80%
Douglas,3/1/09,53017,3,2009,20547,18725,1,1822,8.90%
Ferry,3/1/09,53019,3,2009,3019,2552,1,467,15.50%
Franklin,3/1/09,53021,3,2009,35484,32324,1,3160,8.90%
Garfield,3/1/09,53023,3,2009,1021,941,1,80,7.80%
Grant,3/1/09,53025,3,2009,39741,35519,1,4222,10.60%
Grays Harbor,3/1/09,53027,3,2009,31386,27343,1,4043,12.90%
Island,3/1/09,53029,3,2009,33111,30345,1,2766,8.40%
Jefferson,3/1/09,53031,3,2009,13078,11895,1,1183,9.00%
King,3/1/09,53033,3,2009,1105210,1029628,1,75582,6.80%
Kitsap,3/1/09,53035,3,2009,126601,117194,1,9407,7.40%
Kittitas,3/1/09,53037,3,2009,20925,19012,1,1913,9.10%
Klickitat,3/1/09,53039,3,2009,10313,9133,1,1180,11.40%
Lewis,3/1/09,53041,3,2009,31778,27712,1,4066,12.80%
Lincoln,3/1/09,53043,3,2009,4780,4331,1,449,9.40%
Mason,3/1/09,53045,3,2009,25327,22633,1,2694,10.60%
Okanogan,3/1/09,53047,3,2009,20087,17710,1,2377,11.80%
Pacific,3/1/09,53049,3,2009,9143,7942,1,1201,13.10%
Pend Oreille,3/1/09,53051,3,2009,5564,4668,1,896,16.10%
Pierce,3/1/09,53053,3,2009,401627,364657,1,36970,9.20%
San Juan,3/1/09,53055,3,2009,8053,7468,1,585,7.30%
Skagit,3/1/09,53057,3,2009,58571,53038,1,5533,9.40%
Skamania,3/1/09,53059,3,2009,5212,4504,1,708,13.60%
Snohomish,3/1/09,53061,3,2009,378939,347687,1,31252,8.20%
Spokane,3/1/09,53063,3,2009,242658,220026,1,22632,9.30%
Stevens,3/1/09,53065,3,2009,19068,16299,1,2769,14.50%
Thurston,3/1/09,53067,3,2009,133418,123350,1,10068,7.50%
Wahkiakum,3/1/09,53069,3,2009,1607,1367,1,240,14.90%
Walla Walla,3/1/09,53071,3,2009,30630,28456,1,2174,7.10%
Whatcom,3/1/09,53073,3,2009,110775,102058,1,8717,7.90%
Whitman,3/1/09,53075,3,2009,22399,21207,1,1192,5.30%
Yakima,3/1/09,53077,3,2009,120145,109144,1,11001,9.20%
Adams,3/1/10,53001,3,2010,8318,7172,1,1146,13.80%
Asotin,3/1/10,53003,3,2010,10769,9604,1,1165,10.80%
Clallam,3/1/10,53009,3,2010,29851,26201,1,3650,12.20%
Columbia,3/1/10,53013,3,2010,2001,1786,1,215,10.70%
Cowlitz,3/1/10,53015,3,2010,47371,40654,1,6717,14.20%
Douglas,3/1/10,53017,3,2010,19367,17194,1,2173,11.20%
Ferry,3/1/10,53019,3,2010,2657,2100,1,557,21.00%
Franklin,3/1/10,53021,3,2010,36461,32652,1,3809,10.40%
Garfield,3/1/10,53023,3,2010,1050,947,1,103,9.80%
Grant,3/1/10,53025,3,2010,41517,36129,1,5388,13.00%
Grays Harbor,3/1/10,53027,3,2010,31759,26827,1,4932,15.50%
Island,3/1/10,53029,3,2010,34319,30796,1,3523,10.30%
Jefferson,3/1/10,53031,3,2010,13003,11516,1,1487,11.40%
King,3/1/10,53033,3,2010,1110568,1006297,1,104271,9.40%
Kitsap,3/1/10,53035,3,2010,122200,110711,1,11489,9.40%
Kittitas,3/1/10,53037,3,2010,21582,19179,1,2403,11.10%
Klickitat,3/1/10,53039,3,2010,10409,8901,1,1508,14.50%
Lewis,3/1/10,53041,3,2010,34505,29492,1,5013,14.50%
Lincoln,3/1/10,53043,3,2010,5380,4869,1,511,9.50%
Mason,3/1/10,53045,3,2010,25245,21840,1,3405,13.50%
Okanogan,3/1/10,53047,3,2010,21061,18216,1,2845,13.50%
Pacific,3/1/10,53049,3,2010,8719,7280,1,1439,16.50%
Pend Oreille,3/1/10,53051,3,2010,5412,4385,1,1027,19.00%
Pierce,3/1/10,53053,3,2010,401939,355829,1,46110,11.50%
San Juan,3/1/10,53055,3,2010,8255,7534,1,721,8.70%
Skagit,3/1/10,53057,3,2010,59587,52452,1,7135,12.00%
Skamania,3/1/10,53059,3,2010,5320,4523,1,797,15.00%
Snohomish,3/1/10,53061,3,2010,388123,345237,1,42886,11.00%
Spokane,3/1/10,53063,3,2010,242558,215064,1,27494,11.30%
Stevens,3/1/10,53065,3,2010,19671,16711,1,2960,15.00%
Thurston,3/1/10,53067,3,2010,129177,116490,1,12687,9.80%
Wahkiakum,3/1/10,53069,3,2010,1478,1228,1,250,16.90%
Walla Walla,3/1/10,53071,3,2010,30609,27789,1,2820,9.20%
Whatcom,3/1/10,53073,3,2010,105447,94367,1,11080,10.50%
Whitman,3/1/10,53075,3,2010,23175,21571,1,1604,6.90%
Yakima,3/1/10,53077,3,2010,119103,104492,1,14611,12.30%
Adams,3/1/11,53001,3,2011,7843,6968,1,875,11.20%
Asotin,3/1/11,53003,3,2011,10320,9335,1,985,9.50%
Clallam,3/1/11,53009,3,2011,28680,25328,1,3352,11.70%
Columbia,3/1/11,53013,3,2011,1874,1679,1,195,10.40%
Cowlitz,3/1/11,53015,3,2011,45253,39695,1,5558,12.30%
Douglas,3/1/11,53017,3,2011,18329,16360,1,1969,10.70%
Ferry,3/1/11,53019,3,2011,2549,2054,1,495,19.40%
Franklin,3/1/11,53021,3,2011,37527,33965,1,3562,9.50%
Garfield,3/1/11,53023,3,2011,1019,932,1,87,8.50%
Grant,3/1/11,53025,3,2011,40943,36244,1,4699,11.50%
Grays Harbor,3/1/11,53027,3,2011,29781,25634,1,4147,13.90%
Island,3/1/11,53029,3,2011,33009,29842,1,3167,9.60%
Jefferson,3/1/11,53031,3,2011,12336,10975,1,1361,11.00%
King,3/1/11,53033,3,2011,1107480,1014422,1,93058,8.40%
Kitsap,3/1/11,53035,3,2011,118513,108116,1,10397,8.80%
Kittitas,3/1/11,53037,3,2011,21258,19130,1,2128,10.00%
Klickitat,3/1/11,53039,3,2011,9827,8511,1,1316,13.40%
Lewis,3/1/11,53041,3,2011,32745,28299,1,4446,13.60%
Lincoln,3/1/11,53043,3,2011,5354,4874,1,480,9.00%
Mason,3/1/11,53045,3,2011,23917,20996,1,2921,12.20%
Okanogan,3/1/11,53047,3,2011,19552,17042,1,2510,12.80%
Pacific,3/1/11,53049,3,2011,8104,6905,1,1199,14.80%
Pend Oreille,3/1/11,53051,3,2011,4956,4203,1,753,15.20%
Pierce,3/1/11,53053,3,2011,390113,349234,1,40879,10.50%
San Juan,3/1/11,53055,3,2011,7680,7037,1,643,8.40%
Skagit,3/1/11,53057,3,2011,57635,51144,1,6491,11.30%
Skamania,3/1/11,53059,3,2011,5167,4468,1,699,13.50%
Snohomish,3/1/11,53061,3,2011,384401,345315,1,39086,10.20%
Spokane,3/1/11,53063,3,2011,233671,209172,1,24499,10.50%
Stevens,3/1/11,53065,3,2011,18670,16092,1,2578,13.80%
Thurston,3/1/11,53067,3,2011,125113,113591,1,11522,9.20%
Wahkiakum,3/1/11,53069,3,2011,1467,1240,1,227,15.50%
Walla Walla,3/1/11,53071,3,2011,29822,27200,1,2622,8.80%
Whatcom,3/1/11,53073,3,2011,103511,93495,1,10016,9.70%
Whitman,3/1/11,53075,3,2011,23198,21572,1,1626,7.00%
Yakima,3/1/11,53077,3,2011,115742,102511,1,13231,11.40%
Adams,3/1/12,53001,3,2012,7866,7057,1,809,10.30%
Asotin,3/1/12,53003,3,2012,9924,9076,1,848,8.50%
Clallam,3/1/12,53009,3,2012,28435,25157,1,3278,11.50%
Columbia,3/1/12,53013,3,2012,1845,1679,1,166,9.00%
Cowlitz,3/1/12,53015,3,2012,45379,40215,1,5164,11.40%
Douglas,3/1/12,53017,3,2012,18545,16521,1,2024,10.90%
Ferry,3/1/12,53019,3,2012,2419,1973,1,446,18.40%
Franklin,3/1/12,53021,3,2012,38153,34014,1,4139,10.80%
Garfield,3/1/12,53023,3,2012,1006,918,1,88,8.70%
Grant,3/1/12,53025,3,2012,41865,37195,1,4670,11.20%
Grays Harbor,3/1/12,53027,3,2012,29389,25215,1,4174,14.20%
Island,3/1/12,53029,3,2012,33097,30227,1,2870,8.70%
Jefferson,3/1/12,53031,3,2012,11975,10683,1,1292,10.80%
King,3/1/12,53033,3,2012,1121289,1044284,1,77005,6.90%
Kitsap,3/1/12,53035,3,2012,117857,107864,1,9993,8.50%
Kittitas,3/1/12,53037,3,2012,20656,18575,1,2081,10.10%
Klickitat,3/1/12,53039,3,2012,9805,8661,1,1144,11.70%
Lewis,3/1/12,53041,3,2012,32696,28402,1,4294,13.10%
Lincoln,3/1/12,53043,3,2012,5304,4864,1,440,8.30%
Mason,3/1/12,53045,3,2012,23658,20870,1,2788,11.80%
Okanogan,3/1/12,53047,3,2012,19625,17270,1,2355,12.00%
Pacific,3/1/12,53049,3,2012,8196,7070,1,1126,13.70%
Pend Oreille,3/1/12,53051,3,2012,4933,4226,1,707,14.30%
Pierce,3/1/12,53053,3,2012,391997,353140,1,38857,9.90%
San Juan,3/1/12,53055,3,2012,7752,7152,1,600,7.70%
Skagit,3/1/12,53057,3,2012,57559,51648,1,5911,10.30%
Skamania,3/1/12,53059,3,2012,5123,4533,1,590,11.50%
Snohomish,3/1/12,53061,3,2012,385789,354152,1,31637,8.20%
Spokane,3/1/12,53063,3,2012,234068,210755,1,23313,10.00%
Stevens,3/1/12,53065,3,2012,18638,16145,1,2493,13.40%
Thurston,3/1/12,53067,3,2012,124973,113718,1,11255,9.00%
Wahkiakum,3/1/12,53069,3,2012,1396,1215,1,181,13.00%
Walla Walla,3/1/12,53071,3,2012,29649,27194,1,2455,8.30%
Whatcom,3/1/12,53073,3,2012,105017,96047,1,8970,8.50%
Whitman,3/1/12,53075,3,2012,23087,21418,1,1669,7.20%
Yakima,3/1/12,53077,3,2012,117265,102965,1,14300,12.20%
Adams,3/1/13,53001,3,2013,7901,7127,1,774,9.80%
Asotin,3/1/13,53003,3,2013,9901,9160,1,741,7.50%
Clallam,3/1/13,53009,3,2013,27449,24650,1,2799,10.20%
Clark,3/1/13,53011,3,2013,209382,190367,1,19015,9.10%
Columbia,3/1/13,53013,3,2013,1781,1619,1,162,9.10%
Cowlitz,3/1/13,53015,3,2013,43752,39141,1,4611,10.50%
Douglas,3/1/13,53017,3,2013,18101,16367,1,1734,9.60%
Ferry,3/1/13,53019,3,2013,2544,2150,1,394,15.50%
Franklin,3/1/13,53021,3,2013,37364,33418,1,3946,10.60%
Garfield,3/1/13,53023,3,2013,984,899,1,85,8.60%
Grant,3/1/13,53025,3,2013,42804,38588,1,4216,9.80%
Grays Harbor,3/1/13,53027,3,2013,31194,27638,1,3556,11.40%
Island,3/1/13,53029,3,2013,31904,29410,1,2494,7.80%
Jefferson,3/1/13,53031,3,2013,11408,10238,1,1170,10.30%
King,3/1/13,53033,3,2013,1129155,1072641,1,56514,5.00%
Kitsap,3/1/13,53035,3,2013,114236,105322,1,8914,7.80%
Kittitas,3/1/13,53037,3,2013,20389,18625,1,1764,8.70%
Klickitat,3/1/13,53039,3,2013,9597,8564,1,1033,10.80%
Lewis,3/1/13,53041,3,2013,31462,27843,1,3619,11.50%
Lincoln,3/1/13,53043,3,2013,5082,4684,1,398,7.80%
Mason,3/1/13,53045,3,2013,23367,20869,1,2498,10.70%
Okanogan,3/1/13,53047,3,2013,19365,17203,1,2162,11.20%
Pacific,3/1/13,53049,3,2013,7823,6890,1,933,11.90%
Pend Oreille,3/1/13,53051,3,2013,4786,4132,1,654,13.70%
Pierce,3/1/13,53053,3,2013,386407,351931,1,34476,8.90%
San Juan,3/1/13,53055,3,2013,7220,6681,1,539,7.50%
Skagit,3/1/13,53057,3,2013,56597,51349,1,5248,9.30%
Skamania,3/1/13,53059,3,2013,5046,4487,1,559,11.10%
Snohomish,3/1/13,53061,3,2013,386086,363732,1,22354,5.80%
Spokane,3/1/13,53063,3,2013,230205,209479,1,20726,9.00%
Stevens,3/1/13,53065,3,2013,18142,15860,1,2282,12.60%
Thurston,3/1/13,53067,3,2013,124089,114118,1,9971,8.00%
Wahkiakum,3/1/13,53069,3,2013,1311,1134,1,177,13.50%
Walla Walla,3/1/13,53071,3,2013,28328,26046,1,2282,8.10%
Whatcom,3/1/13,53073,3,2013,103188,94948,1,8240,8.00%
Whitman,3/1/13,53075,3,2013,23026,21534,1,1492,6.50%
Yakima,3/1/13,53077,3,2013,115472,102577,1,12895,11.20%
Adams,3/1/14,53001,3,2014,7978,7278,1,700,8.80%
Asotin,3/1/14,53003,3,2014,9712,9106,1,606,6.20%
Clallam,3/1/14,53009,3,2014,26653,24204,1,2449,9.20%
Clark,3/1/14,53011,3,2014,209213,193131,1,16082,7.70%
Columbia,3/1/14,53013,3,2014,1733,1599,1,134,7.70%
Cowlitz,3/1/14,53015,3,2014,43180,39295,1,3885,9.00%
Douglas,3/1/14,53017,3,2014,18050,16466,1,1584,8.80%
Ferry,3/1/14,53019,3,2014,2420,2075,1,345,14.30%
Franklin,3/1/14,53021,3,2014,36588,32842,1,3746,10.20%
Garfield,3/1/14,53023,3,2014,945,869,1,76,8.00%
Grant,3/1/14,53025,3,2014,42093,38218,1,3875,9.20%
Grays Harbor,3/1/14,53027,3,2014,27278,24201,1,3077,11.30%
Island,3/1/14,53029,3,2014,31771,29503,1,2268,7.10%
Jefferson,3/1/14,53031,3,2014,11154,10160,1,994,8.90%
King,3/1/14,53033,3,2014,1161189,1104578,1,56611,4.90%
Kitsap,3/1/14,53035,3,2014,113030,105427,1,7603,6.70%
Kittitas,3/1/14,53037,3,2014,20159,18526,1,1633,8.10%
Klickitat,3/1/14,53039,3,2014,9395,8532,1,863,9.20%
Lewis,3/1/14,53041,3,2014,30972,27934,1,3038,9.80%
Lincoln,3/1/14,53043,3,2014,5073,4734,1,339,6.70%
Mason,3/1/14,53045,3,2014,23009,20862,1,2147,9.30%
Okanogan,3/1/14,53047,3,2014,19383,17567,1,1816,9.40%
Pacific,3/1/14,53049,3,2014,7741,6835,1,906,11.70%
Pend Oreille,3/1/14,53051,3,2014,4648,4098,1,550,11.80%
Pierce,3/1/14,53053,3,2014,384617,355140,1,29477,7.70%
San Juan,3/1/14,53055,3,2014,7185,6755,1,430,6.00%
Skagit,3/1/14,53057,3,2014,56339,51836,1,4503,8.00%
Skamania,3/1/14,53059,3,2014,4963,4506,1,457,9.20%
Snohomish,3/1/14,53061,3,2014,397144,375010,1,22134,5.60%
Spokane,3/1/14,53063,3,2014,226407,208527,1,17880,7.90%
Stevens,3/1/14,53065,3,2014,17688,15665,1,2023,11.40%
Thurston,3/1/14,53067,3,2014,123526,114688,1,8838,7.20%
Wahkiakum,3/1/14,53069,3,2014,1285,1142,1,143,11.10%
Walla Walla,3/1/14,53071,3,2014,28286,26253,1,2033,7.20%
Whatcom,3/1/14,53073,3,2014,102001,94539,1,7462,7.30%
Whitman,3/1/14,53075,3,2014,22699,21336,1,1363,6.00%
Yakima,3/1/14,53077,3,2014,114625,102746,1,11879,10.40%
Adams,3/1/15,53001,3,2015,8110,7460,1,650,8.00%
Asotin,3/1/15,53003,3,2015,9701,9193,1,508,5.20%
Clallam,3/1/15,53009,3,2015,26632,24251,1,2381,8.90%
Clark,3/1/15,53011,3,2015,213384,198358,1,15026,7.00%
Columbia,3/1/15,53013,3,2015,1696,1575,1,121,7.10%
Cowlitz,3/1/15,53015,3,2015,44296,40654,1,3642,8.20%
Douglas,3/1/15,53017,3,2015,18639,17180,1,1459,7.80%
Ferry,3/1/15,53019,3,2015,2348,2056,1,292,12.40%
Franklin,3/1/15,53021,3,2015,37341,33998,1,3343,9.00%
Garfield,3/1/15,53023,3,2015,941,872,1,69,7.30%
Grant,3/1/15,53025,3,2015,43121,39439,1,3682,8.50%
Grays Harbor,3/1/15,53027,3,2015,26852,24139,1,2713,10.10%
Island,3/1/15,53029,3,2015,31595,29559,1,2036,6.40%
Jefferson,3/1/15,53031,3,2015,11239,10366,1,873,7.80%
King,3/1/15,53033,3,2015,1181224,1131834,1,49390,4.20%
Kitsap,3/1/15,53035,3,2015,114565,107706,1,6859,6.00%
Kittitas,3/1/15,53037,3,2015,21618,20208,1,1410,6.50%
Klickitat,3/1/15,53039,3,2015,9050,8293,1,757,8.40%
Lewis,3/1/15,53041,3,2015,31206,28316,1,2890,9.30%
Lincoln,3/1/15,53043,3,2015,4893,4563,1,330,6.70%
Mason,3/1/15,53045,3,2015,22938,21045,1,1893,8.30%
Okanogan,3/1/15,53047,3,2015,19709,17938,1,1771,9.00%
Pacific,3/1/15,53049,3,2015,8024,7184,1,840,10.50%
Pend Oreille,3/1/15,53051,3,2015,4658,4136,1,522,11.20%
Pierce,3/1/15,53053,3,2015,389987,363007,1,26980,6.90%
San Juan,3/1/15,53055,3,2015,7181,6763,1,418,5.80%
Skagit,3/1/15,53057,3,2015,56357,52174,1,4183,7.40%
Skamania,3/1/15,53059,3,2015,4963,4553,1,410,8.30%
Snohomish,3/1/15,53061,3,2015,402554,384113,1,18441,4.60%
Spokane,3/1/15,53063,3,2015,228096,211759,1,16337,7.20%
Stevens,3/1/15,53065,3,2015,17694,15786,1,1908,10.80%
Thurston,3/1/15,53067,3,2015,125196,117112,1,8084,6.50%
Wahkiakum,3/1/15,53069,3,2015,1314,1185,1,129,9.80%
Walla Walla,3/1/15,53071,3,2015,28043,26204,1,1839,6.60%
Whatcom,3/1/15,53073,3,2015,103541,96986,1,6555,6.30%
Whitman,3/1/15,53075,3,2015,23066,21920,1,1146,5.00%
Yakima,3/1/15,53077,3,2015,118262,107342,1,10920,9.20%
Adams,3/1/16,53001,3,2016,8193,7515,1,678,8.30%
Asotin,3/1/16,53003,3,2016,9925,9362,1,563,5.70%
Clallam,3/1/16,53009,3,2016,27082,24750,1,2332,8.60%
Clark,3/1/16,53011,3,2016,220788,206357,1,14431,6.50%
Columbia,3/1/16,53013,3,2016,1717,1591,1,126,7.30%
Cowlitz,3/1/16,53015,3,2016,44656,41177,1,3479,7.80%
Douglas,3/1/16,53017,3,2016,19710,18020,1,1690,8.60%
Ferry,3/1/16,53019,3,2016,2480,2152,1,328,13.20%
Franklin,3/1/16,53021,3,2016,38937,35326,1,3611,9.30%
Garfield,3/1/16,53023,3,2016,906,844,1,62,6.80%
Grant,3/1/16,53025,3,2016,43354,39488,1,3866,8.90%
Grays Harbor,3/1/16,53027,3,2016,27143,24569,1,2574,9.50%
Island,3/1/16,53029,3,2016,32502,30411,1,2091,6.40%
Jefferson,3/1/16,53031,3,2016,11366,10489,1,877,7.70%
King,3/1/16,53033,3,2016,1215229,1166324,1,48905,4.00%
Kitsap,3/1/16,53035,3,2016,118201,111259,1,6942,5.90%
Kittitas,3/1/16,53037,3,2016,21712,20221,1,1491,6.90%
Klickitat,3/1/16,53039,3,2016,9402,8660,1,742,7.90%
Lewis,3/1/16,53041,3,2016,31789,28974,1,2815,8.90%
Lincoln,3/1/16,53043,3,2016,4849,4518,1,331,6.80%
Mason,3/1/16,53045,3,2016,23338,21363,1,1975,8.50%
Okanogan,3/1/16,53047,3,2016,19908,17995,1,1913,9.60%
Pacific,3/1/16,53049,3,2016,8054,7273,1,781,9.70%
Pend Oreille,3/1/16,53051,3,2016,4728,4214,1,514,10.90%
Pierce,3/1/16,53053,3,2016,401808,375258,1,26550,6.60%
San Juan,3/1/16,53055,3,2016,7338,6926,1,412,5.60%
Skagit,3/1/16,53057,3,2016,57308,53078,1,4230,7.40%
Skamania,3/1/16,53059,3,2016,5104,4714,1,390,7.60%
Snohomish,3/1/16,53061,3,2016,416018,397489,1,18529,4.50%
Spokane,3/1/16,53063,3,2016,234524,218481,1,16043,6.80%
Stevens,3/1/16,53065,3,2016,18250,16289,1,1961,10.70%
Thurston,3/1/16,53067,3,2016,129518,121423,1,8095,6.30%
Wahkiakum,3/1/16,53069,3,2016,1285,1166,1,119,9.30%
Walla Walla,3/1/16,53071,3,2016,28486,26716,1,1770,6.20%
Whatcom,3/1/16,53073,3,2016,107023,100036,1,6987,6.50%
Whitman,3/1/16,53075,3,2016,23642,22407,1,1235,5.20%
Yakima,3/1/16,53077,3,2016,121710,110451,1,11259,9.30%
Adams,3/1/17,53001,3,2017,8187,7577,1,610,7.50%
Asotin,3/1/17,53003,3,2017,10249,9751,1,498,4.90%
Clallam,3/1/17,53009,3,2017,27494,25419,1,2075,7.50%
Clark,3/1/17,53011,3,2017,227420,214916,1,12504,5.50%
Columbia,3/1/17,53013,3,2017,1758,1643,1,115,6.50%
Cowlitz,3/1/17,53015,3,2017,46054,43054,1,3000,6.50%
Douglas,3/1/17,53017,3,2017,19942,18453,1,1489,7.50%
Ferry,3/1/17,53019,3,2017,2513,2171,1,342,13.60%
Franklin,3/1/17,53021,3,2017,39222,36168,1,3054,7.80%
Garfield,3/1/17,53023,3,2017,865,813,1,52,6.00%
Grant,3/1/17,53025,3,2017,43590,40108,1,3482,8.00%
Grays Harbor,3/1/17,53027,3,2017,27509,25250,1,2259,8.20%
Island,3/1/17,53029,3,2017,33596,31829,1,1767,5.30%
Jefferson,3/1/17,53031,3,2017,11631,10874,1,757,6.50%
King,3/1/17,53033,3,2017,1239371,1196055,1,43316,3.50%
Kitsap,3/1/17,53035,3,2017,119552,113374,1,6178,5.20%
Kittitas,3/1/17,53037,3,2017,22358,20983,1,1375,6.10%
Klickitat,3/1/17,53039,3,2017,9675,8987,1,688,7.10%
Lewis,3/1/17,53041,3,2017,33170,30706,1,2464,7.40%
Lincoln,3/1/17,53043,3,2017,4897,4611,1,286,5.80%
Mason,3/1/17,53045,3,2017,23479,21763,1,1716,7.30%
Okanogan,3/1/17,53047,3,2017,19667,17746,1,1921,9.80%
Pacific,3/1/17,53049,3,2017,8188,7540,1,648,7.90%
Pend Oreille,3/1/17,53051,3,2017,4783,4332,1,451,9.40%
Pierce,3/1/17,53053,3,2017,414764,390732,1,24032,5.80%
San Juan,3/1/17,53055,3,2017,7557,7215,1,342,4.50%
Skagit,3/1/17,53057,3,2017,58991,55413,1,3578,6.10%
Skamania,3/1/17,53059,3,2017,5282,4930,1,352,6.70%
Snohomish,3/1/17,53061,3,2017,424646,407748,1,16898,4.00%
Spokane,3/1/17,53063,3,2017,239167,224357,1,14810,6.20%
Stevens,3/1/17,53065,3,2017,18244,16517,1,1727,9.50%
Thurston,3/1/17,53067,3,2017,134268,127101,1,7167,5.30%
Wahkiakum,3/1/17,53069,3,2017,1319,1200,1,119,9.00%
Walla Walla,3/1/17,53071,3,2017,28459,26879,1,1580,5.60%
Whatcom,3/1/17,53073,3,2017,109395,103536,1,5859,5.40%
Whitman,3/1/17,53075,3,2017,23859,22758,1,1101,4.60%
Yakima,3/1/17,53077,3,2017,122389,112128,1,10261,8.40%
Adams,3/1/18,53001,3,2018,8760,8180,1,580,6.60%
Asotin,3/1/18,53003,3,2018,10181,9704,1,477,4.70%
Clallam,3/1/18,53009,3,2018,27844,25819,1,2025,7.30%
Clark,3/1/18,53011,3,2018,231209,219165,1,12044,5.20%
Columbia,3/1/18,53013,3,2018,1760,1648,1,112,6.40%
Cowlitz,3/1/18,53015,3,2018,45926,42877,1,3049,6.60%
Douglas,3/1/18,53017,3,2018,20761,19400,1,1361,6.60%
Ferry,3/1/18,53019,3,2018,2538,2123,1,415,16.40%
Franklin,3/1/18,53021,3,2018,40899,37812,1,3087,7.50%
Garfield,3/1/18,53023,3,2018,883,820,1,63,7.10%
Grant,3/1/18,53025,3,2018,45061,41662,1,3399,7.50%
Grays Harbor,3/1/18,53027,3,2018,28056,25927,1,2129,7.60%
Island,3/1/18,53029,3,2018,34473,32537,1,1936,5.60%
Jefferson,3/1/18,53031,3,2018,12056,11252,1,804,6.70%
King,3/1/18,53033,3,2018,1267434,1226307,1,41127,3.20%
Kitsap,3/1/18,53035,3,2018,122349,116136,1,6213,5.10%
Kittitas,3/1/18,53037,3,2018,21972,20613,1,1359,6.20%
Klickitat,3/1/18,53039,3,2018,9862,9205,1,657,6.70%
Lewis,3/1/18,53041,3,2018,33910,31552,1,2358,7.00%
Lincoln,3/1/18,53043,3,2018,4999,4703,1,296,5.90%
Mason,3/1/18,53045,3,2018,24080,22420,1,1660,6.90%
Okanogan,3/1/18,53047,3,2018,19547,17813,1,1734,8.90%
Pacific,3/1/18,53049,3,2018,8226,7552,1,674,8.20%
Pend Oreille,3/1/18,53051,3,2018,4846,4436,1,410,8.50%
Pierce,3/1/18,53053,3,2018,422227,398250,1,23977,5.70%
San Juan,3/1/18,53055,3,2018,7653,7306,1,347,4.50%
Skagit,3/1/18,53057,3,2018,59324,55950,1,3374,5.70%
Skamania,3/1/18,53059,3,2018,5325,4996,1,329,6.20%
Snohomish,3/1/18,53061,3,2018,432225,416517,1,15708,3.60%
Spokane,3/1/18,53063,3,2018,244135,229645,1,14490,5.90%
Stevens,3/1/18,53065,3,2018,18572,16845,1,1727,9.30%
Thurston,3/1/18,53067,3,2018,137625,130454,1,7171,5.20%
Wahkiakum,3/1/18,53069,3,2018,1305,1213,1,92,7.00%
Walla Walla,3/1/18,53071,3,2018,28607,27079,1,1528,5.30%
Whatcom,3/1/18,53073,3,2018,111575,105851,1,5724,5.10%
Whitman,3/1/18,53075,3,2018,23931,22834,1,1097,4.60%
Yakima,3/1/18,53077,3,2018,125494,116168,1,9326,7.40%
Adams,3/1/19,53001,3,2019,8669,7919,1,750,8.70%
Asotin,3/1/19,53003,3,2019,10349,9835,1,514,5.00%
Clallam,3/1/19,53009,3,2019,28551,26397,1,2154,7.50%
Clark,3/1/19,53011,3,2019,241607,229142,1,12465,5.20%
Columbia,3/1/19,53013,3,2019,1818,1698,1,120,6.60%
Cowlitz,3/1/19,53015,3,2019,48125,45015,1,3110,6.50%
Douglas,3/1/19,53017,3,2019,20702,19188,1,1514,7.30%
Ferry,3/1/19,53019,3,2019,2533,2163,1,370,14.60%
Franklin,3/1/19,53021,3,2019,41324,37697,1,3627,8.80%
Garfield,3/1/19,53023,3,2019,881,819,1,62,7.00%
Grant,3/1/19,53025,3,2019,45298,41092,1,4206,9.30%
Grays Harbor,3/1/19,53027,3,2019,29114,26749,1,2365,8.10%
Island,3/1/19,53029,3,2019,35566,33623,1,1943,5.50%
Jefferson,3/1/19,53031,3,2019,12519,11700,1,819,6.50%
King,3/1/19,53033,3,2019,1289512,1251347,1,38165,3.00%
Kitsap,3/1/19,53035,3,2019,127968,121483,1,6485,5.10%
Kittitas,3/1/19,53037,3,2019,22855,21326,1,1529,6.70%
Klickitat,3/1/19,53039,3,2019,10027,9302,1,725,7.20%
Lewis,3/1/19,53041,3,2019,34866,32441,1,2425,7.00%
Lincoln,3/1/19,53043,3,2019,4995,4681,1,314,6.30%
Mason,3/1/19,53045,3,2019,24911,23148,1,1763,7.10%
Okanogan,3/1/19,53047,3,2019,19358,17540,1,1818,9.40%
Pacific,3/1/19,53049,3,2019,8254,7580,1,674,8.20%
Pend Oreille,3/1/19,53051,3,2019,5075,4605,1,470,9.30%
Pierce,3/1/19,53053,3,2019,440466,415764,1,24702,5.60%
San Juan,3/1/19,53055,3,2019,7963,7581,1,382,4.80%
Skagit,3/1/19,53057,3,2019,62367,58788,1,3579,5.70%
Skamania,3/1/19,53059,3,2019,5551,5214,1,337,6.10%
Snohomish,3/1/19,53061,3,2019,439194,425049,1,14145,3.20%
Spokane,3/1/19,53063,3,2019,254947,238595,1,16352,6.40%
Stevens,3/1/19,53065,3,2019,19243,17419,1,1824,9.50%
Thurston,3/1/19,53067,3,2019,142696,135164,1,7532,5.30%
Wahkiakum,3/1/19,53069,3,2019,1389,1277,1,112,8.10%
Walla Walla,3/1/19,53071,3,2019,29642,27853,1,1789,6.00%
Whatcom,3/1/19,53073,3,2019,115563,109583,1,5980,5.20%
Whitman,3/1/19,53075,3,2019,24727,23603,1,1124,4.50%
Yakima,3/1/19,53077,3,2019,127283,115465,1,11818,9.30%
Adams,3/1/20,53001,3,2020,8464,7979,1,485,5.70%
Asotin,3/1/20,53003,3,2020,10220,9846,1,374,3.70%
Clallam,3/1/20,53009,3,2020,28217,26549,1,1668,5.90%
Clark,3/1/20,53011,3,2020,242747,232047,1,10700,4.40%
Columbia,3/1/20,53013,3,2020,1728,1636,1,92,5.30%
Cowlitz,3/1/20,53015,3,2020,47986,45262,1,2724,5.70%
Douglas,3/1/20,53017,3,2020,20499,19290,1,1209,5.90%
Ferry,3/1/20,53019,3,2020,2357,2061,1,296,12.60%
Franklin,3/1/20,53021,3,2020,42158,39561,1,2597,6.20%
Garfield,3/1/20,53023,3,2020,770,725,1,45,5.80%
Grant,3/1/20,53025,3,2020,44589,41488,1,3101,7.00%
Grays Harbor,3/1/20,53027,3,2020,28568,26631,1,1937,6.80%
Island,3/1/20,53029,3,2020,36034,34362,1,1672,4.60%
Jefferson,3/1/20,53031,3,2020,12908,12225,1,683,5.30%
King,3/1/20,53033,3,2020,1282512,1211129,1,71383,5.60%
Kitsap,3/1/20,53035,3,2020,129623,124196,1,5427,4.20%
Kittitas,3/1/20,53037,3,2020,23677,22383,1,1294,5.50%
Klickitat,3/1/20,53039,3,2020,9580,9051,1,529,5.50%
Lewis,3/1/20,53041,3,2020,34412,32290,1,2122,6.20%
Lincoln,3/1/20,53043,3,2020,4586,4330,1,256,5.60%
Mason,3/1/20,53045,3,2020,25326,23777,1,1549,6.10%
Okanogan,3/1/20,53047,3,2020,18333,16891,1,1442,7.90%
Pacific,3/1/20,53049,3,2020,8358,7800,1,558,6.70%
Pend Oreille,3/1/20,53051,3,2020,5016,4623,1,393,7.80%
Pierce,3/1/20,53053,3,2020,445908,423923,1,21985,4.90%
San Juan,3/1/20,53055,3,2020,8135,7789,1,346,4.30%
Skagit,3/1/20,53057,3,2020,62319,59096,1,3223,5.20%
Skamania,3/1/20,53059,3,2020,5520,5240,1,280,5.10%
Snohomish,3/1/20,53061,3,2020,436723,411131,1,25592,5.90%
Spokane,3/1/20,53063,3,2020,257345,244261,1,13084,5.10%
Stevens,3/1/20,53065,3,2020,18932,17465,1,1467,7.70%
Thurston,3/1/20,53067,3,2020,145437,138675,1,6762,4.60%
Wahkiakum,3/1/20,53069,3,2020,1325,1233,1,92,6.90%
Walla Walla,3/1/20,53071,3,2020,29844,28515,1,1329,4.50%
Whatcom,3/1/20,53073,3,2020,115692,110210,1,5482,4.70%
Whitman,3/1/20,53075,3,2020,23788,22897,1,891,3.70%
Yakima,3/1/20,53077,3,2020,128874,120207,1,8667,6.70%
Adams,4/1/90,53001,4,1990,7431,6754,1,677,9.10%
Asotin,4/1/90,53003,4,1990,9383,8875,1,508,5.40%
Clallam,4/1/90,53009,4,1990,22907,21390,1,1517,6.60%
Columbia,4/1/90,53013,4,1990,2248,2029,1,219,9.70%
Cowlitz,4/1/90,53015,4,1990,38362,35558,1,2804,7.30%
Douglas,4/1/90,53017,4,1990,14520,13341,1,1179,8.10%
Ferry,4/1/90,53019,4,1990,2895,2450,1,445,15.40%
Franklin,4/1/90,53021,4,1990,19016,17400,1,1616,8.50%
Garfield,4/1/90,53023,4,1990,1065,1037,1,28,2.60%
Grant,4/1/90,53025,4,1990,27224,24835,1,2389,8.80%
Grays Harbor,4/1/90,53027,4,1990,27485,24879,1,2606,9.50%
Island,4/1/90,53029,4,1990,22851,22010,1,841,3.70%
Jefferson,4/1/90,53031,4,1990,8270,7862,1,408,4.90%
King,4/1/90,53033,4,1990,851741,824298,1,27443,3.20%
Kitsap,4/1/90,53035,4,1990,84643,81089,1,3554,4.20%
Kittitas,4/1/90,53037,4,1990,12701,11614,1,1087,8.60%
Klickitat,4/1/90,53039,4,1990,8052,6906,1,1146,14.20%
Lewis,4/1/90,53041,4,1990,26276,24282,1,1994,7.60%
Lincoln,4/1/90,53043,4,1990,4247,4079,1,168,4.00%
Mason,4/1/90,53045,4,1990,15705,14787,1,918,5.80%
Okanogan,4/1/90,53047,4,1990,17675,15824,1,1851,10.50%
Pacific,4/1/90,53049,4,1990,7422,6879,1,543,7.30%
Pend Oreille,4/1/90,53051,4,1990,3587,3013,1,574,16.00%
Pierce,4/1/90,53053,4,1990,276128,262764,1,13364,4.80%
San Juan,4/1/90,53055,4,1990,4777,4616,1,161,3.40%
Skagit,4/1/90,53057,4,1990,39055,36379,1,2676,6.90%
Skamania,4/1/90,53059,4,1990,3959,3532,1,427,10.80%
Snohomish,4/1/90,53061,4,1990,247912,238901,1,9011,3.60%
Spokane,4/1/90,53063,4,1990,173285,163102,1,10183,5.90%
Stevens,4/1/90,53065,4,1990,13457,12045,1,1412,10.50%
Thurston,4/1/90,53067,4,1990,80589,76551,1,4038,5.00%
Wahkiakum,4/1/90,53069,4,1990,1499,1425,1,74,4.90%
Walla Walla,4/1/90,53071,4,1990,24638,23036,1,1602,6.50%
Whatcom,4/1/90,53073,4,1990,68076,64349,1,3727,5.50%
Whitman,4/1/90,53075,4,1990,18117,17864,1,253,1.40%
Yakima,4/1/90,53077,4,1990,100746,88330,1,12416,12.30%
Adams,4/1/91,53001,4,1991,7999,7136,1,863,10.80%
Asotin,4/1/91,53003,4,1991,9311,8651,1,660,7.10%
Clallam,4/1/91,53009,4,1991,22941,21098,1,1843,8.00%
Columbia,4/1/91,53013,4,1991,1757,1503,1,254,14.50%
Cowlitz,4/1/91,53015,4,1991,39009,36037,1,2972,7.60%
Douglas,4/1/91,53017,4,1991,14908,13446,1,1462,9.80%
Ferry,4/1/91,53019,4,1991,2790,2292,1,498,17.80%
Franklin,4/1/91,53021,4,1991,19670,17543,1,2127,10.80%
Garfield,4/1/91,53023,4,1991,1027,1003,1,24,2.30%
Grant,4/1/91,53025,4,1991,28605,25801,1,2804,9.80%
Grays Harbor,4/1/91,53027,4,1991,27313,24093,1,3220,11.80%
Island,4/1/91,53029,4,1991,22584,21629,1,955,4.20%
Jefferson,4/1/91,53031,4,1991,8099,7586,1,513,6.30%
King,4/1/91,53033,4,1991,855857,825454,1,30403,3.60%
Kitsap,4/1/91,53035,4,1991,85359,81139,1,4220,4.90%
Kittitas,4/1/91,53037,4,1991,12695,11423,1,1272,10.00%
Klickitat,4/1/91,53039,4,1991,7962,6803,1,1159,14.60%
Lewis,4/1/91,53041,4,1991,26420,23590,1,2830,10.70%
Lincoln,4/1/91,53043,4,1991,4166,4008,1,158,3.80%
Mason,4/1/91,53045,4,1991,15450,14255,1,1195,7.70%
Okanogan,4/1/91,53047,4,1991,18086,15588,1,2498,13.80%
Pacific,4/1/91,53049,4,1991,7684,6927,1,757,9.90%
Pend Oreille,4/1/91,53051,4,1991,3244,2683,1,561,17.30%
Pierce,4/1/91,53053,4,1991,275781,258220,1,17561,6.40%
San Juan,4/1/91,53055,4,1991,5167,4983,1,184,3.60%
Skagit,4/1/91,53057,4,1991,39676,36480,1,3196,8.10%
Skamania,4/1/91,53059,4,1991,4036,3593,1,443,11.00%
Snohomish,4/1/91,53061,4,1991,253733,243088,1,10645,4.20%
Spokane,4/1/91,53063,4,1991,175401,164935,1,10466,6.00%
Stevens,4/1/91,53065,4,1991,13528,11999,1,1529,11.30%
Thurston,4/1/91,53067,4,1991,82359,77642,1,4717,5.70%
Wahkiakum,4/1/91,53069,4,1991,1515,1440,1,75,5.00%
Walla Walla,4/1/91,53071,4,1991,24216,21920,1,2296,9.50%
Whatcom,4/1/91,53073,4,1991,68933,64432,1,4501,6.50%
Whitman,4/1/91,53075,4,1991,18183,17898,1,285,1.60%
Yakima,4/1/91,53077,4,1991,100597,86353,1,14244,14.20%
Adams,4/1/92,53001,4,1992,7814,6854,1,960,12.30%
Asotin,4/1/92,53003,4,1992,9817,9351,1,466,4.70%
Clallam,4/1/92,53009,4,1992,23003,20941,1,2062,9.00%
Columbia,4/1/92,53013,4,1992,1992,1769,1,223,11.20%
Cowlitz,4/1/92,53015,4,1992,37928,33803,1,4125,10.90%
Douglas,4/1/92,53017,4,1992,15565,14029,1,1536,9.90%
Ferry,4/1/92,53019,4,1992,2859,2362,1,497,17.40%
Franklin,4/1/92,53021,4,1992,20385,18344,1,2041,10.00%
Garfield,4/1/92,53023,4,1992,1009,980,1,29,2.90%
Grant,4/1/92,53025,4,1992,29341,26167,1,3174,10.80%
Grays Harbor,4/1/92,53027,4,1992,27748,24339,1,3409,12.30%
Island,4/1/92,53029,4,1992,23745,22462,1,1283,5.40%
Jefferson,4/1/92,53031,4,1992,8488,7724,1,764,9.00%
King,4/1/92,53033,4,1992,880204,837891,1,42313,4.80%
Kitsap,4/1/92,53035,4,1992,87202,82115,1,5087,5.80%
Kittitas,4/1/92,53037,4,1992,13323,11580,1,1743,13.10%
Klickitat,4/1/92,53039,4,1992,7997,6711,1,1286,16.10%
Lewis,4/1/92,53041,4,1992,27097,24122,1,2975,11.00%
Lincoln,4/1/92,53043,4,1992,4252,4058,1,194,4.60%
Mason,4/1/92,53045,4,1992,15651,14282,1,1369,8.70%
Okanogan,4/1/92,53047,4,1992,19065,16765,1,2300,12.10%
Pacific,4/1/92,53049,4,1992,7397,6586,1,811,11.00%
Pend Oreille,4/1/92,53051,4,1992,3643,3082,1,561,15.40%
Pierce,4/1/92,53053,4,1992,284714,263895,1,20819,7.30%
San Juan,4/1/92,53055,4,1992,5115,4778,1,337,6.60%
Skagit,4/1/92,53057,4,1992,40898,36786,1,4112,10.10%
Skamania,4/1/92,53059,4,1992,3796,3014,1,782,20.60%
Snohomish,4/1/92,53061,4,1992,264959,250915,1,14044,5.30%
Spokane,4/1/92,53063,4,1992,179345,167466,1,11879,6.60%
Stevens,4/1/92,53065,4,1992,14508,12601,1,1907,13.10%
Thurston,4/1/92,53067,4,1992,84535,78938,1,5597,6.60%
Wahkiakum,4/1/92,53069,4,1992,1527,1417,1,110,7.20%
Walla Walla,4/1/92,53071,4,1992,24789,23103,1,1686,6.80%
Whatcom,4/1/92,53073,4,1992,72678,66994,1,5684,7.80%
Whitman,4/1/92,53075,4,1992,17867,17510,1,357,2.00%
Yakima,4/1/92,53077,4,1992,104034,89931,1,14103,13.60%
Adams,4/1/93,53001,4,1993,8226,6900,1,1326,16.10%
Asotin,4/1/93,53003,4,1993,10054,9475,1,579,5.80%
Clallam,4/1/93,53009,4,1993,23183,20768,1,2415,10.40%
Columbia,4/1/93,53013,4,1993,2069,1675,1,394,19.00%
Cowlitz,4/1/93,53015,4,1993,37835,33591,1,4244,11.20%
Douglas,4/1/93,53017,4,1993,15830,14480,1,1350,8.50%
Ferry,4/1/93,53019,4,1993,2769,2251,1,518,18.70%
Franklin,4/1/93,53021,4,1993,22027,18952,1,3075,14.00%
Garfield,4/1/93,53023,4,1993,1069,1001,1,68,6.40%
Grant,4/1/93,53025,4,1993,30498,26998,1,3500,11.50%
Grays Harbor,4/1/93,53027,4,1993,27690,23606,1,4084,14.70%
Island,4/1/93,53029,4,1993,23685,22418,1,1267,5.30%
Jefferson,4/1/93,53031,4,1993,8933,8180,1,753,8.40%
King,4/1/93,53033,4,1993,893873,845626,1,48247,5.40%
Kitsap,4/1/93,53035,4,1993,87186,81266,1,5920,6.80%
Kittitas,4/1/93,53037,4,1993,13642,12108,1,1534,11.20%
Klickitat,4/1/93,53039,4,1993,8118,6768,1,1350,16.60%
Lewis,4/1/93,53041,4,1993,27210,24196,1,3014,11.10%
Lincoln,4/1/93,53043,4,1993,4394,4128,1,266,6.10%
Mason,4/1/93,53045,4,1993,15958,14335,1,1623,10.20%
Okanogan,4/1/93,53047,4,1993,19681,16962,1,2719,13.80%
Pacific,4/1/93,53049,4,1993,7763,6857,1,906,11.70%
Pend Oreille,4/1/93,53051,4,1993,3826,3189,1,637,16.60%
Pierce,4/1/93,53053,4,1993,291370,269409,1,21961,7.50%
San Juan,4/1/93,53055,4,1993,5077,4661,1,416,8.20%
Skagit,4/1/93,53057,4,1993,42296,37438,1,4858,11.50%
Skamania,4/1/93,53059,4,1993,4102,3495,1,607,14.80%
Snohomish,4/1/93,53061,4,1993,273407,257042,1,16365,6.00%
Spokane,4/1/93,53063,4,1993,181892,170795,1,11097,6.10%
Stevens,4/1/93,53065,4,1993,15044,13305,1,1739,11.60%
Thurston,4/1/93,53067,4,1993,86851,81097,1,5754,6.60%
Wahkiakum,4/1/93,53069,4,1993,1648,1533,1,115,7.00%
Walla Walla,4/1/93,53071,4,1993,24954,22942,1,2012,8.10%
Whatcom,4/1/93,53073,4,1993,73681,67759,1,5922,8.00%
Whitman,4/1/93,53075,4,1993,17874,17504,1,370,2.10%
Yakima,4/1/93,53077,4,1993,106948,89815,1,17133,16.00%
Adams,4/1/94,53001,4,1994,8174,7180,1,994,12.20%
Asotin,4/1/94,53003,4,1994,10764,10323,1,441,4.10%
Clallam,4/1/94,53009,4,1994,23453,20449,1,3004,12.80%
Columbia,4/1/94,53013,4,1994,2059,1830,1,229,11.10%
Cowlitz,4/1/94,53015,4,1994,38675,34734,1,3941,10.20%
Douglas,4/1/94,53017,4,1994,16648,15112,1,1536,9.20%
Ferry,4/1/94,53019,4,1994,2877,2394,1,483,16.80%
Franklin,4/1/94,53021,4,1994,22548,20220,1,2328,10.30%
Garfield,4/1/94,53023,4,1994,1035,982,1,53,5.10%
Grant,4/1/94,53025,4,1994,32393,29005,1,3388,10.50%
Grays Harbor,4/1/94,53027,4,1994,27268,23313,1,3955,14.50%
Island,4/1/94,53029,4,1994,24281,23017,1,1264,5.20%
Jefferson,4/1/94,53031,4,1994,9211,8307,1,904,9.80%
King,4/1/94,53033,4,1994,887433,846970,1,40463,4.60%
Kitsap,4/1/94,53035,4,1994,88648,82259,1,6389,7.20%
Kittitas,4/1/94,53037,4,1994,14183,12615,1,1568,11.10%
Klickitat,4/1/94,53039,4,1994,8222,7068,1,1154,14.00%
Lewis,4/1/94,53041,4,1994,28173,25296,1,2877,10.20%
Lincoln,4/1/94,53043,4,1994,4429,4164,1,265,6.00%
Mason,4/1/94,53045,4,1994,16840,15027,1,1813,10.80%
Okanogan,4/1/94,53047,4,1994,20122,17615,1,2507,12.50%
Pacific,4/1/94,53049,4,1994,7825,6948,1,877,11.20%
Pend Oreille,4/1/94,53051,4,1994,3798,3229,1,569,15.00%
Pierce,4/1/94,53053,4,1994,304599,280339,1,24260,8.00%
San Juan,4/1/94,53055,4,1994,5116,4699,1,417,8.20%
Skagit,4/1/94,53057,4,1994,46212,40964,1,5248,11.40%
Skamania,4/1/94,53059,4,1994,3968,3448,1,520,13.10%
Snohomish,4/1/94,53061,4,1994,276684,261283,1,15401,5.60%
Spokane,4/1/94,53063,4,1994,189899,179462,1,10437,5.50%
Stevens,4/1/94,53065,4,1994,16280,14461,1,1819,11.20%
Thurston,4/1/94,53067,4,1994,89032,82557,1,6475,7.30%
Wahkiakum,4/1/94,53069,4,1994,1605,1474,1,131,8.20%
Walla Walla,4/1/94,53071,4,1994,25997,24357,1,1640,6.30%
Whatcom,4/1/94,53073,4,1994,74432,68630,1,5802,7.80%
Whitman,4/1/94,53075,4,1994,18327,17954,1,373,2.00%
Yakima,4/1/94,53077,4,1994,108888,93568,1,15320,14.10%
Adams,4/1/95,53001,4,1995,8386,7413,1,973,11.60%
Asotin,4/1/95,53003,4,1995,11454,10916,1,538,4.70%
Clallam,4/1/95,53009,4,1995,24518,22178,1,2340,9.50%
Columbia,4/1/95,53013,4,1995,2178,1923,1,255,11.70%
Cowlitz,4/1/95,53015,4,1995,41099,37620,1,3479,8.50%
Douglas,4/1/95,53017,4,1995,17041,15627,1,1414,8.30%
Ferry,4/1/95,53019,4,1995,2939,2415,1,524,17.80%
Franklin,4/1/95,53021,4,1995,23289,21010,1,2279,9.80%
Garfield,4/1/95,53023,4,1995,1026,994,1,32,3.10%
Grant,4/1/95,53025,4,1995,33520,29955,1,3565,10.60%
Grays Harbor,4/1/95,53027,4,1995,28238,24978,1,3260,11.50%
Island,4/1/95,53029,4,1995,25624,24378,1,1246,4.90%
Jefferson,4/1/95,53031,4,1995,10015,9238,1,777,7.80%
King,4/1/95,53033,4,1995,898234,860119,1,38115,4.20%
Kitsap,4/1/95,53035,4,1995,90753,84124,1,6629,7.30%
Kittitas,4/1/95,53037,4,1995,16074,14364,1,1710,10.60%
Klickitat,4/1/95,53039,4,1995,8961,7731,1,1230,13.70%
Lewis,4/1/95,53041,4,1995,30321,27475,1,2846,9.40%
Lincoln,4/1/95,53043,4,1995,4812,4494,1,318,6.60%
Mason,4/1/95,53045,4,1995,17812,16220,1,1592,8.90%
Okanogan,4/1/95,53047,4,1995,21306,18560,1,2746,12.90%
Pacific,4/1/95,53049,4,1995,8204,7391,1,813,9.90%
Pend Oreille,4/1/95,53051,4,1995,4045,3447,1,598,14.80%
Pierce,4/1/95,53053,4,1995,319227,297135,1,22092,6.90%
San Juan,4/1/95,53055,4,1995,5450,4995,1,455,8.30%
Skagit,4/1/95,53057,4,1995,48307,43345,1,4962,10.30%
Skamania,4/1/95,53059,4,1995,4149,3614,1,535,12.90%
Snohomish,4/1/95,53061,4,1995,280878,267623,1,13255,4.70%
Spokane,4/1/95,53063,4,1995,201321,189571,1,11750,5.80%
Stevens,4/1/95,53065,4,1995,16738,14765,1,1973,11.80%
Thurston,4/1/95,53067,4,1995,95406,89127,1,6279,6.60%
Wahkiakum,4/1/95,53069,4,1995,1621,1514,1,107,6.60%
Walla Walla,4/1/95,53071,4,1995,26942,25023,1,1919,7.10%
Whatcom,4/1/95,53073,4,1995,78789,72232,1,6557,8.30%
Whitman,4/1/95,53075,4,1995,19015,18600,1,415,2.20%
Yakima,4/1/95,53077,4,1995,112680,96168,1,16512,14.70%
Adams,4/1/96,53001,4,1996,8296,7401,1,895,10.80%
Asotin,4/1/96,53003,4,1996,11739,11270,1,469,4.00%
Clallam,4/1/96,53009,4,1996,24550,22134,1,2416,9.80%
Columbia,4/1/96,53013,4,1996,1772,1512,1,260,14.70%
Cowlitz,4/1/96,53015,4,1996,41821,38222,1,3599,8.60%
Douglas,4/1/96,53017,4,1996,17847,16370,1,1477,8.30%
Ferry,4/1/96,53019,4,1996,2865,2388,1,477,16.60%
Franklin,4/1/96,53021,4,1996,23016,20395,1,2621,11.40%
Garfield,4/1/96,53023,4,1996,1067,1025,1,42,3.90%
Grant,4/1/96,53025,4,1996,34552,30970,1,3582,10.40%
Grays Harbor,4/1/96,53027,4,1996,27751,24530,1,3221,11.60%
Island,4/1/96,53029,4,1996,25998,24847,1,1151,4.40%
Jefferson,4/1/96,53031,4,1996,9902,9114,1,788,8.00%
King,4/1/96,53033,4,1996,914643,877317,1,37326,4.10%
Kitsap,4/1/96,53035,4,1996,93884,87667,1,6217,6.60%
Kittitas,4/1/96,53037,4,1996,15929,14357,1,1572,9.90%
Klickitat,4/1/96,53039,4,1996,8991,7763,1,1228,13.70%
Lewis,4/1/96,53041,4,1996,31085,28059,1,3026,9.70%
Lincoln,4/1/96,53043,4,1996,5009,4733,1,276,5.50%
Mason,4/1/96,53045,4,1996,18926,17346,1,1580,8.30%
Okanogan,4/1/96,53047,4,1996,21680,18940,1,2740,12.60%
Pacific,4/1/96,53049,4,1996,8324,7450,1,874,10.50%
Pend Oreille,4/1/96,53051,4,1996,4097,3395,1,702,17.10%
Pierce,4/1/96,53053,4,1996,320651,300279,1,20372,6.40%
San Juan,4/1/96,53055,4,1996,5499,5095,1,404,7.30%
Skagit,4/1/96,53057,4,1996,46679,42153,1,4526,9.70%
Skamania,4/1/96,53059,4,1996,4180,3677,1,503,12.00%
Snohomish,4/1/96,53061,4,1996,289259,276127,1,13132,4.50%
Spokane,4/1/96,53063,4,1996,204934,193304,1,11630,5.70%
Stevens,4/1/96,53065,4,1996,17036,14925,1,2111,12.40%
Thurston,4/1/96,53067,4,1996,97880,91845,1,6035,6.20%
Wahkiakum,4/1/96,53069,4,1996,1657,1548,1,109,6.60%
Walla Walla,4/1/96,53071,4,1996,26965,24888,1,2077,7.70%
Whatcom,4/1/96,53073,4,1996,79645,73884,1,5761,7.20%
Whitman,4/1/96,53075,4,1996,19780,19372,1,408,2.10%
Yakima,4/1/96,53077,4,1996,114068,98108,1,15960,14.00%
Adams,4/1/97,53001,4,1997,8365,7636,1,729,8.70%
Asotin,4/1/97,53003,4,1997,12315,11848,1,467,3.80%
Clallam,4/1/97,53009,4,1997,24972,22837,1,2135,8.50%
Columbia,4/1/97,53013,4,1997,2122,1937,1,185,8.70%
Cowlitz,4/1/97,53015,4,1997,42576,39045,1,3531,8.30%
Douglas,4/1/97,53017,4,1997,18633,17280,1,1353,7.30%
Ferry,4/1/97,53019,4,1997,2923,2509,1,414,14.20%
Franklin,4/1/97,53021,4,1997,22664,20527,1,2137,9.40%
Garfield,4/1/97,53023,4,1997,1079,1049,1,30,2.80%
Grant,4/1/97,53025,4,1997,35966,32493,1,3473,9.70%
Grays Harbor,4/1/97,53027,4,1997,28251,25398,1,2853,10.10%
Island,4/1/97,53029,4,1997,27876,26867,1,1009,3.60%
Jefferson,4/1/97,53031,4,1997,10040,9306,1,734,7.30%
King,4/1/97,53033,4,1997,946949,917275,1,29674,3.10%
Kitsap,4/1/97,53035,4,1997,94350,89178,1,5172,5.50%
Kittitas,4/1/97,53037,4,1997,15922,14836,1,1086,6.80%
Klickitat,4/1/97,53039,4,1997,9351,8186,1,1165,12.50%
Lewis,4/1/97,53041,4,1997,32472,29792,1,2680,8.30%
Lincoln,4/1/97,53043,4,1997,5099,4854,1,245,4.80%
Mason,4/1/97,53045,4,1997,19531,18137,1,1394,7.10%
Okanogan,4/1/97,53047,4,1997,22260,19755,1,2505,11.30%
Pacific,4/1/97,53049,4,1997,8829,8012,1,817,9.30%
Pend Oreille,4/1/97,53051,4,1997,4161,3510,1,651,15.60%
Pierce,4/1/97,53053,4,1997,334063,318323,1,15740,4.70%
San Juan,4/1/97,53055,4,1997,5599,5262,1,337,6.00%
Skagit,4/1/97,53057,4,1997,48036,44459,1,3577,7.40%
Skamania,4/1/97,53059,4,1997,4144,3711,1,433,10.40%
Snohomish,4/1/97,53061,4,1997,306681,296811,1,9870,3.20%
Spokane,4/1/97,53063,4,1997,208298,198188,1,10110,4.90%
Stevens,4/1/97,53065,4,1997,17640,15671,1,1969,11.20%
Thurston,4/1/97,53067,4,1997,100836,95700,1,5136,5.10%
Wahkiakum,4/1/97,53069,4,1997,1865,1738,1,127,6.80%
Walla Walla,4/1/97,53071,4,1997,27198,25252,1,1946,7.20%
Whatcom,4/1/97,53073,4,1997,79250,74594,1,4656,5.90%
Whitman,4/1/97,53075,4,1997,20234,19891,1,343,1.70%
Yakima,4/1/97,53077,4,1997,113848,100353,1,13495,11.90%
Adams,4/1/98,53001,4,1998,8824,8024,1,800,9.10%
Asotin,4/1/98,53003,4,1998,12715,12256,1,459,3.60%
Clallam,4/1/98,53009,4,1998,25253,23449,1,1804,7.10%
Columbia,4/1/98,53013,4,1998,2198,2025,1,173,7.90%
Cowlitz,4/1/98,53015,4,1998,42747,39542,1,3205,7.50%
Douglas,4/1/98,53017,4,1998,18737,17534,1,1203,6.40%
Ferry,4/1/98,53019,4,1998,2814,2463,1,351,12.50%
Franklin,4/1/98,53021,4,1998,23478,21261,1,2217,9.40%
Garfield,4/1/98,53023,4,1998,1102,1071,1,31,2.80%
Grant,4/1/98,53025,4,1998,36650,33721,1,2929,8.00%
Grays Harbor,4/1/98,53027,4,1998,26923,24398,1,2525,9.40%
Island,4/1/98,53029,4,1998,29479,28594,1,885,3.00%
Jefferson,4/1/98,53031,4,1998,10127,9510,1,617,6.10%
King,4/1/98,53033,4,1998,969931,945061,1,24870,2.60%
Kitsap,4/1/98,53035,4,1998,93836,89318,1,4518,4.80%
Kittitas,4/1/98,53037,4,1998,15643,14617,1,1026,6.60%
Klickitat,4/1/98,53039,4,1998,8953,8037,1,916,10.20%
Lewis,4/1/98,53041,4,1998,31198,28555,1,2643,8.50%
Lincoln,4/1/98,53043,4,1998,5185,4941,1,244,4.70%
Mason,4/1/98,53045,4,1998,20037,18747,1,1290,6.40%
Okanogan,4/1/98,53047,4,1998,21792,19526,1,2266,10.40%
Pacific,4/1/98,53049,4,1998,8609,7846,1,763,8.90%
Pend Oreille,4/1/98,53051,4,1998,4280,3697,1,583,13.60%
Pierce,4/1/98,53053,4,1998,342078,327620,1,14458,4.20%
San Juan,4/1/98,53055,4,1998,5870,5627,1,243,4.10%
Skagit,4/1/98,53057,4,1998,48308,45129,1,3179,6.60%
Skamania,4/1/98,53059,4,1998,4411,3999,1,412,9.30%
Snohomish,4/1/98,53061,4,1998,320124,311923,1,8201,2.60%
Spokane,4/1/98,53063,4,1998,214138,205366,1,8772,4.10%
Stevens,4/1/98,53065,4,1998,17848,16274,1,1574,8.80%
Thurston,4/1/98,53067,4,1998,103726,99046,1,4680,4.50%
Wahkiakum,4/1/98,53069,4,1998,1966,1859,1,107,5.40%
Walla Walla,4/1/98,53071,4,1998,28081,26506,1,1575,5.60%
Whatcom,4/1/98,53073,4,1998,80437,76141,1,4296,5.30%
Whitman,4/1/98,53075,4,1998,20525,20178,1,347,1.70%
Yakima,4/1/98,53077,4,1998,113974,102101,1,11873,10.40%
Adams,4/1/99,53001,4,1999,8958,7871,1,1087,12.10%
Asotin,4/1/99,53003,4,1999,12916,12433,1,483,3.70%
Clallam,4/1/99,53009,4,1999,26470,24383,1,2087,7.90%
Columbia,4/1/99,53013,4,1999,2182,1976,1,206,9.40%
Cowlitz,4/1/99,53015,4,1999,43886,40461,1,3425,7.80%
Douglas,4/1/99,53017,4,1999,19030,17598,1,1432,7.50%
Ferry,4/1/99,53019,4,1999,2708,2322,1,386,14.30%
Franklin,4/1/99,53021,4,1999,24056,21723,1,2333,9.70%
Garfield,4/1/99,53023,4,1999,1118,1079,1,39,3.50%
Grant,4/1/99,53025,4,1999,38128,34307,1,3821,10.00%
Grays Harbor,4/1/99,53027,4,1999,27459,25207,1,2252,8.20%
Island,4/1/99,53029,4,1999,30797,29650,1,1147,3.70%
Jefferson,4/1/99,53031,4,1999,11532,10758,1,774,6.70%
King,4/1/99,53033,4,1999,970498,945603,1,24895,2.60%
Kitsap,4/1/99,53035,4,1999,99120,94119,1,5001,5.00%
Kittitas,4/1/99,53037,4,1999,16212,15144,1,1068,6.60%
Klickitat,4/1/99,53039,4,1999,8951,8041,1,910,10.20%
Lewis,4/1/99,53041,4,1999,31406,28788,1,2618,8.30%
Lincoln,4/1/99,53043,4,1999,5033,4770,1,263,5.20%
Mason,4/1/99,53045,4,1999,19728,18398,1,1330,6.70%
Okanogan,4/1/99,53047,4,1999,21134,18608,1,2526,12.00%
Pacific,4/1/99,53049,4,1999,8239,7521,1,718,8.70%
Pend Oreille,4/1/99,53051,4,1999,4383,3834,1,549,12.50%
Pierce,4/1/99,53053,4,1999,350100,334102,1,15998,4.60%
San Juan,4/1/99,53055,4,1999,6516,6238,1,278,4.30%
Skagit,4/1/99,53057,4,1999,51935,48507,1,3428,6.60%
Skamania,4/1/99,53059,4,1999,4227,3855,1,372,8.80%
Snohomish,4/1/99,53061,4,1999,326179,316015,1,10164,3.10%
Spokane,4/1/99,53063,4,1999,219169,207598,1,11571,5.30%
Stevens,4/1/99,53065,4,1999,17543,15794,1,1749,10.00%
Thurston,4/1/99,53067,4,1999,106619,101841,1,4778,4.50%
Wahkiakum,4/1/99,53069,4,1999,2056,1910,1,146,7.10%
Walla Walla,4/1/99,53071,4,1999,27592,25448,1,2144,7.80%
Whatcom,4/1/99,53073,4,1999,85091,80547,1,4544,5.30%
Whitman,4/1/99,53075,4,1999,20551,20213,1,338,1.60%
Yakima,4/1/99,53077,4,1999,114557,101358,1,13199,11.50%
Adams,4/1/00,53001,4,2000,7755,7120,1,635,8.20%
Asotin,4/1/00,53003,4,2000,9899,9365,1,534,5.40%
Clallam,4/1/00,53009,4,2000,26184,24278,1,1906,7.30%
Columbia,4/1/00,53013,4,2000,2300,2128,1,172,7.50%
Cowlitz,4/1/00,53015,4,2000,43558,40609,1,2949,6.80%
Douglas,4/1/00,53017,4,2000,17347,16140,1,1207,7.00%
Ferry,4/1/00,53019,4,2000,3094,2690,1,404,13.10%
Franklin,4/1/00,53021,4,2000,22944,21269,1,1675,7.30%
Garfield,4/1/00,53023,4,2000,1035,984,1,51,4.90%
Grant,4/1/00,53025,4,2000,34409,31259,1,3150,9.20%
Grays Harbor,4/1/00,53027,4,2000,29418,27186,1,2232,7.60%
Island,4/1/00,53029,4,2000,29219,27585,1,1634,5.60%
Jefferson,4/1/00,53031,4,2000,11760,11074,1,686,5.80%
King,4/1/00,53033,4,2000,991495,961780,1,29715,3.00%
Kitsap,4/1/00,53035,4,2000,106628,100834,1,5794,5.40%
Kittitas,4/1/00,53037,4,2000,17698,16579,1,1119,6.30%
Klickitat,4/1/00,53039,4,2000,9102,8315,1,787,8.60%
Lewis,4/1/00,53041,4,2000,29769,27422,1,2347,7.90%
Lincoln,4/1/00,53043,4,2000,4594,4380,1,214,4.70%
Mason,4/1/00,53045,4,2000,20727,19368,1,1359,6.60%
Okanogan,4/1/00,53047,4,2000,19445,17664,1,1781,9.20%
Pacific,4/1/00,53049,4,2000,8677,8020,1,657,7.60%
Pend Oreille,4/1/00,53051,4,2000,4651,4218,1,433,9.30%
Pierce,4/1/00,53053,4,2000,342239,323769,1,18470,5.40%
San Juan,4/1/00,53055,4,2000,7173,6843,1,330,4.60%
Skagit,4/1/00,53057,4,2000,51702,48283,1,3419,6.60%
Skamania,4/1/00,53059,4,2000,4820,4496,1,324,6.70%
Snohomish,4/1/00,53061,4,2000,325326,313935,1,11391,3.50%
Spokane,4/1/00,53063,4,2000,212492,200745,1,11747,5.50%
Stevens,4/1/00,53065,4,2000,17642,16103,1,1539,8.70%
Thurston,4/1/00,53067,4,2000,108833,103599,1,5234,4.80%
Wahkiakum,4/1/00,53069,4,2000,1640,1532,1,108,6.60%
Walla Walla,4/1/00,53071,4,2000,27349,25572,1,1777,6.50%
Whatcom,4/1/00,53073,4,2000,88597,83600,1,4997,5.60%
Whitman,4/1/00,53075,4,2000,20097,19358,1,739,3.70%
Yakima,4/1/00,53077,4,2000,110826,100893,1,9933,9.00%
Adams,4/1/01,53001,4,2001,7529,6855,1,674,9.00%
Asotin,4/1/01,53003,4,2001,9762,9145,1,617,6.30%
Clallam,4/1/01,53009,4,2001,25287,23193,1,2094,8.30%
Columbia,4/1/01,53013,4,2001,2177,1992,1,185,8.50%
Cowlitz,4/1/01,53015,4,2001,42141,37669,1,4472,10.60%
Douglas,4/1/01,53017,4,2001,16252,14954,1,1298,8.00%
Ferry,4/1/01,53019,4,2001,2834,2402,1,432,15.20%
Franklin,4/1/01,53021,4,2001,23116,21041,1,2075,9.00%
Garfield,4/1/01,53023,4,2001,1049,989,1,60,5.70%
Grant,4/1/01,53025,4,2001,34143,30738,1,3405,10.00%
Grays Harbor,4/1/01,53027,4,2001,28309,25389,1,2920,10.30%
Island,4/1/01,53029,4,2001,28605,26858,1,1747,6.10%
Jefferson,4/1/01,53031,4,2001,11755,10970,1,785,6.70%
King,4/1/01,53033,4,2001,996447,958289,1,38158,3.80%
Kitsap,4/1/01,53035,4,2001,103784,97327,1,6457,6.20%
Kittitas,4/1/01,53037,4,2001,17394,16106,1,1288,7.40%
Klickitat,4/1/01,53039,4,2001,9170,7908,1,1262,13.80%
Lewis,4/1/01,53041,4,2001,28736,25948,1,2788,9.70%
Lincoln,4/1/01,53043,4,2001,4497,4234,1,263,5.80%
Mason,4/1/01,53045,4,2001,20260,18604,1,1656,8.20%
Okanogan,4/1/01,53047,4,2001,17493,15400,1,2093,12.00%
Pacific,4/1/01,53049,4,2001,8463,7644,1,819,9.70%
Pend Oreille,4/1/01,53051,4,2001,4526,4026,1,500,11.00%
Pierce,4/1/01,53053,4,2001,331440,308978,1,22462,6.80%
San Juan,4/1/01,53055,4,2001,6998,6629,1,369,5.30%
Skagit,4/1/01,53057,4,2001,50582,46897,1,3685,7.30%
Skamania,4/1/01,53059,4,2001,4884,4317,1,567,11.60%
Snohomish,4/1/01,53061,4,2001,330564,317094,1,13470,4.10%
Spokane,4/1/01,53063,4,2001,210210,195817,1,14393,6.80%
Stevens,4/1/01,53065,4,2001,17052,15134,1,1918,11.20%
Thurston,4/1/01,53067,4,2001,106612,100169,1,6443,6.00%
Wahkiakum,4/1/01,53069,4,2001,1569,1413,1,156,9.90%
Walla Walla,4/1/01,53071,4,2001,26931,24891,1,2040,7.60%
Whatcom,4/1/01,53073,4,2001,86647,80993,1,5654,6.50%
Whitman,4/1/01,53075,4,2001,18946,18140,1,806,4.30%
Yakima,4/1/01,53077,4,2001,105192,93620,1,11572,11.00%
Adams,4/1/02,53001,4,2002,8140,7174,1,966,11.90%
Asotin,4/1/02,53003,4,2002,10341,9397,1,944,9.10%
Clallam,4/1/02,53009,4,2002,26056,23618,1,2438,9.40%
Columbia,4/1/02,53013,4,2002,1977,1772,1,205,10.40%
Cowlitz,4/1/02,53015,4,2002,42347,37038,1,5309,12.50%
Douglas,4/1/02,53017,4,2002,16637,15245,1,1392,8.40%
Ferry,4/1/02,53019,4,2002,2833,2437,1,396,14.00%
Franklin,4/1/02,53021,4,2002,24128,21994,1,2134,8.80%
Garfield,4/1/02,53023,4,2002,1084,1008,1,76,7.00%
Grant,4/1/02,53025,4,2002,34642,30973,1,3669,10.60%
Grays Harbor,4/1/02,53027,4,2002,28548,25725,1,2823,9.90%
Island,4/1/02,53029,4,2002,29827,27442,1,2385,8.00%
Jefferson,4/1/02,53031,4,2002,12169,11168,1,1001,8.20%
King,4/1/02,53033,4,2002,986334,930253,1,56081,5.70%
Kitsap,4/1/02,53035,4,2002,109053,101213,1,7840,7.20%
Kittitas,4/1/02,53037,4,2002,18199,16750,1,1449,8.00%
Klickitat,4/1/02,53039,4,2002,9371,8020,1,1351,14.40%
Lewis,4/1/02,53041,4,2002,29214,26208,1,3006,10.30%
Lincoln,4/1/02,53043,4,2002,4602,4278,1,324,7.00%
Mason,4/1/02,53045,4,2002,20976,19130,1,1846,8.80%
Okanogan,4/1/02,53047,4,2002,17287,15166,1,2121,12.30%
Pacific,4/1/02,53049,4,2002,8483,7569,1,914,10.80%
Pend Oreille,4/1/02,53051,4,2002,4615,4074,1,541,11.70%
Pierce,4/1/02,53053,4,2002,339641,309857,1,29784,8.80%
San Juan,4/1/02,53055,4,2002,7184,6724,1,460,6.40%
Skagit,4/1/02,53057,4,2002,51223,46574,1,4649,9.10%
Skamania,4/1/02,53059,4,2002,4750,4203,1,547,11.50%
Snohomish,4/1/02,53061,4,2002,333500,311367,1,22133,6.60%
Spokane,4/1/02,53063,4,2002,209290,192154,1,17136,8.20%
Stevens,4/1/02,53065,4,2002,17343,15217,1,2126,12.30%
Thurston,4/1/02,53067,4,2002,109762,102122,1,7640,7.00%
Wahkiakum,4/1/02,53069,4,2002,1577,1393,1,184,11.70%
Walla Walla,4/1/02,53071,4,2002,27957,25627,1,2330,8.30%
Whatcom,4/1/02,53073,4,2002,89603,82795,1,6808,7.60%
Whitman,4/1/02,53075,4,2002,19303,18356,1,947,4.90%
Yakima,4/1/02,53077,4,2002,107258,95398,1,11860,11.10%
Adams,4/1/03,53001,4,2003,7818,7139,1,679,8.70%
Asotin,4/1/03,53003,4,2003,9884,9124,1,760,7.70%
Clallam,4/1/03,53009,4,2003,26444,24059,1,2385,9.00%
Columbia,4/1/03,53013,4,2003,2008,1837,1,171,8.50%
Cowlitz,4/1/03,53015,4,2003,42110,37660,1,4450,10.60%
Douglas,4/1/03,53017,4,2003,17166,15684,1,1482,8.60%
Ferry,4/1/03,53019,4,2003,2857,2390,1,467,16.30%
Franklin,4/1/03,53021,4,2003,25758,23461,1,2297,8.90%
Garfield,4/1/03,53023,4,2003,1068,991,1,77,7.20%
Grant,4/1/03,53025,4,2003,34539,31174,1,3365,9.70%
Grays Harbor,4/1/03,53027,4,2003,29227,26294,1,2933,10.00%
Island,4/1/03,53029,4,2003,30195,27963,1,2232,7.40%
Jefferson,4/1/03,53031,4,2003,12526,11573,1,953,7.60%
King,4/1/03,53033,4,2003,989947,932077,1,57870,5.80%
Kitsap,4/1/03,53035,4,2003,111599,103749,1,7850,7.00%
Kittitas,4/1/03,53037,4,2003,18776,17218,1,1558,8.30%
Klickitat,4/1/03,53039,4,2003,9045,7913,1,1132,12.50%
Lewis,4/1/03,53041,4,2003,29690,26720,1,2970,10.00%
Lincoln,4/1/03,53043,4,2003,4604,4277,1,327,7.10%
Mason,4/1/03,53045,4,2003,22130,20116,1,2014,9.10%
Okanogan,4/1/03,53047,4,2003,17931,15871,1,2060,11.50%
Pacific,4/1/03,53049,4,2003,8800,7911,1,889,10.10%
Pend Oreille,4/1/03,53051,4,2003,4670,4116,1,554,11.90%
Pierce,4/1/03,53053,4,2003,344955,316039,1,28916,8.40%
San Juan,4/1/03,53055,4,2003,7473,7012,1,461,6.20%
Skagit,4/1/03,53057,4,2003,52313,47830,1,4483,8.60%
Skamania,4/1/03,53059,4,2003,4698,4206,1,492,10.50%
Snohomish,4/1/03,53061,4,2003,334996,313228,1,21768,6.50%
Spokane,4/1/03,53063,4,2003,212029,195748,1,16281,7.70%
Stevens,4/1/03,53065,4,2003,17513,15501,1,2012,11.50%
Thurston,4/1/03,53067,4,2003,114214,106826,1,7388,6.50%
Wahkiakum,4/1/03,53069,4,2003,1579,1406,1,173,11.00%
Walla Walla,4/1/03,53071,4,2003,28671,26447,1,2224,7.80%
Whatcom,4/1/03,53073,4,2003,93273,86689,1,6584,7.10%
Whitman,4/1/03,53075,4,2003,19462,18497,1,965,5.00%
Yakima,4/1/03,53077,4,2003,109401,97617,1,11784,10.80%
Adams,4/1/04,53001,4,2004,7937,7166,1,771,9.70%
Asotin,4/1/04,53003,4,2004,10107,9471,1,636,6.30%
Clallam,4/1/04,53009,4,2004,27780,25676,1,2104,7.60%
Columbia,4/1/04,53013,4,2004,2206,2074,1,132,6.00%
Cowlitz,4/1/04,53015,4,2004,42663,38868,1,3795,8.90%
Douglas,4/1/04,53017,4,2004,17991,16764,1,1227,6.80%
Ferry,4/1/04,53019,4,2004,2915,2530,1,385,13.20%
Franklin,4/1/04,53021,4,2004,27748,25610,1,2138,7.70%
Garfield,4/1/04,53023,4,2004,1075,1013,1,62,5.80%
Grant,4/1/04,53025,4,2004,36031,32836,1,3195,8.90%
Grays Harbor,4/1/04,53027,4,2004,30347,27672,1,2675,8.80%
Island,4/1/04,53029,4,2004,31038,28744,1,2294,7.40%
Jefferson,4/1/04,53031,4,2004,13267,12388,1,879,6.60%
King,4/1/04,53033,4,2004,992892,947045,1,45847,4.60%
Kitsap,4/1/04,53035,4,2004,117396,110209,1,7187,6.10%
Kittitas,4/1/04,53037,4,2004,19286,17855,1,1431,7.40%
Klickitat,4/1/04,53039,4,2004,9222,8270,1,952,10.30%
Lewis,4/1/04,53041,4,2004,30548,27875,1,2673,8.80%
Lincoln,4/1/04,53043,4,2004,4768,4454,1,314,6.60%
Mason,4/1/04,53045,4,2004,23135,21313,1,1822,7.90%
Okanogan,4/1/04,53047,4,2004,18535,16857,1,1678,9.10%
Pacific,4/1/04,53049,4,2004,9106,8377,1,729,8.00%
Pend Oreille,4/1/04,53051,4,2004,4902,4435,1,467,9.50%
Pierce,4/1/04,53053,4,2004,358395,331371,1,27024,7.50%
San Juan,4/1/04,53055,4,2004,7769,7373,1,396,5.10%
Skagit,4/1/04,53057,4,2004,54063,50053,1,4010,7.40%
Skamania,4/1/04,53059,4,2004,4827,4449,1,378,7.80%
Snohomish,4/1/04,53061,4,2004,337724,319751,1,17973,5.30%
Spokane,4/1/04,53063,4,2004,217675,202858,1,14817,6.80%
Stevens,4/1/04,53065,4,2004,17883,16285,1,1598,8.90%
Thurston,4/1/04,53067,4,2004,118519,111285,1,7234,6.10%
Wahkiakum,4/1/04,53069,4,2004,1587,1456,1,131,8.30%
Walla Walla,4/1/04,53071,4,2004,29050,27204,1,1846,6.40%
Whatcom,4/1/04,53073,4,2004,98152,92088,1,6064,6.20%
Whitman,4/1/04,53075,4,2004,20451,19512,1,939,4.60%
Yakima,4/1/04,53077,4,2004,112629,102251,1,10378,9.20%
Adams,4/1/05,53001,4,2005,7822,7319,1,503,6.40%
Asotin,4/1/05,53003,4,2005,10393,9772,1,621,6.00%
Clallam,4/1/05,53009,4,2005,29322,27276,1,2046,7.00%
Columbia,4/1/05,53013,4,2005,1994,1865,1,129,6.50%
Cowlitz,4/1/05,53015,4,2005,42617,39242,1,3375,7.90%
Douglas,4/1/05,53017,4,2005,18639,17456,1,1183,6.30%
Ferry,4/1/05,53019,4,2005,2967,2641,1,326,11.00%
Franklin,4/1/05,53021,4,2005,29058,27074,1,1984,6.80%
Garfield,4/1/05,53023,4,2005,1068,1002,1,66,6.20%
Grant,4/1/05,53025,4,2005,36685,33825,1,2860,7.80%
Grays Harbor,4/1/05,53027,4,2005,31011,28445,1,2566,8.30%
Island,4/1/05,53029,4,2005,31550,29486,1,2064,6.50%
Jefferson,4/1/05,53031,4,2005,13572,12753,1,819,6.00%
King,4/1/05,53033,4,2005,1008289,968337,1,39952,4.00%
Kitsap,4/1/05,53035,4,2005,120152,113426,1,6726,5.60%
Kittitas,4/1/05,53037,4,2005,19646,18344,1,1302,6.60%
Klickitat,4/1/05,53039,4,2005,9086,8309,1,777,8.60%
Lewis,4/1/05,53041,4,2005,30411,27823,1,2588,8.50%
Lincoln,4/1/05,53043,4,2005,4654,4357,1,297,6.40%
Mason,4/1/05,53045,4,2005,23810,22100,1,1710,7.20%
Okanogan,4/1/05,53047,4,2005,18783,17222,1,1561,8.30%
Pacific,4/1/05,53049,4,2005,8918,8186,1,732,8.20%
Pend Oreille,4/1/05,53051,4,2005,5086,4613,1,473,9.30%
Pierce,4/1/05,53053,4,2005,365910,342004,1,23906,6.50%
San Juan,4/1/05,53055,4,2005,7975,7592,1,383,4.80%
Skagit,4/1/05,53057,4,2005,55501,51885,1,3616,6.50%
Skamania,4/1/05,53059,4,2005,4949,4573,1,376,7.60%
Snohomish,4/1/05,53061,4,2005,344911,329958,1,14953,4.30%
Spokane,4/1/05,53063,4,2005,222919,209575,1,13344,6.00%
Stevens,4/1/05,53065,4,2005,17910,16377,1,1533,8.60%
Thurston,4/1/05,53067,4,2005,121633,114850,1,6783,5.60%
Wahkiakum,4/1/05,53069,4,2005,1607,1473,1,134,8.30%
Walla Walla,4/1/05,53071,4,2005,28665,26864,1,1801,6.30%
Whatcom,4/1/05,53073,4,2005,102279,96713,1,5566,5.40%
Whitman,4/1/05,53075,4,2005,20830,19799,1,1031,4.90%
Yakima,4/1/05,53077,4,2005,113442,104191,1,9251,8.20%
Adams,4/1/06,53001,4,2006,7717,7235,1,482,6.20%
Asotin,4/1/06,53003,4,2006,10466,9895,1,571,5.50%
Clallam,4/1/06,53009,4,2006,29359,27493,1,1866,6.40%
Columbia,4/1/06,53013,4,2006,1472,1320,1,152,10.30%
Cowlitz,4/1/06,53015,4,2006,42348,39353,1,2995,7.10%
Douglas,4/1/06,53017,4,2006,18749,17687,1,1062,5.70%
Ferry,4/1/06,53019,4,2006,2830,2503,1,327,11.60%
Franklin,4/1/06,53021,4,2006,29594,27299,1,2295,7.80%
Garfield,4/1/06,53023,4,2006,1009,945,1,64,6.30%
Grant,4/1/06,53025,4,2006,36722,34015,1,2707,7.40%
Grays Harbor,4/1/06,53027,4,2006,30699,28382,1,2317,7.50%
Island,4/1/06,53029,4,2006,32084,30227,1,1857,5.80%
Jefferson,4/1/06,53031,4,2006,13472,12720,1,752,5.60%
King,4/1/06,53033,4,2006,1042742,1009724,1,33018,3.20%
Kitsap,4/1/06,53035,4,2006,121571,115293,1,6278,5.20%
Kittitas,4/1/06,53037,4,2006,20011,18875,1,1136,5.70%
Klickitat,4/1/06,53039,4,2006,9003,8255,1,748,8.30%
Lewis,4/1/06,53041,4,2006,30911,28582,1,2329,7.50%
Lincoln,4/1/06,53043,4,2006,4589,4318,1,271,5.90%
Mason,4/1/06,53045,4,2006,24073,22527,1,1546,6.40%
Okanogan,4/1/06,53047,4,2006,18875,17477,1,1398,7.40%
Pacific,4/1/06,53049,4,2006,9045,8402,1,643,7.10%
Pend Oreille,4/1/06,53051,4,2006,5022,4584,1,438,8.70%
Pierce,4/1/06,53053,4,2006,370163,349044,1,21119,5.70%
San Juan,4/1/06,53055,4,2006,7848,7505,1,343,4.40%
Skagit,4/1/06,53057,4,2006,55920,52686,1,3234,5.80%
Skamania,4/1/06,53059,4,2006,4995,4648,1,347,6.90%
Snohomish,4/1/06,53061,4,2006,357412,344998,1,12414,3.50%
Spokane,4/1/06,53063,4,2006,225912,213688,1,12224,5.40%
Stevens,4/1/06,53065,4,2006,18044,16589,1,1455,8.10%
Thurston,4/1/06,53067,4,2006,122809,116547,1,6262,5.10%
Wahkiakum,4/1/06,53069,4,2006,1617,1500,1,117,7.20%
Walla Walla,4/1/06,53071,4,2006,28407,26696,1,1711,6.00%
Whatcom,4/1/06,53073,4,2006,102249,97088,1,5161,5.00%
Whitman,4/1/06,53075,4,2006,20692,19758,1,934,4.50%
Yakima,4/1/06,53077,4,2006,113294,104477,1,8817,7.80%
Adams,4/1/07,53001,4,2007,7744,7270,1,474,6.10%
Asotin,4/1/07,53003,4,2007,10288,9722,1,566,5.50%
Clallam,4/1/07,53009,4,2007,29482,27608,1,1874,6.40%
Columbia,4/1/07,53013,4,2007,1537,1425,1,112,7.30%
Cowlitz,4/1/07,53015,4,2007,43244,40190,1,3054,7.10%
Douglas,4/1/07,53017,4,2007,19403,18331,1,1072,5.50%
Ferry,4/1/07,53019,4,2007,2889,2573,1,316,10.90%
Franklin,4/1/07,53021,4,2007,31762,29446,1,2316,7.30%
Garfield,4/1/07,53023,4,2007,984,934,1,50,5.10%
Grant,4/1/07,53025,4,2007,38790,36247,1,2543,6.60%
Grays Harbor,4/1/07,53027,4,2007,30955,28416,1,2539,8.20%
Island,4/1/07,53029,4,2007,32492,30635,1,1857,5.70%
Jefferson,4/1/07,53031,4,2007,13538,12802,1,736,5.40%
King,4/1/07,53033,4,2007,1063920,1037011,1,26909,2.50%
Kitsap,4/1/07,53035,4,2007,121548,115464,1,6084,5.00%
Kittitas,4/1/07,53037,4,2007,20660,19595,1,1065,5.20%
Klickitat,4/1/07,53039,4,2007,9602,8836,1,766,8.00%
Lewis,4/1/07,53041,4,2007,30969,28495,1,2474,8.00%
Lincoln,4/1/07,53043,4,2007,4666,4388,1,278,6.00%
Mason,4/1/07,53045,4,2007,24773,23141,1,1632,6.60%
Okanogan,4/1/07,53047,4,2007,18955,17416,1,1539,8.10%
Pacific,4/1/07,53049,4,2007,9018,8290,1,728,8.10%
Pend Oreille,4/1/07,53051,4,2007,5190,4758,1,432,8.30%
Pierce,4/1/07,53053,4,2007,382284,361287,1,20997,5.50%
San Juan,4/1/07,53055,4,2007,8123,7818,1,305,3.80%
Skagit,4/1/07,53057,4,2007,56986,53891,1,3095,5.40%
Skamania,4/1/07,53059,4,2007,4989,4622,1,367,7.40%
Snohomish,4/1/07,53061,4,2007,361556,351762,1,9794,2.70%
Spokane,4/1/07,53063,4,2007,232543,220575,1,11968,5.10%
Stevens,4/1/07,53065,4,2007,18515,16912,1,1603,8.70%
Thurston,4/1/07,53067,4,2007,126668,120384,1,6284,5.00%
Wahkiakum,4/1/07,53069,4,2007,1663,1522,1,141,8.50%
Walla Walla,4/1/07,53071,4,2007,28633,27103,1,1530,5.30%
Whatcom,4/1/07,53073,4,2007,105088,99999,1,5089,4.80%
Whitman,4/1/07,53075,4,2007,20723,19877,1,846,4.10%
Yakima,4/1/07,53077,4,2007,115478,107140,1,8338,7.20%
Adams,4/1/08,53001,4,2008,7958,7519,1,439,5.50%
Asotin,4/1/08,53003,4,2008,10320,9673,1,647,6.30%
Clallam,4/1/08,53009,4,2008,30002,27710,1,2292,7.60%
Columbia,4/1/08,53013,4,2008,1541,1454,1,87,5.60%
Cowlitz,4/1/08,53015,4,2008,43981,40344,1,3637,8.30%
Douglas,4/1/08,53017,4,2008,19839,18803,1,1036,5.20%
Ferry,4/1/08,53019,4,2008,2860,2557,1,303,10.60%
Franklin,4/1/08,53021,4,2008,33090,31002,1,2088,6.30%
Garfield,4/1/08,53023,4,2008,983,935,1,48,4.90%
Grant,4/1/08,53025,4,2008,39065,36561,1,2504,6.40%
Grays Harbor,4/1/08,53027,4,2008,31469,29009,1,2460,7.80%
Island,4/1/08,53029,4,2008,32957,31155,1,1802,5.50%
Jefferson,4/1/08,53031,4,2008,13613,12839,1,774,5.70%
King,4/1/08,53033,4,2008,1088692,1059072,1,29620,2.70%
Kitsap,4/1/08,53035,4,2008,123922,117614,1,6308,5.10%
Kittitas,4/1/08,53037,4,2008,21552,20235,1,1317,6.10%
Klickitat,4/1/08,53039,4,2008,9768,8968,1,800,8.20%
Lewis,4/1/08,53041,4,2008,31353,28757,1,2596,8.30%
Lincoln,4/1/08,53043,4,2008,4715,4447,1,268,5.70%
Mason,4/1/08,53045,4,2008,25122,23304,1,1818,7.20%
Okanogan,4/1/08,53047,4,2008,19449,18024,1,1425,7.30%
Pacific,4/1/08,53049,4,2008,9078,8353,1,725,8.00%
Pend Oreille,4/1/08,53051,4,2008,5374,4862,1,512,9.50%
Pierce,4/1/08,53053,4,2008,391893,369493,1,22400,5.70%
San Juan,4/1/08,53055,4,2008,8459,8140,1,319,3.80%
Skagit,4/1/08,53057,4,2008,58247,54953,1,3294,5.70%
Skamania,4/1/08,53059,4,2008,5147,4683,1,464,9.00%
Snohomish,4/1/08,53061,4,2008,371348,359690,1,11658,3.10%
Spokane,4/1/08,53063,4,2008,237923,224813,1,13110,5.50%
Stevens,4/1/08,53065,4,2008,18809,17063,1,1746,9.30%
Thurston,4/1/08,53067,4,2008,130607,123884,1,6723,5.10%
Wahkiakum,4/1/08,53069,4,2008,1738,1607,1,131,7.50%
Walla Walla,4/1/08,53071,4,2008,29546,28063,1,1483,5.00%
Whatcom,4/1/08,53073,4,2008,108481,103096,1,5385,5.00%
Whitman,4/1/08,53075,4,2008,21372,20528,1,844,3.90%
Yakima,4/1/08,53077,4,2008,118602,109812,1,8790,7.40%
Adams,4/1/09,53001,4,2009,8108,7485,1,623,7.70%
Asotin,4/1/09,53003,4,2009,10317,9404,1,913,8.80%
Clallam,4/1/09,53009,4,2009,30160,27286,1,2874,9.50%
Columbia,4/1/09,53013,4,2009,1562,1386,1,176,11.30%
Cowlitz,4/1/09,53015,4,2009,44681,38680,1,6001,13.40%
Douglas,4/1/09,53017,4,2009,20403,18764,1,1639,8.00%
Ferry,4/1/09,53019,4,2009,3060,2641,1,419,13.70%
Franklin,4/1/09,53021,4,2009,35276,32520,1,2756,7.80%
Garfield,4/1/09,53023,4,2009,998,936,1,62,6.20%
Grant,4/1/09,53025,4,2009,40458,36847,1,3611,8.90%
Grays Harbor,4/1/09,53027,4,2009,31360,27246,1,4114,13.10%
Island,4/1/09,53029,4,2009,32871,30127,1,2744,8.30%
Jefferson,4/1/09,53031,4,2009,13060,11950,1,1110,8.50%
King,4/1/09,53033,4,2009,1117900,1042979,1,74921,6.70%
Kitsap,4/1/09,53035,4,2009,124860,115731,1,9129,7.30%
Kittitas,4/1/09,53037,4,2009,21372,19600,1,1772,8.30%
Klickitat,4/1/09,53039,4,2009,10495,9365,1,1130,10.80%
Lewis,4/1/09,53041,4,2009,31751,27753,1,3998,12.60%
Lincoln,4/1/09,53043,4,2009,4762,4378,1,384,8.10%
Mason,4/1/09,53045,4,2009,25441,22687,1,2754,10.80%
Okanogan,4/1/09,53047,4,2009,20061,18100,1,1961,9.80%
Pacific,4/1/09,53049,4,2009,9085,7965,1,1120,12.30%
Pend Oreille,4/1/09,53051,4,2009,5445,4616,1,829,15.20%
Pierce,4/1/09,53053,4,2009,397241,360746,1,36495,9.20%
San Juan,4/1/09,53055,4,2009,8170,7643,1,527,6.50%
Skagit,4/1/09,53057,4,2009,58126,52628,1,5498,9.50%
Skamania,4/1/09,53059,4,2009,5113,4451,1,662,12.90%
Snohomish,4/1/09,53061,4,2009,382552,352195,1,30357,7.90%
Spokane,4/1/09,53063,4,2009,239368,219042,1,20326,8.50%
Stevens,4/1/09,53065,4,2009,18981,16483,1,2498,13.20%
Thurston,4/1/09,53067,4,2009,132528,122787,1,9741,7.40%
Wahkiakum,4/1/09,53069,4,2009,1619,1369,1,250,15.40%
Walla Walla,4/1/09,53071,4,2009,30297,28355,1,1942,6.40%
Whatcom,4/1/09,53073,4,2009,107729,99389,1,8340,7.70%
Whitman,4/1/09,53075,4,2009,22279,21188,1,1091,4.90%
Yakima,4/1/09,53077,4,2009,119662,109323,1,10339,8.60%
Adams,4/1/10,53001,4,2010,8276,7484,1,792,9.60%
Asotin,4/1/10,53003,4,2010,10406,9428,1,978,9.40%
Clallam,4/1/10,53009,4,2010,29754,26471,1,3283,11.00%
Columbia,4/1/10,53013,4,2010,1989,1794,1,195,9.80%
Cowlitz,4/1/10,53015,4,2010,46862,40542,1,6320,13.50%
Douglas,4/1/10,53017,4,2010,19413,17442,1,1971,10.20%
Ferry,4/1/10,53019,4,2010,2700,2193,1,507,18.80%
Franklin,4/1/10,53021,4,2010,36900,33596,1,3304,9.00%
Garfield,4/1/10,53023,4,2010,1072,982,1,90,8.40%
Grant,4/1/10,53025,4,2010,42524,37912,1,4612,10.80%
Grays Harbor,4/1/10,53027,4,2010,31378,26809,1,4569,14.60%
Island,4/1/10,53029,4,2010,34194,30946,1,3248,9.50%
Jefferson,4/1/10,53031,4,2010,13049,11719,1,1330,10.20%
King,4/1/10,53033,4,2010,1115452,1019646,1,95806,8.60%
Kitsap,4/1/10,53035,4,2010,121268,110619,1,10649,8.80%
Kittitas,4/1/10,53037,4,2010,22146,20029,1,2117,9.60%
Klickitat,4/1/10,53039,4,2010,10433,9084,1,1349,12.90%
Lewis,4/1/10,53041,4,2010,34439,29771,1,4668,13.60%
Lincoln,4/1/10,53043,4,2010,5294,4842,1,452,8.50%
Mason,4/1/10,53045,4,2010,24866,21821,1,3045,12.20%
Okanogan,4/1/10,53047,4,2010,20926,18415,1,2511,12.00%
Pacific,4/1/10,53049,4,2010,8823,7474,1,1349,15.30%
Pend Oreille,4/1/10,53051,4,2010,5242,4396,1,846,16.10%
Pierce,4/1/10,53053,4,2010,398317,355855,1,42462,10.70%
San Juan,4/1/10,53055,4,2010,8341,7719,1,622,7.50%
Skagit,4/1/10,53057,4,2010,59439,52856,1,6583,11.10%
Skamania,4/1/10,53059,4,2010,5233,4528,1,705,13.50%
Snohomish,4/1/10,53061,4,2010,389456,349893,1,39563,10.20%
Spokane,4/1/10,53063,4,2010,240011,215420,1,24591,10.20%
Stevens,4/1/10,53065,4,2010,19419,16779,1,2640,13.60%
Thurston,4/1/10,53067,4,2010,128114,116301,1,11813,9.20%
Wahkiakum,4/1/10,53069,4,2010,1482,1244,1,238,16.10%
Walla Walla,4/1/10,53071,4,2010,30238,27735,1,2503,8.30%
Whatcom,4/1/10,53073,4,2010,105107,95015,1,10092,9.60%
Whitman,4/1/10,53075,4,2010,22957,21471,1,1486,6.50%
Yakima,4/1/10,53077,4,2010,118236,104905,1,13331,11.30%
Adams,4/1/11,53001,4,2011,8136,7387,1,749,9.20%
Asotin,4/1/11,53003,4,2011,10180,9260,1,920,9.00%
Clallam,4/1/11,53009,4,2011,28385,25293,1,3092,10.90%
Columbia,4/1/11,53013,4,2011,1861,1683,1,178,9.60%
Cowlitz,4/1/11,53015,4,2011,44632,39253,1,5379,12.10%
Douglas,4/1/11,53017,4,2011,18521,16723,1,1798,9.70%
Ferry,4/1/11,53019,4,2011,2456,2011,1,445,18.10%
Franklin,4/1/11,53021,4,2011,37564,34280,1,3284,8.70%
Garfield,4/1/11,53023,4,2011,1032,964,1,68,6.60%
Grant,4/1/11,53025,4,2011,41537,37391,1,4146,10.00%
Grays Harbor,4/1/11,53027,4,2011,29460,25617,1,3843,13.00%
Island,4/1/11,53029,4,2011,32660,29728,1,2932,9.00%
Jefferson,4/1/11,53031,4,2011,12165,10924,1,1241,10.20%
King,4/1/11,53033,4,2011,1110217,1025656,1,84561,7.60%
Kitsap,4/1/11,53035,4,2011,117194,107544,1,9650,8.20%
Kittitas,4/1/11,53037,4,2011,21438,19562,1,1876,8.80%
Klickitat,4/1/11,53039,4,2011,9930,8719,1,1211,12.20%
Lewis,4/1/11,53041,4,2011,32760,28600,1,4160,12.70%
Lincoln,4/1/11,53043,4,2011,5241,4815,1,426,8.10%
Mason,4/1/11,53045,4,2011,23604,20851,1,2753,11.70%
Okanogan,4/1/11,53047,4,2011,19487,17220,1,2267,11.60%
Pacific,4/1/11,53049,4,2011,8145,7006,1,1139,14.00%
Pend Oreille,4/1/11,53051,4,2011,4891,4196,1,695,14.20%
Pierce,4/1/11,53053,4,2011,385403,346458,1,38945,10.10%
San Juan,4/1/11,53055,4,2011,7833,7243,1,590,7.50%
Skagit,4/1/11,53057,4,2011,56915,50949,1,5966,10.50%
Skamania,4/1/11,53059,4,2011,5098,4456,1,642,12.60%
Snohomish,4/1/11,53061,4,2011,384587,349118,1,35469,9.20%
Spokane,4/1/11,53063,4,2011,230604,208711,1,21893,9.50%
Stevens,4/1/11,53065,4,2011,18431,16128,1,2303,12.50%
Thurston,4/1/11,53067,4,2011,123667,112767,1,10900,8.80%
Wahkiakum,4/1/11,53069,4,2011,1446,1244,1,202,14.00%
Walla Walla,4/1/11,53071,4,2011,29098,26781,1,2317,8.00%
Whatcom,4/1/11,53073,4,2011,102945,93985,1,8960,8.70%
Whitman,4/1/11,53075,4,2011,22773,21428,1,1345,5.90%
Yakima,4/1/11,53077,4,2011,114802,101989,1,12813,11.20%
Adams,4/1/12,53001,4,2012,8258,7565,1,693,8.40%
Asotin,4/1/12,53003,4,2012,9679,8920,1,759,7.80%
Clallam,4/1/12,53009,4,2012,28030,25116,1,2914,10.40%
Columbia,4/1/12,53013,4,2012,1831,1677,1,154,8.40%
Cowlitz,4/1/12,53015,4,2012,44624,39938,1,4686,10.50%
Douglas,4/1/12,53017,4,2012,18627,16798,1,1829,9.80%
Ferry,4/1/12,53019,4,2012,2466,2071,1,395,16.00%
Franklin,4/1/12,53021,4,2012,37998,34207,1,3791,10.00%
Garfield,4/1/12,53023,4,2012,1047,966,1,81,7.70%
Grant,4/1/12,53025,4,2012,42435,38231,1,4204,9.90%
Grays Harbor,4/1/12,53027,4,2012,28894,25040,1,3854,13.30%
Island,4/1/12,53029,4,2012,32697,30064,1,2633,8.10%
Jefferson,4/1/12,53031,4,2012,11909,10717,1,1192,10.00%
King,4/1/12,53033,4,2012,1124122,1056759,1,67363,6.00%
Kitsap,4/1/12,53035,4,2012,116086,106979,1,9107,7.80%
Kittitas,4/1/12,53037,4,2012,21172,19366,1,1806,8.50%
Klickitat,4/1/12,53039,4,2012,9802,8769,1,1033,10.50%
Lewis,4/1/12,53041,4,2012,32251,28338,1,3913,12.10%
Lincoln,4/1/12,53043,4,2012,5207,4820,1,387,7.40%
Mason,4/1/12,53045,4,2012,23357,20779,1,2578,11.00%
Okanogan,4/1/12,53047,4,2012,19422,17303,1,2119,10.90%
Pacific,4/1/12,53049,4,2012,8240,7226,1,1014,12.30%
Pend Oreille,4/1/12,53051,4,2012,4866,4213,1,653,13.40%
Pierce,4/1/12,53053,4,2012,386186,350089,1,36097,9.30%
San Juan,4/1/12,53055,4,2012,7865,7336,1,529,6.70%
Skagit,4/1/12,53057,4,2012,57104,51687,1,5417,9.50%
Skamania,4/1/12,53059,4,2012,5056,4533,1,523,10.30%
Snohomish,4/1/12,53061,4,2012,385735,358351,1,27384,7.10%
Spokane,4/1/12,53063,4,2012,230891,209821,1,21070,9.10%
Stevens,4/1/12,53065,4,2012,18407,16159,1,2248,12.20%
Thurston,4/1/12,53067,4,2012,123034,112708,1,10326,8.40%
Wahkiakum,4/1/12,53069,4,2012,1392,1221,1,171,12.30%
Walla Walla,4/1/12,53071,4,2012,29378,27240,1,2138,7.30%
Whatcom,4/1/12,53073,4,2012,103921,95774,1,8147,7.80%
Whitman,4/1/12,53075,4,2012,22766,21418,1,1348,5.90%
Yakima,4/1/12,53077,4,2012,116158,102778,1,13380,11.50%
Adams,4/1/13,53001,4,2013,8419,7738,1,681,8.10%
Asotin,4/1/13,53003,4,2013,9893,9234,1,659,6.70%
Clallam,4/1/13,53009,4,2013,27410,24712,1,2698,9.80%
Clark,4/1/13,53011,4,2013,207799,189996,1,17803,8.60%
Columbia,4/1/13,53013,4,2013,1773,1625,1,148,8.30%
Cowlitz,4/1/13,53015,4,2013,43291,39029,1,4262,9.80%
Douglas,4/1/13,53017,4,2013,18300,16692,1,1608,8.80%
Ferry,4/1/13,53019,4,2013,2491,2144,1,347,13.90%
Franklin,4/1/13,53021,4,2013,37672,33980,1,3692,9.80%
Garfield,4/1/13,53023,4,2013,990,912,1,78,7.90%
Grant,4/1/13,53025,4,2013,43221,39524,1,3697,8.60%
Grays Harbor,4/1/13,53027,4,2013,27686,24236,1,3450,12.50%
Island,4/1/13,53029,4,2013,31664,29306,1,2358,7.40%
Jefferson,4/1/13,53031,4,2013,11381,10280,1,1101,9.70%
King,4/1/13,53033,4,2013,1135960,1085664,1,50296,4.40%
Kitsap,4/1/13,53035,4,2013,113158,104827,1,8331,7.40%
Kittitas,4/1/13,53037,4,2013,20999,19435,1,1564,7.40%
Klickitat,4/1/13,53039,4,2013,9673,8751,1,922,9.50%
Lewis,4/1/13,53041,4,2013,31343,27946,1,3397,10.80%
Lincoln,4/1/13,53043,4,2013,5023,4673,1,350,7.00%
Mason,4/1/13,53045,4,2013,23174,20796,1,2378,10.30%
Okanogan,4/1/13,53047,4,2013,19404,17486,1,1918,9.90%
Pacific,4/1/13,53049,4,2013,7845,6934,1,911,11.60%
Pend Oreille,4/1/13,53051,4,2013,4728,4137,1,591,12.50%
Pierce,4/1/13,53053,4,2013,383275,350593,1,32682,8.50%
San Juan,4/1/13,53055,4,2013,7601,7126,1,475,6.20%
Skagit,4/1/13,53057,4,2013,56722,51768,1,4954,8.70%
Skamania,4/1/13,53059,4,2013,5005,4488,1,517,10.30%
Snohomish,4/1/13,53061,4,2013,387990,368208,1,19782,5.10%
Spokane,4/1/13,53063,4,2013,228105,209514,1,18591,8.20%
Stevens,4/1/13,53065,4,2013,17949,15918,1,2031,11.30%
Thurston,4/1/13,53067,4,2013,123108,113727,1,9381,7.60%
Wahkiakum,4/1/13,53069,4,2013,1319,1146,1,173,13.10%
Walla Walla,4/1/13,53071,4,2013,28322,26299,1,2023,7.10%
Whatcom,4/1/13,53073,4,2013,101755,94131,1,7624,7.50%
Whitman,4/1/13,53075,4,2013,22983,21683,1,1300,5.70%
Yakima,4/1/13,53077,4,2013,116202,104027,1,12175,10.50%
Adams,4/1/14,53001,4,2014,8677,8168,1,509,5.90%
Asotin,4/1/14,53003,4,2014,9611,9126,1,485,5.00%
Clallam,4/1/14,53009,4,2014,26448,24329,1,2119,8.00%
Clark,4/1/14,53011,4,2014,206644,192448,1,14196,6.90%
Columbia,4/1/14,53013,4,2014,1738,1623,1,115,6.60%
Cowlitz,4/1/14,53015,4,2014,42806,39457,1,3349,7.80%
Douglas,4/1/14,53017,4,2014,18359,17045,1,1314,7.20%
Ferry,4/1/14,53019,4,2014,2403,2132,1,271,11.30%
Franklin,4/1/14,53021,4,2014,37169,34170,1,2999,8.10%
Garfield,4/1/14,53023,4,2014,954,894,1,60,6.30%
Grant,4/1/14,53025,4,2014,43122,40096,1,3026,7.00%
Grays Harbor,4/1/14,53027,4,2014,26894,24166,1,2728,10.10%
Island,4/1/14,53029,4,2014,31226,29283,1,1943,6.20%
Jefferson,4/1/14,53031,4,2014,11047,10185,1,862,7.80%
King,4/1/14,53033,4,2014,1157785,1109809,1,47976,4.10%
Kitsap,4/1/14,53035,4,2014,111059,104483,1,6576,5.90%
Kittitas,4/1/14,53037,4,2014,20423,19094,1,1329,6.50%
Klickitat,4/1/14,53039,4,2014,9322,8610,1,712,7.60%
Lewis,4/1/14,53041,4,2014,30399,27729,1,2670,8.80%
Lincoln,4/1/14,53043,4,2014,4993,4730,1,263,5.30%
Mason,4/1/14,53045,4,2014,22629,20768,1,1861,8.20%
Okanogan,4/1/14,53047,4,2014,19356,17844,1,1512,7.80%
Pacific,4/1/14,53049,4,2014,7683,6903,1,780,10.20%
Pend Oreille,4/1/14,53051,4,2014,4584,4118,1,466,10.20%
Pierce,4/1/14,53053,4,2014,379294,353439,1,25855,6.80%
San Juan,4/1/14,53055,4,2014,7235,6893,1,342,4.70%
Skagit,4/1/14,53057,4,2014,55705,51847,1,3858,6.90%
Skamania,4/1/14,53059,4,2014,4885,4491,1,394,8.10%
Snohomish,4/1/14,53061,4,2014,395510,376811,1,18699,4.70%
Spokane,4/1/14,53063,4,2014,224086,209416,1,14670,6.50%
Stevens,4/1/14,53065,4,2014,17451,15777,1,1674,9.60%
Thurston,4/1/14,53067,4,2014,121286,113734,1,7552,6.20%
Wahkiakum,4/1/14,53069,4,2014,1235,1121,1,114,9.20%
Walla Walla,4/1/14,53071,4,2014,28179,26539,1,1640,5.80%
Whatcom,4/1/14,53073,4,2014,99809,93429,1,6380,6.40%
Whitman,4/1/14,53075,4,2014,22350,21273,1,1077,4.80%
Yakima,4/1/14,53077,4,2014,115101,105016,1,10085,8.80%
Adams,4/1/15,53001,4,2015,8393,7859,1,534,6.40%
Asotin,4/1/15,53003,4,2015,9625,9173,1,452,4.70%
Clallam,4/1/15,53009,4,2015,26760,24481,1,2279,8.50%
Clark,4/1/15,53011,4,2015,212231,198014,1,14217,6.70%
Columbia,4/1/15,53013,4,2015,1694,1581,1,113,6.70%
Cowlitz,4/1/15,53015,4,2015,43836,40305,1,3531,8.10%
Douglas,4/1/15,53017,4,2015,19240,17964,1,1276,6.60%
Ferry,4/1/15,53019,4,2015,2469,2225,1,244,9.90%
Franklin,4/1/15,53021,4,2015,38244,35374,1,2870,7.50%
Garfield,4/1/15,53023,4,2015,930,872,1,58,6.20%
Grant,4/1/15,53025,4,2015,43832,40658,1,3174,7.20%
Grays Harbor,4/1/15,53027,4,2015,26765,24202,1,2563,9.60%
Island,4/1/15,53029,4,2015,31561,29612,1,1949,6.20%
Jefferson,4/1/15,53031,4,2015,11100,10305,1,795,7.20%
King,4/1/15,53033,4,2015,1183018,1140190,1,42828,3.60%
Kitsap,4/1/15,53035,4,2015,113818,107267,1,6551,5.80%
Kittitas,4/1/15,53037,4,2015,20967,19617,1,1350,6.40%
Klickitat,4/1/15,53039,4,2015,9339,8668,1,671,7.20%
Lewis,4/1/15,53041,4,2015,31012,28276,1,2736,8.80%
Lincoln,4/1/15,53043,4,2015,4831,4548,1,283,5.90%
Mason,4/1/15,53045,4,2015,22782,21023,1,1759,7.70%
Okanogan,4/1/15,53047,4,2015,19733,18280,1,1453,7.40%
Pacific,4/1/15,53049,4,2015,8127,7378,1,749,9.20%
Pend Oreille,4/1/15,53051,4,2015,4582,4146,1,436,9.50%
Pierce,4/1/15,53053,4,2015,387813,361830,1,25983,6.70%
San Juan,4/1/15,53055,4,2015,7380,7017,1,363,4.90%
Skagit,4/1/15,53057,4,2015,56265,52486,1,3779,6.70%
Skamania,4/1/15,53059,4,2015,4917,4535,1,382,7.80%
Snohomish,4/1/15,53061,4,2015,402850,386981,1,15869,3.90%
Spokane,4/1/15,53063,4,2015,226762,212038,1,14724,6.50%
Stevens,4/1/15,53065,4,2015,17504,15850,1,1654,9.40%
Thurston,4/1/15,53067,4,2015,124754,117190,1,7564,6.10%
Wahkiakum,4/1/15,53069,4,2015,1295,1177,1,118,9.10%
Walla Walla,4/1/15,53071,4,2015,27760,26103,1,1657,6.00%
Whatcom,4/1/15,53073,4,2015,103299,97250,1,6049,5.90%
Whitman,4/1/15,53075,4,2015,23004,21930,1,1074,4.70%
Yakima,4/1/15,53077,4,2015,119090,109415,1,9675,8.10%
Adams,4/1/16,53001,4,2016,8579,8048,1,531,6.20%
Asotin,4/1/16,53003,4,2016,9853,9349,1,504,5.10%
Clallam,4/1/16,53009,4,2016,27126,24996,1,2130,7.90%
Clark,4/1/16,53011,4,2016,218824,204865,1,13959,6.40%
Columbia,4/1/16,53013,4,2016,1706,1591,1,115,6.70%
Cowlitz,4/1/16,53015,4,2016,44532,41209,1,3323,7.50%
Douglas,4/1/16,53017,4,2016,20196,18682,1,1514,7.50%
Ferry,4/1/16,53019,4,2016,2482,2208,1,274,11.00%
Franklin,4/1/16,53021,4,2016,39408,36319,1,3089,7.80%
Garfield,4/1/16,53023,4,2016,908,854,1,54,5.90%
Grant,4/1/16,53025,4,2016,43723,40565,1,3158,7.20%
Grays Harbor,4/1/16,53027,4,2016,26949,24608,1,2341,8.70%
Island,4/1/16,53029,4,2016,32369,30355,1,2014,6.20%
Jefferson,4/1/16,53031,4,2016,11352,10527,1,825,7.30%
King,4/1/16,53033,4,2016,1210121,1168115,1,42006,3.50%
Kitsap,4/1/16,53035,4,2016,117022,110172,1,6850,5.90%
Kittitas,4/1/16,53037,4,2016,21828,20506,1,1322,6.10%
Klickitat,4/1/16,53039,4,2016,9449,8788,1,661,7.00%
Lewis,4/1/16,53041,4,2016,31692,29049,1,2643,8.30%
Lincoln,4/1/16,53043,4,2016,4869,4586,1,283,5.80%
Mason,4/1/16,53045,4,2016,23196,21365,1,1831,7.90%
Okanogan,4/1/16,53047,4,2016,20624,19125,1,1499,7.30%
Pacific,4/1/16,53049,4,2016,8165,7441,1,724,8.90%
Pend Oreille,4/1/16,53051,4,2016,4641,4216,1,425,9.20%
Pierce,4/1/16,53053,4,2016,399560,374166,1,25394,6.40%
San Juan,4/1/16,53055,4,2016,7588,7210,1,378,5.00%
Skagit,4/1/16,53057,4,2016,57007,53104,1,3903,6.80%
Skamania,4/1/16,53059,4,2016,5025,4668,1,357,7.10%
Snohomish,4/1/16,53061,4,2016,413780,398128,1,15652,3.80%
Spokane,4/1/16,53063,4,2016,232518,217945,1,14573,6.30%
Stevens,4/1/16,53065,4,2016,17926,16289,1,1637,9.10%
Thurston,4/1/16,53067,4,2016,128586,120919,1,7667,6.00%
Wahkiakum,4/1/16,53069,4,2016,1270,1160,1,110,8.70%
Walla Walla,4/1/16,53071,4,2016,28267,26701,1,1566,5.50%
Whatcom,4/1/16,53073,4,2016,106226,99754,1,6472,6.10%
Whitman,4/1/16,53075,4,2016,23490,22298,1,1192,5.10%
Yakima,4/1/16,53077,4,2016,123277,113384,1,9893,8.00%
Adams,4/1/17,53001,4,2017,8616,8150,1,466,5.40%
Asotin,4/1/17,53003,4,2017,10142,9724,1,418,4.10%
Clallam,4/1/17,53009,4,2017,27614,25638,1,1976,7.20%
Clark,4/1/17,53011,4,2017,226760,215048,1,11712,5.20%
Columbia,4/1/17,53013,4,2017,1767,1671,1,96,5.40%
Cowlitz,4/1/17,53015,4,2017,45770,42934,1,2836,6.20%
Douglas,4/1/17,53017,4,2017,20238,19029,1,1209,6.00%
Ferry,4/1/17,53019,4,2017,2456,2177,1,279,11.40%
Franklin,4/1/17,53021,4,2017,40483,37970,1,2513,6.20%
Garfield,4/1/17,53023,4,2017,879,834,1,45,5.10%
Grant,4/1/17,53025,4,2017,44021,41306,1,2715,6.20%
Grays Harbor,4/1/17,53027,4,2017,27407,25256,1,2151,7.80%
Island,4/1/17,53029,4,2017,33665,31945,1,1720,5.10%
Jefferson,4/1/17,53031,4,2017,11798,11042,1,756,6.40%
King,4/1/17,53033,4,2017,1235313,1198646,1,36667,3.00%
Kitsap,4/1/17,53035,4,2017,119385,113456,1,5929,5.00%
Kittitas,4/1/17,53037,4,2017,22764,21584,1,1180,5.20%
Klickitat,4/1/17,53039,4,2017,9702,9095,1,607,6.30%
Lewis,4/1/17,53041,4,2017,32792,30537,1,2255,6.90%
Lincoln,4/1/17,53043,4,2017,4903,4672,1,231,4.70%
Mason,4/1/17,53045,4,2017,23424,21810,1,1614,6.90%
Okanogan,4/1/17,53047,4,2017,19910,18280,1,1630,8.20%
Pacific,4/1/17,53049,4,2017,8262,7626,1,636,7.70%
Pend Oreille,4/1/17,53051,4,2017,4740,4357,1,383,8.10%
Pierce,4/1/17,53053,4,2017,412571,389957,1,22614,5.50%
San Juan,4/1/17,53055,4,2017,7844,7523,1,321,4.10%
Skagit,4/1/17,53057,4,2017,58936,55633,1,3303,5.60%
Skamania,4/1/17,53059,4,2017,5269,4954,1,315,6.00%
Snohomish,4/1/17,53061,4,2017,422633,408627,1,14006,3.30%
Spokane,4/1/17,53063,4,2017,238394,225504,1,12890,5.40%
Stevens,4/1/17,53065,4,2017,18164,16699,1,1465,8.10%
Thurston,4/1/17,53067,4,2017,133364,126684,1,6680,5.00%
Wahkiakum,4/1/17,53069,4,2017,1281,1186,1,95,7.40%
Walla Walla,4/1/17,53071,4,2017,28478,27142,1,1336,4.70%
Whatcom,4/1/17,53073,4,2017,109248,103842,1,5406,4.90%
Whitman,4/1/17,53075,4,2017,23981,23012,1,969,4.00%
Yakima,4/1/17,53077,4,2017,122891,114199,1,8692,7.10%
Adams,4/1/18,53001,4,2018,9252,8791,1,461,5.00%
Asotin,4/1/18,53003,4,2018,10125,9687,1,438,4.30%
Clallam,4/1/18,53009,4,2018,27927,26072,1,1855,6.60%
Clark,4/1/18,53011,4,2018,230322,218965,1,11357,4.90%
Columbia,4/1/18,53013,4,2018,1763,1668,1,95,5.40%
Cowlitz,4/1/18,53015,4,2018,45761,42914,1,2847,6.20%
Douglas,4/1/18,53017,4,2018,21253,20102,1,1151,5.40%
Ferry,4/1/18,53019,4,2018,2469,2132,1,337,13.60%
Franklin,4/1/18,53021,4,2018,41783,39245,1,2538,6.10%
Garfield,4/1/18,53023,4,2018,881,836,1,45,5.10%
Grant,4/1/18,53025,4,2018,44797,41969,1,2828,6.30%
Grays Harbor,4/1/18,53027,4,2018,27891,25901,1,1990,7.10%
Island,4/1/18,53029,4,2018,34337,32470,1,1867,5.40%
Jefferson,4/1/18,53031,4,2018,12118,11362,1,756,6.20%
King,4/1/18,53033,4,2018,1260490,1226340,1,34150,2.70%
Kitsap,4/1/18,53035,4,2018,121538,115654,1,5884,4.80%
Kittitas,4/1/18,53037,4,2018,22328,21143,1,1185,5.30%
Klickitat,4/1/18,53039,4,2018,9887,9298,1,589,6.00%
Lewis,4/1/18,53041,4,2018,33550,31344,1,2206,6.60%
Lincoln,4/1/18,53043,4,2018,5009,4756,1,253,5.10%
Mason,4/1/18,53045,4,2018,23961,22397,1,1564,6.50%
Okanogan,4/1/18,53047,4,2018,19955,18556,1,1399,7.00%
Pacific,4/1/18,53049,4,2018,8393,7764,1,629,7.50%
Pend Oreille,4/1/18,53051,4,2018,4795,4447,1,348,7.30%
Pierce,4/1/18,53053,4,2018,420671,397959,1,22712,5.40%
San Juan,4/1/18,53055,4,2018,7853,7524,1,329,4.20%
Skagit,4/1/18,53057,4,2018,59647,56491,1,3156,5.30%
Skamania,4/1/18,53059,4,2018,5298,4997,1,301,5.70%
Snohomish,4/1/18,53061,4,2018,429156,416462,1,12694,3.00%
Spokane,4/1/18,53063,4,2018,242412,229733,1,12679,5.20%
Stevens,4/1/18,53065,4,2018,18378,16926,1,1452,7.90%
Thurston,4/1/18,53067,4,2018,136768,130072,1,6696,4.90%
Wahkiakum,4/1/18,53069,4,2018,1316,1221,1,95,7.20%
Walla Walla,4/1/18,53071,4,2018,28608,27244,1,1364,4.80%
Whatcom,4/1/18,53073,4,2018,110665,105368,1,5297,4.80%
Whitman,4/1/18,53075,4,2018,23905,22863,1,1042,4.40%
Yakima,4/1/18,53077,4,2018,126874,118848,1,8026,6.30%
Adams,4/1/19,53001,4,2019,9760,9213,1,547,5.60%
Asotin,4/1/19,53003,4,2019,10320,9876,1,444,4.30%
Clallam,4/1/19,53009,4,2019,28501,26560,1,1941,6.80%
Clark,4/1/19,53011,4,2019,239613,227833,1,11780,4.90%
Columbia,4/1/19,53013,4,2019,1836,1738,1,98,5.30%
Cowlitz,4/1/19,53015,4,2019,47578,44621,1,2957,6.20%
Douglas,4/1/19,53017,4,2019,21479,20207,1,1272,5.90%
Ferry,4/1/19,53019,4,2019,2525,2200,1,325,12.90%
Franklin,4/1/19,53021,4,2019,42696,39974,1,2722,6.40%
Garfield,4/1/19,53023,4,2019,890,843,1,47,5.30%
Grant,4/1/19,53025,4,2019,45981,42767,1,3214,7.00%
Grays Harbor,4/1/19,53027,4,2019,28686,26575,1,2111,7.40%
Island,4/1/19,53029,4,2019,35525,33676,1,1849,5.20%
Jefferson,4/1/19,53031,4,2019,12687,11926,1,761,6.00%
King,4/1/19,53033,4,2019,1280932,1250940,1,29992,2.30%
Kitsap,4/1/19,53035,4,2019,127232,121159,1,6073,4.80%
Kittitas,4/1/19,53037,4,2019,23479,22194,1,1285,5.50%
Klickitat,4/1/19,53039,4,2019,10096,9461,1,635,6.30%
Lewis,4/1/19,53041,4,2019,34649,32464,1,2185,6.30%
Lincoln,4/1/19,53043,4,2019,4962,4689,1,273,5.50%
Mason,4/1/19,53045,4,2019,24661,23037,1,1624,6.60%
Okanogan,4/1/19,53047,4,2019,19676,18193,1,1483,7.50%
Pacific,4/1/19,53049,4,2019,8412,7775,1,637,7.60%
Pend Oreille,4/1/19,53051,4,2019,5027,4627,1,400,8.00%
Pierce,4/1/19,53053,4,2019,437615,414451,1,23164,5.30%
San Juan,4/1/19,53055,4,2019,8181,7837,1,344,4.20%
Skagit,4/1/19,53057,4,2019,62577,59226,1,3351,5.40%
Skamania,4/1/19,53059,4,2019,5488,5195,1,293,5.30%
Snohomish,4/1/19,53061,4,2019,435804,424878,1,10926,2.50%
Spokane,4/1/19,53063,4,2019,253017,239380,1,13637,5.40%
Stevens,4/1/19,53065,4,2019,19080,17567,1,1513,7.90%
Thurston,4/1/19,53067,4,2019,141797,134643,1,7154,5.00%
Wahkiakum,4/1/19,53069,4,2019,1353,1257,1,96,7.10%
Walla Walla,4/1/19,53071,4,2019,29890,28428,1,1462,4.90%
Whatcom,4/1/19,53073,4,2019,115201,109512,1,5689,4.90%
Whitman,4/1/19,53075,4,2019,24692,23671,1,1021,4.10%
Yakima,4/1/19,53077,4,2019,129058,119608,1,9450,7.30%
Adams,4/1/20,53001,4,2020,9438,8581,1,857,9.10%
Asotin,4/1/20,53003,4,2020,9667,8808,1,859,8.90%
Clallam,4/1/20,53009,4,2020,31914,25920,1,5994,18.80%
Clark,4/1/20,53011,4,2020,244704,209486,1,35218,14.40%
Columbia,4/1/20,53013,4,2020,1727,1528,1,199,11.50%
Cowlitz,4/1/20,53015,4,2020,48630,40664,1,7966,16.40%
Douglas,4/1/20,53017,4,2020,21109,17920,1,3189,15.10%
Ferry,4/1/20,53019,4,2020,2434,2065,1,369,15.20%
Franklin,4/1/20,53021,4,2020,43714,38008,1,5706,13.10%
Garfield,4/1/20,53023,4,2020,817,701,1,116,14.20%
Grant,4/1/20,53025,4,2020,48429,42304,1,6125,12.60%
Grays Harbor,4/1/20,53027,4,2020,32277,26055,1,6222,19.30%
Island,4/1/20,53029,4,2020,37574,31651,1,5923,15.80%
Jefferson,4/1/20,53031,4,2020,14043,11596,1,2447,17.40%
King,4/1/20,53033,4,2020,1260378,1072148,1,188230,14.90%
Kitsap,4/1/20,53035,4,2020,132712,113416,1,19296,14.50%
Kittitas,4/1/20,53037,4,2020,24736,20812,1,3924,15.90%
Klickitat,4/1/20,53039,4,2020,10152,8939,1,1213,11.90%
Lewis,4/1/20,53041,4,2020,37671,31434,1,6237,16.60%
Lincoln,4/1/20,53043,4,2020,4648,4113,1,535,11.50%
Mason,4/1/20,53045,4,2020,27604,23093,1,4511,16.30%
Okanogan,4/1/20,53047,4,2020,19283,16432,1,2851,14.80%
Pacific,4/1/20,53049,4,2020,9412,7812,1,1600,17.00%
Pend Oreille,4/1/20,53051,4,2020,4824,4063,1,761,15.80%
Pierce,4/1/20,53053,4,2020,457362,371915,1,85447,18.70%
San Juan,4/1/20,53055,4,2020,8251,6786,1,1465,17.80%
Skagit,4/1/20,53057,4,2020,65334,52850,1,12484,19.10%
Skamania,4/1/20,53059,4,2020,5553,4737,1,816,14.70%
Snohomish,4/1/20,53061,4,2020,450382,363997,1,86385,19.20%
Spokane,4/1/20,53063,4,2020,257277,214347,1,42930,16.70%
Stevens,4/1/20,53065,4,2020,18436,15404,1,3032,16.40%
Thurston,4/1/20,53067,4,2020,150044,126145,1,23899,15.90%
Wahkiakum,4/1/20,53069,4,2020,1389,1197,1,192,13.80%
Walla Walla,4/1/20,53071,4,2020,30496,26767,1,3729,12.20%
Whatcom,4/1/20,53073,4,2020,119667,98460,1,21207,17.70%
Whitman,4/1/20,53075,4,2020,23593,21640,1,1953,8.30%
Yakima,4/1/20,53077,4,2020,133602,114525,1,19077,14.30%
Adams,5/1/90,53001,5,1990,8346,7092,1,1254,15.00%
Asotin,5/1/90,53003,5,1990,9402,8867,1,535,5.70%
Clallam,5/1/90,53009,5,1990,22945,21553,1,1392,6.10%
Columbia,5/1/90,53013,5,1990,2091,1961,1,130,6.20%
Cowlitz,5/1/90,53015,5,1990,37994,35421,1,2573,6.80%
Douglas,5/1/90,53017,5,1990,14735,13465,1,1270,8.60%
Ferry,5/1/90,53019,5,1990,2851,2512,1,339,11.90%
Franklin,5/1/90,53021,5,1990,19139,17817,1,1322,6.90%
Garfield,5/1/90,53023,5,1990,1091,1066,1,25,2.30%
Grant,5/1/90,53025,5,1990,27318,24883,1,2435,8.90%
Grays Harbor,5/1/90,53027,5,1990,27465,24981,1,2484,9.00%
Island,5/1/90,53029,5,1990,22768,21993,1,775,3.40%
Jefferson,5/1/90,53031,5,1990,8412,8031,1,381,4.50%
King,5/1/90,53033,5,1990,864062,833253,1,30809,3.60%
Kitsap,5/1/90,53035,5,1990,84435,80787,1,3648,4.30%
Kittitas,5/1/90,53037,5,1990,12373,11378,1,995,8.00%
Klickitat,5/1/90,53039,5,1990,7925,6965,1,960,12.10%
Lewis,5/1/90,53041,5,1990,26368,24412,1,1956,7.40%
Lincoln,5/1/90,53043,5,1990,4297,4155,1,142,3.30%
Mason,5/1/90,53045,5,1990,15560,14683,1,877,5.60%
Okanogan,5/1/90,53047,5,1990,17740,16010,1,1730,9.80%
Pacific,5/1/90,53049,5,1990,7424,6923,1,501,6.70%
Pend Oreille,5/1/90,53051,5,1990,3508,3013,1,495,14.10%
Pierce,5/1/90,53053,5,1990,276211,262579,1,13632,4.90%
San Juan,5/1/90,53055,5,1990,5046,4911,1,135,2.70%
Skagit,5/1/90,53057,5,1990,39152,36773,1,2379,6.10%
Skamania,5/1/90,53059,5,1990,3915,3570,1,345,8.80%
Snohomish,5/1/90,53061,5,1990,251311,241496,1,9815,3.90%
Spokane,5/1/90,53063,5,1990,173321,163432,1,9889,5.70%
Stevens,5/1/90,53065,5,1990,13143,12061,1,1082,8.20%
Thurston,5/1/90,53067,5,1990,80421,76418,1,4003,5.00%
Wahkiakum,5/1/90,53069,5,1990,1522,1458,1,64,4.20%
Walla Walla,5/1/90,53071,5,1990,24423,23184,1,1239,5.10%
Whatcom,5/1/90,53073,5,1990,68133,64579,1,3554,5.20%
Whitman,5/1/90,53075,5,1990,17801,17529,1,272,1.50%
Yakima,5/1/90,53077,5,1990,101034,90322,1,10712,10.60%
Adams,5/1/91,53001,5,1991,7832,7010,1,822,10.50%
Asotin,5/1/91,53003,5,1991,9200,8645,1,555,6.00%
Clallam,5/1/91,53009,5,1991,22672,20956,1,1716,7.60%
Columbia,5/1/91,53013,5,1991,1946,1790,1,156,8.00%
Cowlitz,5/1/91,53015,5,1991,38884,35852,1,3032,7.80%
Douglas,5/1/91,53017,5,1991,15050,13519,1,1531,10.20%
Ferry,5/1/91,53019,5,1991,2825,2446,1,379,13.40%
Franklin,5/1/91,53021,5,1991,19614,17889,1,1725,8.80%
Garfield,5/1/91,53023,5,1991,1039,1017,1,22,2.10%
Grant,5/1/91,53025,5,1991,28961,25994,1,2967,10.20%
Grays Harbor,5/1/91,53027,5,1991,27210,24157,1,3053,11.20%
Island,5/1/91,53029,5,1991,22567,21587,1,980,4.30%
Jefferson,5/1/91,53031,5,1991,8185,7684,1,501,6.10%
King,5/1/91,53033,5,1991,860707,825562,1,35145,4.10%
Kitsap,5/1/91,53035,5,1991,85056,80644,1,4412,5.20%
Kittitas,5/1/91,53037,5,1991,12738,11516,1,1222,9.60%
Klickitat,5/1/91,53039,5,1991,7868,6809,1,1059,13.50%
Lewis,5/1/91,53041,5,1991,26064,23563,1,2501,9.60%
Lincoln,5/1/91,53043,5,1991,4162,3989,1,173,4.20%
Mason,5/1/91,53045,5,1991,15400,14171,1,1229,8.00%
Okanogan,5/1/91,53047,5,1991,18253,16121,1,2132,11.70%
Pacific,5/1/91,53049,5,1991,7549,6834,1,715,9.50%
Pend Oreille,5/1/91,53051,5,1991,3391,2916,1,475,14.00%
Pierce,5/1/91,53053,5,1991,274512,256292,1,18220,6.60%
San Juan,5/1/91,53055,5,1991,5295,5143,1,152,2.90%
Skagit,5/1/91,53057,5,1991,39299,36102,1,3197,8.10%
Skamania,5/1/91,53059,5,1991,3981,3507,1,474,11.90%
Snohomish,5/1/91,53061,5,1991,254892,243120,1,11772,4.60%
Spokane,5/1/91,53063,5,1991,174617,163954,1,10663,6.10%
Stevens,5/1/91,53065,5,1991,13636,12352,1,1284,9.40%
Thurston,5/1/91,53067,5,1991,81424,76690,1,4734,5.80%
Wahkiakum,5/1/91,53069,5,1991,1470,1401,1,69,4.70%
Walla Walla,5/1/91,53071,5,1991,23784,22358,1,1426,6.00%
Whatcom,5/1/91,53073,5,1991,68726,64253,1,4473,6.50%
Whitman,5/1/91,53075,5,1991,17441,17149,1,292,1.70%
Yakima,5/1/91,53077,5,1991,101256,88798,1,12458,12.30%
Adams,5/1/92,53001,5,1992,7962,7023,1,939,11.80%
Asotin,5/1/92,53003,5,1992,9682,9231,1,451,4.70%
Clallam,5/1/92,53009,5,1992,22801,20926,1,1875,8.20%
Columbia,5/1/92,53013,5,1992,1879,1731,1,148,7.90%
Cowlitz,5/1/92,53015,5,1992,37573,33583,1,3990,10.60%
Douglas,5/1/92,53017,5,1992,16032,14503,1,1529,9.50%
Ferry,5/1/92,53019,5,1992,2820,2443,1,377,13.40%
Franklin,5/1/92,53021,5,1992,20403,18632,1,1771,8.70%
Garfield,5/1/92,53023,5,1992,1033,1007,1,26,2.50%
Grant,5/1/92,53025,5,1992,30114,26962,1,3152,10.50%
Grays Harbor,5/1/92,53027,5,1992,27856,24477,1,3379,12.10%
Island,5/1/92,53029,5,1992,23791,22366,1,1425,6.00%
Jefferson,5/1/92,53031,5,1992,8538,7760,1,778,9.10%
King,5/1/92,53033,5,1992,894372,846754,1,47618,5.30%
Kitsap,5/1/92,53035,5,1992,86994,81758,1,5236,6.00%
Kittitas,5/1/92,53037,5,1992,13364,11646,1,1718,12.90%
Klickitat,5/1/92,53039,5,1992,7979,6819,1,1160,14.50%
Lewis,5/1/92,53041,5,1992,26735,23866,1,2869,10.70%
Lincoln,5/1/92,53043,5,1992,4318,4144,1,174,4.00%
Mason,5/1/92,53045,5,1992,15752,14452,1,1300,8.30%
Okanogan,5/1/92,53047,5,1992,19300,17092,1,2208,11.40%
Pacific,5/1/92,53049,5,1992,7885,7085,1,800,10.10%
Pend Oreille,5/1/92,53051,5,1992,3584,3104,1,480,13.40%
Pierce,5/1/92,53053,5,1992,284833,263230,1,21603,7.60%
San Juan,5/1/92,53055,5,1992,5303,5007,1,296,5.60%
Skagit,5/1/92,53057,5,1992,40745,36674,1,4071,10.00%
Skamania,5/1/92,53059,5,1992,3789,3072,1,717,18.90%
Snohomish,5/1/92,53061,5,1992,269254,253570,1,15684,5.80%
Spokane,5/1/92,53063,5,1992,178630,166627,1,12003,6.70%
Stevens,5/1/92,53065,5,1992,14425,12724,1,1701,11.80%
Thurston,5/1/92,53067,5,1992,84283,78685,1,5598,6.60%
Wahkiakum,5/1/92,53069,5,1992,1568,1445,1,123,7.80%
Walla Walla,5/1/92,53071,5,1992,24907,23428,1,1479,5.90%
Whatcom,5/1/92,53073,5,1992,72021,66414,1,5607,7.80%
Whitman,5/1/92,53075,5,1992,17201,16802,1,399,2.30%
Yakima,5/1/92,53077,5,1992,106165,92936,1,13229,12.50%
Adams,5/1/93,53001,5,1993,8476,7296,1,1180,13.90%
Asotin,5/1/93,53003,5,1993,10188,9687,1,501,4.90%
Clallam,5/1/93,53009,5,1993,23388,21385,1,2003,8.60%
Columbia,5/1/93,53013,5,1993,2020,1847,1,173,8.60%
Cowlitz,5/1/93,53015,5,1993,38198,33891,1,4307,11.30%
Douglas,5/1/93,53017,5,1993,16173,14818,1,1355,8.40%
Ferry,5/1/93,53019,5,1993,2745,2342,1,403,14.70%
Franklin,5/1/93,53021,5,1993,21393,19564,1,1829,8.50%
Garfield,5/1/93,53023,5,1993,1119,1059,1,60,5.40%
Grant,5/1/93,53025,5,1993,31512,28266,1,3246,10.30%
Grays Harbor,5/1/93,53027,5,1993,27965,23767,1,4198,15.00%
Island,5/1/93,53029,5,1993,23666,22428,1,1238,5.20%
Jefferson,5/1/93,53031,5,1993,9343,8686,1,657,7.00%
King,5/1/93,53033,5,1993,904141,851181,1,52960,5.90%
Kitsap,5/1/93,53035,5,1993,87407,81284,1,6123,7.00%
Kittitas,5/1/93,53037,5,1993,13924,12401,1,1523,10.90%
Klickitat,5/1/93,53039,5,1993,8053,6829,1,1224,15.20%
Lewis,5/1/93,53041,5,1993,27477,24541,1,2936,10.70%
Lincoln,5/1/93,53043,5,1993,4507,4268,1,239,5.30%
Mason,5/1/93,53045,5,1993,16105,14495,1,1610,10.00%
Okanogan,5/1/93,53047,5,1993,19915,17551,1,2364,11.90%
Pacific,5/1/93,53049,5,1993,7878,7023,1,855,10.90%
Pend Oreille,5/1/93,53051,5,1993,3832,3300,1,532,13.90%
Pierce,5/1/93,53053,5,1993,290842,269028,1,21814,7.50%
San Juan,5/1/93,53055,5,1993,5427,5034,1,393,7.20%
Skagit,5/1/93,53057,5,1993,42637,37826,1,4811,11.30%
Skamania,5/1/93,53059,5,1993,4179,3580,1,599,14.30%
Snohomish,5/1/93,53061,5,1993,275716,258732,1,16984,6.20%
Spokane,5/1/93,53063,5,1993,183222,173006,1,10216,5.60%
Stevens,5/1/93,53065,5,1993,15299,13806,1,1493,9.80%
Thurston,5/1/93,53067,5,1993,86910,81122,1,5788,6.70%
Wahkiakum,5/1/93,53069,5,1993,1660,1531,1,129,7.80%
Walla Walla,5/1/93,53071,5,1993,25689,24397,1,1292,5.00%
Whatcom,5/1/93,53073,5,1993,73971,68501,1,5470,7.40%
Whitman,5/1/93,53075,5,1993,17620,17249,1,371,2.10%
Yakima,5/1/93,53077,5,1993,110098,95047,1,15051,13.70%
Adams,5/1/94,53001,5,1994,8341,7467,1,874,10.50%
Asotin,5/1/94,53003,5,1994,10705,10315,1,390,3.60%
Clallam,5/1/94,53009,5,1994,23234,20601,1,2633,11.30%
Columbia,5/1/94,53013,5,1994,2060,1926,1,134,6.50%
Cowlitz,5/1/94,53015,5,1994,38359,34872,1,3487,9.10%
Douglas,5/1/94,53017,5,1994,17001,15647,1,1354,8.00%
Ferry,5/1/94,53019,5,1994,2842,2482,1,360,12.70%
Franklin,5/1/94,53021,5,1994,22303,20869,1,1434,6.40%
Garfield,5/1/94,53023,5,1994,1050,1011,1,39,3.70%
Grant,5/1/94,53025,5,1994,32608,29529,1,3079,9.40%
Grays Harbor,5/1/94,53027,5,1994,27858,23823,1,4035,14.50%
Island,5/1/94,53029,5,1994,24303,23128,1,1175,4.80%
Jefferson,5/1/94,53031,5,1994,9364,8502,1,862,9.20%
King,5/1/94,53033,5,1994,898851,856923,1,41928,4.70%
Kitsap,5/1/94,53035,5,1994,88149,82427,1,5722,6.50%
Kittitas,5/1/94,53037,5,1994,14029,12750,1,1279,9.10%
Klickitat,5/1/94,53039,5,1994,8198,7173,1,1025,12.50%
Lewis,5/1/94,53041,5,1994,28399,25634,1,2765,9.70%
Lincoln,5/1/94,53043,5,1994,4567,4324,1,243,5.30%
Mason,5/1/94,53045,5,1994,16879,15216,1,1663,9.90%
Okanogan,5/1/94,53047,5,1994,20436,18295,1,2141,10.50%
Pacific,5/1/94,53049,5,1994,8310,7174,1,1136,13.70%
Pend Oreille,5/1/94,53051,5,1994,3797,3326,1,471,12.40%
Pierce,5/1/94,53053,5,1994,300612,278807,1,21805,7.30%
San Juan,5/1/94,53055,5,1994,5348,4991,1,357,6.70%
Skagit,5/1/94,53057,5,1994,45062,40528,1,4534,10.10%
Skamania,5/1/94,53059,5,1994,3923,3514,1,409,10.40%
Snohomish,5/1/94,53061,5,1994,280329,264353,1,15976,5.70%
Spokane,5/1/94,53063,5,1994,190437,180996,1,9441,5.00%
Stevens,5/1/94,53065,5,1994,16282,14784,1,1498,9.20%
Thurston,5/1/94,53067,5,1994,89460,83588,1,5872,6.60%
Wahkiakum,5/1/94,53069,5,1994,1672,1477,1,195,11.70%
Walla Walla,5/1/94,53071,5,1994,25802,24583,1,1219,4.70%
Whatcom,5/1/94,53073,5,1994,73898,68223,1,5675,7.70%
Whitman,5/1/94,53075,5,1994,18603,18241,1,362,1.90%
Yakima,5/1/94,53077,5,1994,109938,97046,1,12892,11.70%
Adams,5/1/95,53001,5,1995,8660,7729,1,931,10.80%
Asotin,5/1/95,53003,5,1995,11288,10772,1,516,4.60%
Clallam,5/1/95,53009,5,1995,24366,22279,1,2087,8.60%
Columbia,5/1/95,53013,5,1995,1933,1767,1,166,8.60%
Cowlitz,5/1/95,53015,5,1995,40463,37440,1,3023,7.50%
Douglas,5/1/95,53017,5,1995,17226,15713,1,1513,8.80%
Ferry,5/1/95,53019,5,1995,2944,2556,1,388,13.20%
Franklin,5/1/95,53021,5,1995,22856,21022,1,1834,8.00%
Garfield,5/1/95,53023,5,1995,1045,1009,1,36,3.40%
Grant,5/1/95,53025,5,1995,33861,30396,1,3465,10.20%
Grays Harbor,5/1/95,53027,5,1995,27749,24762,1,2987,10.80%
Island,5/1/95,53029,5,1995,25372,24235,1,1137,4.50%
Jefferson,5/1/95,53031,5,1995,10027,9315,1,712,7.10%
King,5/1/95,53033,5,1995,907750,864713,1,43037,4.70%
Kitsap,5/1/95,53035,5,1995,90146,83865,1,6281,7.00%
Kittitas,5/1/95,53037,5,1995,15040,13564,1,1476,9.80%
Klickitat,5/1/95,53039,5,1995,9059,7845,1,1214,13.40%
Lewis,5/1/95,53041,5,1995,30374,27589,1,2785,9.20%
Lincoln,5/1/95,53043,5,1995,4856,4569,1,287,5.90%
Mason,5/1/95,53045,5,1995,17861,16359,1,1502,8.40%
Okanogan,5/1/95,53047,5,1995,21171,18654,1,2517,11.90%
Pacific,5/1/95,53049,5,1995,8327,7567,1,760,9.10%
Pend Oreille,5/1/95,53051,5,1995,4042,3486,1,556,13.80%
Pierce,5/1/95,53053,5,1995,316013,295049,1,20964,6.60%
San Juan,5/1/95,53055,5,1995,5654,5295,1,359,6.30%
Skagit,5/1/95,53057,5,1995,47604,43097,1,4507,9.50%
Skamania,5/1/95,53059,5,1995,4153,3704,1,449,10.80%
Snohomish,5/1/95,53061,5,1995,283478,269052,1,14426,5.10%
Spokane,5/1/95,53063,5,1995,199481,188463,1,11018,5.50%
Stevens,5/1/95,53065,5,1995,16786,15218,1,1568,9.30%
Thurston,5/1/95,53067,5,1995,94555,88635,1,5920,6.30%
Wahkiakum,5/1/95,53069,5,1995,1650,1551,1,99,6.00%
Walla Walla,5/1/95,53071,5,1995,26862,25281,1,1581,5.90%
Whatcom,5/1/95,53073,5,1995,77925,72014,1,5911,7.60%
Whitman,5/1/95,53075,5,1995,18932,18561,1,371,2.00%
Yakima,5/1/95,53077,5,1995,113133,98323,1,14810,13.10%
Adams,5/1/96,53001,5,1996,8298,7320,1,978,11.80%
Asotin,5/1/96,53003,5,1996,12022,11500,1,522,4.30%
Clallam,5/1/96,53009,5,1996,24751,22544,1,2207,8.90%
Columbia,5/1/96,53013,5,1996,2060,1881,1,179,8.70%
Cowlitz,5/1/96,53015,5,1996,41639,38013,1,3626,8.70%
Douglas,5/1/96,53017,5,1996,18165,16445,1,1720,9.50%
Ferry,5/1/96,53019,5,1996,2921,2523,1,398,13.60%
Franklin,5/1/96,53021,5,1996,22896,20595,1,2301,10.00%
Garfield,5/1/96,53023,5,1996,1132,1085,1,47,4.20%
Grant,5/1/96,53025,5,1996,34728,31102,1,3626,10.40%
Grays Harbor,5/1/96,53027,5,1996,28345,25008,1,3337,11.80%
Island,5/1/96,53029,5,1996,26252,24898,1,1354,5.20%
Jefferson,5/1/96,53031,5,1996,10154,9370,1,784,7.70%
King,5/1/96,53033,5,1996,929078,886230,1,42848,4.60%
Kitsap,5/1/96,53035,5,1996,94589,88138,1,6451,6.80%
Kittitas,5/1/96,53037,5,1996,15053,13661,1,1392,9.20%
Klickitat,5/1/96,53039,5,1996,9134,7948,1,1186,13.00%
Lewis,5/1/96,53041,5,1996,31413,28204,1,3209,10.20%
Lincoln,5/1/96,53043,5,1996,5127,4870,1,257,5.00%
Mason,5/1/96,53045,5,1996,19039,17433,1,1606,8.40%
Okanogan,5/1/96,53047,5,1996,21880,19348,1,2532,11.60%
Pacific,5/1/96,53049,5,1996,8516,7656,1,860,10.10%
Pend Oreille,5/1/96,53051,5,1996,4129,3480,1,649,15.70%
Pierce,5/1/96,53053,5,1996,321243,300488,1,20755,6.50%
San Juan,5/1/96,53055,5,1996,5707,5344,1,363,6.40%
Skagit,5/1/96,53057,5,1996,46605,41933,1,4672,10.00%
Skamania,5/1/96,53059,5,1996,4148,3685,1,463,11.20%
Snohomish,5/1/96,53061,5,1996,293520,278934,1,14586,5.00%
Spokane,5/1/96,53063,5,1996,205805,194612,1,11193,5.40%
Stevens,5/1/96,53065,5,1996,17271,15426,1,1845,10.70%
Thurston,5/1/96,53067,5,1996,98097,91840,1,6257,6.40%
Wahkiakum,5/1/96,53069,5,1996,1746,1614,1,132,7.60%
Walla Walla,5/1/96,53071,5,1996,27292,25547,1,1745,6.40%
Whatcom,5/1/96,53073,5,1996,80010,73911,1,6099,7.60%
Whitman,5/1/96,53075,5,1996,19757,19319,1,438,2.20%
Yakima,5/1/96,53077,5,1996,116208,100575,1,15633,13.50%
Adams,5/1/97,53001,5,1997,8537,7751,1,786,9.20%
Asotin,5/1/97,53003,5,1997,12198,11844,1,354,2.90%
Clallam,5/1/97,53009,5,1997,25174,23180,1,1994,7.90%
Columbia,5/1/97,53013,5,1997,2002,1869,1,133,6.60%
Cowlitz,5/1/97,53015,5,1997,42314,39340,1,2974,7.00%
Douglas,5/1/97,53017,5,1997,18495,17268,1,1227,6.60%
Ferry,5/1/97,53019,5,1997,2891,2561,1,330,11.40%
Franklin,5/1/97,53021,5,1997,22850,21004,1,1846,8.10%
Garfield,5/1/97,53023,5,1997,1083,1059,1,24,2.20%
Grant,5/1/97,53025,5,1997,36320,33531,1,2789,7.70%
Grays Harbor,5/1/97,53027,5,1997,28129,25633,1,2496,8.90%
Island,5/1/97,53029,5,1997,27797,26925,1,872,3.10%
Jefferson,5/1/97,53031,5,1997,10181,9529,1,652,6.40%
King,5/1/97,53033,5,1997,964966,928833,1,36133,3.70%
Kitsap,5/1/97,53035,5,1997,93826,88902,1,4924,5.20%
Kittitas,5/1/97,53037,5,1997,15077,14186,1,891,5.90%
Klickitat,5/1/97,53039,5,1997,9055,8116,1,939,10.40%
Lewis,5/1/97,53041,5,1997,32460,29976,1,2484,7.70%
Lincoln,5/1/97,53043,5,1997,5150,4953,1,197,3.80%
Mason,5/1/97,53045,5,1997,19615,18350,1,1265,6.40%
Okanogan,5/1/97,53047,5,1997,22896,20800,1,2096,9.20%
Pacific,5/1/97,53049,5,1997,8841,8161,1,680,7.70%
Pend Oreille,5/1/97,53051,5,1997,4138,3655,1,483,11.70%
Pierce,5/1/97,53053,5,1997,331418,316750,1,14668,4.40%
San Juan,5/1/97,53055,5,1997,5897,5641,1,256,4.30%
Skagit,5/1/97,53057,5,1997,47928,44638,1,3290,6.90%
Skamania,5/1/97,53059,5,1997,4145,3747,1,398,9.60%
Snohomish,5/1/97,53061,5,1997,312100,300551,1,11549,3.70%
Spokane,5/1/97,53063,5,1997,208397,199591,1,8806,4.20%
Stevens,5/1/97,53065,5,1997,17406,15936,1,1470,8.40%
Thurston,5/1/97,53067,5,1997,100222,95459,1,4763,4.80%
Wahkiakum,5/1/97,53069,5,1997,1837,1735,1,102,5.60%
Walla Walla,5/1/97,53071,5,1997,27914,26533,1,1381,4.90%
Whatcom,5/1/97,53073,5,1997,79276,74909,1,4367,5.50%
Whitman,5/1/97,53075,5,1997,19826,19507,1,319,1.60%
Yakima,5/1/97,53077,5,1997,115352,104734,1,10618,9.20%
Adams,5/1/98,53001,5,1998,9322,8499,1,823,8.80%
Asotin,5/1/98,53003,5,1998,12794,12346,1,448,3.50%
Clallam,5/1/98,53009,5,1998,25352,23604,1,1748,6.90%
Columbia,5/1/98,53013,5,1998,2127,1993,1,134,6.30%
Cowlitz,5/1/98,53015,5,1998,42883,39810,1,3073,7.20%
Douglas,5/1/98,53017,5,1998,19141,17842,1,1299,6.80%
Ferry,5/1/98,53019,5,1998,2803,2557,1,246,8.80%
Franklin,5/1/98,53021,5,1998,23345,21637,1,1708,7.30%
Garfield,5/1/98,53023,5,1998,1135,1103,1,32,2.80%
Grant,5/1/98,53025,5,1998,37682,34789,1,2893,7.70%
Grays Harbor,5/1/98,53027,5,1998,27001,24420,1,2581,9.60%
Island,5/1/98,53029,5,1998,29476,28663,1,813,2.80%
Jefferson,5/1/98,53031,5,1998,10345,9769,1,576,5.60%
King,5/1/98,53033,5,1998,978462,946714,1,31748,3.20%
Kitsap,5/1/98,53035,5,1998,93644,89258,1,4386,4.70%
Kittitas,5/1/98,53037,5,1998,15354,14491,1,863,5.60%
Klickitat,5/1/98,53039,5,1998,8904,7997,1,907,10.20%
Lewis,5/1/98,53041,5,1998,31231,28638,1,2593,8.30%
Lincoln,5/1/98,53043,5,1998,5244,5044,1,200,3.80%
Mason,5/1/98,53045,5,1998,20067,18813,1,1254,6.20%
Okanogan,5/1/98,53047,5,1998,22508,20374,1,2134,9.50%
Pacific,5/1/98,53049,5,1998,8490,7785,1,705,8.30%
Pend Oreille,5/1/98,53051,5,1998,4337,3839,1,498,11.50%
Pierce,5/1/98,53053,5,1998,342062,327919,1,14143,4.10%
San Juan,5/1/98,53055,5,1998,6227,6009,1,218,3.50%
Skagit,5/1/98,53057,5,1998,47971,45033,1,2938,6.10%
Skamania,5/1/98,53059,5,1998,4401,4029,1,372,8.50%
Snohomish,5/1/98,53061,5,1998,322831,312469,1,10362,3.20%
Spokane,5/1/98,53063,5,1998,213810,205639,1,8171,3.80%
Stevens,5/1/98,53065,5,1998,18019,16598,1,1421,7.90%
Thurston,5/1/98,53067,5,1998,103696,99196,1,4500,4.30%
Wahkiakum,5/1/98,53069,5,1998,1999,1900,1,99,5.00%
Walla Walla,5/1/98,53071,5,1998,27843,26512,1,1331,4.80%
Whatcom,5/1/98,53073,5,1998,80815,76707,1,4108,5.10%
Whitman,5/1/98,53075,5,1998,19823,19497,1,326,1.60%
Yakima,5/1/98,53077,5,1998,117763,107350,1,10413,8.80%
Adams,5/1/99,53001,5,1999,8750,7821,1,929,10.60%
Asotin,5/1/99,53003,5,1999,13007,12576,1,431,3.30%
Clallam,5/1/99,53009,5,1999,26414,24473,1,1941,7.30%
Columbia,5/1/99,53013,5,1999,2074,1902,1,172,8.30%
Cowlitz,5/1/99,53015,5,1999,43594,40374,1,3220,7.40%
Douglas,5/1/99,53017,5,1999,19247,17757,1,1490,7.70%
Ferry,5/1/99,53019,5,1999,2692,2376,1,316,11.70%
Franklin,5/1/99,53021,5,1999,23756,21881,1,1875,7.90%
Garfield,5/1/99,53023,5,1999,1157,1121,1,36,3.10%
Grant,5/1/99,53025,5,1999,38480,34722,1,3758,9.80%
Grays Harbor,5/1/99,53027,5,1999,27604,25344,1,2260,8.20%
Island,5/1/99,53029,5,1999,30791,29632,1,1159,3.80%
Jefferson,5/1/99,53031,5,1999,11666,10941,1,725,6.20%
King,5/1/99,53033,5,1999,982192,951954,1,30238,3.10%
Kitsap,5/1/99,53035,5,1999,99264,94070,1,5194,5.20%
Kittitas,5/1/99,53037,5,1999,15497,14556,1,941,6.10%
Klickitat,5/1/99,53039,5,1999,8848,7975,1,873,9.90%
Lewis,5/1/99,53041,5,1999,31267,28779,1,2488,8.00%
Lincoln,5/1/99,53043,5,1999,5098,4874,1,224,4.40%
Mason,5/1/99,53045,5,1999,19783,18491,1,1292,6.50%
Okanogan,5/1/99,53047,5,1999,21090,18891,1,2199,10.40%
Pacific,5/1/99,53049,5,1999,8193,7509,1,684,8.30%
Pend Oreille,5/1/99,53051,5,1999,4455,3992,1,463,10.40%
Pierce,5/1/99,53053,5,1999,349060,332533,1,16527,4.70%
San Juan,5/1/99,53055,5,1999,6688,6469,1,219,3.30%
Skagit,5/1/99,53057,5,1999,51577,48222,1,3355,6.50%
Skamania,5/1/99,53059,5,1999,4340,3984,1,356,8.20%
Snohomish,5/1/99,53061,5,1999,330605,318137,1,12468,3.80%
Spokane,5/1/99,53063,5,1999,220128,208531,1,11597,5.30%
Stevens,5/1/99,53065,5,1999,17649,16116,1,1533,8.70%
Thurston,5/1/99,53067,5,1999,106333,101409,1,4924,4.60%
Wahkiakum,5/1/99,53069,5,1999,1933,1807,1,126,6.50%
Walla Walla,5/1/99,53071,5,1999,27905,26181,1,1724,6.20%
Whatcom,5/1/99,53073,5,1999,85944,81535,1,4409,5.10%
Whitman,5/1/99,53075,5,1999,19842,19502,1,340,1.70%
Yakima,5/1/99,53077,5,1999,114893,103213,1,11680,10.20%
Adams,5/1/00,53001,5,2000,7928,7381,1,547,6.90%
Asotin,5/1/00,53003,5,2000,9900,9430,1,470,4.70%
Clallam,5/1/00,53009,5,2000,26052,24164,1,1888,7.20%
Columbia,5/1/00,53013,5,2000,2245,2112,1,133,5.90%
Cowlitz,5/1/00,53015,5,2000,42985,39986,1,2999,7.00%
Douglas,5/1/00,53017,5,2000,17138,16015,1,1123,6.60%
Ferry,5/1/00,53019,5,2000,3043,2704,1,339,11.10%
Franklin,5/1/00,53021,5,2000,22874,21419,1,1455,6.40%
Garfield,5/1/00,53023,5,2000,1059,1008,1,51,4.80%
Grant,5/1/00,53025,5,2000,34673,31730,1,2943,8.50%
Grays Harbor,5/1/00,53027,5,2000,29518,27270,1,2248,7.60%
Island,5/1/00,53029,5,2000,29066,27360,1,1706,5.90%
Jefferson,5/1/00,53031,5,2000,11860,11187,1,673,5.70%
King,5/1/00,53033,5,2000,993697,958106,1,35591,3.60%
Kitsap,5/1/00,53035,5,2000,106019,100145,1,5874,5.50%
Kittitas,5/1/00,53037,5,2000,17609,16548,1,1061,6.00%
Klickitat,5/1/00,53039,5,2000,9178,8468,1,710,7.70%
Lewis,5/1/00,53041,5,2000,29774,27447,1,2327,7.80%
Lincoln,5/1/00,53043,5,2000,4696,4467,1,229,4.90%
Mason,5/1/00,53045,5,2000,20859,19460,1,1399,6.70%
Okanogan,5/1/00,53047,5,2000,19552,17988,1,1564,8.00%
Pacific,5/1/00,53049,5,2000,8659,7991,1,668,7.70%
Pend Oreille,5/1/00,53051,5,2000,4727,4356,1,371,7.80%
Pierce,5/1/00,53053,5,2000,338211,319651,1,18560,5.50%
San Juan,5/1/00,53055,5,2000,7575,7264,1,311,4.10%
Skagit,5/1/00,53057,5,2000,51303,47963,1,3340,6.50%
Skamania,5/1/00,53059,5,2000,4724,4441,1,283,6.00%
Snohomish,5/1/00,53061,5,2000,325677,312736,1,12941,4.00%
Spokane,5/1/00,53063,5,2000,210867,199507,1,11360,5.40%
Stevens,5/1/00,53065,5,2000,17736,16421,1,1315,7.40%
Thurston,5/1/00,53067,5,2000,107955,102623,1,5332,4.90%
Wahkiakum,5/1/00,53069,5,2000,1640,1525,1,115,7.00%
Walla Walla,5/1/00,53071,5,2000,27472,25957,1,1515,5.50%
Whatcom,5/1/00,53073,5,2000,87917,82967,1,4950,5.60%
Whitman,5/1/00,53075,5,2000,19107,18346,1,761,4.00%
Yakima,5/1/00,53077,5,2000,111373,102154,1,9219,8.30%
Adams,5/1/01,53001,5,2001,7885,7292,1,593,7.50%
Asotin,5/1/01,53003,5,2001,9714,9243,1,471,4.80%
Clallam,5/1/01,53009,5,2001,25323,23337,1,1986,7.80%
Columbia,5/1/01,53013,5,2001,2213,2067,1,146,6.60%
Cowlitz,5/1/01,53015,5,2001,41708,37503,1,4205,10.10%
Douglas,5/1/01,53017,5,2001,16333,15053,1,1280,7.80%
Ferry,5/1/01,53019,5,2001,2859,2496,1,363,12.70%
Franklin,5/1/01,53021,5,2001,22984,21410,1,1574,6.80%
Garfield,5/1/01,53023,5,2001,1070,1019,1,51,4.80%
Grant,5/1/01,53025,5,2001,34453,31127,1,3326,9.70%
Grays Harbor,5/1/01,53027,5,2001,27989,25358,1,2631,9.40%
Island,5/1/01,53029,5,2001,28485,26791,1,1694,5.90%
Jefferson,5/1/01,53031,5,2001,11846,11113,1,733,6.20%
King,5/1/01,53033,5,2001,999273,955065,1,44208,4.40%
Kitsap,5/1/01,53035,5,2001,103130,96910,1,6220,6.00%
Kittitas,5/1/01,53037,5,2001,17208,16082,1,1126,6.50%
Klickitat,5/1/01,53039,5,2001,9279,8144,1,1135,12.20%
Lewis,5/1/01,53041,5,2001,28694,26221,1,2473,8.60%
Lincoln,5/1/01,53043,5,2001,4572,4339,1,233,5.10%
Mason,5/1/01,53045,5,2001,19980,18451,1,1529,7.70%
Okanogan,5/1/01,53047,5,2001,17832,15992,1,1840,10.30%
Pacific,5/1/01,53049,5,2001,8499,7755,1,744,8.80%
Pend Oreille,5/1/01,53051,5,2001,4534,4125,1,409,9.00%
Pierce,5/1/01,53053,5,2001,329098,307654,1,21444,6.50%
San Juan,5/1/01,53055,5,2001,7436,7106,1,330,4.40%
Skagit,5/1/01,53057,5,2001,50082,46606,1,3476,6.90%
Skamania,5/1/01,53059,5,2001,4832,4280,1,552,11.40%
Snohomish,5/1/01,53061,5,2001,331026,316028,1,14998,4.50%
Spokane,5/1/01,53063,5,2001,207669,194627,1,13042,6.30%
Stevens,5/1/01,53065,5,2001,16957,15431,1,1526,9.00%
Thurston,5/1/01,53067,5,2001,105579,99536,1,6043,5.70%
Wahkiakum,5/1/01,53069,5,2001,1543,1398,1,145,9.40%
Walla Walla,5/1/01,53071,5,2001,27048,25535,1,1513,5.60%
Whatcom,5/1/01,53073,5,2001,86483,81033,1,5450,6.30%
Whitman,5/1/01,53075,5,2001,18711,17952,1,759,4.10%
Yakima,5/1/01,53077,5,2001,106592,96505,1,10087,9.50%
Adams,5/1/02,53001,5,2002,7832,7211,1,621,7.90%
Asotin,5/1/02,53003,5,2002,10180,9531,1,649,6.40%
Clallam,5/1/02,53009,5,2002,26275,24094,1,2181,8.30%
Columbia,5/1/02,53013,5,2002,2170,2007,1,163,7.50%
Cowlitz,5/1/02,53015,5,2002,42299,37544,1,4755,11.20%
Douglas,5/1/02,53017,5,2002,16795,15330,1,1465,8.70%
Ferry,5/1/02,53019,5,2002,2851,2549,1,302,10.60%
Franklin,5/1/02,53021,5,2002,24217,22489,1,1728,7.10%
Garfield,5/1/02,53023,5,2002,1095,1032,1,63,5.80%
Grant,5/1/02,53025,5,2002,35229,31497,1,3732,10.60%
Grays Harbor,5/1/02,53027,5,2002,28551,25953,1,2598,9.10%
Island,5/1/02,53029,5,2002,30011,27823,1,2188,7.30%
Jefferson,5/1/02,53031,5,2002,12304,11341,1,963,7.80%
King,5/1/02,53033,5,2002,986288,927602,1,58686,6.00%
Kitsap,5/1/02,53035,5,2002,109688,102356,1,7332,6.70%
Kittitas,5/1/02,53037,5,2002,17844,16571,1,1273,7.10%
Klickitat,5/1/02,53039,5,2002,9118,8053,1,1065,11.70%
Lewis,5/1/02,53041,5,2002,29409,26693,1,2716,9.20%
Lincoln,5/1/02,53043,5,2002,4647,4343,1,304,6.50%
Mason,5/1/02,53045,5,2002,21173,19449,1,1724,8.10%
Okanogan,5/1/02,53047,5,2002,17425,15715,1,1710,9.80%
Pacific,5/1/02,53049,5,2002,8592,7830,1,762,8.90%
Pend Oreille,5/1/02,53051,5,2002,4624,4192,1,432,9.30%
Pierce,5/1/02,53053,5,2002,339711,311692,1,28019,8.20%
San Juan,5/1/02,53055,5,2002,7497,7073,1,424,5.70%
Skagit,5/1/02,53057,5,2002,51363,47143,1,4220,8.20%
Skamania,5/1/02,53059,5,2002,4686,4211,1,475,10.10%
Snohomish,5/1/02,53061,5,2002,333401,310479,1,22922,6.90%
Spokane,5/1/02,53063,5,2002,209365,193928,1,15437,7.40%
Stevens,5/1/02,53065,5,2002,17208,15541,1,1667,9.70%
Thurston,5/1/02,53067,5,2002,109870,102701,1,7169,6.50%
Wahkiakum,5/1/02,53069,5,2002,1532,1382,1,150,9.80%
Walla Walla,5/1/02,53071,5,2002,28031,26297,1,1734,6.20%
Whatcom,5/1/02,53073,5,2002,90034,83774,1,6260,7.00%
Whitman,5/1/02,53075,5,2002,19249,18342,1,907,4.70%
Yakima,5/1/02,53077,5,2002,108281,97785,1,10496,9.70%
Adams,5/1/03,53001,5,2003,7984,7328,1,656,8.20%
Asotin,5/1/03,53003,5,2003,9862,9202,1,660,6.70%
Clallam,5/1/03,53009,5,2003,26624,24311,1,2313,8.70%
Columbia,5/1/03,53013,5,2003,2136,1992,1,144,6.70%
Cowlitz,5/1/03,53015,5,2003,41725,37555,1,4170,10.00%
Douglas,5/1/03,53017,5,2003,17320,15869,1,1451,8.40%
Ferry,5/1/03,53019,5,2003,2849,2434,1,415,14.60%
Franklin,5/1/03,53021,5,2003,25797,23909,1,1888,7.30%
Garfield,5/1/03,53023,5,2003,1096,1027,1,69,6.30%
Grant,5/1/03,53025,5,2003,35326,31841,1,3485,9.90%
Grays Harbor,5/1/03,53027,5,2003,29100,26401,1,2699,9.30%
Island,5/1/03,53029,5,2003,30093,27842,1,2251,7.50%
Jefferson,5/1/03,53031,5,2003,12541,11633,1,908,7.20%
King,5/1/03,53033,5,2003,991551,929479,1,62072,6.30%
Kitsap,5/1/03,53035,5,2003,111247,103562,1,7685,6.90%
Kittitas,5/1/03,53037,5,2003,18670,17263,1,1407,7.50%
Klickitat,5/1/03,53039,5,2003,9079,7945,1,1134,12.50%
Lewis,5/1/03,53041,5,2003,29737,26985,1,2752,9.30%
Lincoln,5/1/03,53043,5,2003,4702,4393,1,309,6.60%
Mason,5/1/03,53045,5,2003,22081,20187,1,1894,8.60%
Okanogan,5/1/03,53047,5,2003,18036,16252,1,1784,9.90%
Pacific,5/1/03,53049,5,2003,8801,7972,1,829,9.40%
Pend Oreille,5/1/03,53051,5,2003,4666,4223,1,443,9.50%
Pierce,5/1/03,53053,5,2003,343299,315201,1,28098,8.20%
San Juan,5/1/03,53055,5,2003,7772,7349,1,423,5.40%
Skagit,5/1/03,53057,5,2003,52279,47994,1,4285,8.20%
Skamania,5/1/03,53059,5,2003,4618,4181,1,437,9.50%
Snohomish,5/1/03,53061,5,2003,335332,312354,1,22978,6.90%
Spokane,5/1/03,53063,5,2003,211490,195963,1,15527,7.30%
Stevens,5/1/03,53065,5,2003,17485,15825,1,1660,9.50%
Thurston,5/1/03,53067,5,2003,113468,106253,1,7215,6.40%
Wahkiakum,5/1/03,53069,5,2003,1539,1391,1,148,9.60%
Walla Walla,5/1/03,53071,5,2003,28203,26381,1,1822,6.50%
Whatcom,5/1/03,53073,5,2003,93361,87062,1,6299,6.70%
Whitman,5/1/03,53075,5,2003,19388,18449,1,939,4.80%
Yakima,5/1/03,53077,5,2003,109890,99691,1,10199,9.30%
Adams,5/1/04,53001,5,2004,8020,7454,1,566,7.10%
Asotin,5/1/04,53003,5,2004,10069,9485,1,584,5.80%
Clallam,5/1/04,53009,5,2004,28142,26167,1,1975,7.00%
Columbia,5/1/04,53013,5,2004,2198,2073,1,125,5.70%
Cowlitz,5/1/04,53015,5,2004,42491,38919,1,3572,8.40%
Douglas,5/1/04,53017,5,2004,18339,17091,1,1248,6.80%
Ferry,5/1/04,53019,5,2004,2970,2656,1,314,10.60%
Franklin,5/1/04,53021,5,2004,27744,26017,1,1727,6.20%
Garfield,5/1/04,53023,5,2004,1085,1031,1,54,5.00%
Grant,5/1/04,53025,5,2004,37313,34196,1,3117,8.40%
Grays Harbor,5/1/04,53027,5,2004,30368,27886,1,2482,8.20%
Island,5/1/04,53029,5,2004,31332,29155,1,2177,6.90%
Jefferson,5/1/04,53031,5,2004,13385,12553,1,832,6.20%
King,5/1/04,53033,5,2004,992311,942830,1,49481,5.00%
Kitsap,5/1/04,53035,5,2004,117485,110606,1,6879,5.90%
Kittitas,5/1/04,53037,5,2004,19134,17853,1,1281,6.70%
Klickitat,5/1/04,53039,5,2004,9179,8368,1,811,8.80%
Lewis,5/1/04,53041,5,2004,30574,28091,1,2483,8.10%
Lincoln,5/1/04,53043,5,2004,4888,4591,1,297,6.10%
Mason,5/1/04,53045,5,2004,23194,21470,1,1724,7.40%
Okanogan,5/1/04,53047,5,2004,18917,17375,1,1542,8.20%
Pacific,5/1/04,53049,5,2004,9188,8533,1,655,7.10%
Pend Oreille,5/1/04,53051,5,2004,4920,4498,1,422,8.60%
Pierce,5/1/04,53053,5,2004,357890,332199,1,25691,7.20%
San Juan,5/1/04,53055,5,2004,8173,7798,1,375,4.60%
Skagit,5/1/04,53057,5,2004,54094,50419,1,3675,6.80%
Skamania,5/1/04,53059,5,2004,4816,4467,1,349,7.20%
Snohomish,5/1/04,53061,5,2004,337226,318327,1,18899,5.60%
Spokane,5/1/04,53063,5,2004,217859,203964,1,13895,6.40%
Stevens,5/1/04,53065,5,2004,17895,16525,1,1370,7.70%
Thurston,5/1/04,53067,5,2004,118288,111514,1,6774,5.70%
Wahkiakum,5/1/04,53069,5,2004,1606,1487,1,119,7.40%
Walla Walla,5/1/04,53071,5,2004,29121,27481,1,1640,5.60%
Whatcom,5/1/04,53073,5,2004,98921,93288,1,5633,5.70%
Whitman,5/1/04,53075,5,2004,19971,19082,1,889,4.50%
Yakima,5/1/04,53077,5,2004,113091,103313,1,9778,8.60%
Adams,5/1/05,53001,5,2005,7932,7439,1,493,6.20%
Asotin,5/1/05,53003,5,2005,10464,9881,1,583,5.60%
Clallam,5/1/05,53009,5,2005,29470,27526,1,1944,6.60%
Columbia,5/1/05,53013,5,2005,2001,1888,1,113,5.60%
Cowlitz,5/1/05,53015,5,2005,42746,39561,1,3185,7.50%
Douglas,5/1/05,53017,5,2005,18935,17807,1,1128,6.00%
Ferry,5/1/05,53019,5,2005,3032,2762,1,270,8.90%
Franklin,5/1/05,53021,5,2005,29386,27575,1,1811,6.20%
Garfield,5/1/05,53023,5,2005,1113,1047,1,66,5.90%
Grant,5/1/05,53025,5,2005,37468,34810,1,2658,7.10%
Grays Harbor,5/1/05,53027,5,2005,31105,28770,1,2335,7.50%
Island,5/1/05,53029,5,2005,31597,29587,1,2010,6.40%
Jefferson,5/1/05,53031,5,2005,13554,12761,1,793,5.90%
King,5/1/05,53033,5,2005,1012895,968195,1,44700,4.40%
Kitsap,5/1/05,53035,5,2005,120197,113726,1,6471,5.40%
Kittitas,5/1/05,53037,5,2005,19406,18270,1,1136,5.90%
Klickitat,5/1/05,53039,5,2005,9214,8459,1,755,8.20%
Lewis,5/1/05,53041,5,2005,30472,28154,1,2318,7.60%
Lincoln,5/1/05,53043,5,2005,4721,4446,1,275,5.80%
Mason,5/1/05,53045,5,2005,23826,22207,1,1619,6.80%
Okanogan,5/1/05,53047,5,2005,19016,17626,1,1390,7.30%
Pacific,5/1/05,53049,5,2005,9052,8383,1,669,7.40%
Pend Oreille,5/1/05,53051,5,2005,5099,4712,1,387,7.60%
Pierce,5/1/05,53053,5,2005,366493,343738,1,22755,6.20%
San Juan,5/1/05,53055,5,2005,8228,7852,1,376,4.60%
Skagit,5/1/05,53057,5,2005,55577,52191,1,3386,6.10%
Skamania,5/1/05,53059,5,2005,4911,4584,1,327,6.70%
Snohomish,5/1/05,53061,5,2005,346190,329910,1,16280,4.70%
Spokane,5/1/05,53063,5,2005,222854,210282,1,12572,5.60%
Stevens,5/1/05,53065,5,2005,18025,16690,1,1335,7.40%
Thurston,5/1/05,53067,5,2005,121125,114714,1,6411,5.30%
Wahkiakum,5/1/05,53069,5,2005,1619,1496,1,123,7.60%
Walla Walla,5/1/05,53071,5,2005,28755,27153,1,1602,5.60%
Whatcom,5/1/05,53073,5,2005,102444,97189,1,5255,5.10%
Whitman,5/1/05,53075,5,2005,20380,19452,1,928,4.60%
Yakima,5/1/05,53077,5,2005,114917,106516,1,8401,7.30%
Adams,5/1/06,53001,5,2006,7797,7332,1,465,6.00%
Asotin,5/1/06,53003,5,2006,10364,9819,1,545,5.30%
Clallam,5/1/06,53009,5,2006,29637,27778,1,1859,6.30%
Columbia,5/1/06,53013,5,2006,1451,1312,1,139,9.60%
Cowlitz,5/1/06,53015,5,2006,42323,39265,1,3058,7.20%
Douglas,5/1/06,53017,5,2006,18901,17800,1,1101,5.80%
Ferry,5/1/06,53019,5,2006,2862,2555,1,307,10.70%
Franklin,5/1/06,53021,5,2006,29864,27927,1,1937,6.50%
Garfield,5/1/06,53023,5,2006,1061,1002,1,59,5.60%
Grant,5/1/06,53025,5,2006,37760,34949,1,2811,7.40%
Grays Harbor,5/1/06,53027,5,2006,30660,28444,1,2216,7.20%
Island,5/1/06,53029,5,2006,32098,30243,1,1855,5.80%
Jefferson,5/1/06,53031,5,2006,13554,12800,1,754,5.60%
King,5/1/06,53033,5,2006,1048639,1009579,1,39060,3.70%
Kitsap,5/1/06,53035,5,2006,121297,114998,1,6299,5.20%
Kittitas,5/1/06,53037,5,2006,19880,18801,1,1079,5.40%
Klickitat,5/1/06,53039,5,2006,9283,8554,1,729,7.90%
Lewis,5/1/06,53041,5,2006,31026,28815,1,2211,7.10%
Lincoln,5/1/06,53043,5,2006,4606,4335,1,271,5.90%
Mason,5/1/06,53045,5,2006,24200,22665,1,1535,6.30%
Okanogan,5/1/06,53047,5,2006,19096,17781,1,1315,6.90%
Pacific,5/1/06,53049,5,2006,9128,8499,1,629,6.90%
Pend Oreille,5/1/06,53051,5,2006,5049,4668,1,381,7.50%
Pierce,5/1/06,53053,5,2006,369816,348745,1,21071,5.70%
San Juan,5/1/06,53055,5,2006,8205,7857,1,348,4.20%
Skagit,5/1/06,53057,5,2006,55967,52800,1,3167,5.70%
Skamania,5/1/06,53059,5,2006,4957,4642,1,315,6.40%
Snohomish,5/1/06,53061,5,2006,359413,344948,1,14465,4.00%
Spokane,5/1/06,53063,5,2006,225620,213659,1,11961,5.30%
Stevens,5/1/06,53065,5,2006,18108,16797,1,1311,7.20%
Thurston,5/1/06,53067,5,2006,122982,116733,1,6249,5.10%
Wahkiakum,5/1/06,53069,5,2006,1624,1505,1,119,7.30%
Walla Walla,5/1/06,53071,5,2006,28497,26794,1,1703,6.00%
Whatcom,5/1/06,53073,5,2006,102086,97013,1,5073,5.00%
Whitman,5/1/06,53075,5,2006,20086,19185,1,901,4.50%
Yakima,5/1/06,53077,5,2006,114545,106047,1,8498,7.40%
Adams,5/1/07,53001,5,2007,7770,7320,1,450,5.80%
Asotin,5/1/07,53003,5,2007,10313,9851,1,462,4.50%
Clallam,5/1/07,53009,5,2007,29685,27894,1,1791,6.00%
Columbia,5/1/07,53013,5,2007,1548,1445,1,103,6.70%
Cowlitz,5/1/07,53015,5,2007,43592,40612,1,2980,6.80%
Douglas,5/1/07,53017,5,2007,19645,18592,1,1053,5.40%
Ferry,5/1/07,53019,5,2007,2941,2672,1,269,9.10%
Franklin,5/1/07,53021,5,2007,32130,30282,1,1848,5.80%
Garfield,5/1/07,53023,5,2007,1020,963,1,57,5.60%
Grant,5/1/07,53025,5,2007,39435,37108,1,2327,5.90%
Grays Harbor,5/1/07,53027,5,2007,31044,28786,1,2258,7.30%
Island,5/1/07,53029,5,2007,32812,31034,1,1778,5.40%
Jefferson,5/1/07,53031,5,2007,13564,12865,1,699,5.20%
King,5/1/07,53033,5,2007,1067094,1035335,1,31759,3.00%
Kitsap,5/1/07,53035,5,2007,121736,115703,1,6033,5.00%
Kittitas,5/1/07,53037,5,2007,20603,19628,1,975,4.70%
Klickitat,5/1/07,53039,5,2007,9739,9041,1,698,7.20%
Lewis,5/1/07,53041,5,2007,31037,28745,1,2292,7.40%
Lincoln,5/1/07,53043,5,2007,4752,4498,1,254,5.30%
Mason,5/1/07,53045,5,2007,24902,23345,1,1557,6.30%
Okanogan,5/1/07,53047,5,2007,19240,17860,1,1380,7.20%
Pacific,5/1/07,53049,5,2007,9074,8423,1,651,7.20%
Pend Oreille,5/1/07,53051,5,2007,5208,4830,1,378,7.30%
Pierce,5/1/07,53053,5,2007,382949,362848,1,20101,5.20%
San Juan,5/1/07,53055,5,2007,8468,8152,1,316,3.70%
Skagit,5/1/07,53057,5,2007,57459,54409,1,3050,5.30%
Skamania,5/1/07,53059,5,2007,4954,4643,1,311,6.30%
Snohomish,5/1/07,53061,5,2007,362792,351194,1,11598,3.20%
Spokane,5/1/07,53063,5,2007,232622,221352,1,11270,4.80%
Stevens,5/1/07,53065,5,2007,18510,17162,1,1348,7.30%
Thurston,5/1/07,53067,5,2007,127066,120895,1,6171,4.90%
Wahkiakum,5/1/07,53069,5,2007,1681,1564,1,117,7.00%
Walla Walla,5/1/07,53071,5,2007,29039,27519,1,1520,5.20%
Whatcom,5/1/07,53073,5,2007,105824,100950,1,4874,4.60%
Whitman,5/1/07,53075,5,2007,19920,19102,1,818,4.10%
Yakima,5/1/07,53077,5,2007,117209,109179,1,8030,6.90%
Adams,5/1/08,53001,5,2008,7922,7455,1,467,5.90%
Asotin,5/1/08,53003,5,2008,10300,9701,1,599,5.80%
Clallam,5/1/08,53009,5,2008,30006,27783,1,2223,7.40%
Columbia,5/1/08,53013,5,2008,1534,1430,1,104,6.80%
Cowlitz,5/1/08,53015,5,2008,44386,40614,1,3772,8.50%
Douglas,5/1/08,53017,5,2008,19999,18790,1,1209,6.00%
Ferry,5/1/08,53019,5,2008,2936,2661,1,275,9.40%
Franklin,5/1/08,53021,5,2008,33792,31712,1,2080,6.20%
Garfield,5/1/08,53023,5,2008,1035,985,1,50,4.80%
Grant,5/1/08,53025,5,2008,39672,37180,1,2492,6.30%
Grays Harbor,5/1/08,53027,5,2008,31758,29266,1,2492,7.80%
Island,5/1/08,53029,5,2008,33114,31237,1,1877,5.70%
Jefferson,5/1/08,53031,5,2008,13724,12924,1,800,5.80%
King,5/1/08,53033,5,2008,1090422,1053364,1,37058,3.40%
Kitsap,5/1/08,53035,5,2008,123963,117317,1,6646,5.40%
Kittitas,5/1/08,53037,5,2008,21029,19778,1,1251,5.90%
Klickitat,5/1/08,53039,5,2008,9998,9169,1,829,8.30%
Lewis,5/1/08,53041,5,2008,31371,28786,1,2585,8.20%
Lincoln,5/1/08,53043,5,2008,4796,4525,1,271,5.70%
Mason,5/1/08,53045,5,2008,25249,23321,1,1928,7.60%
Okanogan,5/1/08,53047,5,2008,19797,18429,1,1368,6.90%
Pacific,5/1/08,53049,5,2008,9251,8555,1,696,7.50%
Pend Oreille,5/1/08,53051,5,2008,5485,5037,1,448,8.20%
Pierce,5/1/08,53053,5,2008,392227,368676,1,23551,6.00%
San Juan,5/1/08,53055,5,2008,8786,8463,1,323,3.70%
Skagit,5/1/08,53057,5,2008,58560,55129,1,3431,5.90%
Skamania,5/1/08,53059,5,2008,5091,4668,1,423,8.30%
Snohomish,5/1/08,53061,5,2008,372446,357750,1,14696,3.90%
Spokane,5/1/08,53063,5,2008,238385,225222,1,13163,5.50%
Stevens,5/1/08,53065,5,2008,18814,17315,1,1499,8.00%
Thurston,5/1/08,53067,5,2008,130947,123990,1,6957,5.30%
Wahkiakum,5/1/08,53069,5,2008,1781,1639,1,142,8.00%
Walla Walla,5/1/08,53071,5,2008,29797,28243,1,1554,5.20%
Whatcom,5/1/08,53073,5,2008,108689,103100,1,5589,5.10%
Whitman,5/1/08,53075,5,2008,21832,20911,1,921,4.20%
Yakima,5/1/08,53077,5,2008,119960,110962,1,8998,7.50%
Adams,5/1/09,53001,5,2009,8259,7620,1,639,7.70%
Asotin,5/1/09,53003,5,2009,10373,9503,1,870,8.40%
Clallam,5/1/09,53009,5,2009,30464,27525,1,2939,9.60%
Columbia,5/1/09,53013,5,2009,1571,1409,1,162,10.30%
Cowlitz,5/1/09,53015,5,2009,44822,39114,1,5708,12.70%
Douglas,5/1/09,53017,5,2009,20562,18915,1,1647,8.00%
Ferry,5/1/09,53019,5,2009,3124,2740,1,384,12.30%
Franklin,5/1/09,53021,5,2009,36421,33661,1,2760,7.60%
Garfield,5/1/09,53023,5,2009,1063,997,1,66,6.20%
Grant,5/1/09,53025,5,2009,41227,37500,1,3727,9.00%
Grays Harbor,5/1/09,53027,5,2009,31685,27348,1,4337,13.70%
Island,5/1/09,53029,5,2009,33247,30351,1,2896,8.70%
Jefferson,5/1/09,53031,5,2009,13301,12142,1,1159,8.70%
King,5/1/09,53033,5,2009,1115289,1030827,1,84462,7.60%
Kitsap,5/1/09,53035,5,2009,125402,115710,1,9692,7.70%
Kittitas,5/1/09,53037,5,2009,21090,19224,1,1866,8.80%
Klickitat,5/1/09,53039,5,2009,10565,9550,1,1015,9.60%
Lewis,5/1/09,53041,5,2009,31857,27752,1,4105,12.90%
Lincoln,5/1/09,53043,5,2009,4906,4513,1,393,8.00%
Mason,5/1/09,53045,5,2009,25338,22718,1,2620,10.30%
Okanogan,5/1/09,53047,5,2009,20452,18610,1,1842,9.00%
Pacific,5/1/09,53049,5,2009,9255,8063,1,1192,12.90%
Pend Oreille,5/1/09,53051,5,2009,5538,4715,1,823,14.90%
Pierce,5/1/09,53053,5,2009,398007,359396,1,38611,9.70%
San Juan,5/1/09,53055,5,2009,8539,7991,1,548,6.40%
Skagit,5/1/09,53057,5,2009,58389,52622,1,5767,9.90%
Skamania,5/1/09,53059,5,2009,5020,4440,1,580,11.60%
Snohomish,5/1/09,53061,5,2009,381866,348092,1,33774,8.80%
Spokane,5/1/09,53063,5,2009,240779,219696,1,21083,8.80%
Stevens,5/1/09,53065,5,2009,19129,16715,1,2414,12.60%
Thurston,5/1/09,53067,5,2009,132409,122073,1,10336,7.80%
Wahkiakum,5/1/09,53069,5,2009,1599,1367,1,232,14.50%
Walla Walla,5/1/09,53071,5,2009,30701,28744,1,1957,6.40%
Whatcom,5/1/09,53073,5,2009,108532,99615,1,8917,8.20%
Whitman,5/1/09,53075,5,2009,22862,21670,1,1192,5.20%
Yakima,5/1/09,53077,5,2009,122439,111899,1,10540,8.60%
Adams,5/1/10,53001,5,2010,8275,7475,1,800,9.70%
Asotin,5/1/10,53003,5,2010,10420,9452,1,968,9.30%
Clallam,5/1/10,53009,5,2010,29989,26804,1,3185,10.60%
Columbia,5/1/10,53013,5,2010,1983,1796,1,187,9.40%
Cowlitz,5/1/10,53015,5,2010,46666,40631,1,6035,12.90%
Douglas,5/1/10,53017,5,2010,19326,17317,1,2009,10.40%
Ferry,5/1/10,53019,5,2010,2678,2211,1,467,17.40%
Franklin,5/1/10,53021,5,2010,37559,34293,1,3266,8.70%
Garfield,5/1/10,53023,5,2010,1098,1008,1,90,8.20%
Grant,5/1/10,53025,5,2010,43418,38868,1,4550,10.50%
Grays Harbor,5/1/10,53027,5,2010,31469,27227,1,4242,13.50%
Island,5/1/10,53029,5,2010,34495,31288,1,3207,9.30%
Jefferson,5/1/10,53031,5,2010,13062,11789,1,1273,9.70%
King,5/1/10,53033,5,2010,1111147,1014163,1,96984,8.70%
Kitsap,5/1/10,53035,5,2010,121030,110506,1,10524,8.70%
Kittitas,5/1/10,53037,5,2010,21868,19756,1,2112,9.70%
Klickitat,5/1/10,53039,5,2010,10378,9091,1,1287,12.40%
Lewis,5/1/10,53041,5,2010,34258,29900,1,4358,12.70%
Lincoln,5/1/10,53043,5,2010,5335,4889,1,446,8.40%
Mason,5/1/10,53045,5,2010,24918,21959,1,2959,11.90%
Okanogan,5/1/10,53047,5,2010,21296,18929,1,2367,11.10%
Pacific,5/1/10,53049,5,2010,8919,7716,1,1203,13.50%
Pend Oreille,5/1/10,53051,5,2010,5178,4412,1,766,14.80%
Pierce,5/1/10,53053,5,2010,397314,355586,1,41728,10.50%
San Juan,5/1/10,53055,5,2010,8647,8067,1,580,6.70%
Skagit,5/1/10,53057,5,2010,59295,52921,1,6374,10.70%
Skamania,5/1/10,53059,5,2010,5188,4535,1,653,12.60%
Snohomish,5/1/10,53061,5,2010,388044,348054,1,39990,10.30%
Spokane,5/1/10,53063,5,2010,239362,215740,1,23622,9.90%
Stevens,5/1/10,53065,5,2010,19230,16836,1,2394,12.40%
Thurston,5/1/10,53067,5,2010,127649,116124,1,11525,9.00%
Wahkiakum,5/1/10,53069,5,2010,1485,1273,1,212,14.30%
Walla Walla,5/1/10,53071,5,2010,30252,27754,1,2498,8.30%
Whatcom,5/1/10,53073,5,2010,105038,95144,1,9894,9.40%
Whitman,5/1/10,53075,5,2010,22530,20938,1,1592,7.10%
Yakima,5/1/10,53077,5,2010,117946,105017,1,12929,11.00%
Adams,5/1/11,53001,5,2011,7993,7233,1,760,9.50%
Asotin,5/1/11,53003,5,2011,10190,9314,1,876,8.60%
Clallam,5/1/11,53009,5,2011,28570,25446,1,3124,10.90%
Columbia,5/1/11,53013,5,2011,1883,1704,1,179,9.50%
Cowlitz,5/1/11,53015,5,2011,44831,39395,1,5436,12.10%
Douglas,5/1/11,53017,5,2011,18583,16730,1,1853,10.00%
Ferry,5/1/11,53019,5,2011,2496,2058,1,438,17.50%
Franklin,5/1/11,53021,5,2011,38603,35213,1,3390,8.80%
Garfield,5/1/11,53023,5,2011,1072,999,1,73,6.80%
Grant,5/1/11,53025,5,2011,41929,37637,1,4292,10.20%
Grays Harbor,5/1/11,53027,5,2011,29730,25769,1,3961,13.30%
Island,5/1/11,53029,5,2011,32887,29864,1,3023,9.20%
Jefferson,5/1/11,53031,5,2011,12205,10937,1,1268,10.40%
King,5/1/11,53033,5,2011,1108262,1022759,1,85503,7.70%
Kitsap,5/1/11,53035,5,2011,117830,107762,1,10068,8.50%
Kittitas,5/1/11,53037,5,2011,21071,19146,1,1925,9.10%
Klickitat,5/1/11,53039,5,2011,10096,8886,1,1210,12.00%
Lewis,5/1/11,53041,5,2011,32819,28683,1,4136,12.60%
Lincoln,5/1/11,53043,5,2011,5335,4898,1,437,8.20%
Mason,5/1/11,53045,5,2011,23818,21017,1,2801,11.80%
Okanogan,5/1/11,53047,5,2011,20047,17836,1,2211,11.00%
Pacific,5/1/11,53049,5,2011,8254,7113,1,1141,13.80%
Pend Oreille,5/1/11,53051,5,2011,4901,4216,1,685,14.00%
Pierce,5/1/11,53053,5,2011,387373,347297,1,40076,10.30%
San Juan,5/1/11,53055,5,2011,8073,7478,1,595,7.40%
Skagit,5/1/11,53057,5,2011,57088,51071,1,6017,10.50%
Skamania,5/1/11,53059,5,2011,5112,4467,1,645,12.60%
Snohomish,5/1/11,53061,5,2011,383725,348308,1,35417,9.20%
Spokane,5/1/11,53063,5,2011,231733,209658,1,22075,9.50%
Stevens,5/1/11,53065,5,2011,18465,16225,1,2240,12.10%
Thurston,5/1/11,53067,5,2011,124334,113019,1,11315,9.10%
Wahkiakum,5/1/11,53069,5,2011,1432,1228,1,204,14.20%
Walla Walla,5/1/11,53071,5,2011,29369,26903,1,2466,8.40%
Whatcom,5/1/11,53073,5,2011,103655,94483,1,9172,8.80%
Whitman,5/1/11,53075,5,2011,23286,21757,1,1529,6.60%
Yakima,5/1/11,53077,5,2011,116850,103750,1,13100,11.20%
Adams,5/1/12,53001,5,2012,8117,7426,1,691,8.50%
Asotin,5/1/12,53003,5,2012,9758,9006,1,752,7.70%
Clallam,5/1/12,53009,5,2012,28221,25255,1,2966,10.50%
Columbia,5/1/12,53013,5,2012,1857,1703,1,154,8.30%
Cowlitz,5/1/12,53015,5,2012,44799,40023,1,4776,10.70%
Douglas,5/1/12,53017,5,2012,18818,16950,1,1868,9.90%
Ferry,5/1/12,53019,5,2012,2491,2112,1,379,15.20%
Franklin,5/1/12,53021,5,2012,39286,35493,1,3793,9.70%
Garfield,5/1/12,53023,5,2012,1058,984,1,74,7.00%
Grant,5/1/12,53025,5,2012,43510,39462,1,4048,9.30%
Grays Harbor,5/1/12,53027,5,2012,29023,25198,1,3825,13.20%
Island,5/1/12,53029,5,2012,32662,29994,1,2668,8.20%
Jefferson,5/1/12,53031,5,2012,11904,10701,1,1203,10.10%
King,5/1/12,53033,5,2012,1128170,1056335,1,71835,6.40%
Kitsap,5/1/12,53035,5,2012,116747,107442,1,9305,8.00%
Kittitas,5/1/12,53037,5,2012,20985,19148,1,1837,8.80%
Klickitat,5/1/12,53039,5,2012,10036,9030,1,1006,10.00%
Lewis,5/1/12,53041,5,2012,32472,28563,1,3909,12.00%
Lincoln,5/1/12,53043,5,2012,5295,4909,1,386,7.30%
Mason,5/1/12,53045,5,2012,23498,20917,1,2581,11.00%
Okanogan,5/1/12,53047,5,2012,19993,17980,1,2013,10.10%
Pacific,5/1/12,53049,5,2012,8344,7338,1,1006,12.10%
Pend Oreille,5/1/12,53051,5,2012,4837,4228,1,609,12.60%
Pierce,5/1/12,53053,5,2012,387786,351093,1,36693,9.50%
San Juan,5/1/12,53055,5,2012,8096,7582,1,514,6.30%
Skagit,5/1/12,53057,5,2012,57387,51780,1,5607,9.80%
Skamania,5/1/12,53059,5,2012,5038,4516,1,522,10.40%
Snohomish,5/1/12,53061,5,2012,387693,358471,1,29222,7.50%
Spokane,5/1/12,53063,5,2012,231855,210847,1,21008,9.10%
Stevens,5/1/12,53065,5,2012,18319,16230,1,2089,11.40%
Thurston,5/1/12,53067,5,2012,123297,112792,1,10505,8.50%
Wahkiakum,5/1/12,53069,5,2012,1387,1210,1,177,12.80%
Walla Walla,5/1/12,53071,5,2012,29523,27332,1,2191,7.40%
Whatcom,5/1/12,53073,5,2012,103447,94838,1,8609,8.30%
Whitman,5/1/12,53075,5,2012,22383,20881,1,1502,6.70%
Yakima,5/1/12,53077,5,2012,118142,104852,1,13290,11.20%
Adams,5/1/13,53001,5,2013,8433,7790,1,643,7.60%
Asotin,5/1/13,53003,5,2013,9857,9232,1,625,6.30%
Clallam,5/1/13,53009,5,2013,27314,24722,1,2592,9.50%
Clark,5/1/13,53011,5,2013,207624,189876,1,17748,8.50%
Columbia,5/1/13,53013,5,2013,1791,1641,1,150,8.40%
Cowlitz,5/1/13,53015,5,2013,43179,38906,1,4273,9.90%
Douglas,5/1/13,53017,5,2013,18425,16835,1,1590,8.60%
Ferry,5/1/13,53019,5,2013,2515,2183,1,332,13.20%
Franklin,5/1/13,53021,5,2013,38820,35198,1,3622,9.30%
Garfield,5/1/13,53023,5,2013,1024,948,1,76,7.40%
Grant,5/1/13,53025,5,2013,44069,40488,1,3581,8.10%
Grays Harbor,5/1/13,53027,5,2013,27969,24600,1,3369,12.00%
Island,5/1/13,53029,5,2013,31702,29373,1,2329,7.30%
Jefferson,5/1/13,53031,5,2013,11343,10265,1,1078,9.50%
King,5/1/13,53033,5,2013,1140354,1086211,1,54143,4.70%
Kitsap,5/1/13,53035,5,2013,113028,104696,1,8332,7.40%
Kittitas,5/1/13,53037,5,2013,20743,19171,1,1572,7.60%
Klickitat,5/1/13,53039,5,2013,9633,8715,1,918,9.50%
Lewis,5/1/13,53041,5,2013,31504,28217,1,3287,10.40%
Lincoln,5/1/13,53043,5,2013,5126,4792,1,334,6.50%
Mason,5/1/13,53045,5,2013,23226,20871,1,2355,10.10%
Okanogan,5/1/13,53047,5,2013,19886,18181,1,1705,8.60%
Pacific,5/1/13,53049,5,2013,7919,7034,1,885,11.20%
Pend Oreille,5/1/13,53051,5,2013,4678,4139,1,539,11.50%
Pierce,5/1/13,53053,5,2013,383388,350798,1,32590,8.50%
San Juan,5/1/13,53055,5,2013,7714,7275,1,439,5.70%
Skagit,5/1/13,53057,5,2013,56675,51786,1,4889,8.60%
Skamania,5/1/13,53059,5,2013,4984,4481,1,503,10.10%
Snohomish,5/1/13,53061,5,2013,389670,368630,1,21040,5.40%
Spokane,5/1/13,53063,5,2013,227711,209586,1,18125,8.00%
Stevens,5/1/13,53065,5,2013,17755,15902,1,1853,10.40%
Thurston,5/1/13,53067,5,2013,122627,113280,1,9347,7.60%
Wahkiakum,5/1/13,53069,5,2013,1278,1116,1,162,12.70%
Walla Walla,5/1/13,53071,5,2013,28718,26710,1,2008,7.00%
Whatcom,5/1/13,53073,5,2013,102083,94367,1,7716,7.60%
Whitman,5/1/13,53075,5,2013,22308,20910,1,1398,6.30%
Yakima,5/1/13,53077,5,2013,116905,104918,1,11987,10.30%
Adams,5/1/14,53001,5,2014,8775,8268,1,507,5.80%
Asotin,5/1/14,53003,5,2014,9749,9234,1,515,5.30%
Clallam,5/1/14,53009,5,2014,26675,24532,1,2143,8.00%
Clark,5/1/14,53011,5,2014,207698,193401,1,14297,6.90%
Columbia,5/1/14,53013,5,2014,1767,1647,1,120,6.80%
Cowlitz,5/1/14,53015,5,2014,43066,39635,1,3431,8.00%
Douglas,5/1/14,53017,5,2014,18512,17129,1,1383,7.50%
Ferry,5/1/14,53019,5,2014,2444,2175,1,269,11.00%
Franklin,5/1/14,53021,5,2014,38061,35152,1,2909,7.60%
Garfield,5/1/14,53023,5,2014,961,899,1,62,6.50%
Grant,5/1/14,53025,5,2014,44387,41409,1,2978,6.70%
Grays Harbor,5/1/14,53027,5,2014,27122,24429,1,2693,9.90%
Island,5/1/14,53029,5,2014,31575,29508,1,2067,6.50%
Jefferson,5/1/14,53031,5,2014,11172,10286,1,886,7.90%
King,5/1/14,53033,5,2014,1159208,1106273,1,52935,4.60%
Kitsap,5/1/14,53035,5,2014,112240,105389,1,6851,6.10%
Kittitas,5/1/14,53037,5,2014,20178,18860,1,1318,6.50%
Klickitat,5/1/14,53039,5,2014,9427,8682,1,745,7.90%
Lewis,5/1/14,53041,5,2014,30233,27591,1,2642,8.70%
Lincoln,5/1/14,53043,5,2014,5100,4838,1,262,5.10%
Mason,5/1/14,53045,5,2014,22906,21012,1,1894,8.30%
Okanogan,5/1/14,53047,5,2014,20563,19169,1,1394,6.80%
Pacific,5/1/14,53049,5,2014,7792,7029,1,763,9.80%
Pend Oreille,5/1/14,53051,5,2014,4549,4125,1,424,9.30%
Pierce,5/1/14,53053,5,2014,381908,355301,1,26607,7.00%
San Juan,5/1/14,53055,5,2014,7691,7338,1,353,4.60%
Skagit,5/1/14,53057,5,2014,56126,52125,1,4001,7.10%
Skamania,5/1/14,53059,5,2014,4903,4506,1,397,8.10%
Snohomish,5/1/14,53061,5,2014,395909,375856,1,20053,5.10%
Spokane,5/1/14,53063,5,2014,224412,209669,1,14743,6.60%
Stevens,5/1/14,53065,5,2014,17307,15819,1,1488,8.60%
Thurston,5/1/14,53067,5,2014,122049,114276,1,7773,6.40%
Wahkiakum,5/1/14,53069,5,2014,1248,1134,1,114,9.10%
Walla Walla,5/1/14,53071,5,2014,28987,27326,1,1661,5.70%
Whatcom,5/1/14,53073,5,2014,100533,93930,1,6603,6.60%
Whitman,5/1/14,53075,5,2014,22221,21091,1,1130,5.10%
Yakima,5/1/14,53077,5,2014,116539,106450,1,10089,8.70%
Adams,5/1/15,53001,5,2015,8708,8207,1,501,5.80%
Asotin,5/1/15,53003,5,2015,9724,9258,1,466,4.80%
Clallam,5/1/15,53009,5,2015,26959,24855,1,2104,7.80%
Clark,5/1/15,53011,5,2015,212853,198828,1,14025,6.60%
Columbia,5/1/15,53013,5,2015,1705,1594,1,111,6.50%
Cowlitz,5/1/15,53015,5,2015,44011,40566,1,3445,7.80%
Douglas,5/1/15,53017,5,2015,19278,18048,1,1230,6.40%
Ferry,5/1/15,53019,5,2015,2532,2296,1,236,9.30%
Franklin,5/1/15,53021,5,2015,39535,36682,1,2853,7.20%
Garfield,5/1/15,53023,5,2015,941,887,1,54,5.70%
Grant,5/1/15,53025,5,2015,44785,41787,1,2998,6.70%
Grays Harbor,5/1/15,53027,5,2015,27127,24680,1,2447,9.00%
Island,5/1/15,53029,5,2015,31925,29977,1,1948,6.10%
Jefferson,5/1/15,53031,5,2015,11265,10472,1,793,7.00%
King,5/1/15,53033,5,2015,1186154,1136924,1,49230,4.20%
Kitsap,5/1/15,53035,5,2015,114610,108071,1,6539,5.70%
Kittitas,5/1/15,53037,5,2015,21133,19836,1,1297,6.10%
Klickitat,5/1/15,53039,5,2015,9485,8798,1,687,7.20%
Lewis,5/1/15,53041,5,2015,31264,28576,1,2688,8.60%
Lincoln,5/1/15,53043,5,2015,4961,4693,1,268,5.40%
Mason,5/1/15,53045,5,2015,22886,21145,1,1741,7.60%
Okanogan,5/1/15,53047,5,2015,21246,19894,1,1352,6.40%
Pacific,5/1/15,53049,5,2015,8163,7441,1,722,8.80%
Pend Oreille,5/1/15,53051,5,2015,4580,4162,1,418,9.10%
Pierce,5/1/15,53053,5,2015,389606,363920,1,25686,6.60%
San Juan,5/1/15,53055,5,2015,7734,7378,1,356,4.60%
Skagit,5/1/15,53057,5,2015,56589,52806,1,3783,6.70%
Skamania,5/1/15,53059,5,2015,4920,4564,1,356,7.20%
Snohomish,5/1/15,53061,5,2015,404060,385970,1,18090,4.50%
Spokane,5/1/15,53063,5,2015,227117,212677,1,14440,6.40%
Stevens,5/1/15,53065,5,2015,17432,15928,1,1504,8.60%
Thurston,5/1/15,53067,5,2015,125036,117521,1,7515,6.00%
Wahkiakum,5/1/15,53069,5,2015,1285,1168,1,117,9.10%
Walla Walla,5/1/15,53071,5,2015,28413,26782,1,1631,5.70%
Whatcom,5/1/15,53073,5,2015,103877,97768,1,6109,5.90%
Whitman,5/1/15,53075,5,2015,23778,22658,1,1120,4.70%
Yakima,5/1/15,53077,5,2015,119787,110228,1,9559,8.00%
Adams,5/1/16,53001,5,2016,8860,8387,1,473,5.30%
Asotin,5/1/16,53003,5,2016,9816,9368,1,448,4.60%
Clallam,5/1/16,53009,5,2016,27212,25157,1,2055,7.60%
Clark,5/1/16,53011,5,2016,218163,205220,1,12943,5.90%
Columbia,5/1/16,53013,5,2016,1709,1606,1,103,6.00%
Cowlitz,5/1/16,53015,5,2016,44471,41373,1,3098,7.00%
Douglas,5/1/16,53017,5,2016,20199,18792,1,1407,7.00%
Ferry,5/1/16,53019,5,2016,2478,2252,1,226,9.10%
Franklin,5/1/16,53021,5,2016,40457,37731,1,2726,6.70%
Garfield,5/1/16,53023,5,2016,914,866,1,48,5.30%
Grant,5/1/16,53025,5,2016,44407,41630,1,2777,6.30%
Grays Harbor,5/1/16,53027,5,2016,27024,24873,1,2151,8.00%
Island,5/1/16,53029,5,2016,32362,30518,1,1844,5.70%
Jefferson,5/1/16,53031,5,2016,11423,10637,1,786,6.90%
King,5/1/16,53033,5,2016,1212287,1167074,1,45213,3.70%
Kitsap,5/1/16,53035,5,2016,117295,110819,1,6476,5.50%
Kittitas,5/1/16,53037,5,2016,21640,20438,1,1202,5.60%
Klickitat,5/1/16,53039,5,2016,9717,9065,1,652,6.70%
Lewis,5/1/16,53041,5,2016,31739,29358,1,2381,7.50%
Lincoln,5/1/16,53043,5,2016,4908,4662,1,246,5.00%
Mason,5/1/16,53045,5,2016,23149,21484,1,1665,7.20%
Okanogan,5/1/16,53047,5,2016,21225,19994,1,1231,5.80%
Pacific,5/1/16,53049,5,2016,8163,7527,1,636,7.80%
Pend Oreille,5/1/16,53051,5,2016,4596,4223,1,373,8.10%
Pierce,5/1/16,53053,5,2016,399347,375822,1,23525,5.90%
San Juan,5/1/16,53055,5,2016,7871,7520,1,351,4.50%
Skagit,5/1/16,53057,5,2016,57089,53529,1,3560,6.20%
Skamania,5/1/16,53059,5,2016,4993,4679,1,314,6.30%
Snohomish,5/1/16,53061,5,2016,414764,397882,1,16882,4.10%
Spokane,5/1/16,53063,5,2016,231626,218253,1,13373,5.80%
Stevens,5/1/16,53065,5,2016,17654,16337,1,1317,7.50%
Thurston,5/1/16,53067,5,2016,128011,120915,1,7096,5.50%
Wahkiakum,5/1/16,53069,5,2016,1267,1165,1,102,8.10%
Walla Walla,5/1/16,53071,5,2016,28595,27178,1,1417,5.00%
Whatcom,5/1/16,53073,5,2016,105868,99955,1,5913,5.60%
Whitman,5/1/16,53075,5,2016,24001,22886,1,1115,4.60%
Yakima,5/1/16,53077,5,2016,123805,114897,1,8908,7.20%
Adams,5/1/17,53001,5,2017,8850,8409,1,441,5.00%
Asotin,5/1/17,53003,5,2017,10211,9806,1,405,4.00%
Clallam,5/1/17,53009,5,2017,27728,25914,1,1814,6.50%
Clark,5/1/17,53011,5,2017,226080,214902,1,11178,4.90%
Columbia,5/1/17,53013,5,2017,1773,1681,1,92,5.20%
Cowlitz,5/1/17,53015,5,2017,45593,42913,1,2680,5.90%
Douglas,5/1/17,53017,5,2017,20627,19451,1,1176,5.70%
Ferry,5/1/17,53019,5,2017,2476,2226,1,250,10.10%
Franklin,5/1/17,53021,5,2017,40812,38523,1,2289,5.60%
Garfield,5/1/17,53023,5,2017,893,854,1,39,4.40%
Grant,5/1/17,53025,5,2017,44442,41953,1,2489,5.60%
Grays Harbor,5/1/17,53027,5,2017,27833,25908,1,1925,6.90%
Island,5/1/17,53029,5,2017,33876,32183,1,1693,5.00%
Jefferson,5/1/17,53031,5,2017,11842,11146,1,696,5.90%
King,5/1/17,53033,5,2017,1236501,1195103,1,41398,3.30%
Kitsap,5/1/17,53035,5,2017,119615,113884,1,5731,4.80%
Kittitas,5/1/17,53037,5,2017,23187,22100,1,1087,4.70%
Klickitat,5/1/17,53039,5,2017,9840,9243,1,597,6.10%
Lewis,5/1/17,53041,5,2017,32778,30695,1,2083,6.40%
Lincoln,5/1/17,53043,5,2017,4972,4748,1,224,4.50%
Mason,5/1/17,53045,5,2017,23418,21880,1,1538,6.60%
Okanogan,5/1/17,53047,5,2017,20186,18777,1,1409,7.00%
Pacific,5/1/17,53049,5,2017,8290,7699,1,591,7.10%
Pend Oreille,5/1/17,53051,5,2017,4707,4381,1,326,6.90%
Pierce,5/1/17,53053,5,2017,412575,390698,1,21877,5.30%
San Juan,5/1/17,53055,5,2017,8165,7867,1,298,3.60%
Skagit,5/1/17,53057,5,2017,58939,55843,1,3096,5.30%
Skamania,5/1/17,53059,5,2017,5226,4936,1,290,5.50%
Snohomish,5/1/17,53061,5,2017,423175,407479,1,15696,3.70%
Spokane,5/1/17,53063,5,2017,238199,226151,1,12048,5.10%
Stevens,5/1/17,53065,5,2017,18070,16819,1,1251,6.90%
Thurston,5/1/17,53067,5,2017,133010,126590,1,6420,4.80%
Wahkiakum,5/1/17,53069,5,2017,1302,1213,1,89,6.80%
Walla Walla,5/1/17,53071,5,2017,28699,27407,1,1292,4.50%
Whatcom,5/1/17,53073,5,2017,109439,104227,1,5212,4.80%
Whitman,5/1/17,53075,5,2017,24505,23547,1,958,3.90%
Yakima,5/1/17,53077,5,2017,122886,115109,1,7777,6.30%
Adams,5/1/18,53001,5,2018,9699,9286,1,413,4.30%
Asotin,5/1/18,53003,5,2018,10168,9766,1,402,4.00%
Clallam,5/1/18,53009,5,2018,28092,26449,1,1643,5.80%
Clark,5/1/18,53011,5,2018,230346,219801,1,10545,4.60%
Columbia,5/1/18,53013,5,2018,1776,1689,1,87,4.90%
Cowlitz,5/1/18,53015,5,2018,45890,43309,1,2581,5.60%
Douglas,5/1/18,53017,5,2018,21257,20221,1,1036,4.90%
Ferry,5/1/18,53019,5,2018,2468,2176,1,292,11.80%
Franklin,5/1/18,53021,5,2018,42577,40378,1,2199,5.20%
Garfield,5/1/18,53023,5,2018,908,861,1,47,5.20%
Grant,5/1/18,53025,5,2018,45898,43219,1,2679,5.80%
Grays Harbor,5/1/18,53027,5,2018,28240,26456,1,1784,6.30%
Island,5/1/18,53029,5,2018,34453,32717,1,1736,5.00%
Jefferson,5/1/18,53031,5,2018,12088,11409,1,679,5.60%
King,5/1/18,53033,5,2018,1262355,1224835,1,37520,3.00%
Kitsap,5/1/18,53035,5,2018,121998,116611,1,5387,4.40%
Kittitas,5/1/18,53037,5,2018,22340,21262,1,1078,4.80%
Klickitat,5/1/18,53039,5,2018,10237,9650,1,587,5.70%
Lewis,5/1/18,53041,5,2018,33651,31648,1,2003,6.00%
Lincoln,5/1/18,53043,5,2018,5122,4891,1,231,4.50%
Mason,5/1/18,53045,5,2018,24138,22677,1,1461,6.10%
Okanogan,5/1/18,53047,5,2018,20258,19089,1,1169,5.80%
Pacific,5/1/18,53049,5,2018,8378,7845,1,533,6.40%
Pend Oreille,5/1/18,53051,5,2018,4795,4494,1,301,6.30%
Pierce,5/1/18,53053,5,2018,421223,400112,1,21111,5.00%
San Juan,5/1/18,53055,5,2018,8169,7868,1,301,3.70%
Skagit,5/1/18,53057,5,2018,60022,57137,1,2885,4.80%
Skamania,5/1/18,53059,5,2018,5275,5013,1,262,5.00%
Snohomish,5/1/18,53061,5,2018,429997,416186,1,13811,3.20%
Spokane,5/1/18,53063,5,2018,243387,231845,1,11542,4.70%
Stevens,5/1/18,53065,5,2018,18283,17081,1,1202,6.60%
Thurston,5/1/18,53067,5,2018,137030,130817,1,6213,4.50%
Wahkiakum,5/1/18,53069,5,2018,1309,1228,1,81,6.20%
Walla Walla,5/1/18,53071,5,2018,28851,27633,1,1218,4.20%
Whatcom,5/1/18,53073,5,2018,110929,106074,1,4855,4.40%
Whitman,5/1/18,53075,5,2018,23127,22191,1,936,4.00%
Yakima,5/1/18,53077,5,2018,127025,119707,1,7318,5.80%
Adams,5/1/19,53001,5,2019,10022,9546,1,476,4.70%
Asotin,5/1/19,53003,5,2019,10271,9872,1,399,3.90%
Clallam,5/1/19,53009,5,2019,28618,26881,1,1737,6.10%
Clark,5/1/19,53011,5,2019,239246,228001,1,11245,4.70%
Columbia,5/1/19,53013,5,2019,1849,1754,1,95,5.10%
Cowlitz,5/1/19,53015,5,2019,47572,44682,1,2890,6.10%
Douglas,5/1/19,53017,5,2019,21608,20496,1,1112,5.10%
Ferry,5/1/19,53019,5,2019,2575,2318,1,257,10.00%
Franklin,5/1/19,53021,5,2019,43872,41440,1,2432,5.50%
Garfield,5/1/19,53023,5,2019,905,864,1,41,4.50%
Grant,5/1/19,53025,5,2019,46618,43699,1,2919,6.30%
Grays Harbor,5/1/19,53027,5,2019,28923,26947,1,1976,6.80%
Island,5/1/19,53029,5,2019,35691,33947,1,1744,4.90%
Jefferson,5/1/19,53031,5,2019,12674,11988,1,686,5.40%
King,5/1/19,53033,5,2019,1286119,1251636,1,34483,2.70%
Kitsap,5/1/19,53035,5,2019,127404,121653,1,5751,4.50%
Kittitas,5/1/19,53037,5,2019,23650,22499,1,1151,4.90%
Klickitat,5/1/19,53039,5,2019,10462,9893,1,569,5.40%
Lewis,5/1/19,53041,5,2019,34791,32769,1,2022,5.80%
Lincoln,5/1/19,53043,5,2019,5015,4792,1,223,4.40%
Mason,5/1/19,53045,5,2019,24801,23253,1,1548,6.20%
Okanogan,5/1/19,53047,5,2019,20034,18782,1,1252,6.20%
Pacific,5/1/19,53049,5,2019,8475,7888,1,587,6.90%
Pend Oreille,5/1/19,53051,5,2019,4998,4660,1,338,6.80%
Pierce,5/1/19,53053,5,2019,437533,415224,1,22309,5.10%
San Juan,5/1/19,53055,5,2019,8537,8230,1,307,3.60%
Skagit,5/1/19,53057,5,2019,62744,59463,1,3281,5.20%
Skamania,5/1/19,53059,5,2019,5482,5200,1,282,5.10%
Snohomish,5/1/19,53061,5,2019,437788,425237,1,12551,2.90%
Spokane,5/1/19,53063,5,2019,253402,240750,1,12652,5.00%
Stevens,5/1/19,53065,5,2019,18903,17714,1,1189,6.30%
Thurston,5/1/19,53067,5,2019,141359,134649,1,6710,4.70%
Wahkiakum,5/1/19,53069,5,2019,1370,1289,1,81,5.90%
Walla Walla,5/1/19,53071,5,2019,29812,28470,1,1342,4.50%
Whatcom,5/1/19,53073,5,2019,114936,109533,1,5403,4.70%
Whitman,5/1/19,53075,5,2019,23361,22400,1,961,4.10%
Yakima,5/1/19,53077,5,2019,130493,121637,1,8856,6.80%
Adams,5/1/20,53001,5,2020,9914,8709,1,1205,12.20%
Asotin,5/1/20,53003,5,2020,9631,8828,1,803,8.30%
Clallam,5/1/20,53009,5,2020,30881,25764,1,5117,16.60%
Clark,5/1/20,53011,5,2020,244152,209156,1,34996,14.30%
Columbia,5/1/20,53013,5,2020,1717,1536,1,181,10.50%
Cowlitz,5/1/20,53015,5,2020,49594,41912,1,7682,15.50%
Douglas,5/1/20,53017,5,2020,21103,18257,1,2846,13.50%
Ferry,5/1/20,53019,5,2020,2400,2016,1,384,16.00%
Franklin,5/1/20,53021,5,2020,44686,39174,1,5512,12.30%
Garfield,5/1/20,53023,5,2020,780,681,1,99,12.70%
Grant,5/1/20,53025,5,2020,48601,42558,1,6043,12.40%
Grays Harbor,5/1/20,53027,5,2020,31658,25548,1,6110,19.30%
Island,5/1/20,53029,5,2020,36351,31339,1,5012,13.80%
Jefferson,5/1/20,53031,5,2020,13607,11428,1,2179,16.00%
King,5/1/20,53033,5,2020,1265143,1083738,1,181405,14.30%
Kitsap,5/1/20,53035,5,2020,133610,115884,1,17726,13.30%
Kittitas,5/1/20,53037,5,2020,23437,20087,1,3350,14.30%
Klickitat,5/1/20,53039,5,2020,9997,8823,1,1174,11.70%
Lewis,5/1/20,53041,5,2020,36331,30604,1,5727,15.80%
Lincoln,5/1/20,53043,5,2020,4509,4062,1,447,9.90%
Mason,5/1/20,53045,5,2020,26917,22933,1,3984,14.80%
Okanogan,5/1/20,53047,5,2020,18939,16364,1,2575,13.60%
Pacific,5/1/20,53049,5,2020,9197,7640,1,1557,16.90%
Pend Oreille,5/1/20,53051,5,2020,4853,4133,1,720,14.80%
Pierce,5/1/20,53053,5,2020,461186,383335,1,77851,16.90%
San Juan,5/1/20,53055,5,2020,8084,6781,1,1303,16.10%
Skagit,5/1/20,53057,5,2020,64507,53805,1,10702,16.60%
Skamania,5/1/20,53059,5,2020,5541,4727,1,814,14.70%
Snohomish,5/1/20,53061,5,2020,438776,367867,1,70909,16.20%
Spokane,5/1/20,53063,5,2020,256298,217623,1,38675,15.10%
Stevens,5/1/20,53065,5,2020,18123,15664,1,2459,13.60%
Thurston,5/1/20,53067,5,2020,148138,126866,1,21272,14.40%
Wahkiakum,5/1/20,53069,5,2020,1396,1206,1,190,13.60%
Walla Walla,5/1/20,53071,5,2020,30434,27158,1,3276,10.80%
Whatcom,5/1/20,53073,5,2020,119541,100822,1,18719,15.70%
Whitman,5/1/20,53075,5,2020,22073,20368,1,1705,7.70%
Yakima,5/1/20,53077,5,2020,134980,116098,1,18882,14.00%
Adams,6/1/90,53001,6,1990,8506,7824,1,682,8.00%
Asotin,6/1/90,53003,6,1990,9363,8907,1,456,4.90%
Clallam,6/1/90,53009,6,1990,22936,21778,1,1158,5.00%
Columbia,6/1/90,53013,6,1990,2057,1960,1,97,4.70%
Cowlitz,6/1/90,53015,6,1990,37382,35148,1,2234,6.00%
Douglas,6/1/90,53017,6,1990,17604,16376,1,1228,7.00%
Ferry,6/1/90,53019,6,1990,2862,2547,1,315,11.00%
Franklin,6/1/90,53021,6,1990,20836,19140,1,1696,8.10%
Garfield,6/1/90,53023,6,1990,1120,1105,1,15,1.30%
Grant,6/1/90,53025,6,1990,28648,26474,1,2174,7.60%
Grays Harbor,6/1/90,53027,6,1990,27180,25098,1,2082,7.70%
Island,6/1/90,53029,6,1990,22576,21844,1,732,3.20%
Jefferson,6/1/90,53031,6,1990,8435,8129,1,306,3.60%
King,6/1/90,53033,6,1990,871968,838851,1,33117,3.80%
Kitsap,6/1/90,53035,6,1990,83115,79739,1,3376,4.10%
Kittitas,6/1/90,53037,6,1990,12503,11574,1,929,7.40%
Klickitat,6/1/90,53039,6,1990,8017,7227,1,790,9.90%
Lewis,6/1/90,53041,6,1990,26096,24331,1,1765,6.80%
Lincoln,6/1/90,53043,6,1990,4323,4191,1,132,3.10%
Mason,6/1/90,53045,6,1990,15689,14876,1,813,5.20%
Okanogan,6/1/90,53047,6,1990,19518,18006,1,1512,7.70%
Pacific,6/1/90,53049,6,1990,7556,7101,1,455,6.00%
Pend Oreille,6/1/90,53051,6,1990,3500,3056,1,444,12.70%
Pierce,6/1/90,53053,6,1990,271434,258949,1,12485,4.60%
San Juan,6/1/90,53055,6,1990,5310,5200,1,110,2.10%
Skagit,6/1/90,53057,6,1990,39113,36983,1,2130,5.40%
Skamania,6/1/90,53059,6,1990,3778,3459,1,319,8.40%
Snohomish,6/1/90,53061,6,1990,253217,243119,1,10098,4.00%
Spokane,6/1/90,53063,6,1990,170343,161542,1,8801,5.20%
Stevens,6/1/90,53065,6,1990,13254,12185,1,1069,8.10%
Thurston,6/1/90,53067,6,1990,79547,75820,1,3727,4.70%
Wahkiakum,6/1/90,53069,6,1990,1571,1507,1,64,4.10%
Walla Walla,6/1/90,53071,6,1990,23996,22898,1,1098,4.60%
Whatcom,6/1/90,53073,6,1990,68014,65099,1,2915,4.30%
Whitman,6/1/90,53075,6,1990,15536,15267,1,269,1.70%
Yakima,6/1/90,53077,6,1990,113972,104865,1,9107,8.00%
Adams,6/1/91,53001,6,1991,8423,7727,1,696,8.30%
Asotin,6/1/91,53003,6,1991,9406,8870,1,536,5.70%
Clallam,6/1/91,53009,6,1991,22885,21286,1,1599,7.00%
Columbia,6/1/91,53013,6,1991,1907,1778,1,129,6.80%
Cowlitz,6/1/91,53015,6,1991,38904,35863,1,3041,7.80%
Douglas,6/1/91,53017,6,1991,17044,15611,1,1433,8.40%
Ferry,6/1/91,53019,6,1991,2874,2524,1,350,12.20%
Franklin,6/1/91,53021,6,1991,20885,19248,1,1637,7.80%
Garfield,6/1/91,53023,6,1991,1138,1121,1,17,1.50%
Grant,6/1/91,53025,6,1991,30053,27464,1,2589,8.60%
Grays Harbor,6/1/91,53027,6,1991,27312,24483,1,2829,10.40%
Island,6/1/91,53029,6,1991,22727,21730,1,997,4.40%
Jefferson,6/1/91,53031,6,1991,8335,7894,1,441,5.30%
King,6/1/91,53033,6,1991,871961,829724,1,42237,4.80%
Kitsap,6/1/91,53035,6,1991,85800,81374,1,4426,5.20%
Kittitas,6/1/91,53037,6,1991,13018,11783,1,1235,9.50%
Klickitat,6/1/91,53039,6,1991,8023,7004,1,1019,12.70%
Lewis,6/1/91,53041,6,1991,26112,23530,1,2582,9.90%
Lincoln,6/1/91,53043,6,1991,4288,4136,1,152,3.50%
Mason,6/1/91,53045,6,1991,15629,14442,1,1187,7.60%
Okanogan,6/1/91,53047,6,1991,20753,18832,1,1921,9.30%
Pacific,6/1/91,53049,6,1991,7785,7121,1,664,8.50%
Pend Oreille,6/1/91,53051,6,1991,3565,3123,1,442,12.40%
Pierce,6/1/91,53053,6,1991,274787,257158,1,17629,6.40%
San Juan,6/1/91,53055,6,1991,5687,5527,1,160,2.80%
Skagit,6/1/91,53057,6,1991,39977,36651,1,3326,8.30%
Skamania,6/1/91,53059,6,1991,4196,3718,1,478,11.40%
Snohomish,6/1/91,53061,6,1991,258238,244346,1,13892,5.40%
Spokane,6/1/91,53063,6,1991,175325,165067,1,10258,5.90%
Stevens,6/1/91,53065,6,1991,14007,12817,1,1190,8.50%
Thurston,6/1/91,53067,6,1991,81846,77079,1,4767,5.80%
Wahkiakum,6/1/91,53069,6,1991,1483,1420,1,63,4.20%
Walla Walla,6/1/91,53071,6,1991,23738,22427,1,1311,5.50%
Whatcom,6/1/91,53073,6,1991,69054,64580,1,4474,6.50%
Whitman,6/1/91,53075,6,1991,15542,15244,1,298,1.90%
Yakima,6/1/91,53077,6,1991,108770,97010,1,11760,10.80%
Adams,6/1/92,53001,6,1992,8631,7806,1,825,9.60%
Asotin,6/1/92,53003,6,1992,9815,9224,1,591,6.00%
Clallam,6/1/92,53009,6,1992,23039,21250,1,1789,7.80%
Columbia,6/1/92,53013,6,1992,1813,1682,1,131,7.20%
Cowlitz,6/1/92,53015,6,1992,37137,33123,1,4014,10.80%
Douglas,6/1/92,53017,6,1992,19026,17618,1,1408,7.40%
Ferry,6/1/92,53019,6,1992,2755,2396,1,359,13.00%
Franklin,6/1/92,53021,6,1992,22414,20709,1,1705,7.60%
Garfield,6/1/92,53023,6,1992,1101,1076,1,25,2.30%
Grant,6/1/92,53025,6,1992,31680,28660,1,3020,9.50%
Grays Harbor,6/1/92,53027,6,1992,27685,24396,1,3289,11.90%
Island,6/1/92,53029,6,1992,23382,21967,1,1415,6.10%
Jefferson,6/1/92,53031,6,1992,8456,7753,1,703,8.30%
King,6/1/92,53033,6,1992,909099,853672,1,55427,6.10%
Kitsap,6/1/92,53035,6,1992,85987,80607,1,5380,6.30%
Kittitas,6/1/92,53037,6,1992,13580,11836,1,1744,12.80%
Klickitat,6/1/92,53039,6,1992,8376,7375,1,1001,12.00%
Lewis,6/1/92,53041,6,1992,26598,23751,1,2847,10.70%
Lincoln,6/1/92,53043,6,1992,4401,4202,1,199,4.50%
Mason,6/1/92,53045,6,1992,15477,14163,1,1314,8.50%
Okanogan,6/1/92,53047,6,1992,22123,20033,1,2090,9.40%
Pacific,6/1/92,53049,6,1992,7622,6881,1,741,9.70%
Pend Oreille,6/1/92,53051,6,1992,3678,3203,1,475,12.90%
Pierce,6/1/92,53053,6,1992,278798,257411,1,21387,7.70%
San Juan,6/1/92,53055,6,1992,5590,5303,1,287,5.10%
Skagit,6/1/92,53057,6,1992,41660,37589,1,4071,9.80%
Skamania,6/1/92,53059,6,1992,3845,3171,1,674,17.50%
Snohomish,6/1/92,53061,6,1992,273180,255642,1,17538,6.40%
Spokane,6/1/92,53063,6,1992,175752,164001,1,11751,6.70%
Stevens,6/1/92,53065,6,1992,14777,13058,1,1719,11.60%
Thurston,6/1/92,53067,6,1992,83709,78115,1,5594,6.70%
Wahkiakum,6/1/92,53069,6,1992,1572,1469,1,103,6.60%
Walla Walla,6/1/92,53071,6,1992,24647,23175,1,1472,6.00%
Whatcom,6/1/92,53073,6,1992,71395,65764,1,5631,7.90%
Whitman,6/1/92,53075,6,1992,15078,14671,1,407,2.70%
Yakima,6/1/92,53077,6,1992,122222,109779,1,12443,10.20%
Adams,6/1/93,53001,6,1993,8761,7719,1,1042,11.90%
Asotin,6/1/93,53003,6,1993,10073,9488,1,585,5.80%
Clallam,6/1/93,53009,6,1993,23704,21757,1,1947,8.20%
Columbia,6/1/93,53013,6,1993,2028,1871,1,157,7.70%
Cowlitz,6/1/93,53015,6,1993,38061,34117,1,3944,10.40%
Douglas,6/1/93,53017,6,1993,19042,17628,1,1414,7.40%
Ferry,6/1/93,53019,6,1993,2758,2383,1,375,13.60%
Franklin,6/1/93,53021,6,1993,23312,21524,1,1788,7.70%
Garfield,6/1/93,53023,6,1993,1153,1104,1,49,4.20%
Grant,6/1/93,53025,6,1993,33389,30257,1,3132,9.40%
Grays Harbor,6/1/93,53027,6,1993,27800,23829,1,3971,14.30%
Island,6/1/93,53029,6,1993,23443,22294,1,1149,4.90%
Jefferson,6/1/93,53031,6,1993,9327,8668,1,659,7.10%
King,6/1/93,53033,6,1993,912062,853920,1,58142,6.40%
Kitsap,6/1/93,53035,6,1993,87152,80973,1,6179,7.10%
Kittitas,6/1/93,53037,6,1993,13488,12111,1,1377,10.20%
Klickitat,6/1/93,53039,6,1993,8309,7183,1,1126,13.60%
Lewis,6/1/93,53041,6,1993,27470,24657,1,2813,10.20%
Lincoln,6/1/93,53043,6,1993,4633,4402,1,231,5.00%
Mason,6/1/93,53045,6,1993,16060,14467,1,1593,9.90%
Okanogan,6/1/93,53047,6,1993,23430,21247,1,2183,9.30%
Pacific,6/1/93,53049,6,1993,7991,7197,1,794,9.90%
Pend Oreille,6/1/93,53051,6,1993,3923,3421,1,502,12.80%
Pierce,6/1/93,53053,6,1993,287837,266213,1,21624,7.50%
San Juan,6/1/93,53055,6,1993,5710,5356,1,354,6.20%
Skagit,6/1/93,53057,6,1993,43883,39181,1,4702,10.70%
Skamania,6/1/93,53059,6,1993,4138,3577,1,561,13.60%
Snohomish,6/1/93,53061,6,1993,278186,259565,1,18621,6.70%
Spokane,6/1/93,53063,6,1993,181505,171512,1,9993,5.50%
Stevens,6/1/93,53065,6,1993,15610,14135,1,1475,9.40%
Thurston,6/1/93,53067,6,1993,86739,80835,1,5904,6.80%
Wahkiakum,6/1/93,53069,6,1993,1708,1569,1,139,8.10%
Walla Walla,6/1/93,53071,6,1993,25537,24334,1,1203,4.70%
Whatcom,6/1/93,53073,6,1993,74419,68925,1,5494,7.40%
Whitman,6/1/93,53075,6,1993,15654,15241,1,413,2.60%
Yakima,6/1/93,53077,6,1993,121708,106879,1,14829,12.20%
Adams,6/1/94,53001,6,1994,9122,8363,1,759,8.30%
Asotin,6/1/94,53003,6,1994,10634,10265,1,369,3.50%
Clallam,6/1/94,53009,6,1994,23045,20664,1,2381,10.30%
Columbia,6/1/94,53013,6,1994,1921,1813,1,108,5.60%
Cowlitz,6/1/94,53015,6,1994,38243,34912,1,3331,8.70%
Douglas,6/1/94,53017,6,1994,20873,19548,1,1325,6.30%
Ferry,6/1/94,53019,6,1994,2911,2588,1,323,11.10%
Franklin,6/1/94,53021,6,1994,23740,22309,1,1431,6.00%
Garfield,6/1/94,53023,6,1994,1079,1044,1,35,3.20%
Grant,6/1/94,53025,6,1994,34555,31548,1,3007,8.70%
Grays Harbor,6/1/94,53027,6,1994,27082,23604,1,3478,12.80%
Island,6/1/94,53029,6,1994,23768,22577,1,1191,5.00%
Jefferson,6/1/94,53031,6,1994,9251,8462,1,789,8.50%
King,6/1/94,53033,6,1994,898490,852268,1,46222,5.10%
Kitsap,6/1/94,53035,6,1994,86957,81505,1,5452,6.30%
Kittitas,6/1/94,53037,6,1994,13861,12675,1,1186,8.60%
Klickitat,6/1/94,53039,6,1994,8338,7389,1,949,11.40%
Lewis,6/1/94,53041,6,1994,27869,25365,1,2504,9.00%
Lincoln,6/1/94,53043,6,1994,4531,4313,1,218,4.80%
Mason,6/1/94,53045,6,1994,16475,14937,1,1538,9.30%
Okanogan,6/1/94,53047,6,1994,24163,22249,1,1914,7.90%
Pacific,6/1/94,53049,6,1994,8004,7083,1,921,11.50%
Pend Oreille,6/1/94,53051,6,1994,3751,3328,1,423,11.30%
Pierce,6/1/94,53053,6,1994,295559,274745,1,20814,7.00%
San Juan,6/1/94,53055,6,1994,5587,5289,1,298,5.30%
Skagit,6/1/94,53057,6,1994,47845,43373,1,4472,9.30%
Skamania,6/1/94,53059,6,1994,3973,3596,1,377,9.50%
Snohomish,6/1/94,53061,6,1994,279851,262916,1,16935,6.10%
Spokane,6/1/94,53063,6,1994,186274,177068,1,9206,4.90%
Stevens,6/1/94,53065,6,1994,16127,14796,1,1331,8.30%
Thurston,6/1/94,53067,6,1994,88016,82264,1,5752,6.50%
Wahkiakum,6/1/94,53069,6,1994,1693,1500,1,193,11.40%
Walla Walla,6/1/94,53071,6,1994,25681,24686,1,995,3.90%
Whatcom,6/1/94,53073,6,1994,75941,69985,1,5956,7.80%
Whitman,6/1/94,53075,6,1994,15982,15626,1,356,2.20%
Yakima,6/1/94,53077,6,1994,123676,111860,1,11816,9.60%
Adams,6/1/95,53001,6,1995,9150,8321,1,829,9.10%
Asotin,6/1/95,53003,6,1995,11141,10582,1,559,5.00%
Clallam,6/1/95,53009,6,1995,24353,22421,1,1932,7.90%
Columbia,6/1/95,53013,6,1995,1864,1730,1,134,7.20%
Cowlitz,6/1/95,53015,6,1995,40598,37601,1,2997,7.40%
Douglas,6/1/95,53017,6,1995,19826,18573,1,1253,6.30%
Ferry,6/1/95,53019,6,1995,2958,2601,1,357,12.10%
Franklin,6/1/95,53021,6,1995,24974,22981,1,1993,8.00%
Garfield,6/1/95,53023,6,1995,1069,1033,1,36,3.40%
Grant,6/1/95,53025,6,1995,37097,33968,1,3129,8.40%
Grays Harbor,6/1/95,53027,6,1995,27703,24751,1,2952,10.70%
Island,6/1/95,53029,6,1995,25020,24028,1,992,4.00%
Jefferson,6/1/95,53031,6,1995,9871,9210,1,661,6.70%
King,6/1/95,53033,6,1995,910101,862059,1,48042,5.30%
Kitsap,6/1/95,53035,6,1995,88962,82786,1,6176,6.90%
Kittitas,6/1/95,53037,6,1995,14795,13605,1,1190,8.00%
Klickitat,6/1/95,53039,6,1995,9076,8039,1,1037,11.40%
Lewis,6/1/95,53041,6,1995,29837,27155,1,2682,9.00%
Lincoln,6/1/95,53043,6,1995,4967,4692,1,275,5.50%
Mason,6/1/95,53045,6,1995,17775,16324,1,1451,8.20%
Okanogan,6/1/95,53047,6,1995,24457,22228,1,2229,9.10%
Pacific,6/1/95,53049,6,1995,8306,7575,1,731,8.80%
Pend Oreille,6/1/95,53051,6,1995,4120,3565,1,555,13.50%
Pierce,6/1/95,53053,6,1995,311633,291242,1,20391,6.50%
San Juan,6/1/95,53055,6,1995,6004,5715,1,289,4.80%
Skagit,6/1/95,53057,6,1995,49612,45386,1,4226,8.50%
Skamania,6/1/95,53059,6,1995,4202,3762,1,440,10.50%
Snohomish,6/1/95,53061,6,1995,284039,268227,1,15812,5.60%
Spokane,6/1/95,53063,6,1995,197009,186527,1,10482,5.30%
Stevens,6/1/95,53065,6,1995,16963,15358,1,1605,9.50%
Thurston,6/1/95,53067,6,1995,93428,87536,1,5892,6.30%
Wahkiakum,6/1/95,53069,6,1995,1693,1582,1,111,6.60%
Walla Walla,6/1/95,53071,6,1995,26987,25738,1,1249,4.60%
Whatcom,6/1/95,53073,6,1995,79855,74063,1,5792,7.30%
Whitman,6/1/95,53075,6,1995,16233,15860,1,373,2.30%
Yakima,6/1/95,53077,6,1995,125172,111635,1,13537,10.80%
Adams,6/1/96,53001,6,1996,9647,8649,1,998,10.30%
Asotin,6/1/96,53003,6,1996,11849,11362,1,487,4.10%
Clallam,6/1/96,53009,6,1996,25087,22836,1,2251,9.00%
Columbia,6/1/96,53013,6,1996,1382,1214,1,168,12.20%
Cowlitz,6/1/96,53015,6,1996,41434,38088,1,3346,8.10%
Douglas,6/1/96,53017,6,1996,20070,18600,1,1470,7.30%
Ferry,6/1/96,53019,6,1996,2931,2594,1,337,11.50%
Franklin,6/1/96,53021,6,1996,24622,22130,1,2492,10.10%
Garfield,6/1/96,53023,6,1996,1155,1119,1,36,3.10%
Grant,6/1/96,53025,6,1996,38302,35160,1,3142,8.20%
Grays Harbor,6/1/96,53027,6,1996,27886,24796,1,3090,11.10%
Island,6/1/96,53029,6,1996,26122,24940,1,1182,4.50%
Jefferson,6/1/96,53031,6,1996,10224,9528,1,696,6.80%
King,6/1/96,53033,6,1996,931141,887418,1,43723,4.70%
Kitsap,6/1/96,53035,6,1996,93940,88241,1,5699,6.10%
Kittitas,6/1/96,53037,6,1996,14789,13735,1,1054,7.10%
Klickitat,6/1/96,53039,6,1996,9136,8107,1,1029,11.30%
Lewis,6/1/96,53041,6,1996,30740,27957,1,2783,9.10%
Lincoln,6/1/96,53043,6,1996,5226,5004,1,222,4.20%
Mason,6/1/96,53045,6,1996,19101,17736,1,1365,7.10%
Okanogan,6/1/96,53047,6,1996,24854,22742,1,2112,8.50%
Pacific,6/1/96,53049,6,1996,8456,7727,1,729,8.60%
Pend Oreille,6/1/96,53051,6,1996,4177,3613,1,564,13.50%
Pierce,6/1/96,53053,6,1996,318203,299597,1,18606,5.80%
San Juan,6/1/96,53055,6,1996,6120,5845,1,275,4.50%
Skagit,6/1/96,53057,6,1996,47189,43163,1,4026,8.50%
Skamania,6/1/96,53059,6,1996,4165,3756,1,409,9.80%
Snohomish,6/1/96,53061,6,1996,293823,279308,1,14515,4.90%
Spokane,6/1/96,53063,6,1996,204933,194895,1,10038,4.90%
Stevens,6/1/96,53065,6,1996,17518,15901,1,1617,9.20%
Thurston,6/1/96,53067,6,1996,97686,92023,1,5663,5.80%
Wahkiakum,6/1/96,53069,6,1996,1746,1635,1,111,6.40%
Walla Walla,6/1/96,53071,6,1996,27320,25839,1,1481,5.40%
Whatcom,6/1/96,53073,6,1996,79389,73922,1,5467,6.90%
Whitman,6/1/96,53075,6,1996,17098,16700,1,398,2.30%
Yakima,6/1/96,53077,6,1996,124208,110440,1,13768,11.10%
Adams,6/1/97,53001,6,1997,9402,8667,1,735,7.80%
Asotin,6/1/97,53003,6,1997,12143,11785,1,358,2.90%
Clallam,6/1/97,53009,6,1997,25025,23283,1,1742,7.00%
Columbia,6/1/97,53013,6,1997,1966,1846,1,120,6.10%
Cowlitz,6/1/97,53015,6,1997,41847,39007,1,2840,6.80%
Douglas,6/1/97,53017,6,1997,20566,19448,1,1118,5.40%
Ferry,6/1/97,53019,6,1997,2921,2652,1,269,9.20%
Franklin,6/1/97,53021,6,1997,24388,22556,1,1832,7.50%
Garfield,6/1/97,53023,6,1997,1136,1104,1,32,2.80%
Grant,6/1/97,53025,6,1997,39917,37325,1,2592,6.50%
Grays Harbor,6/1/97,53027,6,1997,28343,25883,1,2460,8.70%
Island,6/1/97,53029,6,1997,27890,27059,1,831,3.00%
Jefferson,6/1/97,53031,6,1997,10191,9586,1,605,5.90%
King,6/1/97,53033,6,1997,968043,928400,1,39643,4.10%
Kitsap,6/1/97,53035,6,1997,93901,88846,1,5055,5.40%
Kittitas,6/1/97,53037,6,1997,15253,14493,1,760,5.00%
Klickitat,6/1/97,53039,6,1997,9677,8740,1,937,9.70%
Lewis,6/1/97,53041,6,1997,32265,29834,1,2431,7.50%
Lincoln,6/1/97,53043,6,1997,5230,5047,1,183,3.50%
Mason,6/1/97,53045,6,1997,19639,18353,1,1286,6.50%
Okanogan,6/1/97,53047,6,1997,24892,23006,1,1886,7.60%
Pacific,6/1/97,53049,6,1997,8954,8243,1,711,7.90%
Pend Oreille,6/1/97,53051,6,1997,4310,3850,1,460,10.70%
Pierce,6/1/97,53053,6,1997,330026,315419,1,14607,4.40%
San Juan,6/1/97,53055,6,1997,6299,6057,1,242,3.80%
Skagit,6/1/97,53057,6,1997,48531,45252,1,3279,6.80%
Skamania,6/1/97,53059,6,1997,4225,3832,1,393,9.30%
Snohomish,6/1/97,53061,6,1997,312956,300411,1,12545,4.00%
Spokane,6/1/97,53063,6,1997,206859,198263,1,8596,4.20%
Stevens,6/1/97,53065,6,1997,17729,16255,1,1474,8.30%
Thurston,6/1/97,53067,6,1997,100042,95186,1,4856,4.90%
Wahkiakum,6/1/97,53069,6,1997,1850,1744,1,106,5.70%
Walla Walla,6/1/97,53071,6,1997,28337,27043,1,1294,4.60%
Whatcom,6/1/97,53073,6,1997,79863,75378,1,4485,5.60%
Whitman,6/1/97,53075,6,1997,17335,17018,1,317,1.80%
Yakima,6/1/97,53077,6,1997,127822,117587,1,10235,8.00%
Adams,6/1/98,53001,6,1998,9884,9134,1,750,7.60%
Asotin,6/1/98,53003,6,1998,12712,12258,1,454,3.60%
Clallam,6/1/98,53009,6,1998,25273,23535,1,1738,6.90%
Columbia,6/1/98,53013,6,1998,2014,1894,1,120,6.00%
Cowlitz,6/1/98,53015,6,1998,42487,39222,1,3265,7.70%
Douglas,6/1/98,53017,6,1998,22031,20792,1,1239,5.60%
Ferry,6/1/98,53019,6,1998,2821,2562,1,259,9.20%
Franklin,6/1/98,53021,6,1998,24771,23079,1,1692,6.80%
Garfield,6/1/98,53023,6,1998,1190,1155,1,35,2.90%
Grant,6/1/98,53025,6,1998,41348,38430,1,2918,7.10%
Grays Harbor,6/1/98,53027,6,1998,26774,24308,1,2466,9.20%
Island,6/1/98,53029,6,1998,29237,28374,1,863,3.00%
Jefferson,6/1/98,53031,6,1998,10449,9860,1,589,5.60%
King,6/1/98,53033,6,1998,980045,943690,1,36355,3.70%
Kitsap,6/1/98,53035,6,1998,93313,88797,1,4516,4.80%
Kittitas,6/1/98,53037,6,1998,15407,14703,1,704,4.60%
Klickitat,6/1/98,53039,6,1998,9591,8654,1,937,9.80%
Lewis,6/1/98,53041,6,1998,30976,28282,1,2694,8.70%
Lincoln,6/1/98,53043,6,1998,5282,5072,1,210,4.00%
Mason,6/1/98,53045,6,1998,20120,18872,1,1248,6.20%
Okanogan,6/1/98,53047,6,1998,25408,23092,1,2316,9.10%
Pacific,6/1/98,53049,6,1998,8675,7976,1,699,8.10%
Pend Oreille,6/1/98,53051,6,1998,4345,3884,1,461,10.60%
Pierce,6/1/98,53053,6,1998,339397,324914,1,14483,4.30%
San Juan,6/1/98,53055,6,1998,6616,6421,1,195,2.90%
Skagit,6/1/98,53057,6,1998,48981,45950,1,3031,6.20%
Skamania,6/1/98,53059,6,1998,4466,4077,1,389,8.70%
Snohomish,6/1/98,53061,6,1998,323432,311470,1,11962,3.70%
Spokane,6/1/98,53063,6,1998,211795,203248,1,8547,4.00%
Stevens,6/1/98,53065,6,1998,18119,16715,1,1404,7.70%
Thurston,6/1/98,53067,6,1998,103512,98909,1,4603,4.40%
Wahkiakum,6/1/98,53069,6,1998,1965,1860,1,105,5.30%
Walla Walla,6/1/98,53071,6,1998,28732,27411,1,1321,4.60%
Whatcom,6/1/98,53073,6,1998,81405,77256,1,4149,5.10%
Whitman,6/1/98,53075,6,1998,17626,17279,1,347,2.00%
Yakima,6/1/98,53077,6,1998,127404,117008,1,10396,8.20%
Adams,6/1/99,53001,6,1999,9370,8506,1,864,9.20%
Asotin,6/1/99,53003,6,1999,12867,12455,1,412,3.20%
Clallam,6/1/99,53009,6,1999,26822,25012,1,1810,6.70%
Columbia,6/1/99,53013,6,1999,2078,1925,1,153,7.40%
Cowlitz,6/1/99,53015,6,1999,43733,40506,1,3227,7.40%
Douglas,6/1/99,53017,6,1999,21122,19665,1,1457,6.90%
Ferry,6/1/99,53019,6,1999,2774,2512,1,262,9.40%
Franklin,6/1/99,53021,6,1999,25825,23103,1,2722,10.50%
Garfield,6/1/99,53023,6,1999,1226,1185,1,41,3.30%
Grant,6/1/99,53025,6,1999,41739,38042,1,3697,8.90%
Grays Harbor,6/1/99,53027,6,1999,27939,25610,1,2329,8.30%
Island,6/1/99,53029,6,1999,30811,29619,1,1192,3.90%
Jefferson,6/1/99,53031,6,1999,11762,11093,1,669,5.70%
King,6/1/99,53033,6,1999,981664,946311,1,35353,3.60%
Kitsap,6/1/99,53035,6,1999,99461,94262,1,5199,5.20%
Kittitas,6/1/99,53037,6,1999,15805,14963,1,842,5.30%
Klickitat,6/1/99,53039,6,1999,9450,8502,1,948,10.00%
Lewis,6/1/99,53041,6,1999,31654,28767,1,2887,9.10%
Lincoln,6/1/99,53043,6,1999,5191,4989,1,202,3.90%
Mason,6/1/99,53045,6,1999,20154,18876,1,1278,6.30%
Okanogan,6/1/99,53047,6,1999,22641,20708,1,1933,8.50%
Pacific,6/1/99,53049,6,1999,8505,7854,1,651,7.70%
Pend Oreille,6/1/99,53051,6,1999,4566,4146,1,420,9.20%
Pierce,6/1/99,53053,6,1999,349155,332402,1,16753,4.80%
San Juan,6/1/99,53055,6,1999,7450,7255,1,195,2.60%
Skagit,6/1/99,53057,6,1999,52803,49507,1,3296,6.20%
Skamania,6/1/99,53059,6,1999,4447,4081,1,366,8.20%
Snohomish,6/1/99,53061,6,1999,330534,316252,1,14282,4.30%
Spokane,6/1/99,53063,6,1999,221249,209338,1,11911,5.40%
Stevens,6/1/99,53065,6,1999,18014,16553,1,1461,8.10%
Thurston,6/1/99,53067,6,1999,106761,101768,1,4993,4.70%
Wahkiakum,6/1/99,53069,6,1999,1996,1873,1,123,6.20%
Walla Walla,6/1/99,53071,6,1999,29320,27621,1,1699,5.80%
Whatcom,6/1/99,53073,6,1999,86578,82400,1,4178,4.80%
Whitman,6/1/99,53075,6,1999,17838,17478,1,360,2.00%
Yakima,6/1/99,53077,6,1999,121347,109623,1,11724,9.70%
Adams,6/1/00,53001,6,2000,8218,7689,1,529,6.40%
Asotin,6/1/00,53003,6,2000,9640,9158,1,482,5.00%
Clallam,6/1/00,53009,6,2000,25980,24153,1,1827,7.00%
Columbia,6/1/00,53013,6,2000,2173,2040,1,133,6.10%
Cowlitz,6/1/00,53015,6,2000,43127,40213,1,2914,6.80%
Douglas,6/1/00,53017,6,2000,19583,18508,1,1075,5.50%
Ferry,6/1/00,53019,6,2000,3051,2784,1,267,8.80%
Franklin,6/1/00,53021,6,2000,24523,22975,1,1548,6.30%
Garfield,6/1/00,53023,6,2000,1101,1044,1,57,5.20%
Grant,6/1/00,53025,6,2000,36957,34275,1,2682,7.30%
Grays Harbor,6/1/00,53027,6,2000,29554,27333,1,2221,7.50%
Island,6/1/00,53029,6,2000,29124,27414,1,1710,5.90%
Jefferson,6/1/00,53031,6,2000,11761,11101,1,660,5.60%
King,6/1/00,53033,6,2000,993879,955033,1,38846,3.90%
Kitsap,6/1/00,53035,6,2000,105188,99252,1,5936,5.60%
Kittitas,6/1/00,53037,6,2000,17707,16732,1,975,5.50%
Klickitat,6/1/00,53039,6,2000,9691,9034,1,657,6.80%
Lewis,6/1/00,53041,6,2000,29983,27672,1,2311,7.70%
Lincoln,6/1/00,53043,6,2000,4797,4578,1,219,4.60%
Mason,6/1/00,53045,6,2000,20810,19438,1,1372,6.60%
Okanogan,6/1/00,53047,6,2000,22364,20681,1,1683,7.50%
Pacific,6/1/00,53049,6,2000,8809,8195,1,614,7.00%
Pend Oreille,6/1/00,53051,6,2000,4690,4343,1,347,7.40%
Pierce,6/1/00,53053,6,2000,336582,317950,1,18632,5.50%
San Juan,6/1/00,53055,6,2000,7995,7689,1,306,3.80%
Skagit,6/1/00,53057,6,2000,51939,48629,1,3310,6.40%
Skamania,6/1/00,53059,6,2000,4711,4436,1,275,5.80%
Snohomish,6/1/00,53061,6,2000,325469,311733,1,13736,4.20%
Spokane,6/1/00,53063,6,2000,209419,198025,1,11394,5.40%
Stevens,6/1/00,53065,6,2000,17692,16466,1,1226,6.90%
Thurston,6/1/00,53067,6,2000,107719,102278,1,5441,5.10%
Wahkiakum,6/1/00,53069,6,2000,1668,1547,1,121,7.30%
Walla Walla,6/1/00,53071,6,2000,28094,26591,1,1503,5.30%
Whatcom,6/1/00,53073,6,2000,87866,82847,1,5019,5.70%
Whitman,6/1/00,53075,6,2000,17440,16553,1,887,5.10%
Yakima,6/1/00,53077,6,2000,121568,113399,1,8169,6.70%
Adams,6/1/01,53001,6,2001,8549,7969,1,580,6.80%
Asotin,6/1/01,53003,6,2001,9687,9131,1,556,5.70%
Clallam,6/1/01,53009,6,2001,25470,23541,1,1929,7.60%
Columbia,6/1/01,53013,6,2001,2172,2040,1,132,6.10%
Cowlitz,6/1/01,53015,6,2001,41917,37756,1,4161,9.90%
Douglas,6/1/01,53017,6,2001,18030,16853,1,1177,6.50%
Ferry,6/1/01,53019,6,2001,2865,2576,1,289,10.10%
Franklin,6/1/01,53021,6,2001,24130,22618,1,1512,6.30%
Garfield,6/1/01,53023,6,2001,1112,1057,1,55,4.90%
Grant,6/1/01,53025,6,2001,36557,33925,1,2632,7.20%
Grays Harbor,6/1/01,53027,6,2001,28105,25560,1,2545,9.10%
Island,6/1/01,53029,6,2001,28617,26780,1,1837,6.40%
Jefferson,6/1/01,53031,6,2001,11991,11252,1,739,6.20%
King,6/1/01,53033,6,2001,1001548,950924,1,50624,5.10%
Kitsap,6/1/01,53035,6,2001,102846,96344,1,6502,6.30%
Kittitas,6/1/01,53037,6,2001,16711,15629,1,1082,6.50%
Klickitat,6/1/01,53039,6,2001,9589,8558,1,1031,10.80%
Lewis,6/1/01,53041,6,2001,28718,26267,1,2451,8.50%
Lincoln,6/1/01,53043,6,2001,4755,4496,1,259,5.40%
Mason,6/1/01,53045,6,2001,20105,18542,1,1563,7.80%
Okanogan,6/1/01,53047,6,2001,19339,17658,1,1681,8.70%
Pacific,6/1/01,53049,6,2001,8518,7812,1,706,8.30%
Pend Oreille,6/1/01,53051,6,2001,4661,4275,1,386,8.30%
Pierce,6/1/01,53053,6,2001,327048,305047,1,22001,6.70%
San Juan,6/1/01,53055,6,2001,7991,7644,1,347,4.30%
Skagit,6/1/01,53057,6,2001,50113,46639,1,3474,6.90%
Skamania,6/1/01,53059,6,2001,4743,4248,1,495,10.40%
Snohomish,6/1/01,53061,6,2001,331595,314657,1,16938,5.10%
Spokane,6/1/01,53063,6,2001,206234,192829,1,13405,6.50%
Stevens,6/1/01,53065,6,2001,17089,15697,1,1392,8.10%
Thurston,6/1/01,53067,6,2001,105537,99323,1,6214,5.90%
Wahkiakum,6/1/01,53069,6,2001,1557,1435,1,122,7.80%
Walla Walla,6/1/01,53071,6,2001,27578,25987,1,1591,5.80%
Whatcom,6/1/01,53073,6,2001,86259,80594,1,5665,6.60%
Whitman,6/1/01,53075,6,2001,16601,15703,1,898,5.40%
Yakima,6/1/01,53077,6,2001,114676,105169,1,9507,8.30%
Adams,6/1/02,53001,6,2002,8385,7786,1,599,7.10%
Asotin,6/1/02,53003,6,2002,10147,9420,1,727,7.20%
Clallam,6/1/02,53009,6,2002,26543,24386,1,2157,8.10%
Columbia,6/1/02,53013,6,2002,2097,1942,1,155,7.40%
Cowlitz,6/1/02,53015,6,2002,42471,37987,1,4484,10.60%
Douglas,6/1/02,53017,6,2002,18405,17045,1,1360,7.40%
Ferry,6/1/02,53019,6,2002,2921,2654,1,267,9.10%
Franklin,6/1/02,53021,6,2002,25377,23595,1,1782,7.00%
Garfield,6/1/02,53023,6,2002,1120,1061,1,59,5.30%
Grant,6/1/02,53025,6,2002,37536,34448,1,3088,8.20%
Grays Harbor,6/1/02,53027,6,2002,29173,26595,1,2578,8.80%
Island,6/1/02,53029,6,2002,30248,27978,1,2270,7.50%
Jefferson,6/1/02,53031,6,2002,12391,11441,1,950,7.70%
King,6/1/02,53033,6,2002,986875,923912,1,62963,6.40%
Kitsap,6/1/02,53035,6,2002,110082,102606,1,7476,6.80%
Kittitas,6/1/02,53037,6,2002,17628,16386,1,1242,7.00%
Klickitat,6/1/02,53039,6,2002,9774,8663,1,1111,11.40%
Lewis,6/1/02,53041,6,2002,29525,26850,1,2675,9.10%
Lincoln,6/1/02,53043,6,2002,4689,4362,1,327,7.00%
Mason,6/1/02,53045,6,2002,21238,19471,1,1767,8.30%
Okanogan,6/1/02,53047,6,2002,19022,17388,1,1634,8.60%
Pacific,6/1/02,53049,6,2002,8810,8043,1,767,8.70%
Pend Oreille,6/1/02,53051,6,2002,4765,4324,1,441,9.30%
Pierce,6/1/02,53053,6,2002,340704,312730,1,27974,8.20%
San Juan,6/1/02,53055,6,2002,8163,7747,1,416,5.10%
Skagit,6/1/02,53057,6,2002,51724,47484,1,4240,8.20%
Skamania,6/1/02,53059,6,2002,4672,4224,1,448,9.60%
Snohomish,6/1/02,53061,6,2002,333851,309245,1,24606,7.40%
Spokane,6/1/02,53063,6,2002,209058,193678,1,15380,7.40%
Stevens,6/1/02,53065,6,2002,17540,15912,1,1628,9.30%
Thurston,6/1/02,53067,6,2002,110106,102854,1,7252,6.60%
Wahkiakum,6/1/02,53069,6,2002,1536,1383,1,153,10.00%
Walla Walla,6/1/02,53071,6,2002,28953,27194,1,1759,6.10%
Whatcom,6/1/02,53073,6,2002,90142,84019,1,6123,6.80%
Whitman,6/1/02,53075,6,2002,17180,16199,1,981,5.70%
Yakima,6/1/02,53077,6,2002,115189,105446,1,9743,8.50%
Adams,6/1/03,53001,6,2003,8598,7952,1,646,7.50%
Asotin,6/1/03,53003,6,2003,9860,9179,1,681,6.90%
Clallam,6/1/03,53009,6,2003,26990,24681,1,2309,8.60%
Columbia,6/1/03,53013,6,2003,2110,1950,1,160,7.60%
Cowlitz,6/1/03,53015,6,2003,41948,37642,1,4306,10.30%
Douglas,6/1/03,53017,6,2003,19240,17723,1,1517,7.90%
Ferry,6/1/03,53019,6,2003,2968,2581,1,387,13.00%
Franklin,6/1/03,53021,6,2003,27418,25472,1,1946,7.10%
Garfield,6/1/03,53023,6,2003,1113,1042,1,71,6.40%
Grant,6/1/03,53025,6,2003,38383,35246,1,3137,8.20%
Grays Harbor,6/1/03,53027,6,2003,29347,26525,1,2822,9.60%
Island,6/1/03,53029,6,2003,30411,27942,1,2469,8.10%
Jefferson,6/1/03,53031,6,2003,12746,11764,1,982,7.70%
King,6/1/03,53033,6,2003,994062,927026,1,67036,6.70%
Kitsap,6/1/03,53035,6,2003,111619,103500,1,8119,7.30%
Kittitas,6/1/03,53037,6,2003,18510,17103,1,1407,7.60%
Klickitat,6/1/03,53039,6,2003,9818,8659,1,1159,11.80%
Lewis,6/1/03,53041,6,2003,30258,27358,1,2900,9.60%
Lincoln,6/1/03,53043,6,2003,4809,4478,1,331,6.90%
Mason,6/1/03,53045,6,2003,22143,20162,1,1981,8.90%
Okanogan,6/1/03,53047,6,2003,20482,18759,1,1723,8.40%
Pacific,6/1/03,53049,6,2003,9066,8239,1,827,9.10%
Pend Oreille,6/1/03,53051,6,2003,4850,4386,1,464,9.60%
Pierce,6/1/03,53053,6,2003,343184,313892,1,29292,8.50%
San Juan,6/1/03,53055,6,2003,8266,7816,1,450,5.40%
Skagit,6/1/03,53057,6,2003,53010,48646,1,4364,8.20%
Skamania,6/1/03,53059,6,2003,4618,4164,1,454,9.80%
Snohomish,6/1/03,53061,6,2003,336845,311530,1,25315,7.50%
Spokane,6/1/03,53063,6,2003,211402,195294,1,16108,7.60%
Stevens,6/1/03,53065,6,2003,17719,16080,1,1639,9.20%
Thurston,6/1/03,53067,6,2003,113574,105844,1,7730,6.80%
Wahkiakum,6/1/03,53069,6,2003,1581,1412,1,169,10.70%
Walla Walla,6/1/03,53071,6,2003,29755,27844,1,1911,6.40%
Whatcom,6/1/03,53073,6,2003,93853,87220,1,6633,7.10%
Whitman,6/1/03,53075,6,2003,17581,16461,1,1120,6.40%
Yakima,6/1/03,53077,6,2003,120522,110360,1,10162,8.40%
Adams,6/1/04,53001,6,2004,8635,8085,1,550,6.40%
Asotin,6/1/04,53003,6,2004,10086,9433,1,653,6.50%
Clallam,6/1/04,53009,6,2004,28165,26149,1,2016,7.20%
Columbia,6/1/04,53013,6,2004,1554,1420,1,134,8.60%
Cowlitz,6/1/04,53015,6,2004,42626,39048,1,3578,8.40%
Douglas,6/1/04,53017,6,2004,21445,20377,1,1068,5.00%
Ferry,6/1/04,53019,6,2004,2987,2694,1,293,9.80%
Franklin,6/1/04,53021,6,2004,29405,27642,1,1763,6.00%
Garfield,6/1/04,53023,6,2004,1116,1057,1,59,5.30%
Grant,6/1/04,53025,6,2004,39647,36879,1,2768,7.00%
Grays Harbor,6/1/04,53027,6,2004,30752,28223,1,2529,8.20%
Island,6/1/04,53029,6,2004,31206,28954,1,2252,7.20%
Jefferson,6/1/04,53031,6,2004,13343,12499,1,844,6.30%
King,6/1/04,53033,6,2004,996394,943095,1,53299,5.30%
Kitsap,6/1/04,53035,6,2004,116492,109296,1,7196,6.20%
Kittitas,6/1/04,53037,6,2004,18954,17739,1,1215,6.40%
Klickitat,6/1/04,53039,6,2004,10129,9294,1,835,8.20%
Lewis,6/1/04,53041,6,2004,30745,28237,1,2508,8.20%
Lincoln,6/1/04,53043,6,2004,4956,4658,1,298,6.00%
Mason,6/1/04,53045,6,2004,23100,21335,1,1765,7.60%
Okanogan,6/1/04,53047,6,2004,21650,20229,1,1421,6.60%
Pacific,6/1/04,53049,6,2004,9321,8634,1,687,7.40%
Pend Oreille,6/1/04,53051,6,2004,4995,4573,1,422,8.40%
Pierce,6/1/04,53053,6,2004,354263,328443,1,25820,7.30%
San Juan,6/1/04,53055,6,2004,8680,8299,1,381,4.40%
Skagit,6/1/04,53057,6,2004,55289,51524,1,3765,6.80%
Skamania,6/1/04,53059,6,2004,4774,4439,1,335,7.00%
Snohomish,6/1/04,53061,6,2004,338369,318419,1,19950,5.90%
Spokane,6/1/04,53063,6,2004,215584,201688,1,13896,6.40%
Stevens,6/1/04,53065,6,2004,17964,16617,1,1347,7.50%
Thurston,6/1/04,53067,6,2004,117690,110707,1,6983,5.90%
Wahkiakum,6/1/04,53069,6,2004,1638,1513,1,125,7.60%
Walla Walla,6/1/04,53071,6,2004,29897,28130,1,1767,5.90%
Whatcom,6/1/04,53073,6,2004,98816,92937,1,5879,5.90%
Whitman,6/1/04,53075,6,2004,18120,17118,1,1002,5.50%
Yakima,6/1/04,53077,6,2004,126486,117323,1,9163,7.20%
Adams,6/1/05,53001,6,2005,8459,7989,1,470,5.60%
Asotin,6/1/05,53003,6,2005,10292,9672,1,620,6.00%
Clallam,6/1/05,53009,6,2005,29386,27530,1,1856,6.30%
Columbia,6/1/05,53013,6,2005,2012,1901,1,111,5.50%
Cowlitz,6/1/05,53015,6,2005,42644,39496,1,3148,7.40%
Douglas,6/1/05,53017,6,2005,21607,20667,1,940,4.40%
Ferry,6/1/05,53019,6,2005,3060,2803,1,257,8.40%
Franklin,6/1/05,53021,6,2005,31376,29590,1,1786,5.70%
Garfield,6/1/05,53023,6,2005,1149,1093,1,56,4.90%
Grant,6/1/05,53025,6,2005,41039,38430,1,2609,6.40%
Grays Harbor,6/1/05,53027,6,2005,31153,28868,1,2285,7.30%
Island,6/1/05,53029,6,2005,31295,29312,1,1983,6.30%
Jefferson,6/1/05,53031,6,2005,13495,12733,1,762,5.60%
King,6/1/05,53033,6,2005,1016365,967385,1,48980,4.80%
Kitsap,6/1/05,53035,6,2005,119379,113004,1,6375,5.30%
Kittitas,6/1/05,53037,6,2005,19079,18013,1,1066,5.60%
Klickitat,6/1/05,53039,6,2005,10004,9280,1,724,7.20%
Lewis,6/1/05,53041,6,2005,30566,28252,1,2314,7.60%
Lincoln,6/1/05,53043,6,2005,4775,4508,1,267,5.60%
Mason,6/1/05,53045,6,2005,23687,22106,1,1581,6.70%
Okanogan,6/1/05,53047,6,2005,21849,20562,1,1287,5.90%
Pacific,6/1/05,53049,6,2005,9131,8488,1,643,7.00%
Pend Oreille,6/1/05,53051,6,2005,5135,4759,1,376,7.30%
Pierce,6/1/05,53053,6,2005,361950,339919,1,22031,6.10%
San Juan,6/1/05,53055,6,2005,8603,8251,1,352,4.10%
Skagit,6/1/05,53057,6,2005,56144,52790,1,3354,6.00%
Skamania,6/1/05,53059,6,2005,4879,4544,1,335,6.90%
Snohomish,6/1/05,53061,6,2005,347453,329634,1,17819,5.10%
Spokane,6/1/05,53063,6,2005,219808,207556,1,12252,5.60%
Stevens,6/1/05,53065,6,2005,18082,16799,1,1283,7.10%
Thurston,6/1/05,53067,6,2005,119872,113582,1,6290,5.20%
Wahkiakum,6/1/05,53069,6,2005,1622,1501,1,121,7.50%
Walla Walla,6/1/05,53071,6,2005,29613,28034,1,1579,5.30%
Whatcom,6/1/05,53073,6,2005,102315,96979,1,5336,5.20%
Whitman,6/1/05,53075,6,2005,18400,17449,1,951,5.20%
Yakima,6/1/05,53077,6,2005,126501,119059,1,7442,5.90%
Adams,6/1/06,53001,6,2006,8149,7726,1,423,5.20%
Asotin,6/1/06,53003,6,2006,10239,9688,1,551,5.40%
Clallam,6/1/06,53009,6,2006,29418,27626,1,1792,6.10%
Columbia,6/1/06,53013,6,2006,1514,1391,1,123,8.10%
Cowlitz,6/1/06,53015,6,2006,42256,39340,1,2916,6.90%
Douglas,6/1/06,53017,6,2006,21700,20715,1,985,4.50%
Ferry,6/1/06,53019,6,2006,3021,2756,1,265,8.80%
Franklin,6/1/06,53021,6,2006,30773,28899,1,1874,6.10%
Garfield,6/1/06,53023,6,2006,1107,1057,1,50,4.50%
Grant,6/1/06,53025,6,2006,41214,38922,1,2292,5.60%
Grays Harbor,6/1/06,53027,6,2006,30862,28723,1,2139,6.90%
Island,6/1/06,53029,6,2006,32108,30280,1,1828,5.70%
Jefferson,6/1/06,53031,6,2006,13550,12844,1,706,5.20%
King,6/1/06,53033,6,2006,1054124,1010384,1,43740,4.10%
Kitsap,6/1/06,53035,6,2006,120696,114418,1,6278,5.20%
Kittitas,6/1/06,53037,6,2006,19800,18765,1,1035,5.20%
Klickitat,6/1/06,53039,6,2006,10196,9535,1,661,6.50%
Lewis,6/1/06,53041,6,2006,31093,28915,1,2178,7.00%
Lincoln,6/1/06,53043,6,2006,4723,4462,1,261,5.50%
Mason,6/1/06,53045,6,2006,24104,22601,1,1503,6.20%
Okanogan,6/1/06,53047,6,2006,21325,20062,1,1263,5.90%
Pacific,6/1/06,53049,6,2006,9358,8727,1,631,6.70%
Pend Oreille,6/1/06,53051,6,2006,5130,4762,1,368,7.20%
Pierce,6/1/06,53053,6,2006,366529,345913,1,20616,5.60%
San Juan,6/1/06,53055,6,2006,8672,8335,1,337,3.90%
Skagit,6/1/06,53057,6,2006,56567,53460,1,3107,5.50%
Skamania,6/1/06,53059,6,2006,4942,4611,1,331,6.70%
Snohomish,6/1/06,53061,6,2006,361534,345224,1,16310,4.50%
Spokane,6/1/06,53063,6,2006,223623,211991,1,11632,5.20%
Stevens,6/1/06,53065,6,2006,18226,17008,1,1218,6.70%
Thurston,6/1/06,53067,6,2006,122309,116156,1,6153,5.00%
Wahkiakum,6/1/06,53069,6,2006,1639,1534,1,105,6.40%
Walla Walla,6/1/06,53071,6,2006,29300,27715,1,1585,5.40%
Whatcom,6/1/06,53073,6,2006,102171,97130,1,5041,4.90%
Whitman,6/1/06,53075,6,2006,18221,17255,1,966,5.30%
Yakima,6/1/06,53077,6,2006,125754,118144,1,7610,6.10%
Adams,6/1/07,53001,6,2007,8211,7820,1,391,4.80%
Asotin,6/1/07,53003,6,2007,10193,9662,1,531,5.20%
Clallam,6/1/07,53009,6,2007,29720,27964,1,1756,5.90%
Columbia,6/1/07,53013,6,2007,1601,1496,1,105,6.60%
Cowlitz,6/1/07,53015,6,2007,43191,40435,1,2756,6.40%
Douglas,6/1/07,53017,6,2007,22567,21639,1,928,4.10%
Ferry,6/1/07,53019,6,2007,2981,2756,1,225,7.50%
Franklin,6/1/07,53021,6,2007,34150,32352,1,1798,5.30%
Garfield,6/1/07,53023,6,2007,1066,1012,1,54,5.10%
Grant,6/1/07,53025,6,2007,42912,40786,1,2126,5.00%
Grays Harbor,6/1/07,53027,6,2007,31303,29147,1,2156,6.90%
Island,6/1/07,53029,6,2007,32702,30954,1,1748,5.30%
Jefferson,6/1/07,53031,6,2007,13659,12975,1,684,5.00%
King,6/1/07,53033,6,2007,1076058,1037984,1,38074,3.50%
Kitsap,6/1/07,53035,6,2007,121119,115244,1,5875,4.90%
Kittitas,6/1/07,53037,6,2007,20806,19845,1,961,4.60%
Klickitat,6/1/07,53039,6,2007,10336,9678,1,658,6.40%
Lewis,6/1/07,53041,6,2007,31068,28946,1,2122,6.80%
Lincoln,6/1/07,53043,6,2007,4843,4607,1,236,4.90%
Mason,6/1/07,53045,6,2007,24724,23249,1,1475,6.00%
Okanogan,6/1/07,53047,6,2007,21732,20508,1,1224,5.60%
Pacific,6/1/07,53049,6,2007,9411,8802,1,609,6.50%
Pend Oreille,6/1/07,53051,6,2007,5214,4867,1,347,6.70%
Pierce,6/1/07,53053,6,2007,380639,361017,1,19622,5.20%
San Juan,6/1/07,53055,6,2007,8956,8661,1,295,3.30%
Skagit,6/1/07,53057,6,2007,57452,54616,1,2836,4.90%
Skamania,6/1/07,53059,6,2007,4906,4607,1,299,6.10%
Snohomish,6/1/07,53061,6,2007,366099,352093,1,14006,3.80%
Spokane,6/1/07,53063,6,2007,230518,219444,1,11074,4.80%
Stevens,6/1/07,53065,6,2007,18651,17399,1,1252,6.70%
Thurston,6/1/07,53067,6,2007,126573,120646,1,5927,4.70%
Wahkiakum,6/1/07,53069,6,2007,1683,1577,1,106,6.30%
Walla Walla,6/1/07,53071,6,2007,29876,28449,1,1427,4.80%
Whatcom,6/1/07,53073,6,2007,105379,100601,1,4778,4.50%
Whitman,6/1/07,53075,6,2007,18120,17237,1,883,4.90%
Yakima,6/1/07,53077,6,2007,126108,119015,1,7093,5.60%
Adams,6/1/08,53001,6,2008,8468,8017,1,451,5.30%
Asotin,6/1/08,53003,6,2008,10306,9672,1,634,6.20%
Clallam,6/1/08,53009,6,2008,30107,27977,1,2130,7.10%
Columbia,6/1/08,53013,6,2008,1559,1457,1,102,6.50%
Cowlitz,6/1/08,53015,6,2008,43803,40266,1,3537,8.10%
Douglas,6/1/08,53017,6,2008,21942,20723,1,1219,5.60%
Ferry,6/1/08,53019,6,2008,3020,2755,1,265,8.80%
Franklin,6/1/08,53021,6,2008,35192,33235,1,1957,5.60%
Garfield,6/1/08,53023,6,2008,1100,1048,1,52,4.70%
Grant,6/1/08,53025,6,2008,42018,39704,1,2314,5.50%
Grays Harbor,6/1/08,53027,6,2008,31483,29104,1,2379,7.60%
Island,6/1/08,53029,6,2008,33225,31336,1,1889,5.70%
Jefferson,6/1/08,53031,6,2008,13842,13074,1,768,5.50%
King,6/1/08,53033,6,2008,1099477,1054651,1,44826,4.10%
Kitsap,6/1/08,53035,6,2008,123914,117207,1,6707,5.40%
Kittitas,6/1/08,53037,6,2008,21239,20038,1,1201,5.70%
Klickitat,6/1/08,53039,6,2008,10698,9903,1,795,7.40%
Lewis,6/1/08,53041,6,2008,31495,28987,1,2508,8.00%
Lincoln,6/1/08,53043,6,2008,4905,4646,1,259,5.30%
Mason,6/1/08,53045,6,2008,25113,23389,1,1724,6.90%
Okanogan,6/1/08,53047,6,2008,22251,20888,1,1363,6.10%
Pacific,6/1/08,53049,6,2008,9364,8683,1,681,7.30%
Pend Oreille,6/1/08,53051,6,2008,5533,5114,1,419,7.60%
Pierce,6/1/08,53053,6,2008,390438,367360,1,23078,5.90%
San Juan,6/1/08,53055,6,2008,9313,8976,1,337,3.60%
Skagit,6/1/08,53057,6,2008,58597,55212,1,3385,5.80%
Skamania,6/1/08,53059,6,2008,5067,4646,1,421,8.30%
Snohomish,6/1/08,53061,6,2008,375669,358189,1,17480,4.70%
Spokane,6/1/08,53063,6,2008,237033,224042,1,12991,5.50%
Stevens,6/1/08,53065,6,2008,18923,17563,1,1360,7.20%
Thurston,6/1/08,53067,6,2008,130662,123845,1,6817,5.20%
Wahkiakum,6/1/08,53069,6,2008,1799,1663,1,136,7.60%
Walla Walla,6/1/08,53071,6,2008,30565,29111,1,1454,4.80%
Whatcom,6/1/08,53073,6,2008,108353,102754,1,5599,5.20%
Whitman,6/1/08,53075,6,2008,20887,19881,1,1006,4.80%
Yakima,6/1/08,53077,6,2008,125839,117395,1,8444,6.70%
Adams,6/1/09,53001,6,2009,8767,8110,1,657,7.50%
Asotin,6/1/09,53003,6,2009,10260,9413,1,847,8.30%
Clallam,6/1/09,53009,6,2009,30574,27547,1,3027,9.90%
Columbia,6/1/09,53013,6,2009,1606,1443,1,163,10.10%
Cowlitz,6/1/09,53015,6,2009,44363,38600,1,5763,13.00%
Douglas,6/1/09,53017,6,2009,23266,21525,1,1741,7.50%
Ferry,6/1/09,53019,6,2009,3146,2764,1,382,12.10%
Franklin,6/1/09,53021,6,2009,38448,35590,1,2858,7.40%
Garfield,6/1/09,53023,6,2009,1095,1020,1,75,6.80%
Grant,6/1/09,53025,6,2009,44733,41021,1,3712,8.30%
Grays Harbor,6/1/09,53027,6,2009,31494,27505,1,3989,12.70%
Island,6/1/09,53029,6,2009,33352,30343,1,3009,9.00%
Jefferson,6/1/09,53031,6,2009,13284,12134,1,1150,8.70%
King,6/1/09,53033,6,2009,1125579,1028121,1,97458,8.70%
Kitsap,6/1/09,53035,6,2009,124853,114865,1,9988,8.00%
Kittitas,6/1/09,53037,6,2009,21085,19237,1,1848,8.80%
Klickitat,6/1/09,53039,6,2009,11898,10712,1,1186,10.00%
Lewis,6/1/09,53041,6,2009,31768,27683,1,4085,12.90%
Lincoln,6/1/09,53043,6,2009,5020,4618,1,402,8.00%
Mason,6/1/09,53045,6,2009,25233,22629,1,2604,10.30%
Okanogan,6/1/09,53047,6,2009,23175,21345,1,1830,7.90%
Pacific,6/1/09,53049,6,2009,9483,8306,1,1177,12.40%
Pend Oreille,6/1/09,53051,6,2009,5566,4791,1,775,13.90%
Pierce,6/1/09,53053,6,2009,395028,356316,1,38712,9.80%
San Juan,6/1/09,53055,6,2009,9045,8506,1,539,6.00%
Skagit,6/1/09,53057,6,2009,58441,52571,1,5870,10.00%
Skamania,6/1/09,53059,6,2009,4990,4399,1,591,11.80%
Snohomish,6/1/09,53061,6,2009,385141,347177,1,37964,9.90%
Spokane,6/1/09,53063,6,2009,238540,217184,1,21356,9.00%
Stevens,6/1/09,53065,6,2009,19249,16866,1,2383,12.40%
Thurston,6/1/09,53067,6,2009,131173,120661,1,10512,8.00%
Wahkiakum,6/1/09,53069,6,2009,1650,1422,1,228,13.80%
Walla Walla,6/1/09,53071,6,2009,32403,30344,1,2059,6.40%
Whatcom,6/1/09,53073,6,2009,108205,98762,1,9443,8.70%
Whitman,6/1/09,53075,6,2009,21659,20327,1,1332,6.10%
Yakima,6/1/09,53077,6,2009,130888,120287,1,10601,8.10%
Adams,6/1/10,53001,6,2010,8771,8020,1,751,8.60%
Asotin,6/1/10,53003,6,2010,10343,9402,1,941,9.10%
Clallam,6/1/10,53009,6,2010,29713,26700,1,3013,10.10%
Columbia,6/1/10,53013,6,2010,2005,1821,1,184,9.20%
Cowlitz,6/1/10,53015,6,2010,46055,40199,1,5856,12.70%
Douglas,6/1/10,53017,6,2010,21010,19208,1,1802,8.60%
Ferry,6/1/10,53019,6,2010,2701,2266,1,435,16.10%
Franklin,6/1/10,53021,6,2010,40289,37301,1,2988,7.40%
Garfield,6/1/10,53023,6,2010,1126,1042,1,84,7.50%
Grant,6/1/10,53025,6,2010,45310,41080,1,4230,9.30%
Grays Harbor,6/1/10,53027,6,2010,31217,27164,1,4053,13.00%
Island,6/1/10,53029,6,2010,34130,31141,1,2989,8.80%
Jefferson,6/1/10,53031,6,2010,13155,11931,1,1224,9.30%
King,6/1/10,53033,6,2010,1112860,1010051,1,102809,9.20%
Kitsap,6/1/10,53035,6,2010,119955,109970,1,9985,8.30%
Kittitas,6/1/10,53037,6,2010,21893,19930,1,1963,9.00%
Klickitat,6/1/10,53039,6,2010,10767,9529,1,1238,11.50%
Lewis,6/1/10,53041,6,2010,33730,29540,1,4190,12.40%
Lincoln,6/1/10,53043,6,2010,5405,4988,1,417,7.70%
Mason,6/1/10,53045,6,2010,24772,21955,1,2817,11.40%
Okanogan,6/1/10,53047,6,2010,23138,20992,1,2146,9.30%
Pacific,6/1/10,53049,6,2010,9031,7821,1,1210,13.40%
Pend Oreille,6/1/10,53051,6,2010,5090,4390,1,700,13.80%
Pierce,6/1/10,53053,6,2010,391884,352423,1,39461,10.10%
San Juan,6/1/10,53055,6,2010,8977,8425,1,552,6.10%
Skagit,6/1/10,53057,6,2010,58695,52570,1,6125,10.40%
Skamania,6/1/10,53059,6,2010,5127,4507,1,620,12.10%
Snohomish,6/1/10,53061,6,2010,389296,346521,1,42775,11.00%
Spokane,6/1/10,53063,6,2010,236122,213724,1,22398,9.50%
Stevens,6/1/10,53065,6,2010,19084,16752,1,2332,12.20%
Thurston,6/1/10,53067,6,2010,125609,114747,1,10862,8.60%
Wahkiakum,6/1/10,53069,6,2010,1529,1312,1,217,14.20%
Walla Walla,6/1/10,53071,6,2010,31677,29318,1,2359,7.40%
Whatcom,6/1/10,53073,6,2010,104355,94892,1,9463,9.10%
Whitman,6/1/10,53075,6,2010,20373,18806,1,1567,7.70%
Yakima,6/1/10,53077,6,2010,125936,113994,1,11942,9.50%
Adams,6/1/11,53001,6,2011,8426,7691,1,735,8.70%
Asotin,6/1/11,53003,6,2011,10070,9177,1,893,8.90%
Clallam,6/1/11,53009,6,2011,28605,25577,1,3028,10.60%
Columbia,6/1/11,53013,6,2011,1881,1702,1,179,9.50%
Cowlitz,6/1/11,53015,6,2011,44372,39035,1,5337,12.00%
Douglas,6/1/11,53017,6,2011,19510,17756,1,1754,9.00%
Ferry,6/1/11,53019,6,2011,2522,2115,1,407,16.10%
Franklin,6/1/11,53021,6,2011,40074,36840,1,3234,8.10%
Garfield,6/1/11,53023,6,2011,1088,1009,1,79,7.30%
Grant,6/1/11,53025,6,2011,43959,39911,1,4048,9.20%
Grays Harbor,6/1/11,53027,6,2011,29571,25554,1,4017,13.60%
Island,6/1/11,53029,6,2011,32915,29899,1,3016,9.20%
Jefferson,6/1/11,53031,6,2011,12375,11116,1,1259,10.20%
King,6/1/11,53033,6,2011,1115843,1022428,1,93415,8.40%
Kitsap,6/1/11,53035,6,2011,117690,107834,1,9856,8.40%
Kittitas,6/1/11,53037,6,2011,21591,19717,1,1874,8.70%
Klickitat,6/1/11,53039,6,2011,10595,9366,1,1229,11.60%
Lewis,6/1/11,53041,6,2011,32596,28618,1,3978,12.20%
Lincoln,6/1/11,53043,6,2011,5441,5021,1,420,7.70%
Mason,6/1/11,53045,6,2011,23759,21029,1,2730,11.50%
Okanogan,6/1/11,53047,6,2011,21164,19051,1,2113,10.00%
Pacific,6/1/11,53049,6,2011,8332,7255,1,1077,12.90%
Pend Oreille,6/1/11,53051,6,2011,4880,4218,1,662,13.60%
Pierce,6/1/11,53053,6,2011,384998,346172,1,38826,10.10%
San Juan,6/1/11,53055,6,2011,8542,7977,1,565,6.60%
Skagit,6/1/11,53057,6,2011,56894,51006,1,5888,10.30%
Skamania,6/1/11,53059,6,2011,5065,4457,1,608,12.00%
Snohomish,6/1/11,53061,6,2011,386573,348126,1,38447,9.90%
Spokane,6/1/11,53063,6,2011,230582,209160,1,21422,9.30%
Stevens,6/1/11,53065,6,2011,18396,16241,1,2155,11.70%
Thurston,6/1/11,53067,6,2011,123087,112070,1,11017,9.00%
Wahkiakum,6/1/11,53069,6,2011,1462,1257,1,205,14.00%
Walla Walla,6/1/11,53071,6,2011,30737,28379,1,2358,7.70%
Whatcom,6/1/11,53073,6,2011,103293,94025,1,9268,9.00%
Whitman,6/1/11,53075,6,2011,20509,18966,1,1543,7.50%
Yakima,6/1/11,53077,6,2011,120672,107836,1,12836,10.60%
Adams,6/1/12,53001,6,2012,8739,8040,1,699,8.00%
Asotin,6/1/12,53003,6,2012,9634,8865,1,769,8.00%
Clallam,6/1/12,53009,6,2012,28186,25282,1,2904,10.30%
Columbia,6/1/12,53013,6,2012,1850,1697,1,153,8.30%
Cowlitz,6/1/12,53015,6,2012,44185,39427,1,4758,10.80%
Douglas,6/1/12,53017,6,2012,20014,18408,1,1606,8.00%
Ferry,6/1/12,53019,6,2012,2551,2172,1,379,14.90%
Franklin,6/1/12,53021,6,2012,41504,37883,1,3621,8.70%
Garfield,6/1/12,53023,6,2012,1096,1021,1,75,6.80%
Grant,6/1/12,53025,6,2012,47589,43711,1,3878,8.10%
Grays Harbor,6/1/12,53027,6,2012,28938,25209,1,3729,12.90%
Island,6/1/12,53029,6,2012,32534,29904,1,2630,8.10%
Jefferson,6/1/12,53031,6,2012,12091,10895,1,1196,9.90%
King,6/1/12,53033,6,2012,1130640,1054433,1,76207,6.70%
Kitsap,6/1/12,53035,6,2012,115937,106713,1,9224,8.00%
Kittitas,6/1/12,53037,6,2012,21069,19312,1,1757,8.30%
Klickitat,6/1/12,53039,6,2012,10282,9232,1,1050,10.20%
Lewis,6/1/12,53041,6,2012,32249,28445,1,3804,11.80%
Lincoln,6/1/12,53043,6,2012,5361,4979,1,382,7.10%
Mason,6/1/12,53045,6,2012,23522,20956,1,2566,10.90%
Okanogan,6/1/12,53047,6,2012,22040,20123,1,1917,8.70%
Pacific,6/1/12,53049,6,2012,8313,7338,1,975,11.70%
Pend Oreille,6/1/12,53051,6,2012,4787,4196,1,591,12.30%
Pierce,6/1/12,53053,6,2012,384320,348208,1,36112,9.40%
San Juan,6/1/12,53055,6,2012,8537,8055,1,482,5.60%
Skagit,6/1/12,53057,6,2012,57038,51560,1,5478,9.60%
Skamania,6/1/12,53059,6,2012,5013,4480,1,533,10.60%
Snohomish,6/1/12,53061,6,2012,388542,357711,1,30831,7.90%
Spokane,6/1/12,53063,6,2012,229099,208499,1,20600,9.00%
Stevens,6/1/12,53065,6,2012,18173,16128,1,2045,11.30%
Thurston,6/1/12,53067,6,2012,122319,111992,1,10327,8.40%
Wahkiakum,6/1/12,53069,6,2012,1405,1232,1,173,12.30%
Walla Walla,6/1/12,53071,6,2012,30458,28266,1,2192,7.20%
Whatcom,6/1/12,53073,6,2012,103025,94582,1,8443,8.20%
Whitman,6/1/12,53075,6,2012,20310,18784,1,1526,7.50%
Yakima,6/1/12,53077,6,2012,126446,114314,1,12132,9.60%
Adams,6/1/13,53001,6,2013,8769,8136,1,633,7.20%
Asotin,6/1/13,53003,6,2013,9789,9157,1,632,6.50%
Clallam,6/1/13,53009,6,2013,27221,24613,1,2608,9.60%
Clark,6/1/13,53011,6,2013,206564,188956,1,17608,8.50%
Columbia,6/1/13,53013,6,2013,1783,1641,1,142,8.00%
Cowlitz,6/1/13,53015,6,2013,42705,38427,1,4278,10.00%
Douglas,6/1/13,53017,6,2013,20254,18829,1,1425,7.00%
Ferry,6/1/13,53019,6,2013,2525,2198,1,327,13.00%
Franklin,6/1/13,53021,6,2013,41090,37694,1,3396,8.30%
Garfield,6/1/13,53023,6,2013,1043,970,1,73,7.00%
Grant,6/1/13,53025,6,2013,47418,44013,1,3405,7.20%
Grays Harbor,6/1/13,53027,6,2013,27678,24432,1,3246,11.70%
Island,6/1/13,53029,6,2013,31748,29364,1,2384,7.50%
Jefferson,6/1/13,53031,6,2013,11352,10320,1,1032,9.10%
King,6/1/13,53033,6,2013,1144576,1083926,1,60650,5.30%
Kitsap,6/1/13,53035,6,2013,112763,104453,1,8310,7.40%
Kittitas,6/1/13,53037,6,2013,20680,19119,1,1561,7.50%
Klickitat,6/1/13,53039,6,2013,10228,9348,1,880,8.60%
Lewis,6/1/13,53041,6,2013,31114,27875,1,3239,10.40%
Lincoln,6/1/13,53043,6,2013,5214,4873,1,341,6.50%
Mason,6/1/13,53045,6,2013,23223,20865,1,2358,10.20%
Okanogan,6/1/13,53047,6,2013,23127,21513,1,1614,7.00%
Pacific,6/1/13,53049,6,2013,7939,7070,1,869,10.90%
Pend Oreille,6/1/13,53051,6,2013,4620,4111,1,509,11.00%
Pierce,6/1/13,53053,6,2013,380042,347991,1,32051,8.40%
San Juan,6/1/13,53055,6,2013,8170,7736,1,434,5.30%
Skagit,6/1/13,53057,6,2013,56352,51509,1,4843,8.60%
Skamania,6/1/13,53059,6,2013,4941,4465,1,476,9.60%
Snohomish,6/1/13,53061,6,2013,391488,367835,1,23653,6.00%
Spokane,6/1/13,53063,6,2013,225747,207541,1,18206,8.10%
Stevens,6/1/13,53065,6,2013,17598,15794,1,1804,10.30%
Thurston,6/1/13,53067,6,2013,121547,112259,1,9288,7.60%
Wahkiakum,6/1/13,53069,6,2013,1300,1140,1,160,12.30%
Walla Walla,6/1/13,53071,6,2013,29289,27299,1,1990,6.80%
Whatcom,6/1/13,53073,6,2013,102249,94534,1,7715,7.50%
Whitman,6/1/13,53075,6,2013,20143,18601,1,1542,7.70%
Yakima,6/1/13,53077,6,2013,126206,115283,1,10923,8.70%
Adams,6/1/14,53001,6,2014,9052,8580,1,472,5.20%
Asotin,6/1/14,53003,6,2014,9600,9130,1,470,4.90%
Clallam,6/1/14,53009,6,2014,26417,24423,1,1994,7.50%
Clark,6/1/14,53011,6,2014,206060,192414,1,13646,6.60%
Columbia,6/1/14,53013,6,2014,1755,1650,1,105,6.00%
Cowlitz,6/1/14,53015,6,2014,42949,39693,1,3256,7.60%
Douglas,6/1/14,53017,6,2014,21001,19853,1,1148,5.50%
Ferry,6/1/14,53019,6,2014,2467,2216,1,251,10.20%
Franklin,6/1/14,53021,6,2014,40800,38167,1,2633,6.50%
Garfield,6/1/14,53023,6,2014,963,904,1,59,6.10%
Grant,6/1/14,53025,6,2014,47924,45158,1,2766,5.80%
Grays Harbor,6/1/14,53027,6,2014,26953,24442,1,2511,9.30%
Island,6/1/14,53029,6,2014,31383,29451,1,1932,6.20%
Jefferson,6/1/14,53031,6,2014,11067,10264,1,803,7.30%
King,6/1/14,53033,6,2014,1162324,1105914,1,56410,4.90%
Kitsap,6/1/14,53035,6,2014,111938,105463,1,6475,5.80%
Kittitas,6/1/14,53037,6,2014,20538,19281,1,1257,6.10%
Klickitat,6/1/14,53039,6,2014,10041,9350,1,691,6.90%
Lewis,6/1/14,53041,6,2014,29741,27246,1,2495,8.40%
Lincoln,6/1/14,53043,6,2014,5138,4890,1,248,4.80%
Mason,6/1/14,53045,6,2014,22706,20955,1,1751,7.70%
Okanogan,6/1/14,53047,6,2014,23078,21825,1,1253,5.40%
Pacific,6/1/14,53049,6,2014,7848,7138,1,710,9.00%
Pend Oreille,6/1/14,53051,6,2014,4491,4096,1,395,8.80%
Pierce,6/1/14,53053,6,2014,377864,352560,1,25304,6.70%
San Juan,6/1/14,53055,6,2014,7937,7611,1,326,4.10%
Skagit,6/1/14,53057,6,2014,56015,52303,1,3712,6.60%
Skamania,6/1/14,53059,6,2014,4861,4484,1,377,7.80%
Snohomish,6/1/14,53061,6,2014,397244,375805,1,21439,5.40%
Spokane,6/1/14,53063,6,2014,221734,207823,1,13911,6.30%
Stevens,6/1/14,53065,6,2014,17119,15717,1,1402,8.20%
Thurston,6/1/14,53067,6,2014,120721,113353,1,7368,6.10%
Wahkiakum,6/1/14,53069,6,2014,1243,1135,1,108,8.70%
Walla Walla,6/1/14,53071,6,2014,28996,27409,1,1587,5.50%
Whatcom,6/1/14,53073,6,2014,100591,94434,1,6157,6.10%
Whitman,6/1/14,53075,6,2014,19856,18750,1,1106,5.60%
Yakima,6/1/14,53077,6,2014,125561,116899,1,8662,6.90%
Adams,6/1/15,53001,6,2015,9092,8574,1,518,5.70%
Asotin,6/1/15,53003,6,2015,9562,9106,1,456,4.80%
Clallam,6/1/15,53009,6,2015,26731,24681,1,2050,7.70%
Clark,6/1/15,53011,6,2015,210715,196764,1,13951,6.60%
Columbia,6/1/15,53013,6,2015,1691,1589,1,102,6.00%
Cowlitz,6/1/15,53015,6,2015,43477,40043,1,3434,7.90%
Douglas,6/1/15,53017,6,2015,21898,20782,1,1116,5.10%
Ferry,6/1/15,53019,6,2015,2542,2305,1,237,9.30%
Franklin,6/1/15,53021,6,2015,42241,39589,1,2652,6.30%
Garfield,6/1/15,53023,6,2015,948,895,1,53,5.60%
Grant,6/1/15,53025,6,2015,48240,45423,1,2817,5.80%
Grays Harbor,6/1/15,53027,6,2015,26965,24579,1,2386,8.80%
Island,6/1/15,53029,6,2015,31695,29758,1,1937,6.10%
Jefferson,6/1/15,53031,6,2015,11167,10394,1,773,6.90%
King,6/1/15,53033,6,2015,1184582,1135384,1,49198,4.20%
Kitsap,6/1/15,53035,6,2015,113931,107463,1,6468,5.70%
Kittitas,6/1/15,53037,6,2015,21396,20129,1,1267,5.90%
Klickitat,6/1/15,53039,6,2015,10296,9633,1,663,6.40%
Lewis,6/1/15,53041,6,2015,30590,28022,1,2568,8.40%
Lincoln,6/1/15,53043,6,2015,5019,4752,1,267,5.30%
Mason,6/1/15,53045,6,2015,22725,21014,1,1711,7.50%
Okanogan,6/1/15,53047,6,2015,23625,22345,1,1280,5.40%
Pacific,6/1/15,53049,6,2015,8181,7476,1,705,8.60%
Pend Oreille,6/1/15,53051,6,2015,4533,4113,1,420,9.30%
Pierce,6/1/15,53053,6,2015,385918,360523,1,25395,6.60%
San Juan,6/1/15,53055,6,2015,8023,7668,1,355,4.40%
Skagit,6/1/15,53057,6,2015,56551,52751,1,3800,6.70%
Skamania,6/1/15,53059,6,2015,4865,4507,1,358,7.40%
Snohomish,6/1/15,53061,6,2015,403939,385711,1,18228,4.50%
Spokane,6/1/15,53063,6,2015,224672,210155,1,14517,6.50%
Stevens,6/1/15,53065,6,2015,17217,15757,1,1460,8.50%
Thurston,6/1/15,53067,6,2015,123789,116290,1,7499,6.10%
Wahkiakum,6/1/15,53069,6,2015,1280,1163,1,117,9.10%
Walla Walla,6/1/15,53071,6,2015,28321,26680,1,1641,5.80%
Whatcom,6/1/15,53073,6,2015,104186,97928,1,6258,6.00%
Whitman,6/1/15,53075,6,2015,20354,19135,1,1219,6.00%
Yakima,6/1/15,53077,6,2015,130189,121553,1,8636,6.60%
Adams,6/1/16,53001,6,2016,9138,8666,1,472,5.20%
Asotin,6/1/16,53003,6,2016,9782,9308,1,474,4.80%
Clallam,6/1/16,53009,6,2016,27286,25221,1,2065,7.60%
Clark,6/1/16,53011,6,2016,218024,204185,1,13839,6.30%
Columbia,6/1/16,53013,6,2016,1708,1605,1,103,6.00%
Cowlitz,6/1/16,53015,6,2016,44095,40888,1,3207,7.30%
Douglas,6/1/16,53017,6,2016,22943,21656,1,1287,5.60%
Ferry,6/1/16,53019,6,2016,2525,2297,1,228,9.00%
Franklin,6/1/16,53021,6,2016,42373,39622,1,2751,6.50%
Garfield,6/1/16,53023,6,2016,947,898,1,49,5.20%
Grant,6/1/16,53025,6,2016,48446,45662,1,2784,5.70%
Grays Harbor,6/1/16,53027,6,2016,27071,24870,1,2201,8.10%
Island,6/1/16,53029,6,2016,32456,30547,1,1909,5.90%
Jefferson,6/1/16,53031,6,2016,11528,10739,1,789,6.80%
King,6/1/16,53033,6,2016,1212990,1166074,1,46916,3.90%
Kitsap,6/1/16,53035,6,2016,117009,110260,1,6749,5.80%
Kittitas,6/1/16,53037,6,2016,22626,21401,1,1225,5.40%
Klickitat,6/1/16,53039,6,2016,10125,9467,1,658,6.50%
Lewis,6/1/16,53041,6,2016,31497,29025,1,2472,7.80%
Lincoln,6/1/16,53043,6,2016,4986,4739,1,247,5.00%
Mason,6/1/16,53045,6,2016,23231,21507,1,1724,7.40%
Okanogan,6/1/16,53047,6,2016,23940,22694,1,1246,5.20%
Pacific,6/1/16,53049,6,2016,8284,7639,1,645,7.80%
Pend Oreille,6/1/16,53051,6,2016,4592,4205,1,387,8.40%
Pierce,6/1/16,53053,6,2016,398482,373982,1,24500,6.10%
San Juan,6/1/16,53055,6,2016,8261,7901,1,360,4.40%
Skagit,6/1/16,53057,6,2016,57750,54023,1,3727,6.50%
Skamania,6/1/16,53059,6,2016,4987,4654,1,333,6.70%
Snohomish,6/1/16,53061,6,2016,415295,397709,1,17586,4.20%
Spokane,6/1/16,53063,6,2016,230811,216906,1,13905,6.00%
Stevens,6/1/16,53065,6,2016,17610,16273,1,1337,7.60%
Thurston,6/1/16,53067,6,2016,127600,120239,1,7361,5.80%
Wahkiakum,6/1/16,53069,6,2016,1290,1176,1,114,8.80%
Walla Walla,6/1/16,53071,6,2016,28889,27396,1,1493,5.20%
Whatcom,6/1/16,53073,6,2016,106507,100232,1,6275,5.90%
Whitman,6/1/16,53075,6,2016,20736,19505,1,1231,5.90%
Yakima,6/1/16,53077,6,2016,132895,124469,1,8426,6.30%
Adams,6/1/17,53001,6,2017,9385,8968,1,417,4.40%
Asotin,6/1/17,53003,6,2017,10259,9849,1,410,4.00%
Clallam,6/1/17,53009,6,2017,27928,26096,1,1832,6.60%
Clark,6/1/17,53011,6,2017,227169,215555,1,11614,5.10%
Columbia,6/1/17,53013,6,2017,1805,1719,1,86,4.80%
Cowlitz,6/1/17,53015,6,2017,45733,42996,1,2737,6.00%
Douglas,6/1/17,53017,6,2017,21946,20881,1,1065,4.90%
Ferry,6/1/17,53019,6,2017,2582,2307,1,275,10.70%
Franklin,6/1/17,53021,6,2017,43593,41361,1,2232,5.10%
Garfield,6/1/17,53023,6,2017,934,894,1,40,4.30%
Grant,6/1/17,53025,6,2017,47788,45372,1,2416,5.10%
Grays Harbor,6/1/17,53027,6,2017,28159,26304,1,1855,6.60%
Island,6/1/17,53029,6,2017,34190,32453,1,1737,5.10%
Jefferson,6/1/17,53031,6,2017,12117,11425,1,692,5.70%
King,6/1/17,53033,6,2017,1235090,1191548,1,43542,3.50%
Kitsap,6/1/17,53035,6,2017,120666,114754,1,5912,4.90%
Kittitas,6/1/17,53037,6,2017,22662,21551,1,1111,4.90%
Klickitat,6/1/17,53039,6,2017,10688,10104,1,584,5.50%
Lewis,6/1/17,53041,6,2017,32675,30596,1,2079,6.40%
Lincoln,6/1/17,53043,6,2017,5093,4866,1,227,4.50%
Mason,6/1/17,53045,6,2017,23542,22011,1,1531,6.50%
Okanogan,6/1/17,53047,6,2017,21658,20347,1,1311,6.10%
Pacific,6/1/17,53049,6,2017,8395,7807,1,588,7.00%
Pend Oreille,6/1/17,53051,6,2017,4722,4406,1,316,6.70%
Pierce,6/1/17,53053,6,2017,413581,391185,1,22396,5.40%
San Juan,6/1/17,53055,6,2017,8781,8480,1,301,3.40%
Skagit,6/1/17,53057,6,2017,59911,56695,1,3216,5.40%
Skamania,6/1/17,53059,6,2017,5259,4959,1,300,5.70%
Snohomish,6/1/17,53061,6,2017,422805,406340,1,16465,3.90%
Spokane,6/1/17,53063,6,2017,239806,227338,1,12468,5.20%
Stevens,6/1/17,53065,6,2017,18098,16966,1,1132,6.30%
Thurston,6/1/17,53067,6,2017,133129,126497,1,6632,5.00%
Wahkiakum,6/1/17,53069,6,2017,1314,1223,1,91,6.90%
Walla Walla,6/1/17,53071,6,2017,29338,27969,1,1369,4.70%
Whatcom,6/1/17,53073,6,2017,109581,103889,1,5692,5.20%
Whitman,6/1/17,53075,6,2017,21191,20110,1,1081,5.10%
Yakima,6/1/17,53077,6,2017,130678,123492,1,7186,5.50%
Adams,6/1/18,53001,6,2018,10614,10190,1,424,4.00%
Asotin,6/1/18,53003,6,2018,10085,9641,1,444,4.40%
Clallam,6/1/18,53009,6,2018,28277,26516,1,1761,6.20%
Clark,6/1/18,53011,6,2018,230491,219176,1,11315,4.90%
Columbia,6/1/18,53013,6,2018,1827,1733,1,94,5.10%
Cowlitz,6/1/18,53015,6,2018,45968,43164,1,2804,6.10%
Douglas,6/1/18,53017,6,2018,23321,22269,1,1052,4.50%
Ferry,6/1/18,53019,6,2018,2523,2248,1,275,10.90%
Franklin,6/1/18,53021,6,2018,44893,42541,1,2352,5.20%
Garfield,6/1/18,53023,6,2018,925,875,1,50,5.40%
Grant,6/1/18,53025,6,2018,48895,46221,1,2674,5.50%
Grays Harbor,6/1/18,53027,6,2018,28287,26435,1,1852,6.50%
Island,6/1/18,53029,6,2018,34522,32675,1,1847,5.40%
Jefferson,6/1/18,53031,6,2018,12259,11534,1,725,5.90%
King,6/1/18,53033,6,2018,1260690,1219914,1,40776,3.20%
Kitsap,6/1/18,53035,6,2018,122447,116687,1,5760,4.70%
Kittitas,6/1/18,53037,6,2018,22568,21379,1,1189,5.30%
Klickitat,6/1/18,53039,6,2018,10934,10374,1,560,5.10%
Lewis,6/1/18,53041,6,2018,33511,31416,1,2095,6.30%
Lincoln,6/1/18,53043,6,2018,5149,4907,1,242,4.70%
Mason,6/1/18,53045,6,2018,24246,22686,1,1560,6.40%
Okanogan,6/1/18,53047,6,2018,21815,20626,1,1189,5.50%
Pacific,6/1/18,53049,6,2018,8513,7959,1,554,6.50%
Pend Oreille,6/1/18,53051,6,2018,4797,4470,1,327,6.80%
Pierce,6/1/18,53053,6,2018,420955,398518,1,22437,5.30%
San Juan,6/1/18,53055,6,2018,8712,8397,1,315,3.60%
Skagit,6/1/18,53057,6,2018,60913,57733,1,3180,5.20%
Skamania,6/1/18,53059,6,2018,5292,5004,1,288,5.40%
Snohomish,6/1/18,53061,6,2018,429451,414491,1,14960,3.50%
Spokane,6/1/18,53063,6,2018,242953,230475,1,12478,5.10%
Stevens,6/1/18,53065,6,2018,18171,17007,1,1164,6.40%
Thurston,6/1/18,53067,6,2018,136648,129900,1,6748,4.90%
Wahkiakum,6/1/18,53069,6,2018,1322,1235,1,87,6.60%
Walla Walla,6/1/18,53071,6,2018,29931,28569,1,1362,4.60%
Whatcom,6/1/18,53073,6,2018,111657,106201,1,5456,4.90%
Whitman,6/1/18,53075,6,2018,21082,20030,1,1052,5.00%
Yakima,6/1/18,53077,6,2018,137724,130423,1,7301,5.30%
Adams,6/1/19,53001,6,2019,11077,10596,1,481,4.30%
Asotin,6/1/19,53003,6,2019,10278,9864,1,414,4.00%
Clallam,6/1/19,53009,6,2019,28865,26997,1,1868,6.50%
Clark,6/1/19,53011,6,2019,239487,227714,1,11773,4.90%
Columbia,6/1/19,53013,6,2019,1864,1770,1,94,5.00%
Cowlitz,6/1/19,53015,6,2019,47638,44672,1,2966,6.20%
Douglas,6/1/19,53017,6,2019,22802,21712,1,1090,4.80%
Ferry,6/1/19,53019,6,2019,2573,2317,1,256,9.90%
Franklin,6/1/19,53021,6,2019,45874,43347,1,2527,5.50%
Garfield,6/1/19,53023,6,2019,936,893,1,43,4.60%
Grant,6/1/19,53025,6,2019,49963,47202,1,2761,5.50%
Grays Harbor,6/1/19,53027,6,2019,29054,27060,1,1994,6.90%
Island,6/1/19,53029,6,2019,35965,34088,1,1877,5.20%
Jefferson,6/1/19,53031,6,2019,12947,12210,1,737,5.70%
King,6/1/19,53033,6,2019,1287036,1250770,1,36266,2.80%
Kitsap,6/1/19,53035,6,2019,127845,121693,1,6152,4.80%
Kittitas,6/1/19,53037,6,2019,23477,22222,1,1255,5.30%
Klickitat,6/1/19,53039,6,2019,11075,10472,1,603,5.40%
Lewis,6/1/19,53041,6,2019,34884,32797,1,2087,6.00%
Lincoln,6/1/19,53043,6,2019,5110,4872,1,238,4.70%
Mason,6/1/19,53045,6,2019,24910,23300,1,1610,6.50%
Okanogan,6/1/19,53047,6,2019,21218,20022,1,1196,5.60%
Pacific,6/1/19,53049,6,2019,8644,8062,1,582,6.70%
Pend Oreille,6/1/19,53051,6,2019,4994,4659,1,335,6.70%
Pierce,6/1/19,53053,6,2019,438243,415121,1,23122,5.30%
San Juan,6/1/19,53055,6,2019,9188,8869,1,319,3.50%
Skagit,6/1/19,53057,6,2019,63521,60058,1,3463,5.50%
Skamania,6/1/19,53059,6,2019,5495,5196,1,299,5.40%
Snohomish,6/1/19,53061,6,2019,438192,424926,1,13266,3.00%
Spokane,6/1/19,53063,6,2019,253127,240047,1,13080,5.20%
Stevens,6/1/19,53065,6,2019,18865,17693,1,1172,6.20%
Thurston,6/1/19,53067,6,2019,141189,134142,1,7047,5.00%
Wahkiakum,6/1/19,53069,6,2019,1348,1267,1,81,6.00%
Walla Walla,6/1/19,53071,6,2019,30500,29007,1,1493,4.90%
Whatcom,6/1/19,53073,6,2019,115468,109588,1,5880,5.10%
Whitman,6/1/19,53075,6,2019,21528,20426,1,1102,5.10%
Yakima,6/1/19,53077,6,2019,140204,132028,1,8176,5.80%
Adams,7/1/90,53001,7,1990,8596,7450,1,1146,13.30%
Asotin,7/1/90,53003,7,1990,9499,9082,1,417,4.40%
Clallam,7/1/90,53009,7,1990,23627,22427,1,1200,5.10%
Columbia,7/1/90,53013,7,1990,1233,1101,1,132,10.70%
Cowlitz,7/1/90,53015,7,1990,38576,36301,1,2275,5.90%
Douglas,7/1/90,53017,7,1990,18805,17696,1,1109,5.90%
Ferry,7/1/90,53019,7,1990,2810,2527,1,283,10.10%
Franklin,7/1/90,53021,7,1990,19723,17398,1,2325,11.80%
Garfield,7/1/90,53023,7,1990,1147,1130,1,17,1.50%
Grant,7/1/90,53025,7,1990,29603,27219,1,2384,8.10%
Grays Harbor,7/1/90,53027,7,1990,27440,25338,1,2102,7.70%
Island,7/1/90,53029,7,1990,23010,22290,1,720,3.10%
Jefferson,7/1/90,53031,7,1990,8634,8303,1,331,3.80%
King,7/1/90,53033,7,1990,868801,839311,1,29490,3.40%
Kitsap,7/1/90,53035,7,1990,84868,81412,1,3456,4.10%
Kittitas,7/1/90,53037,7,1990,11581,10663,1,918,7.90%
Klickitat,7/1/90,53039,7,1990,8390,7747,1,643,7.70%
Lewis,7/1/90,53041,7,1990,26223,24538,1,1685,6.40%
Lincoln,7/1/90,53043,7,1990,4505,4394,1,111,2.50%
Mason,7/1/90,53045,7,1990,15839,15025,1,814,5.10%
Okanogan,7/1/90,53047,7,1990,21062,19461,1,1601,7.60%
Pacific,7/1/90,53049,7,1990,8083,7620,1,463,5.70%
Pend Oreille,7/1/90,53051,7,1990,3560,3112,1,448,12.60%
Pierce,7/1/90,53053,7,1990,277982,265378,1,12604,4.50%
San Juan,7/1/90,53055,7,1990,6007,5902,1,105,1.70%
Skagit,7/1/90,53057,7,1990,41295,39114,1,2181,5.30%
Skamania,7/1/90,53059,7,1990,4068,3772,1,296,7.30%
Snohomish,7/1/90,53061,7,1990,252525,243252,1,9273,3.70%
Spokane,7/1/90,53063,7,1990,170769,161879,1,8890,5.20%
Stevens,7/1/90,53065,7,1990,13708,12765,1,943,6.90%
Thurston,7/1/90,53067,7,1990,81257,77444,1,3813,4.70%
Wahkiakum,7/1/90,53069,7,1990,1610,1541,1,69,4.30%
Walla Walla,7/1/90,53071,7,1990,24079,22859,1,1220,5.10%
Whatcom,7/1/90,53073,7,1990,69935,66646,1,3289,4.70%
Whitman,7/1/90,53075,7,1990,15813,15545,1,268,1.70%
Yakima,7/1/90,53077,7,1990,110484,100448,1,10036,9.10%
Adams,7/1/91,53001,7,1991,8772,7642,1,1130,12.90%
Asotin,7/1/91,53003,7,1991,9490,9049,1,441,4.60%
Clallam,7/1/91,53009,7,1991,23468,21836,1,1632,7.00%
Columbia,7/1/91,53013,7,1991,1218,1077,1,141,11.60%
Cowlitz,7/1/91,53015,7,1991,39016,36108,1,2908,7.50%
Douglas,7/1/91,53017,7,1991,19537,18467,1,1070,5.50%
Ferry,7/1/91,53019,7,1991,2761,2483,1,278,10.10%
Franklin,7/1/91,53021,7,1991,20623,17940,1,2683,13.00%
Garfield,7/1/91,53023,7,1991,1141,1124,1,17,1.50%
Grant,7/1/91,53025,7,1991,30201,27176,1,3025,10.00%
Grays Harbor,7/1/91,53027,7,1991,27004,24316,1,2688,10.00%
Island,7/1/91,53029,7,1991,22851,21905,1,946,4.10%
Jefferson,7/1/91,53031,7,1991,8275,7827,1,448,5.40%
King,7/1/91,53033,7,1991,876055,835752,1,40303,4.60%
Kitsap,7/1/91,53035,7,1991,86467,82228,1,4239,4.90%
Kittitas,7/1/91,53037,7,1991,12003,10886,1,1117,9.30%
Klickitat,7/1/91,53039,7,1991,8372,7603,1,769,9.20%
Lewis,7/1/91,53041,7,1991,25540,23183,1,2357,9.20%
Lincoln,7/1/91,53043,7,1991,4330,4191,1,139,3.20%
Mason,7/1/91,53045,7,1991,15533,14393,1,1140,7.30%
Okanogan,7/1/91,53047,7,1991,22650,20963,1,1687,7.40%
Pacific,7/1/91,53049,7,1991,7944,7334,1,610,7.70%
Pend Oreille,7/1/91,53051,7,1991,3511,3093,1,418,11.90%
Pierce,7/1/91,53053,7,1991,278164,261313,1,16851,6.10%
San Juan,7/1/91,53055,7,1991,6088,5937,1,151,2.50%
Skagit,7/1/91,53057,7,1991,42097,39232,1,2865,6.80%
Skamania,7/1/91,53059,7,1991,4082,3655,1,427,10.50%
Snohomish,7/1/91,53061,7,1991,258903,246122,1,12781,4.90%
Spokane,7/1/91,53063,7,1991,172753,162635,1,10118,5.90%
Stevens,7/1/91,53065,7,1991,14147,13032,1,1115,7.90%
Thurston,7/1/91,53067,7,1991,82300,77709,1,4591,5.60%
Wahkiakum,7/1/91,53069,7,1991,1599,1516,1,83,5.20%
Walla Walla,7/1/91,53071,7,1991,23929,22538,1,1391,5.80%
Whatcom,7/1/91,53073,7,1991,69237,65131,1,4106,5.90%
Whitman,7/1/91,53075,7,1991,15420,15134,1,286,1.90%
Yakima,7/1/91,53077,7,1991,108178,97779,1,10399,9.60%
Adams,7/1/92,53001,7,1992,9277,8176,1,1101,11.90%
Asotin,7/1/92,53003,7,1992,10238,9709,1,529,5.20%
Clallam,7/1/92,53009,7,1992,24019,22237,1,1782,7.40%
Columbia,7/1/92,53013,7,1992,1257,1087,1,170,13.50%
Cowlitz,7/1/92,53015,7,1992,38436,34625,1,3811,9.90%
Douglas,7/1/92,53017,7,1992,18993,17469,1,1524,8.00%
Ferry,7/1/92,53019,7,1992,2948,2592,1,356,12.10%
Franklin,7/1/92,53021,7,1992,21349,18879,1,2470,11.60%
Garfield,7/1/92,53023,7,1992,1169,1152,1,17,1.50%
Grant,7/1/92,53025,7,1992,31605,28090,1,3515,11.10%
Grays Harbor,7/1/92,53027,7,1992,28258,25238,1,3020,10.70%
Island,7/1/92,53029,7,1992,24065,22652,1,1413,5.90%
Jefferson,7/1/92,53031,7,1992,8973,8290,1,683,7.60%
King,7/1/92,53033,7,1992,909610,858090,1,51520,5.70%
Kitsap,7/1/92,53035,7,1992,88649,83467,1,5182,5.80%
Kittitas,7/1/92,53037,7,1992,13008,11341,1,1667,12.80%
Klickitat,7/1/92,53039,7,1992,8758,7615,1,1143,13.10%
Lewis,7/1/92,53041,7,1992,27652,24828,1,2824,10.20%
Lincoln,7/1/92,53043,7,1992,4651,4475,1,176,3.80%
Mason,7/1/92,53045,7,1992,15983,14724,1,1259,7.90%
Okanogan,7/1/92,53047,7,1992,22837,20724,1,2113,9.30%
Pacific,7/1/92,53049,7,1992,8257,7545,1,712,8.60%
Pend Oreille,7/1/92,53051,7,1992,3741,3295,1,446,11.90%
Pierce,7/1/92,53053,7,1992,286533,265529,1,21004,7.30%
San Juan,7/1/92,53055,7,1992,6273,6015,1,258,4.10%
Skagit,7/1/92,53057,7,1992,44647,40625,1,4022,9.00%
Skamania,7/1/92,53059,7,1992,3874,3233,1,641,16.50%
Snohomish,7/1/92,53061,7,1992,273200,256964,1,16236,5.90%
Spokane,7/1/92,53063,7,1992,178680,167285,1,11395,6.40%
Stevens,7/1/92,53065,7,1992,15026,13514,1,1512,10.10%
Thurston,7/1/92,53067,7,1992,87187,81620,1,5567,6.40%
Wahkiakum,7/1/92,53069,7,1992,1602,1527,1,75,4.70%
Walla Walla,7/1/92,53071,7,1992,24513,22979,1,1534,6.30%
Whatcom,7/1/92,53073,7,1992,74679,69523,1,5156,6.90%
Whitman,7/1/92,53075,7,1992,15353,14991,1,362,2.40%
Yakima,7/1/92,53077,7,1992,115541,101364,1,14177,12.30%
Adams,7/1/93,53001,7,1993,9355,8336,1,1019,10.90%
Asotin,7/1/93,53003,7,1993,10376,9854,1,522,5.00%
Clallam,7/1/93,53009,7,1993,23614,21545,1,2069,8.80%
Columbia,7/1/93,53013,7,1993,1741,1544,1,197,11.30%
Cowlitz,7/1/93,53015,7,1993,38825,34845,1,3980,10.30%
Douglas,7/1/93,53017,7,1993,20645,19355,1,1290,6.20%
Ferry,7/1/93,53019,7,1993,2916,2520,1,396,13.60%
Franklin,7/1/93,53021,7,1993,22224,19694,1,2530,11.40%
Garfield,7/1/93,53023,7,1993,1212,1152,1,60,5.00%
Grant,7/1/93,53025,7,1993,32226,28929,1,3297,10.20%
Grays Harbor,7/1/93,53027,7,1993,27950,23879,1,4071,14.60%
Island,7/1/93,53029,7,1993,23812,22710,1,1102,4.60%
Jefferson,7/1/93,53031,7,1993,9494,8857,1,637,6.70%
King,7/1/93,53033,7,1993,916757,860959,1,55798,6.10%
Kitsap,7/1/93,53035,7,1993,88358,82288,1,6070,6.90%
Kittitas,7/1/93,53037,7,1993,12888,11568,1,1320,10.20%
Klickitat,7/1/93,53039,7,1993,8887,7742,1,1145,12.90%
Lewis,7/1/93,53041,7,1993,27976,24881,1,3095,11.10%
Lincoln,7/1/93,53043,7,1993,4810,4594,1,216,4.50%
Mason,7/1/93,53045,7,1993,16581,15084,1,1497,9.00%
Okanogan,7/1/93,53047,7,1993,24373,22203,1,2170,8.90%
Pacific,7/1/93,53049,7,1993,8372,7536,1,836,10.00%
Pend Oreille,7/1/93,53051,7,1993,3918,3440,1,478,12.20%
Pierce,7/1/93,53053,7,1993,293602,271856,1,21746,7.40%
San Juan,7/1/93,53055,7,1993,6009,5718,1,291,4.80%
Skagit,7/1/93,53057,7,1993,45741,41267,1,4474,9.80%
Skamania,7/1/93,53059,7,1993,4365,3886,1,479,11.00%
Snohomish,7/1/93,53061,7,1993,279426,261705,1,17721,6.30%
Spokane,7/1/93,53063,7,1993,182668,173020,1,9648,5.30%
Stevens,7/1/93,53065,7,1993,15774,14343,1,1431,9.10%
Thurston,7/1/93,53067,7,1993,88178,82174,1,6004,6.80%
Wahkiakum,7/1/93,53069,7,1993,1762,1651,1,111,6.30%
Walla Walla,7/1/93,53071,7,1993,25126,23813,1,1313,5.20%
Whatcom,7/1/93,53073,7,1993,74735,69457,1,5278,7.10%
Whitman,7/1/93,53075,7,1993,15692,15300,1,392,2.50%
Yakima,7/1/93,53077,7,1993,118972,104452,1,14520,12.20%
Adams,7/1/94,53001,7,1994,9071,7874,1,1197,13.20%
Asotin,7/1/94,53003,7,1994,10692,10328,1,364,3.40%
Clallam,7/1/94,53009,7,1994,23772,21271,1,2501,10.50%
Columbia,7/1/94,53013,7,1994,2089,1969,1,120,5.70%
Cowlitz,7/1/94,53015,7,1994,39294,36186,1,3108,7.90%
Douglas,7/1/94,53017,7,1994,20778,19552,1,1226,5.90%
Ferry,7/1/94,53019,7,1994,3019,2705,1,314,10.40%
Franklin,7/1/94,53021,7,1994,22682,20756,1,1926,8.50%
Garfield,7/1/94,53023,7,1994,1118,1078,1,40,3.60%
Grant,7/1/94,53025,7,1994,35315,32095,1,3220,9.10%
Grays Harbor,7/1/94,53027,7,1994,27887,24421,1,3466,12.40%
Island,7/1/94,53029,7,1994,24363,23172,1,1191,4.90%
Jefferson,7/1/94,53031,7,1994,9631,8842,1,789,8.20%
King,7/1/94,53033,7,1994,901728,858513,1,43215,4.80%
Kitsap,7/1/94,53035,7,1994,89543,83959,1,5584,6.20%
Kittitas,7/1/94,53037,7,1994,13406,12289,1,1117,8.30%
Klickitat,7/1/94,53039,7,1994,8973,8110,1,863,9.60%
Lewis,7/1/94,53041,7,1994,28886,26374,1,2512,8.70%
Lincoln,7/1/94,53043,7,1994,4800,4563,1,237,4.90%
Mason,7/1/94,53045,7,1994,17098,15634,1,1464,8.60%
Okanogan,7/1/94,53047,7,1994,25132,22943,1,2189,8.70%
Pacific,7/1/94,53049,7,1994,8252,7339,1,913,11.10%
Pend Oreille,7/1/94,53051,7,1994,3835,3407,1,428,11.20%
Pierce,7/1/94,53053,7,1994,301182,280687,1,20495,6.80%
San Juan,7/1/94,53055,7,1994,6212,5944,1,268,4.30%
Skagit,7/1/94,53057,7,1994,52045,47711,1,4334,8.30%
Skamania,7/1/94,53059,7,1994,4134,3778,1,356,8.60%
Snohomish,7/1/94,53061,7,1994,280128,264844,1,15284,5.50%
Spokane,7/1/94,53063,7,1994,188783,179724,1,9059,4.80%
Stevens,7/1/94,53065,7,1994,16723,15386,1,1337,8.00%
Thurston,7/1/94,53067,7,1994,89520,83713,1,5807,6.50%
Wahkiakum,7/1/94,53069,7,1994,1733,1548,1,185,10.70%
Walla Walla,7/1/94,53071,7,1994,25372,24079,1,1293,5.10%
Whatcom,7/1/94,53073,7,1994,77576,71712,1,5864,7.60%
Whitman,7/1/94,53075,7,1994,15886,15544,1,342,2.20%
Yakima,7/1/94,53077,7,1994,115875,102871,1,13004,11.20%
Adams,7/1/95,53001,7,1995,9751,8724,1,1027,10.50%
Asotin,7/1/95,53003,7,1995,11361,10819,1,542,4.80%
Clallam,7/1/95,53009,7,1995,24979,23025,1,1954,7.80%
Columbia,7/1/95,53013,7,1995,1483,1349,1,134,9.00%
Cowlitz,7/1/95,53015,7,1995,41020,37919,1,3101,7.60%
Douglas,7/1/95,53017,7,1995,21451,20237,1,1214,5.70%
Ferry,7/1/95,53019,7,1995,3023,2668,1,355,11.70%
Franklin,7/1/95,53021,7,1995,23212,20955,1,2257,9.70%
Garfield,7/1/95,53023,7,1995,1093,1066,1,27,2.50%
Grant,7/1/95,53025,7,1995,35349,31949,1,3400,9.60%
Grays Harbor,7/1/95,53027,7,1995,28385,25431,1,2954,10.40%
Island,7/1/95,53029,7,1995,25402,24408,1,994,3.90%
Jefferson,7/1/95,53031,7,1995,10081,9396,1,685,6.80%
King,7/1/95,53033,7,1995,918275,870997,1,47278,5.10%
Kitsap,7/1/95,53035,7,1995,90397,84272,1,6125,6.80%
Kittitas,7/1/95,53037,7,1995,14234,12968,1,1266,8.90%
Klickitat,7/1/95,53039,7,1995,9304,8324,1,980,10.50%
Lewis,7/1/95,53041,7,1995,30049,27422,1,2627,8.70%
Lincoln,7/1/95,53043,7,1995,4932,4674,1,258,5.20%
Mason,7/1/95,53045,7,1995,18307,16834,1,1473,8.00%
Okanogan,7/1/95,53047,7,1995,25891,23626,1,2265,8.70%
Pacific,7/1/95,53049,7,1995,8604,7874,1,730,8.50%
Pend Oreille,7/1/95,53051,7,1995,4103,3597,1,506,12.30%
Pierce,7/1/95,53053,7,1995,316861,295961,1,20900,6.60%
San Juan,7/1/95,53055,7,1995,6612,6344,1,268,4.10%
Skagit,7/1/95,53057,7,1995,54255,50131,1,4124,7.60%
Skamania,7/1/95,53059,7,1995,4461,4074,1,387,8.70%
Snohomish,7/1/95,53061,7,1995,286398,271008,1,15390,5.40%
Spokane,7/1/95,53063,7,1995,197051,186671,1,10380,5.30%
Stevens,7/1/95,53065,7,1995,17146,15608,1,1538,9.00%
Thurston,7/1/95,53067,7,1995,94879,88794,1,6085,6.40%
Wahkiakum,7/1/95,53069,7,1995,1716,1621,1,95,5.50%
Walla Walla,7/1/95,53071,7,1995,26604,25303,1,1301,4.90%
Whatcom,7/1/95,53073,7,1995,83357,77758,1,5599,6.70%
Whitman,7/1/95,53075,7,1995,16183,15791,1,392,2.40%
Yakima,7/1/95,53077,7,1995,121570,108248,1,13322,11.00%
Adams,7/1/96,53001,7,1996,9981,9166,1,815,8.20%
Asotin,7/1/96,53003,7,1996,11872,11422,1,450,3.80%
Clallam,7/1/96,53009,7,1996,25121,22974,1,2147,8.50%
Columbia,7/1/96,53013,7,1996,1406,1222,1,184,13.10%
Cowlitz,7/1/96,53015,7,1996,42205,38753,1,3452,8.20%
Douglas,7/1/96,53017,7,1996,22631,21263,1,1368,6.00%
Ferry,7/1/96,53019,7,1996,2980,2669,1,311,10.40%
Franklin,7/1/96,53021,7,1996,23934,21343,1,2591,10.80%
Garfield,7/1/96,53023,7,1996,1206,1172,1,34,2.80%
Grant,7/1/96,53025,7,1996,38412,34890,1,3522,9.20%
Grays Harbor,7/1/96,53027,7,1996,28311,25304,1,3007,10.60%
Island,7/1/96,53029,7,1996,26346,25220,1,1126,4.30%
Jefferson,7/1/96,53031,7,1996,10380,9649,1,731,7.00%
King,7/1/96,53033,7,1996,939939,896916,1,43023,4.60%
Kitsap,7/1/96,53035,7,1996,94850,89090,1,5760,6.10%
Kittitas,7/1/96,53037,7,1996,14275,13221,1,1054,7.40%
Klickitat,7/1/96,53039,7,1996,9531,8567,1,964,10.10%
Lewis,7/1/96,53041,7,1996,30754,27894,1,2860,9.30%
Lincoln,7/1/96,53043,7,1996,5332,5100,1,232,4.40%
Mason,7/1/96,53045,7,1996,19232,17804,1,1428,7.40%
Okanogan,7/1/96,53047,7,1996,26704,24594,1,2110,7.90%
Pacific,7/1/96,53049,7,1996,8674,7934,1,740,8.50%
Pend Oreille,7/1/96,53051,7,1996,4276,3714,1,562,13.10%
Pierce,7/1/96,53053,7,1996,321520,302830,1,18690,5.80%
San Juan,7/1/96,53055,7,1996,6674,6402,1,272,4.10%
Skagit,7/1/96,53057,7,1996,50522,46578,1,3944,7.80%
Skamania,7/1/96,53059,7,1996,4362,3970,1,392,9.00%
Snohomish,7/1/96,53061,7,1996,296800,282297,1,14503,4.90%
Spokane,7/1/96,53063,7,1996,203405,193180,1,10225,5.00%
Stevens,7/1/96,53065,7,1996,17527,16017,1,1510,8.60%
Thurston,7/1/96,53067,7,1996,97983,91971,1,6012,6.10%
Wahkiakum,7/1/96,53069,7,1996,1842,1729,1,113,6.10%
Walla Walla,7/1/96,53071,7,1996,26986,25332,1,1654,6.10%
Whatcom,7/1/96,53073,7,1996,82408,76908,1,5500,6.70%
Whitman,7/1/96,53075,7,1996,17140,16747,1,393,2.30%
Yakima,7/1/96,53077,7,1996,126018,112916,1,13102,10.40%
Adams,7/1/97,53001,7,1997,11685,10545,1,1140,9.80%
Asotin,7/1/97,53003,7,1997,12455,12108,1,347,2.80%
Clallam,7/1/97,53009,7,1997,25661,23828,1,1833,7.10%
Columbia,7/1/97,53013,7,1997,1342,1216,1,126,9.40%
Cowlitz,7/1/97,53015,7,1997,42222,39517,1,2705,6.40%
Douglas,7/1/97,53017,7,1997,22663,21644,1,1019,4.50%
Ferry,7/1/97,53019,7,1997,2977,2741,1,236,7.90%
Franklin,7/1/97,53021,7,1997,22974,21324,1,1650,7.20%
Garfield,7/1/97,53023,7,1997,1164,1136,1,28,2.40%
Grant,7/1/97,53025,7,1997,40267,37517,1,2750,6.80%
Grays Harbor,7/1/97,53027,7,1997,28915,26556,1,2359,8.20%
Island,7/1/97,53029,7,1997,28248,27457,1,791,2.80%
Jefferson,7/1/97,53031,7,1997,10484,9903,1,581,5.50%
King,7/1/97,53033,7,1997,974586,935755,1,38831,4.00%
Kitsap,7/1/97,53035,7,1997,95122,90363,1,4759,5.00%
Kittitas,7/1/97,53037,7,1997,14393,13626,1,767,5.30%
Klickitat,7/1/97,53039,7,1997,9817,9013,1,804,8.20%
Lewis,7/1/97,53041,7,1997,32340,30096,1,2244,6.90%
Lincoln,7/1/97,53043,7,1997,5307,5134,1,173,3.30%
Mason,7/1/97,53045,7,1997,20092,18883,1,1209,6.00%
Okanogan,7/1/97,53047,7,1997,26891,25173,1,1718,6.40%
Pacific,7/1/97,53049,7,1997,9184,8535,1,649,7.10%
Pend Oreille,7/1/97,53051,7,1997,4389,3981,1,408,9.30%
Pierce,7/1/97,53053,7,1997,334736,320560,1,14176,4.20%
San Juan,7/1/97,53055,7,1997,7023,6799,1,224,3.20%
Skagit,7/1/97,53057,7,1997,52223,49110,1,3113,6.00%
Skamania,7/1/97,53059,7,1997,4496,4091,1,405,9.00%
Snohomish,7/1/97,53061,7,1997,315018,302791,1,12227,3.90%
Spokane,7/1/97,53063,7,1997,207878,199709,1,8169,3.90%
Stevens,7/1/97,53065,7,1997,17888,16507,1,1381,7.70%
Thurston,7/1/97,53067,7,1997,100665,95863,1,4802,4.80%
Wahkiakum,7/1/97,53069,7,1997,2000,1905,1,95,4.80%
Walla Walla,7/1/97,53071,7,1997,27817,26457,1,1360,4.90%
Whatcom,7/1/97,53073,7,1997,83419,79177,1,4242,5.10%
Whitman,7/1/97,53075,7,1997,17390,17105,1,285,1.60%
Yakima,7/1/97,53077,7,1997,123522,114087,1,9435,7.60%
Adams,7/1/98,53001,7,1998,10914,10185,1,729,6.70%
Asotin,7/1/98,53003,7,1998,13041,12528,1,513,3.90%
Clallam,7/1/98,53009,7,1998,25538,23722,1,1816,7.10%
Columbia,7/1/98,53013,7,1998,1595,1479,1,116,7.30%
Cowlitz,7/1/98,53015,7,1998,44166,41116,1,3050,6.90%
Douglas,7/1/98,53017,7,1998,23995,22723,1,1272,5.30%
Ferry,7/1/98,53019,7,1998,2815,2568,1,247,8.80%
Franklin,7/1/98,53021,7,1998,23611,21945,1,1666,7.10%
Garfield,7/1/98,53023,7,1998,1235,1203,1,32,2.60%
Grant,7/1/98,53025,7,1998,41636,38616,1,3020,7.30%
Grays Harbor,7/1/98,53027,7,1998,28545,26103,1,2442,8.60%
Island,7/1/98,53029,7,1998,29564,28673,1,891,3.00%
Jefferson,7/1/98,53031,7,1998,10507,9931,1,576,5.50%
King,7/1/98,53033,7,1998,985464,948963,1,36501,3.70%
Kitsap,7/1/98,53035,7,1998,94051,89602,1,4449,4.70%
Kittitas,7/1/98,53037,7,1998,14309,13603,1,706,4.90%
Klickitat,7/1/98,53039,7,1998,9527,8792,1,735,7.70%
Lewis,7/1/98,53041,7,1998,31204,28692,1,2512,8.10%
Lincoln,7/1/98,53043,7,1998,5456,5240,1,216,4.00%
Mason,7/1/98,53045,7,1998,20250,19099,1,1151,5.70%
Okanogan,7/1/98,53047,7,1998,27097,24876,1,2221,8.20%
Pacific,7/1/98,53049,7,1998,8653,8001,1,652,7.50%
Pend Oreille,7/1/98,53051,7,1998,4352,3933,1,419,9.60%
Pierce,7/1/98,53053,7,1998,341448,327165,1,14283,4.20%
San Juan,7/1/98,53055,7,1998,7082,6908,1,174,2.50%
Skagit,7/1/98,53057,7,1998,51929,48942,1,2987,5.80%
Skamania,7/1/98,53059,7,1998,4613,4277,1,336,7.30%
Snohomish,7/1/98,53061,7,1998,325312,313210,1,12102,3.70%
Spokane,7/1/98,53063,7,1998,209931,201442,1,8489,4.00%
Stevens,7/1/98,53065,7,1998,18124,16821,1,1303,7.20%
Thurston,7/1/98,53067,7,1998,104370,99631,1,4739,4.50%
Wahkiakum,7/1/98,53069,7,1998,1991,1886,1,105,5.30%
Walla Walla,7/1/98,53071,7,1998,28424,26936,1,1488,5.20%
Whatcom,7/1/98,53073,7,1998,83939,79722,1,4217,5.00%
Whitman,7/1/98,53075,7,1998,17489,17149,1,340,1.90%
Yakima,7/1/98,53077,7,1998,126167,116040,1,10127,8.00%
Adams,7/1/99,53001,7,1999,10163,9437,1,726,7.10%
Asotin,7/1/99,53003,7,1999,12670,12291,1,379,3.00%
Clallam,7/1/99,53009,7,1999,26555,24756,1,1799,6.80%
Columbia,7/1/99,53013,7,1999,1515,1379,1,136,9.00%
Cowlitz,7/1/99,53015,7,1999,43761,40824,1,2937,6.70%
Douglas,7/1/99,53017,7,1999,23055,21848,1,1207,5.20%
Ferry,7/1/99,53019,7,1999,2703,2456,1,247,9.10%
Franklin,7/1/99,53021,7,1999,24451,22490,1,1961,8.00%
Garfield,7/1/99,53023,7,1999,1252,1220,1,32,2.60%
Grant,7/1/99,53025,7,1999,42320,38784,1,3536,8.40%
Grays Harbor,7/1/99,53027,7,1999,27412,25351,1,2061,7.50%
Island,7/1/99,53029,7,1999,30811,29538,1,1273,4.10%
Jefferson,7/1/99,53031,7,1999,11712,11121,1,591,5.00%
King,7/1/99,53033,7,1999,988612,953198,1,35414,3.60%
Kitsap,7/1/99,53035,7,1999,98547,93586,1,4961,5.00%
Kittitas,7/1/99,53037,7,1999,14643,13936,1,707,4.80%
Klickitat,7/1/99,53039,7,1999,9401,8686,1,715,7.60%
Lewis,7/1/99,53041,7,1999,31405,28798,1,2607,8.30%
Lincoln,7/1/99,53043,7,1999,5059,4861,1,198,3.90%
Mason,7/1/99,53045,7,1999,20101,18853,1,1248,6.20%
Okanogan,7/1/99,53047,7,1999,25088,23155,1,1933,7.70%
Pacific,7/1/99,53049,7,1999,8496,7902,1,594,7.00%
Pend Oreille,7/1/99,53051,7,1999,4516,4127,1,389,8.60%
Pierce,7/1/99,53053,7,1999,347675,331309,1,16366,4.70%
San Juan,7/1/99,53055,7,1999,7770,7602,1,168,2.20%
Skagit,7/1/99,53057,7,1999,54659,51337,1,3322,6.10%
Skamania,7/1/99,53059,7,1999,4476,4152,1,324,7.20%
Snohomish,7/1/99,53061,7,1999,333066,318552,1,14514,4.40%
Spokane,7/1/99,53063,7,1999,217209,205706,1,11503,5.30%
Stevens,7/1/99,53065,7,1999,18002,16590,1,1412,7.80%
Thurston,7/1/99,53067,7,1999,105859,100970,1,4889,4.60%
Wahkiakum,7/1/99,53069,7,1999,2092,1955,1,137,6.50%
Walla Walla,7/1/99,53071,7,1999,28021,26470,1,1551,5.50%
Whatcom,7/1/99,53073,7,1999,86645,82329,1,4316,5.00%
Whitman,7/1/99,53075,7,1999,17371,17044,1,327,1.90%
Yakima,7/1/99,53077,7,1999,126010,115717,1,10293,8.20%
Adams,7/1/00,53001,7,2000,9090,8588,1,502,5.50%
Asotin,7/1/00,53003,7,2000,9535,9169,1,366,3.80%
Clallam,7/1/00,53009,7,2000,25906,24020,1,1886,7.30%
Columbia,7/1/00,53013,7,2000,1828,1697,1,131,7.20%
Cowlitz,7/1/00,53015,7,2000,43390,40444,1,2946,6.80%
Douglas,7/1/00,53017,7,2000,20568,19549,1,1019,5.00%
Ferry,7/1/00,53019,7,2000,3045,2789,1,256,8.40%
Franklin,7/1/00,53021,7,2000,23134,21562,1,1572,6.80%
Garfield,7/1/00,53023,7,2000,1129,1085,1,44,3.90%
Grant,7/1/00,53025,7,2000,37858,35241,1,2617,6.90%
Grays Harbor,7/1/00,53027,7,2000,29651,27475,1,2176,7.30%
Island,7/1/00,53029,7,2000,28580,27076,1,1504,5.30%
Jefferson,7/1/00,53031,7,2000,11870,11266,1,604,5.10%
King,7/1/00,53033,7,2000,993862,953455,1,40407,4.10%
Kitsap,7/1/00,53035,7,2000,104931,99170,1,5761,5.50%
Kittitas,7/1/00,53037,7,2000,16500,15578,1,922,5.60%
Klickitat,7/1/00,53039,7,2000,10000,9354,1,646,6.50%
Lewis,7/1/00,53041,7,2000,29824,27489,1,2335,7.80%
Lincoln,7/1/00,53043,7,2000,4941,4735,1,206,4.20%
Mason,7/1/00,53045,7,2000,20962,19545,1,1417,6.80%
Okanogan,7/1/00,53047,7,2000,22757,21069,1,1688,7.40%
Pacific,7/1/00,53049,7,2000,8955,8373,1,582,6.50%
Pend Oreille,7/1/00,53051,7,2000,4747,4398,1,349,7.40%
Pierce,7/1/00,53053,7,2000,337301,318404,1,18897,5.60%
San Juan,7/1/00,53055,7,2000,8389,8132,1,257,3.10%
Skagit,7/1/00,53057,7,2000,53600,50449,1,3151,5.90%
Skamania,7/1/00,53059,7,2000,4748,4482,1,266,5.60%
Snohomish,7/1/00,53061,7,2000,325284,311217,1,14067,4.30%
Spokane,7/1/00,53063,7,2000,207412,196243,1,11169,5.40%
Stevens,7/1/00,53065,7,2000,17689,16403,1,1286,7.30%
Thurston,7/1/00,53067,7,2000,107327,102021,1,5306,4.90%
Wahkiakum,7/1/00,53069,7,2000,1719,1595,1,124,7.20%
Walla Walla,7/1/00,53071,7,2000,27623,26168,1,1455,5.30%
Whatcom,7/1/00,53073,7,2000,87590,82860,1,4730,5.40%
Whitman,7/1/00,53075,7,2000,17395,16584,1,811,4.70%
Yakima,7/1/00,53077,7,2000,120599,112230,1,8369,6.90%
Adams,7/1/01,53001,7,2001,9411,8869,1,542,5.80%
Asotin,7/1/01,53003,7,2001,9594,9210,1,384,4.00%
Clallam,7/1/01,53009,7,2001,25551,23627,1,1924,7.50%
Columbia,7/1/01,53013,7,2001,1526,1405,1,121,7.90%
Cowlitz,7/1/01,53015,7,2001,41617,37554,1,4063,9.80%
Douglas,7/1/01,53017,7,2001,20247,19167,1,1080,5.30%
Ferry,7/1/01,53019,7,2001,2868,2608,1,260,9.10%
Franklin,7/1/01,53021,7,2001,23451,21856,1,1595,6.80%
Garfield,7/1/01,53023,7,2001,1119,1080,1,39,3.50%
Grant,7/1/01,53025,7,2001,37478,34842,1,2636,7.00%
Grays Harbor,7/1/01,53027,7,2001,28238,25813,1,2425,8.60%
Island,7/1/01,53029,7,2001,28436,26773,1,1663,5.80%
Jefferson,7/1/01,53031,7,2001,11897,11217,1,680,5.70%
King,7/1/01,53033,7,2001,1005401,955969,1,49432,4.90%
Kitsap,7/1/01,53035,7,2001,103755,97697,1,6058,5.80%
Kittitas,7/1/01,53037,7,2001,16524,15525,1,999,6.00%
Klickitat,7/1/01,53039,7,2001,9894,8968,1,926,9.40%
Lewis,7/1/01,53041,7,2001,28606,26268,1,2338,8.20%
Lincoln,7/1/01,53043,7,2001,4712,4472,1,240,5.10%
Mason,7/1/01,53045,7,2001,20238,18756,1,1482,7.30%
Okanogan,7/1/01,53047,7,2001,21715,20127,1,1588,7.30%
Pacific,7/1/01,53049,7,2001,8642,7985,1,657,7.60%
Pend Oreille,7/1/01,53051,7,2001,4642,4282,1,360,7.80%
Pierce,7/1/01,53053,7,2001,328063,307447,1,20616,6.30%
San Juan,7/1/01,53055,7,2001,8460,8172,1,288,3.40%
Skagit,7/1/01,53057,7,2001,52064,48778,1,3286,6.30%
Skamania,7/1/01,53059,7,2001,4704,4228,1,476,10.10%
Snohomish,7/1/01,53061,7,2001,333077,316327,1,16750,5.00%
Spokane,7/1/01,53063,7,2001,202834,190070,1,12764,6.30%
Stevens,7/1/01,53065,7,2001,17078,15733,1,1345,7.90%
Thurston,7/1/01,53067,7,2001,105085,99264,1,5821,5.50%
Wahkiakum,7/1/01,53069,7,2001,1556,1437,1,119,7.60%
Walla Walla,7/1/01,53071,7,2001,27024,25444,1,1580,5.80%
Whatcom,7/1/01,53073,7,2001,86576,81168,1,5408,6.20%
Whitman,7/1/01,53075,7,2001,16150,15404,1,746,4.60%
Yakima,7/1/01,53077,7,2001,115301,106492,1,8809,7.60%
Adams,7/1/02,53001,7,2002,9349,8804,1,545,5.80%
Asotin,7/1/02,53003,7,2002,10199,9548,1,651,6.40%
Clallam,7/1/02,53009,7,2002,26689,24460,1,2229,8.40%
Columbia,7/1/02,53013,7,2002,1598,1459,1,139,8.70%
Cowlitz,7/1/02,53015,7,2002,42831,38507,1,4324,10.10%
Douglas,7/1/02,53017,7,2002,20231,19138,1,1093,5.40%
Ferry,7/1/02,53019,7,2002,3002,2744,1,258,8.60%
Franklin,7/1/02,53021,7,2002,25295,23389,1,1906,7.50%
Garfield,7/1/02,53023,7,2002,1159,1108,1,51,4.40%
Grant,7/1/02,53025,7,2002,38202,35117,1,3085,8.10%
Grays Harbor,7/1/02,53027,7,2002,29107,26670,1,2437,8.40%
Island,7/1/02,53029,7,2002,30199,28056,1,2143,7.10%
Jefferson,7/1/02,53031,7,2002,12415,11532,1,883,7.10%
King,7/1/02,53033,7,2002,992391,929802,1,62589,6.30%
Kitsap,7/1/02,53035,7,2002,109850,102816,1,7034,6.40%
Kittitas,7/1/02,53037,7,2002,17265,16126,1,1139,6.60%
Klickitat,7/1/02,53039,7,2002,10291,9340,1,951,9.20%
Lewis,7/1/02,53041,7,2002,29186,26627,1,2559,8.80%
Lincoln,7/1/02,53043,7,2002,4737,4450,1,287,6.10%
Mason,7/1/02,53045,7,2002,21314,19649,1,1665,7.80%
Okanogan,7/1/02,53047,7,2002,22190,20641,1,1549,7.00%
Pacific,7/1/02,53049,7,2002,8849,8142,1,707,8.00%
Pend Oreille,7/1/02,53051,7,2002,4688,4296,1,392,8.40%
Pierce,7/1/02,53053,7,2002,340682,313906,1,26776,7.90%
San Juan,7/1/02,53055,7,2002,8721,8348,1,373,4.30%
Skagit,7/1/02,53057,7,2002,53703,49642,1,4061,7.60%
Skamania,7/1/02,53059,7,2002,4592,4189,1,403,8.80%
Snohomish,7/1/02,53061,7,2002,335796,311216,1,24580,7.30%
Spokane,7/1/02,53063,7,2002,206188,191260,1,14928,7.20%
Stevens,7/1/02,53065,7,2002,17522,15879,1,1643,9.40%
Thurston,7/1/02,53067,7,2002,109311,102418,1,6893,6.30%
Wahkiakum,7/1/02,53069,7,2002,1547,1406,1,141,9.10%
Walla Walla,7/1/02,53071,7,2002,28717,26983,1,1734,6.00%
Whatcom,7/1/02,53073,7,2002,90901,85006,1,5895,6.50%
Whitman,7/1/02,53075,7,2002,16897,15988,1,909,5.40%
Yakima,7/1/02,53077,7,2002,119259,109916,1,9343,7.80%
Adams,7/1/03,53001,7,2003,9243,8660,1,583,6.30%
Asotin,7/1/03,53003,7,2003,9940,9252,1,688,6.90%
Clallam,7/1/03,53009,7,2003,26984,24721,1,2263,8.40%
Columbia,7/1/03,53013,7,2003,1593,1441,1,152,9.50%
Cowlitz,7/1/03,53015,7,2003,42004,37859,1,4145,9.90%
Douglas,7/1/03,53017,7,2003,21232,20000,1,1232,5.80%
Ferry,7/1/03,53019,7,2003,2933,2584,1,349,11.90%
Franklin,7/1/03,53021,7,2003,26271,24376,1,1895,7.20%
Garfield,7/1/03,53023,7,2003,1168,1104,1,64,5.50%
Grant,7/1/03,53025,7,2003,38866,35937,1,2929,7.50%
Grays Harbor,7/1/03,53027,7,2003,29921,27243,1,2678,9.00%
Island,7/1/03,53029,7,2003,30338,28004,1,2334,7.70%
Jefferson,7/1/03,53031,7,2003,12871,11971,1,900,7.00%
King,7/1/03,53033,7,2003,994818,930854,1,63964,6.40%
Kitsap,7/1/03,53035,7,2003,112618,105201,1,7417,6.60%
Kittitas,7/1/03,53037,7,2003,18014,16722,1,1292,7.20%
Klickitat,7/1/03,53039,7,2003,10385,9318,1,1067,10.30%
Lewis,7/1/03,53041,7,2003,30152,27336,1,2816,9.30%
Lincoln,7/1/03,53043,7,2003,4863,4561,1,302,6.20%
Mason,7/1/03,53045,7,2003,22171,20300,1,1871,8.40%
Okanogan,7/1/03,53047,7,2003,24172,22610,1,1562,6.50%
Pacific,7/1/03,53049,7,2003,9278,8507,1,771,8.30%
Pend Oreille,7/1/03,53051,7,2003,4937,4480,1,457,9.30%
Pierce,7/1/03,53053,7,2003,343343,315145,1,28198,8.20%
San Juan,7/1/03,53055,7,2003,8955,8571,1,384,4.30%
Skagit,7/1/03,53057,7,2003,55431,51285,1,4146,7.50%
Skamania,7/1/03,53059,7,2003,4621,4190,1,431,9.30%
Snohomish,7/1/03,53061,7,2003,338038,312817,1,25221,7.50%
Spokane,7/1/03,53063,7,2003,208894,193576,1,15318,7.30%
Stevens,7/1/03,53065,7,2003,17729,16159,1,1570,8.90%
Thurston,7/1/03,53067,7,2003,112952,105461,1,7491,6.60%
Wahkiakum,7/1/03,53069,7,2003,1534,1374,1,160,10.40%
Walla Walla,7/1/03,53071,7,2003,29017,27290,1,1727,6.00%
Whatcom,7/1/03,53073,7,2003,94471,88176,1,6295,6.70%
Whitman,7/1/03,53075,7,2003,17120,16156,1,964,5.60%
Yakima,7/1/03,53077,7,2003,119475,109669,1,9806,8.20%
Adams,7/1/04,53001,7,2004,9225,8734,1,491,5.30%
Asotin,7/1/04,53003,7,2004,10067,9504,1,563,5.60%
Clallam,7/1/04,53009,7,2004,28701,26771,1,1930,6.70%
Columbia,7/1/04,53013,7,2004,1585,1470,1,115,7.30%
Cowlitz,7/1/04,53015,7,2004,42561,39149,1,3412,8.00%
Douglas,7/1/04,53017,7,2004,22292,21199,1,1093,4.90%
Ferry,7/1/04,53019,7,2004,3091,2811,1,280,9.10%
Franklin,7/1/04,53021,7,2004,27977,26314,1,1663,5.90%
Garfield,7/1/04,53023,7,2004,1210,1160,1,50,4.10%
Grant,7/1/04,53025,7,2004,39665,37094,1,2571,6.50%
Grays Harbor,7/1/04,53027,7,2004,31209,28797,1,2412,7.70%
Island,7/1/04,53029,7,2004,31605,29484,1,2121,6.70%
Jefferson,7/1/04,53031,7,2004,13546,12771,1,775,5.70%
King,7/1/04,53033,7,2004,999947,948615,1,51332,5.10%
Kitsap,7/1/04,53035,7,2004,118539,111803,1,6736,5.70%
Kittitas,7/1/04,53037,7,2004,18262,17031,1,1231,6.70%
Klickitat,7/1/04,53039,7,2004,10463,9688,1,775,7.40%
Lewis,7/1/04,53041,7,2004,30930,28541,1,2389,7.70%
Lincoln,7/1/04,53043,7,2004,4931,4640,1,291,5.90%
Mason,7/1/04,53045,7,2004,23531,21858,1,1673,7.10%
Okanogan,7/1/04,53047,7,2004,24978,23631,1,1347,5.40%
Pacific,7/1/04,53049,7,2004,9687,9054,1,633,6.50%
Pend Oreille,7/1/04,53051,7,2004,5015,4619,1,396,7.90%
Pierce,7/1/04,53053,7,2004,357463,332953,1,24510,6.90%
San Juan,7/1/04,53055,7,2004,9413,9073,1,340,3.60%
Skagit,7/1/04,53057,7,2004,56672,53091,1,3581,6.30%
Skamania,7/1/04,53059,7,2004,4860,4509,1,351,7.20%
Snohomish,7/1/04,53061,7,2004,339301,320281,1,19020,5.60%
Spokane,7/1/04,53063,7,2004,215574,202208,1,13366,6.20%
Stevens,7/1/04,53065,7,2004,18311,16990,1,1321,7.20%
Thurston,7/1/04,53067,7,2004,118474,111773,1,6701,5.70%
Wahkiakum,7/1/04,53069,7,2004,1605,1489,1,116,7.20%
Walla Walla,7/1/04,53071,7,2004,29713,28089,1,1624,5.50%
Whatcom,7/1/04,53073,7,2004,99807,94100,1,5707,5.70%
Whitman,7/1/04,53075,7,2004,18110,17168,1,942,5.20%
Yakima,7/1/04,53077,7,2004,122064,113200,1,8864,7.30%
Adams,7/1/05,53001,7,2005,9269,8705,1,564,6.10%
Asotin,7/1/05,53003,7,2005,10352,9782,1,570,5.50%
Clallam,7/1/05,53009,7,2005,29931,28067,1,1864,6.20%
Columbia,7/1/05,53013,7,2005,1579,1472,1,107,6.80%
Cowlitz,7/1/05,53015,7,2005,43186,40196,1,2990,6.90%
Douglas,7/1/05,53017,7,2005,23034,22103,1,931,4.00%
Ferry,7/1/05,53019,7,2005,3052,2807,1,245,8.00%
Franklin,7/1/05,53021,7,2005,29375,27492,1,1883,6.40%
Garfield,7/1/05,53023,7,2005,1194,1140,1,54,4.50%
Grant,7/1/05,53025,7,2005,40822,38466,1,2356,5.80%
Grays Harbor,7/1/05,53027,7,2005,31577,29339,1,2238,7.10%
Island,7/1/05,53029,7,2005,31695,29802,1,1893,6.00%
Jefferson,7/1/05,53031,7,2005,13673,12961,1,712,5.20%
King,7/1/05,53033,7,2005,1023100,975480,1,47620,4.70%
Kitsap,7/1/05,53035,7,2005,121265,115103,1,6162,5.10%
Kittitas,7/1/05,53037,7,2005,18530,17464,1,1066,5.80%
Klickitat,7/1/05,53039,7,2005,9987,9351,1,636,6.40%
Lewis,7/1/05,53041,7,2005,30657,28340,1,2317,7.60%
Lincoln,7/1/05,53043,7,2005,4871,4607,1,264,5.40%
Mason,7/1/05,53045,7,2005,24195,22670,1,1525,6.30%
Okanogan,7/1/05,53047,7,2005,26635,25366,1,1269,4.80%
Pacific,7/1/05,53049,7,2005,9345,8777,1,568,6.10%
Pend Oreille,7/1/05,53051,7,2005,5136,4774,1,362,7.00%
Pierce,7/1/05,53053,7,2005,366835,345304,1,21531,5.90%
San Juan,7/1/05,53055,7,2005,9288,8960,1,328,3.50%
Skagit,7/1/05,53057,7,2005,57668,54406,1,3262,5.70%
Skamania,7/1/05,53059,7,2005,4932,4615,1,317,6.40%
Snohomish,7/1/05,53061,7,2005,349848,332392,1,17456,5.00%
Spokane,7/1/05,53063,7,2005,219952,207891,1,12061,5.50%
Stevens,7/1/05,53065,7,2005,18192,16947,1,1245,6.80%
Thurston,7/1/05,53067,7,2005,121052,114880,1,6172,5.10%
Wahkiakum,7/1/05,53069,7,2005,1630,1520,1,110,6.70%
Walla Walla,7/1/05,53071,7,2005,29557,27967,1,1590,5.40%
Whatcom,7/1/05,53073,7,2005,102703,97540,1,5163,5.00%
Whitman,7/1/05,53075,7,2005,18318,17391,1,927,5.10%
Yakima,7/1/05,53077,7,2005,122797,114785,1,8012,6.50%
Adams,7/1/06,53001,7,2006,8657,8205,1,452,5.20%
Asotin,7/1/06,53003,7,2006,10228,9745,1,483,4.70%
Clallam,7/1/06,53009,7,2006,29612,27779,1,1833,6.20%
Columbia,7/1/06,53013,7,2006,1536,1422,1,114,7.40%
Cowlitz,7/1/06,53015,7,2006,42640,39643,1,2997,7.00%
Douglas,7/1/06,53017,7,2006,24412,23444,1,968,4.00%
Ferry,7/1/06,53019,7,2006,2950,2692,1,258,8.70%
Franklin,7/1/06,53021,7,2006,30385,28340,1,2045,6.70%
Garfield,7/1/06,53023,7,2006,1141,1090,1,51,4.50%
Grant,7/1/06,53025,7,2006,41964,39625,1,2339,5.60%
Grays Harbor,7/1/06,53027,7,2006,31328,29149,1,2179,7.00%
Island,7/1/06,53029,7,2006,32320,30539,1,1781,5.50%
Jefferson,7/1/06,53031,7,2006,13544,12817,1,727,5.40%
King,7/1/06,53033,7,2006,1052725,1010087,1,42638,4.10%
Kitsap,7/1/06,53035,7,2006,120803,114544,1,6259,5.20%
Kittitas,7/1/06,53037,7,2006,18842,17798,1,1044,5.50%
Klickitat,7/1/06,53039,7,2006,10213,9560,1,653,6.40%
Lewis,7/1/06,53041,7,2006,31334,29129,1,2205,7.00%
Lincoln,7/1/06,53043,7,2006,4763,4495,1,268,5.60%
Mason,7/1/06,53045,7,2006,24373,22872,1,1501,6.20%
Okanogan,7/1/06,53047,7,2006,26164,24835,1,1329,5.10%
Pacific,7/1/06,53049,7,2006,9456,8827,1,629,6.70%
Pend Oreille,7/1/06,53051,7,2006,5161,4802,1,359,7.00%
Pierce,7/1/06,53053,7,2006,367748,347122,1,20626,5.60%
San Juan,7/1/06,53055,7,2006,9157,8838,1,319,3.50%
Skagit,7/1/06,53057,7,2006,57971,54947,1,3024,5.20%
Skamania,7/1/06,53059,7,2006,4986,4632,1,354,7.10%
Snohomish,7/1/06,53061,7,2006,361074,345122,1,15952,4.40%
Spokane,7/1/06,53063,7,2006,220683,208965,1,11718,5.30%
Stevens,7/1/06,53065,7,2006,18274,17031,1,1243,6.80%
Thurston,7/1/06,53067,7,2006,122244,116092,1,6152,5.00%
Wahkiakum,7/1/06,53069,7,2006,1645,1543,1,102,6.20%
Walla Walla,7/1/06,53071,7,2006,29305,27741,1,1564,5.30%
Whatcom,7/1/06,53073,7,2006,102764,97737,1,5027,4.90%
Whitman,7/1/06,53075,7,2006,18114,17178,1,936,5.20%
Yakima,7/1/06,53077,7,2006,127405,119880,1,7525,5.90%
Adams,7/1/07,53001,7,2007,8481,8062,1,419,4.90%
Asotin,7/1/07,53003,7,2007,10092,9617,1,475,4.70%
Clallam,7/1/07,53009,7,2007,30292,28443,1,1849,6.10%
Columbia,7/1/07,53013,7,2007,1547,1446,1,101,6.50%
Cowlitz,7/1/07,53015,7,2007,43802,40920,1,2882,6.60%
Douglas,7/1/07,53017,7,2007,25324,24345,1,979,3.90%
Ferry,7/1/07,53019,7,2007,3055,2840,1,215,7.00%
Franklin,7/1/07,53021,7,2007,32385,30400,1,1985,6.10%
Garfield,7/1/07,53023,7,2007,1106,1057,1,49,4.40%
Grant,7/1/07,53025,7,2007,43199,41017,1,2182,5.10%
Grays Harbor,7/1/07,53027,7,2007,31545,29414,1,2131,6.80%
Island,7/1/07,53029,7,2007,33013,31196,1,1817,5.50%
Jefferson,7/1/07,53031,7,2007,13780,13099,1,681,4.90%
King,7/1/07,53033,7,2007,1079850,1042984,1,36866,3.40%
Kitsap,7/1/07,53035,7,2007,123059,117076,1,5983,4.90%
Kittitas,7/1/07,53037,7,2007,19769,18740,1,1029,5.20%
Klickitat,7/1/07,53039,7,2007,10028,9407,1,621,6.20%
Lewis,7/1/07,53041,7,2007,30767,28620,1,2147,7.00%
Lincoln,7/1/07,53043,7,2007,4801,4553,1,248,5.20%
Mason,7/1/07,53045,7,2007,25166,23652,1,1514,6.00%
Okanogan,7/1/07,53047,7,2007,26442,25201,1,1241,4.70%
Pacific,7/1/07,53049,7,2007,9796,9207,1,589,6.00%
Pend Oreille,7/1/07,53051,7,2007,5354,5005,1,349,6.50%
Pierce,7/1/07,53053,7,2007,382891,362819,1,20072,5.20%
San Juan,7/1/07,53055,7,2007,9797,9497,1,300,3.10%
Skagit,7/1/07,53057,7,2007,58739,55818,1,2921,5.00%
Skamania,7/1/07,53059,7,2007,4949,4639,1,310,6.30%
Snohomish,7/1/07,53061,7,2007,367488,353788,1,13700,3.70%
Spokane,7/1/07,53063,7,2007,227547,215839,1,11708,5.10%
Stevens,7/1/07,53065,7,2007,18611,17361,1,1250,6.70%
Thurston,7/1/07,53067,7,2007,127077,121057,1,6020,4.70%
Wahkiakum,7/1/07,53069,7,2007,1687,1571,1,116,6.90%
Walla Walla,7/1/07,53071,7,2007,29999,28509,1,1490,5.00%
Whatcom,7/1/07,53073,7,2007,106797,101839,1,4958,4.60%
Whitman,7/1/07,53075,7,2007,18008,17021,1,987,5.50%
Yakima,7/1/07,53077,7,2007,126467,119155,1,7312,5.80%
Adams,7/1/08,53001,7,2008,8602,8155,1,447,5.20%
Asotin,7/1/08,53003,7,2008,10146,9577,1,569,5.60%
Clallam,7/1/08,53009,7,2008,30261,28168,1,2093,6.90%
Columbia,7/1/08,53013,7,2008,1580,1474,1,106,6.70%
Cowlitz,7/1/08,53015,7,2008,43940,40382,1,3558,8.10%
Douglas,7/1/08,53017,7,2008,24465,23415,1,1050,4.30%
Ferry,7/1/08,53019,7,2008,2978,2748,1,230,7.70%
Franklin,7/1/08,53021,7,2008,34806,32799,1,2007,5.80%
Garfield,7/1/08,53023,7,2008,1099,1055,1,44,4.00%
Grant,7/1/08,53025,7,2008,43211,40854,1,2357,5.50%
Grays Harbor,7/1/08,53027,7,2008,31910,29624,1,2286,7.20%
Island,7/1/08,53029,7,2008,33125,31265,1,1860,5.60%
Jefferson,7/1/08,53031,7,2008,13956,13202,1,754,5.40%
King,7/1/08,53033,7,2008,1105323,1058758,1,46565,4.20%
Kitsap,7/1/08,53035,7,2008,124313,117800,1,6513,5.20%
Kittitas,7/1/08,53037,7,2008,20254,19072,1,1182,5.80%
Klickitat,7/1/08,53039,7,2008,10891,10166,1,725,6.70%
Lewis,7/1/08,53041,7,2008,31031,28573,1,2458,7.90%
Lincoln,7/1/08,53043,7,2008,4910,4660,1,250,5.10%
Mason,7/1/08,53045,7,2008,25268,23606,1,1662,6.60%
Okanogan,7/1/08,53047,7,2008,26071,24825,1,1246,4.80%
Pacific,7/1/08,53049,7,2008,9417,8765,1,652,6.90%
Pend Oreille,7/1/08,53051,7,2008,5588,5151,1,437,7.80%
Pierce,7/1/08,53053,7,2008,389080,366290,1,22790,5.90%
San Juan,7/1/08,53055,7,2008,10105,9780,1,325,3.20%
Skagit,7/1/08,53057,7,2008,59636,56321,1,3315,5.60%
Skamania,7/1/08,53059,7,2008,5058,4654,1,404,8.00%
Snohomish,7/1/08,53061,7,2008,377820,359581,1,18239,4.80%
Spokane,7/1/08,53063,7,2008,233772,220722,1,13050,5.60%
Stevens,7/1/08,53065,7,2008,18995,17626,1,1369,7.20%
Thurston,7/1/08,53067,7,2008,130500,123778,1,6722,5.20%
Wahkiakum,7/1/08,53069,7,2008,1802,1678,1,124,6.90%
Walla Walla,7/1/08,53071,7,2008,31410,29912,1,1498,4.80%
Whatcom,7/1/08,53073,7,2008,109247,103572,1,5675,5.20%
Whitman,7/1/08,53075,7,2008,19533,18484,1,1049,5.40%
Yakima,7/1/08,53077,7,2008,130522,122298,1,8224,6.30%
Adams,7/1/09,53001,7,2009,9058,8385,1,673,7.40%
Asotin,7/1/09,53003,7,2009,10198,9226,1,972,9.50%
Clallam,7/1/09,53009,7,2009,30381,27398,1,2983,9.80%
Columbia,7/1/09,53013,7,2009,1624,1471,1,153,9.40%
Cowlitz,7/1/09,53015,7,2009,44336,38338,1,5998,13.50%
Douglas,7/1/09,53017,7,2009,28331,26729,1,1602,5.70%
Ferry,7/1/09,53019,7,2009,3077,2714,1,363,11.80%
Franklin,7/1/09,53021,7,2009,38113,35518,1,2595,6.80%
Garfield,7/1/09,53023,7,2009,1080,1017,1,63,5.80%
Grant,7/1/09,53025,7,2009,47026,43309,1,3717,7.90%
Grays Harbor,7/1/09,53027,7,2009,31818,27826,1,3992,12.50%
Island,7/1/09,53029,7,2009,32691,29790,1,2901,8.90%
Jefferson,7/1/09,53031,7,2009,13263,12194,1,1069,8.10%
King,7/1/09,53033,7,2009,1130598,1031229,1,99369,8.80%
Kitsap,7/1/09,53035,7,2009,124025,114375,1,9650,7.80%
Kittitas,7/1/09,53037,7,2009,19988,18159,1,1829,9.20%
Klickitat,7/1/09,53039,7,2009,11838,10824,1,1014,8.60%
Lewis,7/1/09,53041,7,2009,31405,27348,1,4057,12.90%
Lincoln,7/1/09,53043,7,2009,4969,4589,1,380,7.60%
Mason,7/1/09,53045,7,2009,25183,22705,1,2478,9.80%
Okanogan,7/1/09,53047,7,2009,26950,25089,1,1861,6.90%
Pacific,7/1/09,53049,7,2009,9533,8424,1,1109,11.60%
Pend Oreille,7/1/09,53051,7,2009,5541,4768,1,773,14.00%
Pierce,7/1/09,53053,7,2009,390746,352242,1,38504,9.90%
San Juan,7/1/09,53055,7,2009,9578,9082,1,496,5.20%
Skagit,7/1/09,53057,7,2009,59362,53474,1,5888,9.90%
Skamania,7/1/09,53059,7,2009,4992,4359,1,633,12.70%
Snohomish,7/1/09,53061,7,2009,387304,348226,1,39078,10.10%
Spokane,7/1/09,53063,7,2009,233311,212392,1,20919,9.00%
Stevens,7/1/09,53065,7,2009,18850,16555,1,2295,12.20%
Thurston,7/1/09,53067,7,2009,129314,119101,1,10213,7.90%
Wahkiakum,7/1/09,53069,7,2009,1682,1464,1,218,13.00%
Walla Walla,7/1/09,53071,7,2009,31866,29916,1,1950,6.10%
Whatcom,7/1/09,53073,7,2009,107570,98198,1,9372,8.70%
Whitman,7/1/09,53075,7,2009,20017,18677,1,1340,6.70%
Yakima,7/1/09,53077,7,2009,138274,128090,1,10184,7.40%
Adams,7/1/10,53001,7,2010,9334,8561,1,773,8.30%
Asotin,7/1/10,53003,7,2010,10162,9310,1,852,8.40%
Clallam,7/1/10,53009,7,2010,29619,26622,1,2997,10.10%
Columbia,7/1/10,53013,7,2010,1922,1761,1,161,8.40%
Cowlitz,7/1/10,53015,7,2010,46019,40402,1,5617,12.20%
Douglas,7/1/10,53017,7,2010,23404,21799,1,1605,6.90%
Ferry,7/1/10,53019,7,2010,2659,2248,1,411,15.50%
Franklin,7/1/10,53021,7,2010,40439,37407,1,3032,7.50%
Garfield,7/1/10,53023,7,2010,1120,1042,1,78,7.00%
Grant,7/1/10,53025,7,2010,46242,42162,1,4080,8.80%
Grays Harbor,7/1/10,53027,7,2010,31067,27110,1,3957,12.70%
Island,7/1/10,53029,7,2010,33419,30573,1,2846,8.50%
Jefferson,7/1/10,53031,7,2010,12763,11576,1,1187,9.30%
King,7/1/10,53033,7,2010,1113102,1012121,1,100981,9.10%
Kitsap,7/1/10,53035,7,2010,119450,109741,1,9709,8.10%
Kittitas,7/1/10,53037,7,2010,20292,18349,1,1943,9.60%
Klickitat,7/1/10,53039,7,2010,10904,9812,1,1092,10.00%
Lewis,7/1/10,53041,7,2010,33537,29478,1,4059,12.10%
Lincoln,7/1/10,53043,7,2010,5402,4990,1,412,7.60%
Mason,7/1/10,53045,7,2010,24664,21961,1,2703,11.00%
Okanogan,7/1/10,53047,7,2010,27475,25480,1,1995,7.30%
Pacific,7/1/10,53049,7,2010,8933,7833,1,1100,12.30%
Pend Oreille,7/1/10,53051,7,2010,4988,4311,1,677,13.60%
Pierce,7/1/10,53053,7,2010,388885,350465,1,38420,9.90%
San Juan,7/1/10,53055,7,2010,9245,8711,1,534,5.80%
Skagit,7/1/10,53057,7,2010,59783,53862,1,5921,9.90%
Skamania,7/1/10,53059,7,2010,5038,4447,1,591,11.70%
Snohomish,7/1/10,53061,7,2010,389673,347706,1,41967,10.80%
Spokane,7/1/10,53063,7,2010,232142,210191,1,21951,9.50%
Stevens,7/1/10,53065,7,2010,18715,16449,1,2266,12.10%
Thurston,7/1/10,53067,7,2010,125131,114456,1,10675,8.50%
Wahkiakum,7/1/10,53069,7,2010,1470,1263,1,207,14.10%
Walla Walla,7/1/10,53071,7,2010,31155,28884,1,2271,7.30%
Whatcom,7/1/10,53073,7,2010,103873,94600,1,9273,8.90%
Whitman,7/1/10,53075,7,2010,20087,18404,1,1683,8.40%
Yakima,7/1/10,53077,7,2010,131320,119856,1,11464,8.70%
Adams,7/1/11,53001,7,2011,8946,8196,1,750,8.40%
Asotin,7/1/11,53003,7,2011,9784,8953,1,831,8.50%
Clallam,7/1/11,53009,7,2011,28391,25481,1,2910,10.20%
Columbia,7/1/11,53013,7,2011,1817,1651,1,166,9.10%
Cowlitz,7/1/11,53015,7,2011,44611,39536,1,5075,11.40%
Douglas,7/1/11,53017,7,2011,22676,21087,1,1589,7.00%
Ferry,7/1/11,53019,7,2011,2577,2163,1,414,16.10%
Franklin,7/1/11,53021,7,2011,40681,37473,1,3208,7.90%
Garfield,7/1/11,53023,7,2011,1047,975,1,72,6.90%
Grant,7/1/11,53025,7,2011,46289,42387,1,3902,8.40%
Grays Harbor,7/1/11,53027,7,2011,29816,25962,1,3854,12.90%
Island,7/1/11,53029,7,2011,32165,29275,1,2890,9.00%
Jefferson,7/1/11,53031,7,2011,11965,10774,1,1191,10.00%
King,7/1/11,53033,7,2011,1117663,1026227,1,91436,8.20%
Kitsap,7/1/11,53035,7,2011,115862,106343,1,9519,8.20%
Kittitas,7/1/11,53037,7,2011,19560,17736,1,1824,9.30%
Klickitat,7/1/11,53039,7,2011,10990,9872,1,1118,10.20%
Lewis,7/1/11,53041,7,2011,32013,28133,1,3880,12.10%
Lincoln,7/1/11,53043,7,2011,5287,4884,1,403,7.60%
Mason,7/1/11,53045,7,2011,23321,20713,1,2608,11.20%
Okanogan,7/1/11,53047,7,2011,25983,24082,1,1901,7.30%
Pacific,7/1/11,53049,7,2011,8318,7304,1,1014,12.20%
Pend Oreille,7/1/11,53051,7,2011,4723,4085,1,638,13.50%
Pierce,7/1/11,53053,7,2011,379976,342117,1,37859,10.00%
San Juan,7/1/11,53055,7,2011,8957,8442,1,515,5.70%
Skagit,7/1/11,53057,7,2011,57038,51356,1,5682,10.00%
Skamania,7/1/11,53059,7,2011,4954,4379,1,575,11.60%
Snohomish,7/1/11,53061,7,2011,387732,349774,1,37958,9.80%
Spokane,7/1/11,53063,7,2011,224016,202915,1,21101,9.40%
Stevens,7/1/11,53065,7,2011,17825,15728,1,2097,11.80%
Thurston,7/1/11,53067,7,2011,120464,109760,1,10704,8.90%
Wahkiakum,7/1/11,53069,7,2011,1407,1212,1,195,13.90%
Walla Walla,7/1/11,53071,7,2011,30074,27802,1,2272,7.60%
Whatcom,7/1/11,53073,7,2011,101440,92344,1,9096,9.00%
Whitman,7/1/11,53075,7,2011,19795,18158,1,1637,8.30%
Yakima,7/1/11,53077,7,2011,131404,119687,1,11717,8.90%
Adams,7/1/12,53001,7,2012,8990,8291,1,699,7.80%
Asotin,7/1/12,53003,7,2012,9570,8816,1,754,7.90%
Clallam,7/1/12,53009,7,2012,28191,25296,1,2895,10.30%
Clark,7/1/12,53011,7,2012,205558,185734,1,19824,9.60%
Columbia,7/1/12,53013,7,2012,1793,1649,1,144,8.00%
Cowlitz,7/1/12,53015,7,2012,44059,39312,1,4747,10.80%
Douglas,7/1/12,53017,7,2012,23133,21568,1,1565,6.80%
Ferry,7/1/12,53019,7,2012,2532,2171,1,361,14.30%
Franklin,7/1/12,53021,7,2012,41487,37874,1,3613,8.70%
Garfield,7/1/12,53023,7,2012,1070,994,1,76,7.10%
Grant,7/1/12,53025,7,2012,47698,43866,1,3832,8.00%
Grays Harbor,7/1/12,53027,7,2012,28865,25252,1,3613,12.50%
Island,7/1/12,53029,7,2012,32016,29404,1,2612,8.20%
Jefferson,7/1/12,53031,7,2012,11910,10782,1,1128,9.50%
King,7/1/12,53033,7,2012,1130634,1054076,1,76558,6.80%
Kitsap,7/1/12,53035,7,2012,114384,105186,1,9198,8.00%
Kittitas,7/1/12,53037,7,2012,19627,17853,1,1774,9.00%
Klickitat,7/1/12,53039,7,2012,10757,9778,1,979,9.10%
Lewis,7/1/12,53041,7,2012,31902,28112,1,3790,11.90%
Lincoln,7/1/12,53043,7,2012,5257,4895,1,362,6.90%
Mason,7/1/12,53045,7,2012,23269,20734,1,2535,10.90%
Okanogan,7/1/12,53047,7,2012,26512,24719,1,1793,6.80%
Pacific,7/1/12,53049,7,2012,8344,7427,1,917,11.00%
Pend Oreille,7/1/12,53051,7,2012,4700,4113,1,587,12.50%
Pierce,7/1/12,53053,7,2012,380611,344594,1,36017,9.50%
San Juan,7/1/12,53055,7,2012,8926,8485,1,441,4.90%
Skagit,7/1/12,53057,7,2012,57521,52166,1,5355,9.30%
Skamania,7/1/12,53059,7,2012,4933,4413,1,520,10.50%
Snohomish,7/1/12,53061,7,2012,388549,357693,1,30856,7.90%
Spokane,7/1/12,53063,7,2012,224603,204094,1,20509,9.10%
Stevens,7/1/12,53065,7,2012,17855,15790,1,2065,11.60%
Thurston,7/1/12,53067,7,2012,120850,110482,1,10368,8.60%
Wahkiakum,7/1/12,53069,7,2012,1388,1216,1,172,12.40%
Walla Walla,7/1/12,53071,7,2012,29729,27480,1,2249,7.60%
Whatcom,7/1/12,53073,7,2012,102926,94321,1,8605,8.40%
Whitman,7/1/12,53075,7,2012,20198,18398,1,1800,8.90%
Yakima,7/1/12,53077,7,2012,133987,122297,1,11690,8.70%
Adams,7/1/13,53001,7,2013,9209,8594,1,615,6.70%
Asotin,7/1/13,53003,7,2013,9733,9117,1,616,6.30%
Clallam,7/1/13,53009,7,2013,27454,24994,1,2460,9.00%
Clark,7/1/13,53011,7,2013,206053,188710,1,17343,8.40%
Columbia,7/1/13,53013,7,2013,1761,1631,1,130,7.40%
Cowlitz,7/1/13,53015,7,2013,42570,38425,1,4145,9.70%
Douglas,7/1/13,53017,7,2013,21586,20253,1,1333,6.20%
Ferry,7/1/13,53019,7,2013,2483,2178,1,305,12.30%
Franklin,7/1/13,53021,7,2013,38992,35616,1,3376,8.70%
Garfield,7/1/13,53023,7,2013,1059,994,1,65,6.10%
Grant,7/1/13,53025,7,2013,47615,44146,1,3469,7.30%
Grays Harbor,7/1/13,53027,7,2013,27958,24852,1,3106,11.10%
Island,7/1/13,53029,7,2013,31696,29426,1,2270,7.20%
Jefferson,7/1/13,53031,7,2013,11586,10589,1,997,8.60%
King,7/1/13,53033,7,2013,1144056,1084215,1,59841,5.20%
Kitsap,7/1/13,53035,7,2013,113082,105038,1,8044,7.10%
Kittitas,7/1/13,53037,7,2013,19739,18271,1,1468,7.40%
Klickitat,7/1/13,53039,7,2013,10458,9623,1,835,8.00%
Lewis,7/1/13,53041,7,2013,31168,27981,1,3187,10.20%
Lincoln,7/1/13,53043,7,2013,5158,4841,1,317,6.10%
Mason,7/1/13,53045,7,2013,23320,21100,1,2220,9.50%
Okanogan,7/1/13,53047,7,2013,25353,23823,1,1530,6.00%
Pacific,7/1/13,53049,7,2013,8156,7335,1,821,10.10%
Pend Oreille,7/1/13,53051,7,2013,4591,4094,1,497,10.80%
Pierce,7/1/13,53053,7,2013,380361,349435,1,30926,8.10%
San Juan,7/1/13,53055,7,2013,8891,8477,1,414,4.70%
Skagit,7/1/13,53057,7,2013,57410,52791,1,4619,8.00%
Skamania,7/1/13,53059,7,2013,4912,4471,1,441,9.00%
Snohomish,7/1/13,53061,7,2013,391167,367855,1,23312,6.00%
Spokane,7/1/13,53063,7,2013,223455,205744,1,17711,7.90%
Stevens,7/1/13,53065,7,2013,17455,15723,1,1732,9.90%
Thurston,7/1/13,53067,7,2013,120939,111924,1,9015,7.50%
Wahkiakum,7/1/13,53069,7,2013,1296,1152,1,144,11.10%
Walla Walla,7/1/13,53071,7,2013,28806,26870,1,1936,6.70%
Whatcom,7/1/13,53073,7,2013,102829,95362,1,7467,7.30%
Whitman,7/1/13,53075,7,2013,19895,18341,1,1554,7.80%
Yakima,7/1/13,53077,7,2013,126146,115792,1,10354,8.20%
Adams,7/1/14,53001,7,2014,9522,8906,1,616,6.50%
Asotin,7/1/14,53003,7,2014,9636,9147,1,489,5.10%
Clallam,7/1/14,53009,7,2014,26935,24827,1,2108,7.80%
Clark,7/1/14,53011,7,2014,206784,192435,1,14349,6.90%
Columbia,7/1/14,53013,7,2014,1737,1627,1,110,6.30%
Cowlitz,7/1/14,53015,7,2014,43583,40251,1,3332,7.60%
Douglas,7/1/14,53017,7,2014,22337,21156,1,1181,5.30%
Ferry,7/1/14,53019,7,2014,2504,2250,1,254,10.10%
Franklin,7/1/14,53021,7,2014,39409,36700,1,2709,6.90%
Garfield,7/1/14,53023,7,2014,1032,975,1,57,5.50%
Grant,7/1/14,53025,7,2014,49045,46139,1,2906,5.90%
Grays Harbor,7/1/14,53027,7,2014,27157,24661,1,2496,9.20%
Island,7/1/14,53029,7,2014,31555,29581,1,1974,6.30%
Jefferson,7/1/14,53031,7,2014,11312,10488,1,824,7.30%
King,7/1/14,53033,7,2014,1169382,1111045,1,58337,5.00%
Kitsap,7/1/14,53035,7,2014,113271,106558,1,6713,5.90%
Kittitas,7/1/14,53037,7,2014,19335,18022,1,1313,6.80%
Klickitat,7/1/14,53039,7,2014,10286,9639,1,647,6.30%
Lewis,7/1/14,53041,7,2014,30259,27634,1,2625,8.70%
Lincoln,7/1/14,53043,7,2014,5201,4944,1,257,4.90%
Mason,7/1/14,53045,7,2014,23162,21353,1,1809,7.80%
Okanogan,7/1/14,53047,7,2014,25793,24533,1,1260,4.90%
Pacific,7/1/14,53049,7,2014,8031,7352,1,679,8.50%
Pend Oreille,7/1/14,53051,7,2014,4514,4091,1,423,9.40%
Pierce,7/1/14,53053,7,2014,381517,355599,1,25918,6.80%
San Juan,7/1/14,53055,7,2014,8662,8331,1,331,3.80%
Skagit,7/1/14,53057,7,2014,56952,53161,1,3791,6.70%
Skamania,7/1/14,53059,7,2014,4883,4515,1,368,7.50%
Snohomish,7/1/14,53061,7,2014,399367,377323,1,22044,5.50%
Spokane,7/1/14,53063,7,2014,221015,206324,1,14691,6.60%
Stevens,7/1/14,53065,7,2014,17127,15673,1,1454,8.50%
Thurston,7/1/14,53067,7,2014,121596,113934,1,7662,6.30%
Wahkiakum,7/1/14,53069,7,2014,1284,1174,1,110,8.60%
Walla Walla,7/1/14,53071,7,2014,28850,27180,1,1670,5.80%
Whatcom,7/1/14,53073,7,2014,101247,94796,1,6451,6.40%
Whitman,7/1/14,53075,7,2014,19899,18617,1,1282,6.40%
Yakima,7/1/14,53077,7,2014,125697,116972,1,8725,6.90%
Adams,7/1/15,53001,7,2015,9498,8989,1,509,5.40%
Asotin,7/1/15,53003,7,2015,9578,9120,1,458,4.80%
Clallam,7/1/15,53009,7,2015,27050,25000,1,2050,7.60%
Clark,7/1/15,53011,7,2015,212165,198090,1,14075,6.60%
Columbia,7/1/15,53013,7,2015,1703,1607,1,96,5.60%
Cowlitz,7/1/15,53015,7,2015,43795,40441,1,3354,7.70%
Douglas,7/1/15,53017,7,2015,21577,20425,1,1152,5.30%
Ferry,7/1/15,53019,7,2015,2475,2250,1,225,9.10%
Franklin,7/1/15,53021,7,2015,40651,38087,1,2564,6.30%
Garfield,7/1/15,53023,7,2015,997,948,1,49,4.90%
Grant,7/1/15,53025,7,2015,47804,45045,1,2759,5.80%
Grays Harbor,7/1/15,53027,7,2015,27067,24787,1,2280,8.40%
Island,7/1/15,53029,7,2015,31850,29985,1,1865,5.90%
Jefferson,7/1/15,53031,7,2015,11343,10588,1,755,6.70%
King,7/1/15,53033,7,2015,1186877,1135730,1,51147,4.30%
Kitsap,7/1/15,53035,7,2015,115104,108882,1,6222,5.40%
Kittitas,7/1/15,53037,7,2015,19892,18644,1,1248,6.30%
Klickitat,7/1/15,53039,7,2015,10199,9505,1,694,6.80%
Lewis,7/1/15,53041,7,2015,31374,28845,1,2529,8.10%
Lincoln,7/1/15,53043,7,2015,5015,4755,1,260,5.20%
Mason,7/1/15,53045,7,2015,22961,21146,1,1815,7.90%
Okanogan,7/1/15,53047,7,2015,24378,23134,1,1244,5.10%
Pacific,7/1/15,53049,7,2015,8314,7678,1,636,7.60%
Pend Oreille,7/1/15,53051,7,2015,4533,4121,1,412,9.10%
Pierce,7/1/15,53053,7,2015,388575,364021,1,24554,6.30%
San Juan,7/1/15,53055,7,2015,8771,8442,1,329,3.80%
Skagit,7/1/15,53057,7,2015,57369,53677,1,3692,6.40%
Skamania,7/1/15,53059,7,2015,4889,4538,1,351,7.20%
Snohomish,7/1/15,53061,7,2015,404824,385688,1,19136,4.70%
Spokane,7/1/15,53063,7,2015,223696,209462,1,14234,6.40%
Stevens,7/1/15,53065,7,2015,17183,15816,1,1367,8.00%
Thurston,7/1/15,53067,7,2015,123997,116658,1,7339,5.90%
Wahkiakum,7/1/15,53069,7,2015,1304,1198,1,106,8.10%
Walla Walla,7/1/15,53071,7,2015,27937,26357,1,1580,5.70%
Whatcom,7/1/15,53073,7,2015,105623,99445,1,6178,5.80%
Whitman,7/1/15,53075,7,2015,20169,18913,1,1256,6.20%
Yakima,7/1/15,53077,7,2015,126072,117235,1,8837,7.00%
Adams,7/1/16,53001,7,2016,9686,9231,1,455,4.70%
Asotin,7/1/16,53003,7,2016,9951,9471,1,480,4.80%
Clallam,7/1/16,53009,7,2016,27766,25780,1,1986,7.20%
Clark,7/1/16,53011,7,2016,218956,205698,1,13258,6.10%
Columbia,7/1/16,53013,7,2016,1747,1648,1,99,5.70%
Cowlitz,7/1/16,53015,7,2016,44529,41515,1,3014,6.80%
Douglas,7/1/16,53017,7,2016,21110,19855,1,1255,5.90%
Ferry,7/1/16,53019,7,2016,2531,2310,1,221,8.70%
Franklin,7/1/16,53021,7,2016,41807,39314,1,2493,6.00%
Garfield,7/1/16,53023,7,2016,966,916,1,50,5.20%
Grant,7/1/16,53025,7,2016,47004,44354,1,2650,5.60%
Grays Harbor,7/1/16,53027,7,2016,27310,25235,1,2075,7.60%
Island,7/1/16,53029,7,2016,32908,31024,1,1884,5.70%
Jefferson,7/1/16,53031,7,2016,11803,11019,1,784,6.60%
King,7/1/16,53033,7,2016,1218300,1169556,1,48744,4.00%
Kitsap,7/1/16,53035,7,2016,118232,111694,1,6538,5.50%
Kittitas,7/1/16,53037,7,2016,20770,19568,1,1202,5.80%
Klickitat,7/1/16,53039,7,2016,10040,9443,1,597,5.90%
Lewis,7/1/16,53041,7,2016,32173,29810,1,2363,7.30%
Lincoln,7/1/16,53043,7,2016,5075,4827,1,248,4.90%
Mason,7/1/16,53045,7,2016,23661,22017,1,1644,6.90%
Okanogan,7/1/16,53047,7,2016,24261,23068,1,1193,4.90%
Pacific,7/1/16,53049,7,2016,8575,7976,1,599,7.00%
Pend Oreille,7/1/16,53051,7,2016,4605,4225,1,380,8.30%
Pierce,7/1/16,53053,7,2016,402955,379337,1,23618,5.90%
San Juan,7/1/16,53055,7,2016,8973,8625,1,348,3.90%
Skagit,7/1/16,53057,7,2016,59067,55524,1,3543,6.00%
Skamania,7/1/16,53059,7,2016,5018,4695,1,323,6.40%
Snohomish,7/1/16,53061,7,2016,417183,398881,1,18302,4.40%
Spokane,7/1/16,53063,7,2016,231354,217840,1,13514,5.80%
Stevens,7/1/16,53065,7,2016,17671,16411,1,1260,7.10%
Thurston,7/1/16,53067,7,2016,128778,121699,1,7079,5.50%
Wahkiakum,7/1/16,53069,7,2016,1306,1203,1,103,7.90%
Walla Walla,7/1/16,53071,7,2016,29103,27637,1,1466,5.00%
Whatcom,7/1/16,53073,7,2016,108795,102742,1,6053,5.60%
Whitman,7/1/16,53075,7,2016,20718,19426,1,1292,6.20%
Yakima,7/1/16,53077,7,2016,130704,122554,1,8150,6.20%
Adams,7/1/17,53001,7,2017,9991,9577,1,414,4.10%
Asotin,7/1/17,53003,7,2017,10193,9788,1,405,4.00%
Clallam,7/1/17,53009,7,2017,28043,26209,1,1834,6.50%
Clark,7/1/17,53011,7,2017,225668,214220,1,11448,5.10%
Columbia,7/1/17,53013,7,2017,1783,1700,1,83,4.70%
Cowlitz,7/1/17,53015,7,2017,45311,42662,1,2649,5.80%
Douglas,7/1/17,53017,7,2017,24776,23797,1,979,4.00%
Ferry,7/1/17,53019,7,2017,2546,2306,1,240,9.40%
Franklin,7/1/17,53021,7,2017,43957,41822,1,2135,4.90%
Garfield,7/1/17,53023,7,2017,1003,964,1,39,3.90%
Grant,7/1/17,53025,7,2017,49647,47286,1,2361,4.80%
Grays Harbor,7/1/17,53027,7,2017,27905,26082,1,1823,6.50%
Island,7/1/17,53029,7,2017,34198,32474,1,1724,5.00%
Jefferson,7/1/17,53031,7,2017,12045,11339,1,706,5.90%
King,7/1/17,53033,7,2017,1241498,1195483,1,46015,3.70%
Kitsap,7/1/17,53035,7,2017,120301,114524,1,5777,4.80%
Kittitas,7/1/17,53037,7,2017,21119,20019,1,1100,5.20%
Klickitat,7/1/17,53039,7,2017,10592,10055,1,537,5.10%
Lewis,7/1/17,53041,7,2017,33152,31064,1,2088,6.30%
Lincoln,7/1/17,53043,7,2017,5099,4876,1,223,4.40%
Mason,7/1/17,53045,7,2017,23795,22333,1,1462,6.10%
Okanogan,7/1/17,53047,7,2017,25139,23934,1,1205,4.80%
Pacific,7/1/17,53049,7,2017,8609,8044,1,565,6.60%
Pend Oreille,7/1/17,53051,7,2017,4669,4355,1,314,6.70%
Pierce,7/1/17,53053,7,2017,411920,390044,1,21876,5.30%
San Juan,7/1/17,53055,7,2017,9242,8946,1,296,3.20%
Skagit,7/1/17,53057,7,2017,59913,56816,1,3097,5.20%
Skamania,7/1/17,53059,7,2017,5223,4931,1,292,5.60%
Snohomish,7/1/17,53061,7,2017,425174,407647,1,17527,4.10%
Spokane,7/1/17,53063,7,2017,236498,224265,1,12233,5.20%
Stevens,7/1/17,53065,7,2017,17905,16784,1,1121,6.30%
Thurston,7/1/17,53067,7,2017,132497,125917,1,6580,5.00%
Wahkiakum,7/1/17,53069,7,2017,1310,1218,1,92,7.00%
Walla Walla,7/1/17,53071,7,2017,29341,27994,1,1347,4.60%
Whatcom,7/1/17,53073,7,2017,110733,105214,1,5519,5.00%
Whitman,7/1/17,53075,7,2017,20762,19694,1,1068,5.10%
Yakima,7/1/17,53077,7,2017,133636,126991,1,6645,5.00%
Adams,7/1/18,53001,7,2018,10311,9901,1,410,4.00%
Asotin,7/1/18,53003,7,2018,10025,9622,1,403,4.00%
Clallam,7/1/18,53009,7,2018,28315,26639,1,1676,5.90%
Clark,7/1/18,53011,7,2018,231066,219998,1,11068,4.80%
Columbia,7/1/18,53013,7,2018,1824,1734,1,90,4.90%
Cowlitz,7/1/18,53015,7,2018,45933,43271,1,2662,5.80%
Douglas,7/1/18,53017,7,2018,25191,24215,1,976,3.90%
Ferry,7/1/18,53019,7,2018,2507,2259,1,248,9.90%
Franklin,7/1/18,53021,7,2018,43153,40927,1,2226,5.20%
Garfield,7/1/18,53023,7,2018,957,912,1,45,4.70%
Grant,7/1/18,53025,7,2018,51288,48549,1,2739,5.30%
Grays Harbor,7/1/18,53027,7,2018,28466,26708,1,1758,6.20%
Island,7/1/18,53029,7,2018,34753,33029,1,1724,5.00%
Jefferson,7/1/18,53031,7,2018,12451,11781,1,670,5.40%
King,7/1/18,53033,7,2018,1269320,1227416,1,41904,3.30%
Kitsap,7/1/18,53035,7,2018,123397,117997,1,5400,4.40%
Kittitas,7/1/18,53037,7,2018,21132,20017,1,1115,5.30%
Klickitat,7/1/18,53039,7,2018,10790,10270,1,520,4.80%
Lewis,7/1/18,53041,7,2018,33934,31928,1,2006,5.90%
Lincoln,7/1/18,53043,7,2018,5218,4998,1,220,4.20%
Mason,7/1/18,53045,7,2018,24394,22933,1,1461,6.00%
Okanogan,7/1/18,53047,7,2018,24042,22938,1,1104,4.60%
Pacific,7/1/18,53049,7,2018,8729,8218,1,511,5.90%
Pend Oreille,7/1/18,53051,7,2018,4791,4478,1,313,6.50%
Pierce,7/1/18,53053,7,2018,423591,402364,1,21227,5.00%
San Juan,7/1/18,53055,7,2018,9204,8911,1,293,3.20%
Skagit,7/1/18,53057,7,2018,61417,58377,1,3040,4.90%
Skamania,7/1/18,53059,7,2018,5298,5022,1,276,5.20%
Snohomish,7/1/18,53061,7,2018,432478,417127,1,15351,3.50%
Spokane,7/1/18,53063,7,2018,242157,230191,1,11966,4.90%
Stevens,7/1/18,53065,7,2018,18141,17031,1,1110,6.10%
Thurston,7/1/18,53067,7,2018,136296,129965,1,6331,4.60%
Wahkiakum,7/1/18,53069,7,2018,1352,1274,1,78,5.80%
Walla Walla,7/1/18,53071,7,2018,29827,28502,1,1325,4.40%
Whatcom,7/1/18,53073,7,2018,111134,105960,1,5174,4.70%
Whitman,7/1/18,53075,7,2018,20944,19891,1,1053,5.00%
Yakima,7/1/18,53077,7,2018,135936,128949,1,6987,5.10%
Adams,7/1/19,53001,7,2019,11548,11099,1,449,3.90%
Asotin,7/1/19,53003,7,2019,10297,9873,1,424,4.10%
Clallam,7/1/19,53009,7,2019,29166,27357,1,1809,6.20%
Clark,7/1/19,53011,7,2019,239896,228202,1,11694,4.90%
Columbia,7/1/19,53013,7,2019,1868,1784,1,84,4.50%
Cowlitz,7/1/19,53015,7,2019,47659,44857,1,2802,5.90%
Douglas,7/1/19,53017,7,2019,25217,24169,1,1048,4.20%
Ferry,7/1/19,53019,7,2019,2505,2273,1,232,9.30%
Franklin,7/1/19,53021,7,2019,45342,42973,1,2369,5.20%
Garfield,7/1/19,53023,7,2019,958,916,1,42,4.40%
Grant,7/1/19,53025,7,2019,51218,48625,1,2593,5.10%
Grays Harbor,7/1/19,53027,7,2019,29048,27184,1,1864,6.40%
Island,7/1/19,53029,7,2019,36222,34382,1,1840,5.10%
Jefferson,7/1/19,53031,7,2019,13134,12418,1,716,5.50%
King,7/1/19,53033,7,2019,1298313,1259313,1,39000,3.00%
Kitsap,7/1/19,53035,7,2019,128283,122403,1,5880,4.60%
Kittitas,7/1/19,53037,7,2019,22095,20932,1,1163,5.30%
Klickitat,7/1/19,53039,7,2019,10960,10393,1,567,5.20%
Lewis,7/1/19,53041,7,2019,35199,33120,1,2079,5.90%
Lincoln,7/1/19,53043,7,2019,5193,4968,1,225,4.30%
Mason,7/1/19,53045,7,2019,25138,23614,1,1524,6.10%
Okanogan,7/1/19,53047,7,2019,23242,22121,1,1121,4.80%
Pacific,7/1/19,53049,7,2019,9054,8513,1,541,6.00%
Pend Oreille,7/1/19,53051,7,2019,4975,4648,1,327,6.60%
Pierce,7/1/19,53053,7,2019,439331,417202,1,22129,5.00%
San Juan,7/1/19,53055,7,2019,9840,9539,1,301,3.10%
Skagit,7/1/19,53057,7,2019,63642,60319,1,3323,5.20%
Skamania,7/1/19,53059,7,2019,5522,5213,1,309,5.60%
Snohomish,7/1/19,53061,7,2019,441932,427741,1,14191,3.20%
Spokane,7/1/19,53063,7,2019,251461,238797,1,12664,5.00%
Stevens,7/1/19,53065,7,2019,18861,17708,1,1153,6.10%
Thurston,7/1/19,53067,7,2019,141080,134273,1,6807,4.80%
Wahkiakum,7/1/19,53069,7,2019,1389,1302,1,87,6.30%
Walla Walla,7/1/19,53071,7,2019,30556,29076,1,1480,4.80%
Whatcom,7/1/19,53073,7,2019,115641,109911,1,5730,5.00%
Whitman,7/1/19,53075,7,2019,21292,20222,1,1070,5.00%
Yakima,7/1/19,53077,7,2019,140212,132485,1,7727,5.50%
Adams,8/1/90,53001,8,1990,8281,7719,1,562,6.80%
Asotin,8/1/90,53003,8,1990,9374,8944,1,430,4.60%
Clallam,8/1/90,53009,8,1990,23673,22325,1,1348,5.70%
Columbia,8/1/90,53013,8,1990,1196,1048,1,148,12.40%
Cowlitz,8/1/90,53015,8,1990,38242,35842,1,2400,6.30%
Douglas,8/1/90,53017,8,1990,16997,15353,1,1644,9.70%
Ferry,8/1/90,53019,8,1990,2808,2550,1,258,9.20%
Franklin,8/1/90,53021,8,1990,19698,17619,1,2079,10.60%
Garfield,8/1/90,53023,8,1990,1131,1110,1,21,1.90%
Grant,8/1/90,53025,8,1990,28721,26769,1,1952,6.80%
Grays Harbor,8/1/90,53027,8,1990,27823,25593,1,2230,8.00%
Island,8/1/90,53029,8,1990,22979,22269,1,710,3.10%
Jefferson,8/1/90,53031,8,1990,8585,8220,1,365,4.30%
King,8/1/90,53033,8,1990,862572,834262,1,28310,3.30%
Kitsap,8/1/90,53035,8,1990,84410,80828,1,3582,4.20%
Kittitas,8/1/90,53037,8,1990,11878,11024,1,854,7.20%
Klickitat,8/1/90,53039,8,1990,7954,7276,1,678,8.50%
Lewis,8/1/90,53041,8,1990,26542,24824,1,1718,6.50%
Lincoln,8/1/90,53043,8,1990,4604,4511,1,93,2.00%
Mason,8/1/90,53045,8,1990,15839,14953,1,886,5.60%
Okanogan,8/1/90,53047,8,1990,19903,17816,1,2087,10.50%
Pacific,8/1/90,53049,8,1990,7779,7200,1,579,7.40%
Pend Oreille,8/1/90,53051,8,1990,3453,3031,1,422,12.20%
Pierce,8/1/90,53053,8,1990,276721,264212,1,12509,4.50%
San Juan,8/1/90,53055,8,1990,6267,6146,1,121,1.90%
Skagit,8/1/90,53057,8,1990,42244,39510,1,2734,6.50%
Skamania,8/1/90,53059,8,1990,4165,3822,1,343,8.20%
Snohomish,8/1/90,53061,8,1990,250643,241788,1,8855,3.50%
Spokane,8/1/90,53063,8,1990,170252,161579,1,8673,5.10%
Stevens,8/1/90,53065,8,1990,13443,12560,1,883,6.60%
Thurston,8/1/90,53067,8,1990,81006,77165,1,3841,4.70%
Wahkiakum,8/1/90,53069,8,1990,1585,1533,1,52,3.30%
Walla Walla,8/1/90,53071,8,1990,23281,21977,1,1304,5.60%
Whatcom,8/1/90,53073,8,1990,68621,65333,1,3288,4.80%
Whitman,8/1/90,53075,8,1990,16883,16634,1,249,1.50%
Yakima,8/1/90,53077,8,1990,109871,98798,1,11073,10.10%
Adams,8/1/91,53001,8,1991,8624,7815,1,809,9.40%
Asotin,8/1/91,53003,8,1991,9522,9065,1,457,4.80%
Clallam,8/1/91,53009,8,1991,23294,21745,1,1549,6.60%
Columbia,8/1/91,53013,8,1991,1253,1119,1,134,10.70%
Cowlitz,8/1/91,53015,8,1991,37681,34820,1,2861,7.60%
Douglas,8/1/91,53017,8,1991,16936,15174,1,1762,10.40%
Ferry,8/1/91,53019,8,1991,2682,2437,1,245,9.10%
Franklin,8/1/91,53021,8,1991,19802,17779,1,2023,10.20%
Garfield,8/1/91,53023,8,1991,1145,1133,1,12,1.00%
Grant,8/1/91,53025,8,1991,29324,26790,1,2534,8.60%
Grays Harbor,8/1/91,53027,8,1991,27195,24366,1,2829,10.40%
Island,8/1/91,53029,8,1991,22640,21745,1,895,4.00%
Jefferson,8/1/91,53031,8,1991,8329,7880,1,449,5.40%
King,8/1/91,53033,8,1991,870697,829827,1,40870,4.70%
Kitsap,8/1/91,53035,8,1991,85568,81389,1,4179,4.90%
Kittitas,8/1/91,53037,8,1991,12187,11086,1,1101,9.00%
Klickitat,8/1/91,53039,8,1991,7933,7029,1,904,11.40%
Lewis,8/1/91,53041,8,1991,25389,23089,1,2300,9.10%
Lincoln,8/1/91,53043,8,1991,4501,4374,1,127,2.80%
Mason,8/1/91,53045,8,1991,15586,14522,1,1064,6.80%
Okanogan,8/1/91,53047,8,1991,21284,18919,1,2365,11.10%
Pacific,8/1/91,53049,8,1991,7931,7300,1,631,8.00%
Pend Oreille,8/1/91,53051,8,1991,3425,3069,1,356,10.40%
Pierce,8/1/91,53053,8,1991,274533,258292,1,16241,5.90%
San Juan,8/1/91,53055,8,1991,6261,6110,1,151,2.40%
Skagit,8/1/91,53057,8,1991,43350,40597,1,2753,6.40%
Skamania,8/1/91,53059,8,1991,4050,3601,1,449,11.10%
Snohomish,8/1/91,53061,8,1991,256920,244376,1,12544,4.90%
Spokane,8/1/91,53063,8,1991,172727,163064,1,9663,5.60%
Stevens,8/1/91,53065,8,1991,14170,13150,1,1020,7.20%
Thurston,8/1/91,53067,8,1991,81806,77095,1,4711,5.80%
Wahkiakum,8/1/91,53069,8,1991,1579,1518,1,61,3.90%
Walla Walla,8/1/91,53071,8,1991,23620,22275,1,1345,5.70%
Whatcom,8/1/91,53073,8,1991,68999,65030,1,3969,5.80%
Whitman,8/1/91,53075,8,1991,17178,16904,1,274,1.60%
Yakima,8/1/91,53077,8,1991,106020,93040,1,12980,12.20%
Adams,8/1/92,53001,8,1992,8891,7980,1,911,10.20%
Asotin,8/1/92,53003,8,1992,10125,9606,1,519,5.10%
Clallam,8/1/92,53009,8,1992,23914,22025,1,1889,7.90%
Columbia,8/1/92,53013,8,1992,1241,1080,1,161,13.00%
Cowlitz,8/1/92,53015,8,1992,37427,33613,1,3814,10.20%
Douglas,8/1/92,53017,8,1992,17962,16340,1,1622,9.00%
Ferry,8/1/92,53019,8,1992,2903,2573,1,330,11.40%
Franklin,8/1/92,53021,8,1992,20589,18511,1,2078,10.10%
Garfield,8/1/92,53023,8,1992,1130,1111,1,19,1.70%
Grant,8/1/92,53025,8,1992,31375,28362,1,3013,9.60%
Grays Harbor,8/1/92,53027,8,1992,28209,25103,1,3106,11.00%
Island,8/1/92,53029,8,1992,23912,22487,1,1425,6.00%
Jefferson,8/1/92,53031,8,1992,8966,8249,1,717,8.00%
King,8/1/92,53033,8,1992,905392,853812,1,51580,5.70%
Kitsap,8/1/92,53035,8,1992,87523,82110,1,5413,6.20%
Kittitas,8/1/92,53037,8,1992,13061,11440,1,1621,12.40%
Klickitat,8/1/92,53039,8,1992,8561,7678,1,883,10.30%
Lewis,8/1/92,53041,8,1992,27944,25037,1,2907,10.40%
Lincoln,8/1/92,53043,8,1992,4727,4547,1,180,3.80%
Mason,8/1/92,53045,8,1992,15787,14529,1,1258,8.00%
Okanogan,8/1/92,53047,8,1992,22859,20287,1,2572,11.30%
Pacific,8/1/92,53049,8,1992,8303,7449,1,854,10.30%
Pend Oreille,8/1/92,53051,8,1992,3727,3251,1,476,12.80%
Pierce,8/1/92,53053,8,1992,286184,263806,1,22378,7.80%
San Juan,8/1/92,53055,8,1992,6318,6059,1,259,4.10%
Skagit,8/1/92,53057,8,1992,44971,40879,1,4092,9.10%
Skamania,8/1/92,53059,8,1992,3872,3238,1,634,16.40%
Snohomish,8/1/92,53061,8,1992,271531,255683,1,15848,5.80%
Spokane,8/1/92,53063,8,1992,177880,166444,1,11436,6.40%
Stevens,8/1/92,53065,8,1992,14974,13505,1,1469,9.80%
Thurston,8/1/92,53067,8,1992,85678,80133,1,5545,6.50%
Wahkiakum,8/1/92,53069,8,1992,1593,1476,1,117,7.30%
Walla Walla,8/1/92,53071,8,1992,24272,22693,1,1579,6.50%
Whatcom,8/1/92,53073,8,1992,72894,67815,1,5079,7.00%
Whitman,8/1/92,53075,8,1992,16862,16507,1,355,2.10%
Yakima,8/1/92,53077,8,1992,115249,101868,1,13381,11.60%
Adams,8/1/93,53001,8,1993,9179,8152,1,1027,11.20%
Asotin,8/1/93,53003,8,1993,10468,9993,1,475,4.50%
Clallam,8/1/93,53009,8,1993,24024,21384,1,2640,11.00%
Columbia,8/1/93,53013,8,1993,1317,1140,1,177,13.40%
Cowlitz,8/1/93,53015,8,1993,37956,34362,1,3594,9.50%
Douglas,8/1/93,53017,8,1993,18473,16930,1,1543,8.40%
Ferry,8/1/93,53019,8,1993,2908,2529,1,379,13.00%
Franklin,8/1/93,53021,8,1993,21642,19612,1,2030,9.40%
Garfield,8/1/93,53023,8,1993,1215,1171,1,44,3.60%
Grant,8/1/93,53025,8,1993,32171,29231,1,2940,9.10%
Grays Harbor,8/1/93,53027,8,1993,28034,23972,1,4062,14.50%
Island,8/1/93,53029,8,1993,23846,22750,1,1096,4.60%
Jefferson,8/1/93,53031,8,1993,9605,8960,1,645,6.70%
King,8/1/93,53033,8,1993,911908,858595,1,53313,5.80%
Kitsap,8/1/93,53035,8,1993,88644,82709,1,5935,6.70%
Kittitas,8/1/93,53037,8,1993,13014,11834,1,1180,9.10%
Klickitat,8/1/93,53039,8,1993,8492,7330,1,1162,13.70%
Lewis,8/1/93,53041,8,1993,27846,25161,1,2685,9.60%
Lincoln,8/1/93,53043,8,1993,5036,4817,1,219,4.30%
Mason,8/1/93,53045,8,1993,16566,15085,1,1481,8.90%
Okanogan,8/1/93,53047,8,1993,23193,20748,1,2445,10.50%
Pacific,8/1/93,53049,8,1993,8396,7506,1,890,10.60%
Pend Oreille,8/1/93,53051,8,1993,3894,3435,1,459,11.80%
Pierce,8/1/93,53053,8,1993,293755,272010,1,21745,7.40%
San Juan,8/1/93,53055,8,1993,6240,5965,1,275,4.40%
Skagit,8/1/93,53057,8,1993,46495,42237,1,4258,9.20%
Skamania,8/1/93,53059,8,1993,4403,3903,1,500,11.40%
Snohomish,8/1/93,53061,8,1993,277761,260985,1,16776,6.00%
Spokane,8/1/93,53063,8,1993,181780,172122,1,9658,5.30%
Stevens,8/1/93,53065,8,1993,15762,14435,1,1327,8.40%
Thurston,8/1/93,53067,8,1993,87491,81417,1,6074,6.90%
Wahkiakum,8/1/93,53069,8,1993,1707,1605,1,102,6.00%
Walla Walla,8/1/93,53071,8,1993,24704,23441,1,1263,5.10%
Whatcom,8/1/93,53073,8,1993,74279,69060,1,5219,7.00%
Whitman,8/1/93,53075,8,1993,17925,17576,1,349,1.90%
Yakima,8/1/93,53077,8,1993,118370,103459,1,14911,12.60%
Adams,8/1/94,53001,8,1994,8338,7605,1,733,8.80%
Asotin,8/1/94,53003,8,1994,10750,10349,1,401,3.70%
Clallam,8/1/94,53009,8,1994,24028,21473,1,2555,10.60%
Columbia,8/1/94,53013,8,1994,1347,1203,1,144,10.70%
Cowlitz,8/1/94,53015,8,1994,39005,35804,1,3201,8.20%
Douglas,8/1/94,53017,8,1994,19056,17425,1,1631,8.60%
Ferry,8/1/94,53019,8,1994,3021,2673,1,348,11.50%
Franklin,8/1/94,53021,8,1994,22269,20639,1,1630,7.30%
Garfield,8/1/94,53023,8,1994,1140,1088,1,52,4.60%
Grant,8/1/94,53025,8,1994,35496,32253,1,3243,9.10%
Grays Harbor,8/1/94,53027,8,1994,27993,24640,1,3353,12.00%
Island,8/1/94,53029,8,1994,24871,23356,1,1515,6.10%
Jefferson,8/1/94,53031,8,1994,9756,8962,1,794,8.10%
King,8/1/94,53033,8,1994,893964,853019,1,40945,4.60%
Kitsap,8/1/94,53035,8,1994,89395,83966,1,5429,6.10%
Kittitas,8/1/94,53037,8,1994,13656,12620,1,1036,7.60%
Klickitat,8/1/94,53039,8,1994,9454,8407,1,1047,11.10%
Lewis,8/1/94,53041,8,1994,28981,26500,1,2481,8.60%
Lincoln,8/1/94,53043,8,1994,4991,4742,1,249,5.00%
Mason,8/1/94,53045,8,1994,17185,15655,1,1530,8.90%
Okanogan,8/1/94,53047,8,1994,23608,21133,1,2475,10.50%
Pacific,8/1/94,53049,8,1994,8265,7324,1,941,11.40%
Pend Oreille,8/1/94,53051,8,1994,3908,3499,1,409,10.50%
Pierce,8/1/94,53053,8,1994,304946,284659,1,20287,6.70%
San Juan,8/1/94,53055,8,1994,6541,6276,1,265,4.10%
Skagit,8/1/94,53057,8,1994,52625,48228,1,4397,8.40%
Skamania,8/1/94,53059,8,1994,4247,3845,1,402,9.50%
Snohomish,8/1/94,53061,8,1994,277493,263149,1,14344,5.20%
Spokane,8/1/94,53063,8,1994,190279,180976,1,9303,4.90%
Stevens,8/1/94,53065,8,1994,16821,15477,1,1344,8.00%
Thurston,8/1/94,53067,8,1994,89420,83527,1,5893,6.60%
Wahkiakum,8/1/94,53069,8,1994,1731,1532,1,199,11.50%
Walla Walla,8/1/94,53071,8,1994,24902,23874,1,1028,4.10%
Whatcom,8/1/94,53073,8,1994,76818,70927,1,5891,7.70%
Whitman,8/1/94,53075,8,1994,17473,17133,1,340,1.90%
Yakima,8/1/94,53077,8,1994,119914,106365,1,13549,11.30%
Adams,8/1/95,53001,8,1995,9057,8290,1,767,8.50%
Asotin,8/1/95,53003,8,1995,11306,10810,1,496,4.40%
Clallam,8/1/95,53009,8,1995,25083,23119,1,1964,7.80%
Columbia,8/1/95,53013,8,1995,1478,1354,1,124,8.40%
Cowlitz,8/1/95,53015,8,1995,40185,37067,1,3118,7.80%
Douglas,8/1/95,53017,8,1995,19151,17222,1,1929,10.10%
Ferry,8/1/95,53019,8,1995,2906,2596,1,310,10.70%
Franklin,8/1/95,53021,8,1995,22523,20575,1,1948,8.60%
Garfield,8/1/95,53023,8,1995,1127,1095,1,32,2.80%
Grant,8/1/95,53025,8,1995,34856,31816,1,3040,8.70%
Grays Harbor,8/1/95,53027,8,1995,28573,25333,1,3240,11.30%
Island,8/1/95,53029,8,1995,25842,24542,1,1300,5.00%
Jefferson,8/1/95,53031,8,1995,10147,9466,1,681,6.70%
King,8/1/95,53033,8,1995,909448,864316,1,45132,5.00%
Kitsap,8/1/95,53035,8,1995,90137,83817,1,6320,7.00%
Kittitas,8/1/95,53037,8,1995,14269,13074,1,1195,8.40%
Klickitat,8/1/95,53039,8,1995,9330,8258,1,1072,11.50%
Lewis,8/1/95,53041,8,1995,30048,27515,1,2533,8.40%
Lincoln,8/1/95,53043,8,1995,5119,4859,1,260,5.10%
Mason,8/1/95,53045,8,1995,18408,16908,1,1500,8.10%
Okanogan,8/1/95,53047,8,1995,24446,21844,1,2602,10.60%
Pacific,8/1/95,53049,8,1995,8726,7847,1,879,10.10%
Pend Oreille,8/1/95,53051,8,1995,4091,3567,1,524,12.80%
Pierce,8/1/95,53053,8,1995,317725,297042,1,20683,6.50%
San Juan,8/1/95,53055,8,1995,6711,6447,1,264,3.90%
Skagit,8/1/95,53057,8,1995,53985,49885,1,4100,7.60%
Skamania,8/1/95,53059,8,1995,4456,4041,1,415,9.30%
Snohomish,8/1/95,53061,8,1995,283575,268928,1,14647,5.20%
Spokane,8/1/95,53063,8,1995,197711,187248,1,10463,5.30%
Stevens,8/1/95,53065,8,1995,17125,15668,1,1457,8.50%
Thurston,8/1/95,53067,8,1995,94668,88427,1,6241,6.60%
Wahkiakum,8/1/95,53069,8,1995,1733,1635,1,98,5.70%
Walla Walla,8/1/95,53071,8,1995,25921,24624,1,1297,5.00%
Whatcom,8/1/95,53073,8,1995,80895,75181,1,5714,7.10%
Whitman,8/1/95,53075,8,1995,18019,17625,1,394,2.20%
Yakima,8/1/95,53077,8,1995,122321,106537,1,15784,12.90%
Adams,8/1/96,53001,8,1996,9642,8927,1,715,7.40%
Asotin,8/1/96,53003,8,1996,11885,11469,1,416,3.50%
Clallam,8/1/96,53009,8,1996,25397,23460,1,1937,7.60%
Columbia,8/1/96,53013,8,1996,1376,1227,1,149,10.80%
Cowlitz,8/1/96,53015,8,1996,41685,38462,1,3223,7.70%
Douglas,8/1/96,53017,8,1996,20061,18128,1,1933,9.60%
Ferry,8/1/96,53019,8,1996,2993,2703,1,290,9.70%
Franklin,8/1/96,53021,8,1996,22715,20816,1,1899,8.40%
Garfield,8/1/96,53023,8,1996,1255,1225,1,30,2.40%
Grant,8/1/96,53025,8,1996,37504,34667,1,2837,7.60%
Grays Harbor,8/1/96,53027,8,1996,28372,25478,1,2894,10.20%
Island,8/1/96,53029,8,1996,26473,25382,1,1091,4.10%
Jefferson,8/1/96,53031,8,1996,10396,9706,1,690,6.60%
King,8/1/96,53033,8,1996,928562,888882,1,39680,4.30%
Kitsap,8/1/96,53035,8,1996,94620,89105,1,5515,5.80%
Kittitas,8/1/96,53037,8,1996,14568,13625,1,943,6.50%
Klickitat,8/1/96,53039,8,1996,9552,8605,1,947,9.90%
Lewis,8/1/96,53041,8,1996,31675,29025,1,2650,8.40%
Lincoln,8/1/96,53043,8,1996,5734,5540,1,194,3.40%
Mason,8/1/96,53045,8,1996,19516,18096,1,1420,7.30%
Okanogan,8/1/96,53047,8,1996,25145,22558,1,2587,10.30%
Pacific,8/1/96,53049,8,1996,8582,7860,1,722,8.40%
Pend Oreille,8/1/96,53051,8,1996,4271,3733,1,538,12.60%
Pierce,8/1/96,53053,8,1996,323446,305777,1,17669,5.50%
San Juan,8/1/96,53055,8,1996,6917,6645,1,272,3.90%
Skagit,8/1/96,53057,8,1996,51159,47492,1,3667,7.20%
Skamania,8/1/96,53059,8,1996,3647,3325,1,322,8.80%
Snohomish,8/1/96,53061,8,1996,292769,279769,1,13000,4.40%
Spokane,8/1/96,53063,8,1996,205585,195815,1,9770,4.80%
Stevens,8/1/96,53065,8,1996,17433,16078,1,1355,7.80%
Thurston,8/1/96,53067,8,1996,98228,92632,1,5596,5.70%
Wahkiakum,8/1/96,53069,8,1996,1852,1746,1,106,5.70%
Walla Walla,8/1/96,53071,8,1996,26795,25286,1,1509,5.60%
Whatcom,8/1/96,53073,8,1996,81745,76536,1,5209,6.40%
Whitman,8/1/96,53075,8,1996,18934,18588,1,346,1.80%
Yakima,8/1/96,53077,8,1996,121213,107500,1,13713,11.30%
Adams,8/1/97,53001,8,1997,10426,9766,1,660,6.30%
Asotin,8/1/97,53003,8,1997,12523,12245,1,278,2.20%
Clallam,8/1/97,53009,8,1997,25837,24003,1,1834,7.10%
Columbia,8/1/97,53013,8,1997,1348,1232,1,116,8.60%
Cowlitz,8/1/97,53015,8,1997,42330,39502,1,2828,6.70%
Douglas,8/1/97,53017,8,1997,20340,19267,1,1073,5.30%
Ferry,8/1/97,53019,8,1997,2992,2774,1,218,7.30%
Franklin,8/1/97,53021,8,1997,22828,21216,1,1612,7.10%
Garfield,8/1/97,53023,8,1997,1216,1183,1,33,2.70%
Grant,8/1/97,53025,8,1997,38819,36381,1,2438,6.30%
Grays Harbor,8/1/97,53027,8,1997,29267,26755,1,2512,8.60%
Island,8/1/97,53029,8,1997,28675,27746,1,929,3.20%
Jefferson,8/1/97,53031,8,1997,10498,9888,1,610,5.80%
King,8/1/97,53033,8,1997,960064,926024,1,34040,3.50%
Kitsap,8/1/97,53035,8,1997,95991,90760,1,5231,5.40%
Kittitas,8/1/97,53037,8,1997,14502,13767,1,735,5.10%
Klickitat,8/1/97,53039,8,1997,9930,9163,1,767,7.70%
Lewis,8/1/97,53041,8,1997,33031,30780,1,2251,6.80%
Lincoln,8/1/97,53043,8,1997,5511,5325,1,186,3.40%
Mason,8/1/97,53045,8,1997,20701,19301,1,1400,6.80%
Okanogan,8/1/97,53047,8,1997,24999,22964,1,2035,8.10%
Pacific,8/1/97,53049,8,1997,9301,8549,1,752,8.10%
Pend Oreille,8/1/97,53051,8,1997,4530,4094,1,436,9.60%
Pierce,8/1/97,53053,8,1997,338385,323100,1,15285,4.50%
San Juan,8/1/97,53055,8,1997,7153,6903,1,250,3.50%
Skagit,8/1/97,53057,8,1997,52524,49229,1,3295,6.30%
Skamania,8/1/97,53059,8,1997,4530,4171,1,359,7.90%
Snohomish,8/1/97,53061,8,1997,310460,299642,1,10818,3.50%
Spokane,8/1/97,53063,8,1997,210418,201674,1,8744,4.20%
Stevens,8/1/97,53065,8,1997,18137,16835,1,1302,7.20%
Thurston,8/1/97,53067,8,1997,101720,96454,1,5266,5.20%
Wahkiakum,8/1/97,53069,8,1997,1975,1872,1,103,5.20%
Walla Walla,8/1/97,53071,8,1997,27096,25696,1,1400,5.20%
Whatcom,8/1/97,53073,8,1997,82996,78194,1,4802,5.80%
Whitman,8/1/97,53075,8,1997,19198,18915,1,283,1.50%
Yakima,8/1/97,53077,8,1997,121674,112434,1,9240,7.60%
Adams,8/1/98,53001,8,1998,10577,9918,1,659,6.20%
Asotin,8/1/98,53003,8,1998,13047,12614,1,433,3.30%
Clallam,8/1/98,53009,8,1998,25686,23910,1,1776,6.90%
Columbia,8/1/98,53013,8,1998,1359,1233,1,126,9.30%
Cowlitz,8/1/98,53015,8,1998,44074,41026,1,3048,6.90%
Douglas,8/1/98,53017,8,1998,21930,20277,1,1653,7.50%
Ferry,8/1/98,53019,8,1998,2864,2597,1,267,9.30%
Franklin,8/1/98,53021,8,1998,23245,21640,1,1605,6.90%
Garfield,8/1/98,53023,8,1998,1220,1193,1,27,2.20%
Grant,8/1/98,53025,8,1998,41360,38496,1,2864,6.90%
Grays Harbor,8/1/98,53027,8,1998,28669,26198,1,2471,8.60%
Island,8/1/98,53029,8,1998,29735,28839,1,896,3.00%
Jefferson,8/1/98,53031,8,1998,10474,9868,1,606,5.80%
King,8/1/98,53033,8,1998,972360,938300,1,34060,3.50%
Kitsap,8/1/98,53035,8,1998,94656,89877,1,4779,5.00%
Kittitas,8/1/98,53037,8,1998,15025,14318,1,707,4.70%
Klickitat,8/1/98,53039,8,1998,9633,8788,1,845,8.80%
Lewis,8/1/98,53041,8,1998,31152,28708,1,2444,7.80%
Lincoln,8/1/98,53043,8,1998,5540,5324,1,216,3.90%
Mason,8/1/98,53045,8,1998,20367,19166,1,1201,5.90%
Okanogan,8/1/98,53047,8,1998,25951,23379,1,2572,9.90%
Pacific,8/1/98,53049,8,1998,8633,7916,1,717,8.30%
Pend Oreille,8/1/98,53051,8,1998,4358,3937,1,421,9.70%
Pierce,8/1/98,53053,8,1998,343121,328456,1,14665,4.30%
San Juan,8/1/98,53055,8,1998,7221,7047,1,174,2.40%
Skagit,8/1/98,53057,8,1998,52664,49656,1,3008,5.70%
Skamania,8/1/98,53059,8,1998,4702,4331,1,371,7.90%
Snohomish,8/1/98,53061,8,1998,320761,309691,1,11070,3.50%
Spokane,8/1/98,53063,8,1998,211061,202328,1,8733,4.10%
Stevens,8/1/98,53065,8,1998,18263,16978,1,1285,7.00%
Thurston,8/1/98,53067,8,1998,103793,99101,1,4692,4.50%
Wahkiakum,8/1/98,53069,8,1998,2031,1926,1,105,5.20%
Walla Walla,8/1/98,53071,8,1998,27180,25700,1,1480,5.40%
Whatcom,8/1/98,53073,8,1998,83110,78715,1,4395,5.30%
Whitman,8/1/98,53075,8,1998,19448,19089,1,359,1.80%
Yakima,8/1/98,53077,8,1998,125097,114252,1,10845,8.70%
Adams,8/1/99,53001,8,1999,9641,8928,1,713,7.40%
Asotin,8/1/99,53003,8,1999,12757,12367,1,390,3.10%
Clallam,8/1/99,53009,8,1999,27346,25557,1,1789,6.50%
Columbia,8/1/99,53013,8,1999,1428,1292,1,136,9.50%
Cowlitz,8/1/99,53015,8,1999,43661,40847,1,2814,6.40%
Douglas,8/1/99,53017,8,1999,20793,19192,1,1601,7.70%
Ferry,8/1/99,53019,8,1999,2714,2485,1,229,8.40%
Franklin,8/1/99,53021,8,1999,23390,21865,1,1525,6.50%
Garfield,8/1/99,53023,8,1999,1250,1225,1,25,2.00%
Grant,8/1/99,53025,8,1999,40867,37485,1,3382,8.30%
Grays Harbor,8/1/99,53027,8,1999,27680,25481,1,2199,7.90%
Island,8/1/99,53029,8,1999,31076,29805,1,1271,4.10%
Jefferson,8/1/99,53031,8,1999,11783,11235,1,548,4.70%
King,8/1/99,53033,8,1999,979059,945851,1,33208,3.40%
Kitsap,8/1/99,53035,8,1999,98904,93950,1,4954,5.00%
Kittitas,8/1/99,53037,8,1999,14776,14113,1,663,4.50%
Klickitat,8/1/99,53039,8,1999,9466,8625,1,841,8.90%
Lewis,8/1/99,53041,8,1999,31430,29022,1,2408,7.70%
Lincoln,8/1/99,53043,8,1999,5199,5009,1,190,3.70%
Mason,8/1/99,53045,8,1999,20086,18933,1,1153,5.70%
Okanogan,8/1/99,53047,8,1999,23455,21211,1,2244,9.60%
Pacific,8/1/99,53049,8,1999,8468,7866,1,602,7.10%
Pend Oreille,8/1/99,53051,8,1999,4553,4195,1,358,7.90%
Pierce,8/1/99,53053,8,1999,348025,331892,1,16133,4.60%
San Juan,8/1/99,53055,8,1999,7712,7551,1,161,2.10%
Skagit,8/1/99,53057,8,1999,55812,52623,1,3189,5.70%
Skamania,8/1/99,53059,8,1999,4349,4026,1,323,7.40%
Snohomish,8/1/99,53061,8,1999,329807,316098,1,13709,4.20%
Spokane,8/1/99,53063,8,1999,218153,208238,1,9915,4.50%
Stevens,8/1/99,53065,8,1999,17989,16714,1,1275,7.10%
Thurston,8/1/99,53067,8,1999,105911,101053,1,4858,4.60%
Wahkiakum,8/1/99,53069,8,1999,2157,2030,1,127,5.90%
Walla Walla,8/1/99,53071,8,1999,26995,25573,1,1422,5.30%
Whatcom,8/1/99,53073,8,1999,87270,82899,1,4371,5.00%
Whitman,8/1/99,53075,8,1999,19307,19000,1,307,1.60%
Yakima,8/1/99,53077,8,1999,119937,108928,1,11009,9.20%
Adams,8/1/00,53001,8,2000,8682,8188,1,494,5.70%
Asotin,8/1/00,53003,8,2000,9761,9119,1,642,6.60%
Clallam,8/1/00,53009,8,2000,26088,24136,1,1952,7.50%
Columbia,8/1/00,53013,8,2000,1845,1712,1,133,7.20%
Cowlitz,8/1/00,53015,8,2000,43046,40028,1,3018,7.00%
Douglas,8/1/00,53017,8,2000,18674,17262,1,1412,7.60%
Ferry,8/1/00,53019,8,2000,2980,2712,1,268,9.00%
Franklin,8/1/00,53021,8,2000,23027,21636,1,1391,6.00%
Garfield,8/1/00,53023,8,2000,1144,1098,1,46,4.00%
Grant,8/1/00,53025,8,2000,37241,34652,1,2589,7.00%
Grays Harbor,8/1/00,53027,8,2000,29719,27304,1,2415,8.10%
Island,8/1/00,53029,8,2000,28675,27137,1,1538,5.40%
Jefferson,8/1/00,53031,8,2000,11797,11164,1,633,5.40%
King,8/1/00,53033,8,2000,981752,943704,1,38048,3.90%
Kitsap,8/1/00,53035,8,2000,105174,99278,1,5896,5.60%
Kittitas,8/1/00,53037,8,2000,16725,15812,1,913,5.50%
Klickitat,8/1/00,53039,8,2000,9752,9010,1,742,7.60%
Lewis,8/1/00,53041,8,2000,29861,27465,1,2396,8.00%
Lincoln,8/1/00,53043,8,2000,5020,4808,1,212,4.20%
Mason,8/1/00,53045,8,2000,21347,19692,1,1655,7.80%
Okanogan,8/1/00,53047,8,2000,21914,19987,1,1927,8.80%
Pacific,8/1/00,53049,8,2000,8966,8325,1,641,7.10%
Pend Oreille,8/1/00,53051,8,2000,4692,4338,1,354,7.50%
Pierce,8/1/00,53053,8,2000,339366,319682,1,19684,5.80%
San Juan,8/1/00,53055,8,2000,8460,8201,1,259,3.10%
Skagit,8/1/00,53057,8,2000,54167,51033,1,3134,5.80%
Skamania,8/1/00,53059,8,2000,4795,4475,1,320,6.70%
Snohomish,8/1/00,53061,8,2000,321124,308035,1,13089,4.10%
Spokane,8/1/00,53063,8,2000,209085,197664,1,11421,5.50%
Stevens,8/1/00,53065,8,2000,17548,16385,1,1163,6.60%
Thurston,8/1/00,53067,8,2000,107039,101553,1,5486,5.10%
Wahkiakum,8/1/00,53069,8,2000,1761,1642,1,119,6.80%
Walla Walla,8/1/00,53071,8,2000,26889,25374,1,1515,5.60%
Whatcom,8/1/00,53073,8,2000,86933,82056,1,4877,5.60%
Whitman,8/1/00,53075,8,2000,18820,18040,1,780,4.10%
Yakima,8/1/00,53077,8,2000,118628,109600,1,9028,7.60%
Adams,8/1/01,53001,8,2001,9299,8704,1,595,6.40%
Asotin,8/1/01,53003,8,2001,9737,9252,1,485,5.00%
Clallam,8/1/01,53009,8,2001,25694,23726,1,1968,7.70%
Columbia,8/1/01,53013,8,2001,1513,1370,1,143,9.50%
Cowlitz,8/1/01,53015,8,2001,41991,37556,1,4435,10.60%
Douglas,8/1/01,53017,8,2001,17858,16363,1,1495,8.40%
Ferry,8/1/01,53019,8,2001,2839,2566,1,273,9.60%
Franklin,8/1/01,53021,8,2001,22792,21317,1,1475,6.50%
Garfield,8/1/01,53023,8,2001,1145,1108,1,37,3.20%
Grant,8/1/01,53025,8,2001,36479,33718,1,2761,7.60%
Grays Harbor,8/1/01,53027,8,2001,28133,25643,1,2490,8.90%
Island,8/1/01,53029,8,2001,28393,26587,1,1806,6.40%
Jefferson,8/1/01,53031,8,2001,12099,11350,1,749,6.20%
King,8/1/01,53033,8,2001,987667,938605,1,49062,5.00%
Kitsap,8/1/01,53035,8,2001,103770,97320,1,6450,6.20%
Kittitas,8/1/01,53037,8,2001,16593,15567,1,1026,6.20%
Klickitat,8/1/01,53039,8,2001,9508,8480,1,1028,10.80%
Lewis,8/1/01,53041,8,2001,28664,26244,1,2420,8.40%
Lincoln,8/1/01,53043,8,2001,4806,4572,1,234,4.90%
Mason,8/1/01,53045,8,2001,20189,18666,1,1523,7.50%
Okanogan,8/1/01,53047,8,2001,20062,18372,1,1690,8.40%
Pacific,8/1/01,53049,8,2001,8687,8033,1,654,7.50%
Pend Oreille,8/1/01,53051,8,2001,4642,4249,1,393,8.50%
Pierce,8/1/01,53053,8,2001,329059,306496,1,22563,6.90%
San Juan,8/1/01,53055,8,2001,8473,8156,1,317,3.70%
Skagit,8/1/01,53057,8,2001,52811,49257,1,3554,6.70%
Skamania,8/1/01,53059,8,2001,4734,4210,1,524,11.10%
Snohomish,8/1/01,53061,8,2001,326644,310581,1,16063,4.90%
Spokane,8/1/01,53063,8,2001,204817,191140,1,13677,6.70%
Stevens,8/1/01,53065,8,2001,17000,15664,1,1336,7.90%
Thurston,8/1/01,53067,8,2001,104911,98745,1,6166,5.90%
Wahkiakum,8/1/01,53069,8,2001,1578,1464,1,114,7.20%
Walla Walla,8/1/01,53071,8,2001,26501,24847,1,1654,6.20%
Whatcom,8/1/01,53073,8,2001,86579,80718,1,5861,6.80%
Whitman,8/1/01,53075,8,2001,17717,16936,1,781,4.40%
Yakima,8/1/01,53077,8,2001,111715,101950,1,9765,8.70%
Adams,8/1/02,53001,8,2002,9114,8618,1,496,5.40%
Asotin,8/1/02,53003,8,2002,10309,9606,1,703,6.80%
Clallam,8/1/02,53009,8,2002,26947,24866,1,2081,7.70%
Columbia,8/1/02,53013,8,2002,1551,1411,1,140,9.00%
Cowlitz,8/1/02,53015,8,2002,42666,38401,1,4265,10.00%
Douglas,8/1/02,53017,8,2002,18436,16997,1,1439,7.80%
Ferry,8/1/02,53019,8,2002,3184,2929,1,255,8.00%
Franklin,8/1/02,53021,8,2002,24486,22920,1,1566,6.40%
Garfield,8/1/02,53023,8,2002,1182,1128,1,54,4.60%
Grant,8/1/02,53025,8,2002,38668,35866,1,2802,7.20%
Grays Harbor,8/1/02,53027,8,2002,29175,26655,1,2520,8.60%
Island,8/1/02,53029,8,2002,30475,28334,1,2141,7.00%
Jefferson,8/1/02,53031,8,2002,12613,11723,1,890,7.10%
King,8/1/02,53033,8,2002,979881,920427,1,59454,6.10%
Kitsap,8/1/02,53035,8,2002,111297,104154,1,7143,6.40%
Kittitas,8/1/02,53037,8,2002,17716,16606,1,1110,6.30%
Klickitat,8/1/02,53039,8,2002,9868,8813,1,1055,10.70%
Lewis,8/1/02,53041,8,2002,29773,27190,1,2583,8.70%
Lincoln,8/1/02,53043,8,2002,4934,4647,1,287,5.80%
Mason,8/1/02,53045,8,2002,21604,19889,1,1715,7.90%
Okanogan,8/1/02,53047,8,2002,19656,18052,1,1604,8.20%
Pacific,8/1/02,53049,8,2002,9010,8280,1,730,8.10%
Pend Oreille,8/1/02,53051,8,2002,4707,4324,1,383,8.10%
Pierce,8/1/02,53053,8,2002,344586,317521,1,27065,7.90%
San Juan,8/1/02,53055,8,2002,8772,8403,1,369,4.20%
Skagit,8/1/02,53057,8,2002,54796,50700,1,4096,7.50%
Skamania,8/1/02,53059,8,2002,4674,4239,1,435,9.30%
Snohomish,8/1/02,53061,8,2002,331328,308079,1,23249,7.00%
Spokane,8/1/02,53063,8,2002,209091,193871,1,15220,7.30%
Stevens,8/1/02,53065,8,2002,17655,16131,1,1524,8.60%
Thurston,8/1/02,53067,8,2002,110979,104162,1,6817,6.10%
Wahkiakum,8/1/02,53069,8,2002,1553,1420,1,133,8.60%
Walla Walla,8/1/02,53071,8,2002,28343,26629,1,1714,6.00%
Whatcom,8/1/02,53073,8,2002,92059,86119,1,5940,6.50%
Whitman,8/1/02,53075,8,2002,18859,17972,1,887,4.70%
Yakima,8/1/02,53077,8,2002,115640,105411,1,10229,8.80%
Adams,8/1/03,53001,8,2003,8843,8286,1,557,6.30%
Asotin,8/1/03,53003,8,2003,9930,9203,1,727,7.30%
Clallam,8/1/03,53009,8,2003,27422,25176,1,2246,8.20%
Columbia,8/1/03,53013,8,2003,1551,1403,1,148,9.50%
Cowlitz,8/1/03,53015,8,2003,42187,38020,1,4167,9.90%
Douglas,8/1/03,53017,8,2003,18728,17309,1,1419,7.60%
Ferry,8/1/03,53019,8,2003,2946,2594,1,352,11.90%
Franklin,8/1/03,53021,8,2003,26039,24214,1,1825,7.00%
Garfield,8/1/03,53023,8,2003,1154,1094,1,60,5.20%
Grant,8/1/03,53025,8,2003,38635,35597,1,3038,7.90%
Grays Harbor,8/1/03,53027,8,2003,29792,27129,1,2663,8.90%
Island,8/1/03,53029,8,2003,30477,28065,1,2412,7.90%
Jefferson,8/1/03,53031,8,2003,13068,12162,1,906,6.90%
King,8/1/03,53033,8,2003,986077,927144,1,58933,6.00%
Kitsap,8/1/03,53035,8,2003,113622,106160,1,7462,6.60%
Kittitas,8/1/03,53037,8,2003,18032,16780,1,1252,6.90%
Klickitat,8/1/03,53039,8,2003,9970,8831,1,1139,11.40%
Lewis,8/1/03,53041,8,2003,30415,27617,1,2798,9.20%
Lincoln,8/1/03,53043,8,2003,4964,4645,1,319,6.40%
Mason,8/1/03,53045,8,2003,22300,20410,1,1890,8.50%
Okanogan,8/1/03,53047,8,2003,20872,19146,1,1726,8.30%
Pacific,8/1/03,53049,8,2003,9327,8541,1,786,8.40%
Pend Oreille,8/1/03,53051,8,2003,4933,4474,1,459,9.30%
Pierce,8/1/03,53053,8,2003,347494,318499,1,28995,8.30%
San Juan,8/1/03,53055,8,2003,9042,8660,1,382,4.20%
Skagit,8/1/03,53057,8,2003,55325,51050,1,4275,7.70%
Skamania,8/1/03,53059,8,2003,4670,4229,1,441,9.40%
Snohomish,8/1/03,53061,8,2003,335479,311569,1,23910,7.10%
Spokane,8/1/03,53063,8,2003,211215,195352,1,15863,7.50%
Stevens,8/1/03,53065,8,2003,17726,16188,1,1538,8.70%
Thurston,8/1/03,53067,8,2003,114109,106534,1,7575,6.60%
Wahkiakum,8/1/03,53069,8,2003,1567,1402,1,165,10.50%
Walla Walla,8/1/03,53071,8,2003,28545,26768,1,1777,6.20%
Whatcom,8/1/03,53073,8,2003,94075,87685,1,6390,6.80%
Whitman,8/1/03,53075,8,2003,19301,18359,1,942,4.90%
Yakima,8/1/03,53077,8,2003,117101,106751,1,10350,8.80%
Adams,8/1/04,53001,8,2004,8596,8146,1,450,5.20%
Asotin,8/1/04,53003,8,2004,10005,9383,1,622,6.20%
Clallam,8/1/04,53009,8,2004,28847,26935,1,1912,6.60%
Columbia,8/1/04,53013,8,2004,1551,1434,1,117,7.50%
Cowlitz,8/1/04,53015,8,2004,42420,38934,1,3486,8.20%
Douglas,8/1/04,53017,8,2004,20216,18928,1,1288,6.40%
Ferry,8/1/04,53019,8,2004,3045,2787,1,258,8.50%
Franklin,8/1/04,53021,8,2004,27997,26409,1,1588,5.70%
Garfield,8/1/04,53023,8,2004,1209,1156,1,53,4.40%
Grant,8/1/04,53025,8,2004,39267,36729,1,2538,6.50%
Grays Harbor,8/1/04,53027,8,2004,31207,28737,1,2470,7.90%
Island,8/1/04,53029,8,2004,31681,29587,1,2094,6.60%
Jefferson,8/1/04,53031,8,2004,13689,12913,1,776,5.70%
King,8/1/04,53033,8,2004,992579,946033,1,46546,4.70%
Kitsap,8/1/04,53035,8,2004,118397,111812,1,6585,5.60%
Kittitas,8/1/04,53037,8,2004,18260,17126,1,1134,6.20%
Klickitat,8/1/04,53039,8,2004,10168,9413,1,755,7.40%
Lewis,8/1/04,53041,8,2004,30974,28616,1,2358,7.60%
Lincoln,8/1/04,53043,8,2004,5023,4746,1,277,5.50%
Mason,8/1/04,53045,8,2004,23541,21848,1,1693,7.20%
Okanogan,8/1/04,53047,8,2004,21525,20122,1,1403,6.50%
Pacific,8/1/04,53049,8,2004,9672,9020,1,652,6.70%
Pend Oreille,8/1/04,53051,8,2004,5074,4683,1,391,7.70%
Pierce,8/1/04,53053,8,2004,357976,333561,1,24415,6.80%
San Juan,8/1/04,53055,8,2004,9541,9201,1,340,3.60%
Skagit,8/1/04,53057,8,2004,57099,53466,1,3633,6.40%
Skamania,8/1/04,53059,8,2004,4893,4528,1,365,7.50%
Snohomish,8/1/04,53061,8,2004,336419,319410,1,17009,5.10%
Spokane,8/1/04,53063,8,2004,216134,202766,1,13368,6.20%
Stevens,8/1/04,53065,8,2004,18131,16851,1,1280,7.10%
Thurston,8/1/04,53067,8,2004,118695,111999,1,6696,5.60%
Wahkiakum,8/1/04,53069,8,2004,1597,1488,1,109,6.80%
Walla Walla,8/1/04,53071,8,2004,29016,27474,1,1542,5.30%
Whatcom,8/1/04,53073,8,2004,99198,93425,1,5773,5.80%
Whitman,8/1/04,53075,8,2004,20030,19162,1,868,4.30%
Yakima,8/1/04,53077,8,2004,119534,110661,1,8873,7.40%
Adams,8/1/05,53001,8,2005,8745,8304,1,441,5.00%
Asotin,8/1/05,53003,8,2005,10408,9812,1,596,5.70%
Clallam,8/1/05,53009,8,2005,30028,28100,1,1928,6.40%
Columbia,8/1/05,53013,8,2005,1651,1526,1,125,7.60%
Cowlitz,8/1/05,53015,8,2005,43035,39921,1,3114,7.20%
Douglas,8/1/05,53017,8,2005,20856,19669,1,1187,5.70%
Ferry,8/1/05,53019,8,2005,3042,2803,1,239,7.90%
Franklin,8/1/05,53021,8,2005,29260,27482,1,1778,6.10%
Garfield,8/1/05,53023,8,2005,1183,1131,1,52,4.40%
Grant,8/1/05,53025,8,2005,40894,38509,1,2385,5.80%
Grays Harbor,8/1/05,53027,8,2005,31531,29210,1,2321,7.40%
Island,8/1/05,53029,8,2005,32012,30061,1,1951,6.10%
Jefferson,8/1/05,53031,8,2005,13808,13077,1,731,5.30%
King,8/1/05,53033,8,2005,1016138,972803,1,43335,4.30%
Kitsap,8/1/05,53035,8,2005,121597,115382,1,6215,5.10%
Kittitas,8/1/05,53037,8,2005,18161,17140,1,1021,5.60%
Klickitat,8/1/05,53039,8,2005,9595,8864,1,731,7.60%
Lewis,8/1/05,53041,8,2005,30892,28571,1,2321,7.50%
Lincoln,8/1/05,53043,8,2005,5168,4884,1,284,5.50%
Mason,8/1/05,53045,8,2005,24113,22568,1,1545,6.40%
Okanogan,8/1/05,53047,8,2005,22457,21058,1,1399,6.20%
Pacific,8/1/05,53049,8,2005,9385,8783,1,602,6.40%
Pend Oreille,8/1/05,53051,8,2005,5152,4788,1,364,7.10%
Pierce,8/1/05,53053,8,2005,368970,346977,1,21993,6.00%
San Juan,8/1/05,53055,8,2005,9537,9196,1,341,3.60%
Skagit,8/1/05,53057,8,2005,58126,54850,1,3276,5.60%
Skamania,8/1/05,53059,8,2005,4995,4652,1,343,6.90%
Snohomish,8/1/05,53061,8,2005,347215,331481,1,15734,4.50%
Spokane,8/1/05,53063,8,2005,221797,209303,1,12494,5.60%
Stevens,8/1/05,53065,8,2005,18170,16910,1,1260,6.90%
Thurston,8/1/05,53067,8,2005,121489,115291,1,6198,5.10%
Wahkiakum,8/1/05,53069,8,2005,1641,1529,1,112,6.80%
Walla Walla,8/1/05,53071,8,2005,28934,27377,1,1557,5.40%
Whatcom,8/1/05,53073,8,2005,102197,97079,1,5118,5.00%
Whitman,8/1/05,53075,8,2005,20575,19689,1,886,4.30%
Yakima,8/1/05,53077,8,2005,121755,112858,1,8897,7.30%
Adams,8/1/06,53001,8,2006,8541,8128,1,413,4.80%
Asotin,8/1/06,53003,8,2006,10279,9776,1,503,4.90%
Clallam,8/1/06,53009,8,2006,29876,28031,1,1845,6.20%
Columbia,8/1/06,53013,8,2006,1538,1410,1,128,8.30%
Cowlitz,8/1/06,53015,8,2006,42830,39817,1,3013,7.00%
Douglas,8/1/06,53017,8,2006,21190,20025,1,1165,5.50%
Ferry,8/1/06,53019,8,2006,2999,2732,1,267,8.90%
Franklin,8/1/06,53021,8,2006,29701,27890,1,1811,6.10%
Garfield,8/1/06,53023,8,2006,1117,1062,1,55,4.90%
Grant,8/1/06,53025,8,2006,41348,39065,1,2283,5.50%
Grays Harbor,8/1/06,53027,8,2006,31397,29179,1,2218,7.10%
Island,8/1/06,53029,8,2006,32628,30791,1,1837,5.60%
Jefferson,8/1/06,53031,8,2006,13780,13030,1,750,5.40%
King,8/1/06,53033,8,2006,1045047,1005528,1,39519,3.80%
Kitsap,8/1/06,53035,8,2006,121740,115409,1,6331,5.20%
Kittitas,8/1/06,53037,8,2006,18848,17866,1,982,5.20%
Klickitat,8/1/06,53039,8,2006,10035,9286,1,749,7.50%
Lewis,8/1/06,53041,8,2006,31468,29298,1,2170,6.90%
Lincoln,8/1/06,53043,8,2006,4890,4628,1,262,5.40%
Mason,8/1/06,53045,8,2006,24619,23036,1,1583,6.40%
Okanogan,8/1/06,53047,8,2006,22986,21538,1,1448,6.30%
Pacific,8/1/06,53049,8,2006,9441,8822,1,619,6.60%
Pend Oreille,8/1/06,53051,8,2006,5160,4801,1,359,7.00%
Pierce,8/1/06,53053,8,2006,371722,351049,1,20673,5.60%
San Juan,8/1/06,53055,8,2006,9412,9084,1,328,3.50%
Skagit,8/1/06,53057,8,2006,58279,55173,1,3106,5.30%
Skamania,8/1/06,53059,8,2006,5050,4674,1,376,7.40%
Snohomish,8/1/06,53061,8,2006,358512,343565,1,14947,4.20%
Spokane,8/1/06,53063,8,2006,223745,211940,1,11805,5.30%
Stevens,8/1/06,53065,8,2006,18332,17082,1,1250,6.80%
Thurston,8/1/06,53067,8,2006,123628,117394,1,6234,5.00%
Wahkiakum,8/1/06,53069,8,2006,1655,1546,1,109,6.60%
Walla Walla,8/1/06,53071,8,2006,28910,27385,1,1525,5.30%
Whatcom,8/1/06,53073,8,2006,102478,97516,1,4962,4.80%
Whitman,8/1/06,53075,8,2006,20155,19295,1,860,4.30%
Yakima,8/1/06,53077,8,2006,122880,114153,1,8727,7.10%
Adams,8/1/07,53001,8,2007,8294,7925,1,369,4.40%
Asotin,8/1/07,53003,8,2007,10236,9764,1,472,4.60%
Clallam,8/1/07,53009,8,2007,30472,28606,1,1866,6.10%
Columbia,8/1/07,53013,8,2007,1581,1485,1,96,6.10%
Cowlitz,8/1/07,53015,8,2007,43964,40988,1,2976,6.80%
Douglas,8/1/07,53017,8,2007,22274,21194,1,1080,4.80%
Ferry,8/1/07,53019,8,2007,3006,2790,1,216,7.20%
Franklin,8/1/07,53021,8,2007,32815,31035,1,1780,5.40%
Garfield,8/1/07,53023,8,2007,1134,1088,1,46,4.10%
Grant,8/1/07,53025,8,2007,43155,41047,1,2108,4.90%
Grays Harbor,8/1/07,53027,8,2007,31641,29438,1,2203,7.00%
Island,8/1/07,53029,8,2007,33264,31530,1,1734,5.20%
Jefferson,8/1/07,53031,8,2007,13883,13167,1,716,5.20%
King,8/1/07,53033,8,2007,1064591,1031764,1,32827,3.10%
Kitsap,8/1/07,53035,8,2007,123324,117409,1,5915,4.80%
Kittitas,8/1/07,53037,8,2007,19920,18970,1,950,4.80%
Klickitat,8/1/07,53039,8,2007,10474,9841,1,633,6.00%
Lewis,8/1/07,53041,8,2007,31353,29179,1,2174,6.90%
Lincoln,8/1/07,53043,8,2007,4887,4638,1,249,5.10%
Mason,8/1/07,53045,8,2007,25227,23658,1,1569,6.20%
Okanogan,8/1/07,53047,8,2007,22305,21037,1,1268,5.70%
Pacific,8/1/07,53049,8,2007,9649,9056,1,593,6.10%
Pend Oreille,8/1/07,53051,8,2007,5299,4944,1,355,6.70%
Pierce,8/1/07,53053,8,2007,385863,365640,1,20223,5.20%
San Juan,8/1/07,53055,8,2007,9756,9453,1,303,3.10%
Skagit,8/1/07,53057,8,2007,59523,56636,1,2887,4.90%
Skamania,8/1/07,53059,8,2007,5055,4682,1,373,7.40%
Snohomish,8/1/07,53061,8,2007,361952,349982,1,11970,3.30%
Spokane,8/1/07,53063,8,2007,229133,217387,1,11746,5.10%
Stevens,8/1/07,53065,8,2007,18754,17521,1,1233,6.60%
Thurston,8/1/07,53067,8,2007,127755,121652,1,6103,4.80%
Wahkiakum,8/1/07,53069,8,2007,1675,1567,1,108,6.40%
Walla Walla,8/1/07,53071,8,2007,29116,27720,1,1396,4.80%
Whatcom,8/1/07,53073,8,2007,106496,101711,1,4785,4.50%
Whitman,8/1/07,53075,8,2007,20194,19372,1,822,4.10%
Yakima,8/1/07,53077,8,2007,123906,116035,1,7871,6.40%
Adams,8/1/08,53001,8,2008,8567,8119,1,448,5.20%
Asotin,8/1/08,53003,8,2008,10314,9676,1,638,6.20%
Clallam,8/1/08,53009,8,2008,30425,28282,1,2143,7.00%
Columbia,8/1/08,53013,8,2008,1626,1519,1,107,6.60%
Cowlitz,8/1/08,53015,8,2008,44539,40730,1,3809,8.60%
Douglas,8/1/08,53017,8,2008,22203,21039,1,1164,5.20%
Ferry,8/1/08,53019,8,2008,3121,2891,1,230,7.40%
Franklin,8/1/08,53021,8,2008,34329,32502,1,1827,5.30%
Garfield,8/1/08,53023,8,2008,1106,1068,1,38,3.40%
Grant,8/1/08,53025,8,2008,43209,40776,1,2433,5.60%
Grays Harbor,8/1/08,53027,8,2008,32367,29951,1,2416,7.50%
Island,8/1/08,53029,8,2008,33425,31519,1,1906,5.70%
Jefferson,8/1/08,53031,8,2008,13953,13178,1,775,5.60%
King,8/1/08,53033,8,2008,1092374,1046997,1,45377,4.20%
Kitsap,8/1/08,53035,8,2008,125284,118687,1,6597,5.30%
Kittitas,8/1/08,53037,8,2008,20355,19204,1,1151,5.70%
Klickitat,8/1/08,53039,8,2008,10584,9810,1,774,7.30%
Lewis,8/1/08,53041,8,2008,31655,29133,1,2522,8.00%
Lincoln,8/1/08,53043,8,2008,5009,4765,1,244,4.90%
Mason,8/1/08,53045,8,2008,25478,23632,1,1846,7.20%
Okanogan,8/1/08,53047,8,2008,22967,21643,1,1324,5.80%
Pacific,8/1/08,53049,8,2008,9608,8889,1,719,7.50%
Pend Oreille,8/1/08,53051,8,2008,5551,5121,1,430,7.70%
Pierce,8/1/08,53053,8,2008,392484,368978,1,23506,6.00%
San Juan,8/1/08,53055,8,2008,10179,9860,1,319,3.10%
Skagit,8/1/08,53057,8,2008,60071,56548,1,3523,5.90%
Skamania,8/1/08,53059,8,2008,5164,4702,1,462,8.90%
Snohomish,8/1/08,53061,8,2008,373645,355587,1,18058,4.80%
Spokane,8/1/08,53063,8,2008,236828,223468,1,13360,5.60%
Stevens,8/1/08,53065,8,2008,19136,17782,1,1354,7.10%
Thurston,8/1/08,53067,8,2008,131862,124926,1,6936,5.30%
Wahkiakum,8/1/08,53069,8,2008,1782,1658,1,124,7.00%
Walla Walla,8/1/08,53071,8,2008,30928,29488,1,1440,4.70%
Whatcom,8/1/08,53073,8,2008,110554,104808,1,5746,5.20%
Whitman,8/1/08,53075,8,2008,20581,19656,1,925,4.50%
Yakima,8/1/08,53077,8,2008,126131,116874,1,9257,7.30%
Adams,8/1/09,53001,8,2009,8885,8214,1,671,7.60%
Asotin,8/1/09,53003,8,2009,10477,9430,1,1047,10.00%
Clallam,8/1/09,53009,8,2009,31007,27895,1,3112,10.00%
Columbia,8/1/09,53013,8,2009,1655,1485,1,170,10.30%
Cowlitz,8/1/09,53015,8,2009,45058,38761,1,6297,14.00%
Douglas,8/1/09,53017,8,2009,23610,21744,1,1866,7.90%
Ferry,8/1/09,53019,8,2009,3163,2775,1,388,12.30%
Franklin,8/1/09,53021,8,2009,37939,34978,1,2961,7.80%
Garfield,8/1/09,53023,8,2009,1094,1022,1,72,6.60%
Grant,8/1/09,53025,8,2009,45323,41375,1,3948,8.70%
Grays Harbor,8/1/09,53027,8,2009,32199,28040,1,4159,12.90%
Island,8/1/09,53029,8,2009,33201,30070,1,3131,9.40%
Jefferson,8/1/09,53031,8,2009,13582,12426,1,1156,8.50%
King,8/1/09,53033,8,2009,1117949,1018105,1,99844,8.90%
Kitsap,8/1/09,53035,8,2009,126041,115904,1,10137,8.00%
Kittitas,8/1/09,53037,8,2009,20537,18614,1,1923,9.40%
Klickitat,8/1/09,53039,8,2009,11667,10569,1,1098,9.40%
Lewis,8/1/09,53041,8,2009,32236,28018,1,4218,13.10%
Lincoln,8/1/09,53043,8,2009,5130,4727,1,403,7.90%
Mason,8/1/09,53045,8,2009,25483,22809,1,2674,10.50%
Okanogan,8/1/09,53047,8,2009,23982,22030,1,1952,8.10%
Pacific,8/1/09,53049,8,2009,9566,8414,1,1152,12.00%
Pend Oreille,8/1/09,53051,8,2009,5656,4863,1,793,14.00%
Pierce,8/1/09,53053,8,2009,396261,355750,1,40511,10.20%
San Juan,8/1/09,53055,8,2009,9843,9329,1,514,5.20%
Skagit,8/1/09,53057,8,2009,60067,53881,1,6186,10.30%
Skamania,8/1/09,53059,8,2009,5067,4439,1,628,12.40%
Snohomish,8/1/09,53061,8,2009,382760,343795,1,38965,10.20%
Spokane,8/1/09,53063,8,2009,238231,215965,1,22266,9.30%
Stevens,8/1/09,53065,8,2009,19091,16772,1,2319,12.10%
Thurston,8/1/09,53067,8,2009,131554,120748,1,10806,8.20%
Wahkiakum,8/1/09,53069,8,2009,1692,1460,1,232,13.70%
Walla Walla,8/1/09,53071,8,2009,31218,29138,1,2080,6.70%
Whatcom,8/1/09,53073,8,2009,109233,99382,1,9851,9.00%
Whitman,8/1/09,53075,8,2009,21289,19893,1,1396,6.60%
Yakima,8/1/09,53077,8,2009,131350,119362,1,11988,9.10%
Adams,8/1/10,53001,8,2010,9221,8490,1,731,7.90%
Asotin,8/1/10,53003,8,2010,10183,9392,1,791,7.80%
Clallam,8/1/10,53009,8,2010,29976,26856,1,3120,10.40%
Columbia,8/1/10,53013,8,2010,1987,1825,1,162,8.20%
Cowlitz,8/1/10,53015,8,2010,46625,40911,1,5714,12.30%
Douglas,8/1/10,53017,8,2010,20213,18330,1,1883,9.30%
Ferry,8/1/10,53019,8,2010,2668,2248,1,420,15.70%
Franklin,8/1/10,53021,8,2010,39923,36912,1,3011,7.50%
Garfield,8/1/10,53023,8,2010,1143,1073,1,70,6.10%
Grant,8/1/10,53025,8,2010,44747,40567,1,4180,9.30%
Grays Harbor,8/1/10,53027,8,2010,31201,27188,1,4013,12.90%
Island,8/1/10,53029,8,2010,33765,30853,1,2912,8.60%
Jefferson,8/1/10,53031,8,2010,12832,11585,1,1247,9.70%
King,8/1/10,53033,8,2010,1098876,1000844,1,98032,8.90%
Kitsap,8/1/10,53035,8,2010,120716,110758,1,9958,8.20%
Kittitas,8/1/10,53037,8,2010,20398,18456,1,1942,9.50%
Klickitat,8/1/10,53039,8,2010,10661,9478,1,1183,11.10%
Lewis,8/1/10,53041,8,2010,34319,30152,1,4167,12.10%
Lincoln,8/1/10,53043,8,2010,5594,5194,1,400,7.20%
Mason,8/1/10,53045,8,2010,24880,22019,1,2861,11.50%
Okanogan,8/1/10,53047,8,2010,24677,22489,1,2188,8.90%
Pacific,8/1/10,53049,8,2010,8969,7850,1,1119,12.50%
Pend Oreille,8/1/10,53051,8,2010,5028,4359,1,669,13.30%
Pierce,8/1/10,53053,8,2010,393692,354182,1,39510,10.00%
San Juan,8/1/10,53055,8,2010,9483,8932,1,551,5.80%
Skagit,8/1/10,53057,8,2010,60247,54282,1,5965,9.90%
Skamania,8/1/10,53059,8,2010,5155,4536,1,619,12.00%
Snohomish,8/1/10,53061,8,2010,384219,343662,1,40557,10.60%
Spokane,8/1/10,53063,8,2010,235753,213527,1,22226,9.40%
Stevens,8/1/10,53065,8,2010,18910,16656,1,2254,11.90%
Thurston,8/1/10,53067,8,2010,126544,115672,1,10872,8.60%
Wahkiakum,8/1/10,53069,8,2010,1491,1279,1,212,14.20%
Walla Walla,8/1/10,53071,8,2010,30374,28051,1,2323,7.60%
Whatcom,8/1/10,53073,8,2010,104826,95393,1,9433,9.00%
Whitman,8/1/10,53075,8,2010,22898,21352,1,1546,6.80%
Yakima,8/1/10,53077,8,2010,125150,112311,1,12839,10.30%
Adams,8/1/11,53001,8,2011,9008,8313,1,695,7.70%
Asotin,8/1/11,53003,8,2011,9892,9054,1,838,8.50%
Clallam,8/1/11,53009,8,2011,28526,25593,1,2933,10.30%
Columbia,8/1/11,53013,8,2011,1883,1726,1,157,8.30%
Cowlitz,8/1/11,53015,8,2011,44601,39431,1,5170,11.60%
Douglas,8/1/11,53017,8,2011,20468,18754,1,1714,8.40%
Ferry,8/1/11,53019,8,2011,2557,2128,1,429,16.80%
Franklin,8/1/11,53021,8,2011,40204,37098,1,3106,7.70%
Garfield,8/1/11,53023,8,2011,1084,1011,1,73,6.70%
Grant,8/1/11,53025,8,2011,44756,40880,1,3876,8.70%
Grays Harbor,8/1/11,53027,8,2011,30052,26118,1,3934,13.10%
Island,8/1/11,53029,8,2011,32285,29389,1,2896,9.00%
Jefferson,8/1/11,53031,8,2011,11986,10787,1,1199,10.00%
King,8/1/11,53033,8,2011,1107018,1020367,1,86651,7.80%
Kitsap,8/1/11,53035,8,2011,116585,107032,1,9553,8.20%
Kittitas,8/1/11,53037,8,2011,19493,17661,1,1832,9.40%
Klickitat,8/1/11,53039,8,2011,10737,9593,1,1144,10.70%
Lewis,8/1/11,53041,8,2011,32336,28365,1,3971,12.30%
Lincoln,8/1/11,53043,8,2011,5507,5105,1,402,7.30%
Mason,8/1/11,53045,8,2011,23352,20735,1,2617,11.20%
Okanogan,8/1/11,53047,8,2011,24511,22603,1,1908,7.80%
Pacific,8/1/11,53049,8,2011,8403,7379,1,1024,12.20%
Pend Oreille,8/1/11,53051,8,2011,4759,4121,1,638,13.40%
Pierce,8/1/11,53053,8,2011,383327,345142,1,38185,10.00%
San Juan,8/1/11,53055,8,2011,9061,8553,1,508,5.60%
Skagit,8/1/11,53057,8,2011,57697,52015,1,5682,9.80%
Skamania,8/1/11,53059,8,2011,5015,4441,1,574,11.40%
Snohomish,8/1/11,53061,8,2011,383196,347769,1,35427,9.20%
Spokane,8/1/11,53063,8,2011,226887,205651,1,21236,9.40%
Stevens,8/1/11,53065,8,2011,17974,15862,1,2112,11.80%
Thurston,8/1/11,53067,8,2011,121300,110444,1,10856,8.90%
Wahkiakum,8/1/11,53069,8,2011,1408,1223,1,185,13.10%
Walla Walla,8/1/11,53071,8,2011,28911,26636,1,2275,7.90%
Whatcom,8/1/11,53073,8,2011,103059,94022,1,9037,8.80%
Whitman,8/1/11,53075,8,2011,22702,21150,1,1552,6.80%
Yakima,8/1/11,53077,8,2011,124593,111996,1,12597,10.10%
Adams,8/1/12,53001,8,2012,8877,8203,1,674,7.60%
Asotin,8/1/12,53003,8,2012,9616,8894,1,722,7.50%
Clallam,8/1/12,53009,8,2012,28132,25370,1,2762,9.80%
Clark,8/1/12,53011,8,2012,206866,187300,1,19566,9.50%
Columbia,8/1/12,53013,8,2012,1833,1699,1,134,7.30%
Cowlitz,8/1/12,53015,8,2012,44158,39509,1,4649,10.50%
Douglas,8/1/12,53017,8,2012,19945,18283,1,1662,8.30%
Ferry,8/1/12,53019,8,2012,2482,2132,1,350,14.10%
Franklin,8/1/12,53021,8,2012,40709,37224,1,3485,8.60%
Garfield,8/1/12,53023,8,2012,1059,992,1,67,6.30%
Grant,8/1/12,53025,8,2012,45756,42028,1,3728,8.10%
Grays Harbor,8/1/12,53027,8,2012,28566,25087,1,3479,12.20%
Island,8/1/12,53029,8,2012,32142,29609,1,2533,7.90%
Jefferson,8/1/12,53031,8,2012,11831,10697,1,1134,9.60%
King,8/1/12,53033,8,2012,1121663,1051498,1,70165,6.30%
Kitsap,8/1/12,53035,8,2012,114625,105705,1,8920,7.80%
Kittitas,8/1/12,53037,8,2012,19564,17893,1,1671,8.50%
Klickitat,8/1/12,53039,8,2012,10387,9407,1,980,9.40%
Lewis,8/1/12,53041,8,2012,32245,28579,1,3666,11.40%
Lincoln,8/1/12,53043,8,2012,5416,5064,1,352,6.50%
Mason,8/1/12,53045,8,2012,23192,20723,1,2469,10.60%
Okanogan,8/1/12,53047,8,2012,24089,22295,1,1794,7.40%
Pacific,8/1/12,53049,8,2012,8332,7434,1,898,10.80%
Pend Oreille,8/1/12,53051,8,2012,4684,4122,1,562,12.00%
Pierce,8/1/12,53053,8,2012,381451,346187,1,35264,9.20%
San Juan,8/1/12,53055,8,2012,9043,8602,1,441,4.90%
Skagit,8/1/12,53057,8,2012,57421,52186,1,5235,9.10%
Skamania,8/1/12,53059,8,2012,4958,4451,1,507,10.20%
Snohomish,8/1/12,53061,8,2012,385069,356788,1,28281,7.30%
Spokane,8/1/12,53063,8,2012,225219,205476,1,19743,8.80%
Stevens,8/1/12,53065,8,2012,17796,15815,1,1981,11.10%
Thurston,8/1/12,53067,8,2012,121558,111321,1,10237,8.40%
Wahkiakum,8/1/12,53069,8,2012,1357,1185,1,172,12.70%
Walla Walla,8/1/12,53071,8,2012,29035,26900,1,2135,7.40%
Whatcom,8/1/12,53073,8,2012,102560,94295,1,8265,8.10%
Whitman,8/1/12,53075,8,2012,22638,21005,1,1633,7.20%
Yakima,8/1/12,53077,8,2012,123867,111439,1,12428,10.00%
Adams,8/1/13,53001,8,2013,9018,8426,1,592,6.60%
Asotin,8/1/13,53003,8,2013,9773,9183,1,590,6.00%
Clallam,8/1/13,53009,8,2013,27505,25049,1,2456,8.90%
Clark,8/1/13,53011,8,2013,207076,190017,1,17059,8.20%
Columbia,8/1/13,53013,8,2013,1796,1673,1,123,6.80%
Cowlitz,8/1/13,53015,8,2013,43042,39028,1,4014,9.30%
Douglas,8/1/13,53017,8,2013,19480,18021,1,1459,7.50%
Ferry,8/1/13,53019,8,2013,2507,2212,1,295,11.80%
Franklin,8/1/13,53021,8,2013,39644,36533,1,3111,7.80%
Garfield,8/1/13,53023,8,2013,1038,975,1,63,6.10%
Grant,8/1/13,53025,8,2013,45546,42300,1,3246,7.10%
Grays Harbor,8/1/13,53027,8,2013,27881,24775,1,3106,11.10%
Island,8/1/13,53029,8,2013,31609,29408,1,2201,7.00%
Jefferson,8/1/13,53031,8,2013,11488,10512,1,976,8.50%
King,8/1/13,53033,8,2013,1138928,1080107,1,58821,5.20%
Kitsap,8/1/13,53035,8,2013,112987,105301,1,7686,6.80%
Kittitas,8/1/13,53037,8,2013,19290,17859,1,1431,7.40%
Klickitat,8/1/13,53039,8,2013,10094,9260,1,834,8.30%
Lewis,8/1/13,53041,8,2013,31135,28052,1,3083,9.90%
Lincoln,8/1/13,53043,8,2013,5274,4985,1,289,5.50%
Mason,8/1/13,53045,8,2013,23216,21023,1,2193,9.40%
Okanogan,8/1/13,53047,8,2013,23050,21478,1,1572,6.80%
Pacific,8/1/13,53049,8,2013,8176,7349,1,827,10.10%
Pend Oreille,8/1/13,53051,8,2013,4579,4087,1,492,10.70%
Pierce,8/1/13,53053,8,2013,380697,350280,1,30417,8.00%
San Juan,8/1/13,53055,8,2013,8907,8518,1,389,4.40%
Skagit,8/1/13,53057,8,2013,57550,53058,1,4492,7.80%
Skamania,8/1/13,53059,8,2013,4948,4511,1,437,8.80%
Snohomish,8/1/13,53061,8,2013,389213,366386,1,22827,5.90%
Spokane,8/1/13,53063,8,2013,223369,206330,1,17039,7.60%
Stevens,8/1/13,53065,8,2013,17368,15716,1,1652,9.50%
Thurston,8/1/13,53067,8,2013,120985,112280,1,8705,7.20%
Wahkiakum,8/1/13,53069,8,2013,1282,1154,1,128,10.00%
Walla Walla,8/1/13,53071,8,2013,28091,26281,1,1810,6.40%
Whatcom,8/1/13,53073,8,2013,101692,94575,1,7117,7.00%
Whitman,8/1/13,53075,8,2013,22536,21190,1,1346,6.00%
Yakima,8/1/13,53077,8,2013,121508,110167,1,11341,9.30%
Adams,8/1/14,53001,8,2014,9227,8739,1,488,5.30%
Asotin,8/1/14,53003,8,2014,9668,9170,1,498,5.20%
Clallam,8/1/14,53009,8,2014,26937,24852,1,2085,7.70%
Clark,8/1/14,53011,8,2014,208229,193707,1,14522,7.00%
Columbia,8/1/14,53013,8,2014,1751,1640,1,111,6.30%
Cowlitz,8/1/14,53015,8,2014,43679,40288,1,3391,7.80%
Douglas,8/1/14,53017,8,2014,20072,18748,1,1324,6.60%
Ferry,8/1/14,53019,8,2014,2500,2253,1,247,9.90%
Franklin,8/1/14,53021,8,2014,39446,36785,1,2661,6.70%
Garfield,8/1/14,53023,8,2014,1026,966,1,60,5.80%
Grant,8/1/14,53025,8,2014,46545,43672,1,2873,6.20%
Grays Harbor,8/1/14,53027,8,2014,27208,24656,1,2552,9.40%
Island,8/1/14,53029,8,2014,31707,29684,1,2023,6.40%
Jefferson,8/1/14,53031,8,2014,11303,10474,1,829,7.30%
King,8/1/14,53033,8,2014,1164914,1109368,1,55546,4.80%
Kitsap,8/1/14,53035,8,2014,114186,107406,1,6780,5.90%
Kittitas,8/1/14,53037,8,2014,19038,17743,1,1295,6.80%
Klickitat,8/1/14,53039,8,2014,9850,9194,1,656,6.70%
Lewis,8/1/14,53041,8,2014,30449,27789,1,2660,8.70%
Lincoln,8/1/14,53043,8,2014,5198,4939,1,259,5.00%
Mason,8/1/14,53045,8,2014,23044,21188,1,1856,8.10%
Okanogan,8/1/14,53047,8,2014,23503,22136,1,1367,5.80%
Pacific,8/1/14,53049,8,2014,8000,7331,1,669,8.40%
Pend Oreille,8/1/14,53051,8,2014,4511,4085,1,426,9.40%
Pierce,8/1/14,53053,8,2014,383510,357266,1,26244,6.80%
San Juan,8/1/14,53055,8,2014,8653,8311,1,342,4.00%
Skagit,8/1/14,53057,8,2014,57405,53514,1,3891,6.80%
Skamania,8/1/14,53059,8,2014,4892,4538,1,354,7.20%
Snohomish,8/1/14,53061,8,2014,397590,376703,1,20887,5.30%
Spokane,8/1/14,53063,8,2014,221902,206994,1,14908,6.70%
Stevens,8/1/14,53065,8,2014,17111,15689,1,1422,8.30%
Thurston,8/1/14,53067,8,2014,122207,114501,1,7706,6.30%
Wahkiakum,8/1/14,53069,8,2014,1310,1198,1,112,8.50%
Walla Walla,8/1/14,53071,8,2014,27869,26235,1,1634,5.90%
Whatcom,8/1/14,53073,8,2014,100234,93876,1,6358,6.30%
Whitman,8/1/14,53075,8,2014,22351,21157,1,1194,5.30%
Yakima,8/1/14,53077,8,2014,124071,114218,1,9853,7.90%
Adams,8/1/15,53001,8,2015,9397,8914,1,483,5.10%
Asotin,8/1/15,53003,8,2015,9528,9105,1,423,4.40%
Clallam,8/1/15,53009,8,2015,26781,24724,1,2057,7.70%
Clark,8/1/15,53011,8,2015,212043,198275,1,13768,6.50%
Columbia,8/1/15,53013,8,2015,1679,1587,1,92,5.50%
Cowlitz,8/1/15,53015,8,2015,43573,40238,1,3335,7.70%
Douglas,8/1/15,53017,8,2015,20616,19465,1,1151,5.60%
Ferry,8/1/15,53019,8,2015,2505,2273,1,232,9.30%
Franklin,8/1/15,53021,8,2015,40424,37900,1,2524,6.20%
Garfield,8/1/15,53023,8,2015,957,909,1,48,5.00%
Grant,8/1/15,53025,8,2015,46711,44041,1,2670,5.70%
Grays Harbor,8/1/15,53027,8,2015,26610,24300,1,2310,8.70%
Island,8/1/15,53029,8,2015,31482,29672,1,1810,5.70%
Jefferson,8/1/15,53031,8,2015,11175,10418,1,757,6.80%
King,8/1/15,53033,8,2015,1190381,1142318,1,48063,4.00%
Kitsap,8/1/15,53035,8,2015,114408,108292,1,6116,5.30%
Kittitas,8/1/15,53037,8,2015,19428,18254,1,1174,6.00%
Klickitat,8/1/15,53039,8,2015,9601,8998,1,603,6.30%
Lewis,8/1/15,53041,8,2015,30856,28329,1,2527,8.20%
Lincoln,8/1/15,53043,8,2015,4901,4647,1,254,5.20%
Mason,8/1/15,53045,8,2015,22652,20861,1,1791,7.90%
Okanogan,8/1/15,53047,8,2015,23031,21761,1,1270,5.50%
Pacific,8/1/15,53049,8,2015,8168,7525,1,643,7.90%
Pend Oreille,8/1/15,53051,8,2015,4514,4081,1,433,9.60%
Pierce,8/1/15,53053,8,2015,387184,362479,1,24705,6.40%
San Juan,8/1/15,53055,8,2015,8658,8336,1,322,3.70%
Skagit,8/1/15,53057,8,2015,57010,53287,1,3723,6.50%
Skamania,8/1/15,53059,8,2015,4877,4543,1,334,6.80%
Snohomish,8/1/15,53061,8,2015,405878,388013,1,17865,4.40%
Spokane,8/1/15,53063,8,2015,222597,208563,1,14034,6.30%
Stevens,8/1/15,53065,8,2015,16989,15665,1,1324,7.80%
Thurston,8/1/15,53067,8,2015,123461,116197,1,7264,5.90%
Wahkiakum,8/1/15,53069,8,2015,1258,1153,1,105,8.30%
Walla Walla,8/1/15,53071,8,2015,27239,25737,1,1502,5.50%
Whatcom,8/1/15,53073,8,2015,102139,96034,1,6105,6.00%
Whitman,8/1/15,53075,8,2015,22229,21132,1,1097,4.90%
Yakima,8/1/15,53077,8,2015,127654,118730,1,8924,7.00%
Adams,8/1/16,53001,8,2016,9561,9144,1,417,4.40%
Asotin,8/1/16,53003,8,2016,9790,9350,1,440,4.50%
Clallam,8/1/16,53009,8,2016,27426,25520,1,1906,6.90%
Clark,8/1/16,53011,8,2016,218435,204932,1,13503,6.20%
Columbia,8/1/16,53013,8,2016,1727,1631,1,96,5.60%
Cowlitz,8/1/16,53015,8,2016,44487,41342,1,3145,7.10%
Douglas,8/1/16,53017,8,2016,21430,20127,1,1303,6.10%
Ferry,8/1/16,53019,8,2016,2508,2277,1,231,9.20%
Franklin,8/1/16,53021,8,2016,41587,39049,1,2538,6.10%
Garfield,8/1/16,53023,8,2016,960,915,1,45,4.70%
Grant,8/1/16,53025,8,2016,46191,43467,1,2724,5.90%
Grays Harbor,8/1/16,53027,8,2016,27258,25093,1,2165,7.90%
Island,8/1/16,53029,8,2016,32662,30874,1,1788,5.50%
Jefferson,8/1/16,53031,8,2016,11566,10810,1,756,6.50%
King,8/1/16,53033,8,2016,1220950,1175526,1,45424,3.70%
Kitsap,8/1/16,53035,8,2016,116631,110250,1,6381,5.50%
Kittitas,8/1/16,53037,8,2016,20083,18945,1,1138,5.70%
Klickitat,8/1/16,53039,8,2016,9844,9269,1,575,5.80%
Lewis,8/1/16,53041,8,2016,31783,29394,1,2389,7.50%
Lincoln,8/1/16,53043,8,2016,4997,4771,1,226,4.50%
Mason,8/1/16,53045,8,2016,23404,21654,1,1750,7.50%
Okanogan,8/1/16,53047,8,2016,23459,22192,1,1267,5.40%
Pacific,8/1/16,53049,8,2016,8451,7866,1,585,6.90%
Pend Oreille,8/1/16,53051,8,2016,4573,4182,1,391,8.60%
Pierce,8/1/16,53053,8,2016,400866,377033,1,23833,5.90%
San Juan,8/1/16,53055,8,2016,8888,8582,1,306,3.40%
Skagit,8/1/16,53057,8,2016,58649,55041,1,3608,6.20%
Skamania,8/1/16,53059,8,2016,4996,4678,1,318,6.40%
Snohomish,8/1/16,53061,8,2016,418457,401017,1,17440,4.20%
Spokane,8/1/16,53063,8,2016,230176,216715,1,13461,5.80%
Stevens,8/1/16,53065,8,2016,17507,16235,1,1272,7.30%
Thurston,8/1/16,53067,8,2016,127657,120765,1,6892,5.40%
Wahkiakum,8/1/16,53069,8,2016,1264,1168,1,96,7.60%
Walla Walla,8/1/16,53071,8,2016,28583,27165,1,1418,5.00%
Whatcom,8/1/16,53073,8,2016,105302,99279,1,6023,5.70%
Whitman,8/1/16,53075,8,2016,21716,20566,1,1150,5.30%
Yakima,8/1/16,53077,8,2016,133778,125175,1,8603,6.40%
Adams,8/1/17,53001,8,2017,9988,9600,1,388,3.90%
Asotin,8/1/17,53003,8,2017,10165,9786,1,379,3.70%
Clallam,8/1/17,53009,8,2017,27898,26034,1,1864,6.70%
Clark,8/1/17,53011,8,2017,226553,214722,1,11831,5.20%
Columbia,8/1/17,53013,8,2017,1800,1706,1,94,5.20%
Cowlitz,8/1/17,53015,8,2017,45383,42647,1,2736,6.00%
Douglas,8/1/17,53017,8,2017,21898,20827,1,1071,4.90%
Ferry,8/1/17,53019,8,2017,2551,2296,1,255,10.00%
Franklin,8/1/17,53021,8,2017,41886,39701,1,2185,5.20%
Garfield,8/1/17,53023,8,2017,953,907,1,46,4.80%
Grant,8/1/17,53025,8,2017,46967,44462,1,2505,5.30%
Grays Harbor,8/1/17,53027,8,2017,27954,26085,1,1869,6.70%
Island,8/1/17,53029,8,2017,33905,32140,1,1765,5.20%
Jefferson,8/1/17,53031,8,2017,11974,11261,1,713,6.00%
King,8/1/17,53033,8,2017,1243337,1199346,1,43991,3.50%
Kitsap,8/1/17,53035,8,2017,119713,113821,1,5892,4.90%
Kittitas,8/1/17,53037,8,2017,20846,19768,1,1078,5.20%
Klickitat,8/1/17,53039,8,2017,10238,9689,1,549,5.40%
Lewis,8/1/17,53041,8,2017,33181,31006,1,2175,6.60%
Lincoln,8/1/17,53043,8,2017,5116,4898,1,218,4.30%
Mason,8/1/17,53045,8,2017,23552,22090,1,1462,6.20%
Okanogan,8/1/17,53047,8,2017,23014,21769,1,1245,5.40%
Pacific,8/1/17,53049,8,2017,8535,7962,1,573,6.70%
Pend Oreille,8/1/17,53051,8,2017,4640,4336,1,304,6.60%
Pierce,8/1/17,53053,8,2017,413831,391204,1,22627,5.50%
San Juan,8/1/17,53055,8,2017,9201,8917,1,284,3.10%
Skagit,8/1/17,53057,8,2017,59856,56695,1,3161,5.30%
Skamania,8/1/17,53059,8,2017,5250,4937,1,313,6.00%
Snohomish,8/1/17,53061,8,2017,426053,409144,1,16909,4.00%
Spokane,8/1/17,53063,8,2017,236679,224155,1,12524,5.30%
Stevens,8/1/17,53065,8,2017,17808,16670,1,1138,6.40%
Thurston,8/1/17,53067,8,2017,132836,126136,1,6700,5.00%
Wahkiakum,8/1/17,53069,8,2017,1301,1216,1,85,6.50%
Walla Walla,8/1/17,53071,8,2017,29036,27694,1,1342,4.60%
Whatcom,8/1/17,53073,8,2017,109926,104392,1,5534,5.00%
Whitman,8/1/17,53075,8,2017,21319,20329,1,990,4.60%
Yakima,8/1/17,53077,8,2017,129173,120694,1,8479,6.60%
Adams,8/1/18,53001,8,2018,10299,9887,1,412,4.00%
Asotin,8/1/18,53003,8,2018,9972,9593,1,379,3.80%
Clallam,8/1/18,53009,8,2018,28179,26528,1,1651,5.90%
Clark,8/1/18,53011,8,2018,230497,219233,1,11264,4.90%
Columbia,8/1/18,53013,8,2018,1812,1723,1,89,4.90%
Cowlitz,8/1/18,53015,8,2018,46031,43337,1,2694,5.90%
Douglas,8/1/18,53017,8,2018,22218,21120,1,1098,4.90%
Ferry,8/1/18,53019,8,2018,2471,2228,1,243,9.80%
Franklin,8/1/18,53021,8,2018,42774,40572,1,2202,5.10%
Garfield,8/1/18,53023,8,2018,958,906,1,52,5.40%
Grant,8/1/18,53025,8,2018,48552,45980,1,2572,5.30%
Grays Harbor,8/1/18,53027,8,2018,28130,26369,1,1761,6.30%
Island,8/1/18,53029,8,2018,34389,32626,1,1763,5.10%
Jefferson,8/1/18,53031,8,2018,12251,11609,1,642,5.20%
King,8/1/18,53033,8,2018,1264763,1225806,1,38957,3.10%
Kitsap,8/1/18,53035,8,2018,122610,117098,1,5512,4.50%
Kittitas,8/1/18,53037,8,2018,20702,19581,1,1121,5.40%
Klickitat,8/1/18,53039,8,2018,10360,9839,1,521,5.00%
Lewis,8/1/18,53041,8,2018,33801,31688,1,2113,6.30%
Lincoln,8/1/18,53043,8,2018,5253,5032,1,221,4.20%
Mason,8/1/18,53045,8,2018,24295,22774,1,1521,6.30%
Okanogan,8/1/18,53047,8,2018,21872,20686,1,1186,5.40%
Pacific,8/1/18,53049,8,2018,8697,8185,1,512,5.90%
Pend Oreille,8/1/18,53051,8,2018,4747,4439,1,308,6.50%
Pierce,8/1/18,53053,8,2018,423209,401257,1,21952,5.20%
San Juan,8/1/18,53055,8,2018,9158,8876,1,282,3.10%
Skagit,8/1/18,53057,8,2018,60915,57881,1,3034,5.00%
Skamania,8/1/18,53059,8,2018,5285,5010,1,275,5.20%
Snohomish,8/1/18,53061,8,2018,431011,416587,1,14424,3.30%
Spokane,8/1/18,53063,8,2018,241360,229066,1,12294,5.10%
Stevens,8/1/18,53065,8,2018,18024,16877,1,1147,6.40%
Thurston,8/1/18,53067,8,2018,136137,129706,1,6431,4.70%
Wahkiakum,8/1/18,53069,8,2018,1306,1223,1,83,6.40%
Walla Walla,8/1/18,53071,8,2018,29527,28234,1,1293,4.40%
Whatcom,8/1/18,53073,8,2018,110252,104986,1,5266,4.80%
Whitman,8/1/18,53075,8,2018,23632,22604,1,1028,4.40%
Yakima,8/1/18,53077,8,2018,133772,125979,1,7793,5.80%
Adams,8/1/19,53001,8,2019,11034,10588,1,446,4.00%
Asotin,8/1/19,53003,8,2019,10279,9881,1,398,3.90%
Clallam,8/1/19,53009,8,2019,28959,27197,1,1762,6.10%
Clark,8/1/19,53011,8,2019,240864,229108,1,11756,4.90%
Columbia,8/1/19,53013,8,2019,1852,1765,1,87,4.70%
Cowlitz,8/1/19,53015,8,2019,47709,44864,1,2845,6.00%
Douglas,8/1/19,53017,8,2019,22419,21220,1,1199,5.30%
Ferry,8/1/19,53019,8,2019,2495,2254,1,241,9.70%
Franklin,8/1/19,53021,8,2019,45219,42870,1,2349,5.20%
Garfield,8/1/19,53023,8,2019,965,923,1,42,4.40%
Grant,8/1/19,53025,8,2019,49109,46309,1,2800,5.70%
Grays Harbor,8/1/19,53027,8,2019,28896,27014,1,1882,6.50%
Island,8/1/19,53029,8,2019,36015,34185,1,1830,5.10%
Jefferson,8/1/19,53031,8,2019,13091,12390,1,701,5.40%
King,8/1/19,53033,8,2019,1297538,1261969,1,35569,2.70%
Kitsap,8/1/19,53035,8,2019,128041,122293,1,5748,4.50%
Kittitas,8/1/19,53037,8,2019,21585,20438,1,1147,5.30%
Klickitat,8/1/19,53039,8,2019,10832,10288,1,544,5.00%
Lewis,8/1/19,53041,8,2019,35169,33107,1,2062,5.90%
Lincoln,8/1/19,53043,8,2019,5218,4996,1,222,4.30%
Mason,8/1/19,53045,8,2019,24984,23505,1,1479,5.90%
Okanogan,8/1/19,53047,8,2019,21803,20630,1,1173,5.40%
Pacific,8/1/19,53049,8,2019,8950,8406,1,544,6.10%
Pend Oreille,8/1/19,53051,8,2019,5059,4633,1,426,8.40%
Pierce,8/1/19,53053,8,2019,440461,418147,1,22314,5.10%
San Juan,8/1/19,53055,8,2019,9714,9427,1,287,3.00%
Skagit,8/1/19,53057,8,2019,63724,60373,1,3351,5.30%
Skamania,8/1/19,53059,8,2019,5545,5239,1,306,5.50%
Snohomish,8/1/19,53061,8,2019,442018,428834,1,13184,3.00%
Spokane,8/1/19,53063,8,2019,251787,239196,1,12591,5.00%
Stevens,8/1/19,53065,8,2019,18751,17613,1,1138,6.10%
Thurston,8/1/19,53067,8,2019,141325,134594,1,6731,4.80%
Wahkiakum,8/1/19,53069,8,2019,1366,1286,1,80,5.90%
Walla Walla,8/1/19,53071,8,2019,30254,28837,1,1417,4.70%
Whatcom,8/1/19,53073,8,2019,114378,108647,1,5731,5.00%
Whitman,8/1/19,53075,8,2019,24190,23110,1,1080,4.50%
Yakima,8/1/19,53077,8,2019,137152,128750,1,8402,6.10%
Adams,9/1/90,53001,9,1990,8834,8381,1,453,5.10%
Asotin,9/1/90,53003,9,1990,9294,8888,1,406,4.40%
Clallam,9/1/90,53009,9,1990,23116,21837,1,1279,5.50%
Columbia,9/1/90,53013,9,1990,1136,1000,1,136,12.00%
Cowlitz,9/1/90,53015,9,1990,37665,35343,1,2322,6.20%
Douglas,9/1/90,53017,9,1990,18312,17204,1,1108,6.10%
Ferry,9/1/90,53019,9,1990,2806,2560,1,246,8.80%
Franklin,9/1/90,53021,9,1990,19144,17600,1,1544,8.10%
Garfield,9/1/90,53023,9,1990,1030,1012,1,18,1.70%
Grant,9/1/90,53025,9,1990,29492,27678,1,1814,6.20%
Grays Harbor,9/1/90,53027,9,1990,27054,24906,1,2148,7.90%
Island,9/1/90,53029,9,1990,22596,21890,1,706,3.10%
Jefferson,9/1/90,53031,9,1990,8374,8010,1,364,4.30%
King,9/1/90,53033,9,1990,849826,819727,1,30099,3.50%
Kitsap,9/1/90,53035,9,1990,83018,79441,1,3577,4.30%
Kittitas,9/1/90,53037,9,1990,12447,11609,1,838,6.70%
Klickitat,9/1/90,53039,9,1990,8027,7471,1,556,6.90%
Lewis,9/1/90,53041,9,1990,26258,24683,1,1575,6.00%
Lincoln,9/1/90,53043,9,1990,4186,4076,1,110,2.60%
Mason,9/1/90,53045,9,1990,15294,14472,1,822,5.40%
Okanogan,9/1/90,53047,9,1990,22368,20893,1,1475,6.60%
Pacific,9/1/90,53049,9,1990,7553,7011,1,542,7.20%
Pend Oreille,9/1/90,53051,9,1990,3319,2918,1,401,12.10%
Pierce,9/1/90,53053,9,1990,272522,259514,1,13008,4.80%
San Juan,9/1/90,53055,9,1990,5686,5571,1,115,2.00%
Skagit,9/1/90,53057,9,1990,40057,37754,1,2303,5.70%
Skamania,9/1/90,53059,9,1990,3826,3555,1,271,7.10%
Snohomish,9/1/90,53061,9,1990,247131,237576,1,9555,3.90%
Spokane,9/1/90,53063,9,1990,170160,161439,1,8721,5.10%
Stevens,9/1/90,53065,9,1990,13292,12393,1,899,6.80%
Thurston,9/1/90,53067,9,1990,78977,75252,1,3725,4.70%
Wahkiakum,9/1/90,53069,9,1990,1490,1413,1,77,5.20%
Walla Walla,9/1/90,53071,9,1990,22793,21693,1,1100,4.80%
Whatcom,9/1/90,53073,9,1990,66011,62741,1,3270,5.00%
Whitman,9/1/90,53075,9,1990,18149,17903,1,246,1.40%
Yakima,9/1/90,53077,9,1990,111784,104297,1,7487,6.70%
Adams,9/1/91,53001,9,1991,8440,7779,1,661,7.80%
Asotin,9/1/91,53003,9,1991,9452,8968,1,484,5.10%
Clallam,9/1/91,53009,9,1991,22787,21438,1,1349,5.90%
Columbia,9/1/91,53013,9,1991,1133,1009,1,124,10.90%
Cowlitz,9/1/91,53015,9,1991,37403,34451,1,2952,7.90%
Douglas,9/1/91,53017,9,1991,18246,17102,1,1144,6.30%
Ferry,9/1/91,53019,9,1991,2650,2440,1,210,7.90%
Franklin,9/1/91,53021,9,1991,19849,17936,1,1913,9.60%
Garfield,9/1/91,53023,9,1991,1032,1024,1,8,0.80%
Grant,9/1/91,53025,9,1991,30337,28143,1,2194,7.20%
Grays Harbor,9/1/91,53027,9,1991,26419,23736,1,2683,10.20%
Island,9/1/91,53029,9,1991,22546,21578,1,968,4.30%
Jefferson,9/1/91,53031,9,1991,8260,7817,1,443,5.40%
King,9/1/91,53033,9,1991,863980,821621,1,42359,4.90%
Kitsap,9/1/91,53035,9,1991,85050,80737,1,4313,5.10%
Kittitas,9/1/91,53037,9,1991,13205,12074,1,1131,8.60%
Klickitat,9/1/91,53039,9,1991,7837,7163,1,674,8.60%
Lewis,9/1/91,53041,9,1991,25703,23567,1,2136,8.30%
Lincoln,9/1/91,53043,9,1991,4162,4038,1,124,3.00%
Mason,9/1/91,53045,9,1991,15336,14285,1,1051,6.90%
Okanogan,9/1/91,53047,9,1991,23602,21734,1,1868,7.90%
Pacific,9/1/91,53049,9,1991,7777,7182,1,595,7.70%
Pend Oreille,9/1/91,53051,9,1991,3390,3066,1,324,9.60%
Pierce,9/1/91,53053,9,1991,272427,256073,1,16354,6.00%
San Juan,9/1/91,53055,9,1991,5855,5697,1,158,2.70%
Skagit,9/1/91,53057,9,1991,41092,38528,1,2564,6.20%
Skamania,9/1/91,53059,9,1991,3978,3537,1,441,11.10%
Snohomish,9/1/91,53061,9,1991,255427,241959,1,13468,5.30%
Spokane,9/1/91,53063,9,1991,172427,162812,1,9615,5.60%
Stevens,9/1/91,53065,9,1991,13741,12787,1,954,6.90%
Thurston,9/1/91,53067,9,1991,80989,76218,1,4771,5.90%
Wahkiakum,9/1/91,53069,9,1991,1501,1445,1,56,3.70%
Walla Walla,9/1/91,53071,9,1991,23165,21861,1,1304,5.60%
Whatcom,9/1/91,53073,9,1991,68377,64569,1,3808,5.60%
Whitman,9/1/91,53075,9,1991,17623,17362,1,261,1.50%
Yakima,9/1/91,53077,9,1991,108269,98497,1,9772,9.00%
Adams,9/1/92,53001,9,1992,9012,8100,1,912,10.10%
Asotin,9/1/92,53003,9,1992,9792,9363,1,429,4.40%
Clallam,9/1/92,53009,9,1992,22984,21257,1,1727,7.50%
Columbia,9/1/92,53013,9,1992,1164,1015,1,149,12.80%
Cowlitz,9/1/92,53015,9,1992,37167,33553,1,3614,9.70%
Douglas,9/1/92,53017,9,1992,19511,18374,1,1137,5.80%
Ferry,9/1/92,53019,9,1992,2794,2501,1,293,10.50%
Franklin,9/1/92,53021,9,1992,20484,18713,1,1771,8.60%
Garfield,9/1/92,53023,9,1992,1051,1033,1,18,1.70%
Grant,9/1/92,53025,9,1992,33527,30754,1,2773,8.30%
Grays Harbor,9/1/92,53027,9,1992,27176,24397,1,2779,10.20%
Island,9/1/92,53029,9,1992,23526,22125,1,1401,6.00%
Jefferson,9/1/92,53031,9,1992,8734,8068,1,666,7.60%
King,9/1/92,53033,9,1992,895202,839611,1,55591,6.20%
Kitsap,9/1/92,53035,9,1992,85682,80463,1,5219,6.10%
Kittitas,9/1/92,53037,9,1992,13378,11773,1,1605,12.00%
Klickitat,9/1/92,53039,9,1992,8402,7617,1,785,9.30%
Lewis,9/1/92,53041,9,1992,26841,24222,1,2619,9.80%
Lincoln,9/1/92,53043,9,1992,4159,3998,1,161,3.90%
Mason,9/1/92,53045,9,1992,15554,14241,1,1313,8.40%
Okanogan,9/1/92,53047,9,1992,27007,25216,1,1791,6.60%
Pacific,9/1/92,53049,9,1992,8174,7445,1,729,8.90%
Pend Oreille,9/1/92,53051,9,1992,3553,3151,1,402,11.30%
Pierce,9/1/92,53053,9,1992,281063,260254,1,20809,7.40%
San Juan,9/1/92,53055,9,1992,5717,5492,1,225,3.90%
Skagit,9/1/92,53057,9,1992,42782,38943,1,3839,9.00%
Skamania,9/1/92,53059,9,1992,3563,2999,1,564,15.80%
Snohomish,9/1/92,53061,9,1992,268725,251430,1,17295,6.40%
Spokane,9/1/92,53063,9,1992,176195,165226,1,10969,6.20%
Stevens,9/1/92,53065,9,1992,14415,13124,1,1291,9.00%
Thurston,9/1/92,53067,9,1992,83126,77702,1,5424,6.50%
Wahkiakum,9/1/92,53069,9,1992,1488,1390,1,98,6.60%
Walla Walla,9/1/92,53071,9,1992,24170,22776,1,1394,5.80%
Whatcom,9/1/92,53073,9,1992,70803,65733,1,5070,7.20%
Whitman,9/1/92,53075,9,1992,17838,17477,1,361,2.00%
Yakima,9/1/92,53077,9,1992,120372,110171,1,10201,8.50%
Adams,9/1/93,53001,9,1993,9197,8327,1,870,9.50%
Asotin,9/1/93,53003,9,1993,10117,9761,1,356,3.50%
Clallam,9/1/93,53009,9,1993,23465,21587,1,1878,8.00%
Columbia,9/1/93,53013,9,1993,1245,1065,1,180,14.50%
Cowlitz,9/1/93,53015,9,1993,38232,34697,1,3535,9.20%
Douglas,9/1/93,53017,9,1993,20326,19156,1,1170,5.80%
Ferry,9/1/93,53019,9,1993,2840,2489,1,351,12.40%
Franklin,9/1/93,53021,9,1993,21490,19768,1,1722,8.00%
Garfield,9/1/93,53023,9,1993,1091,1049,1,42,3.80%
Grant,9/1/93,53025,9,1993,33959,31414,1,2545,7.50%
Grays Harbor,9/1/93,53027,9,1993,27104,23276,1,3828,14.10%
Island,9/1/93,53029,9,1993,23477,22353,1,1124,4.80%
Jefferson,9/1/93,53031,9,1993,9269,8580,1,689,7.40%
King,9/1/93,53033,9,1993,893156,840426,1,52730,5.90%
Kitsap,9/1/93,53035,9,1993,86718,81030,1,5688,6.60%
Kittitas,9/1/93,53037,9,1993,13761,12696,1,1065,7.70%
Klickitat,9/1/93,53039,9,1993,8534,7622,1,912,10.70%
Lewis,9/1/93,53041,9,1993,27335,24937,1,2398,8.80%
Lincoln,9/1/93,53043,9,1993,4581,4358,1,223,4.90%
Mason,9/1/93,53045,9,1993,16570,15153,1,1417,8.60%
Okanogan,9/1/93,53047,9,1993,27070,25038,1,2032,7.50%
Pacific,9/1/93,53049,9,1993,8120,7302,1,818,10.10%
Pend Oreille,9/1/93,53051,9,1993,3775,3356,1,419,11.10%
Pierce,9/1/93,53053,9,1993,291409,270461,1,20948,7.20%
San Juan,9/1/93,53055,9,1993,5932,5658,1,274,4.60%
Skagit,9/1/93,53057,9,1993,44160,40083,1,4077,9.20%
Skamania,9/1/93,53059,9,1993,4147,3707,1,440,10.60%
Snohomish,9/1/93,53061,9,1993,271997,255462,1,16535,6.10%
Spokane,9/1/93,53063,9,1993,182438,173196,1,9242,5.10%
Stevens,9/1/93,53065,9,1993,15277,14080,1,1197,7.80%
Thurston,9/1/93,53067,9,1993,85704,79890,1,5814,6.80%
Wahkiakum,9/1/93,53069,9,1993,1590,1497,1,93,5.80%
Walla Walla,9/1/93,53071,9,1993,24515,23427,1,1088,4.40%
Whatcom,9/1/93,53073,9,1993,72529,67536,1,4993,6.90%
Whitman,9/1/93,53075,9,1993,18378,18049,1,329,1.80%
Yakima,9/1/93,53077,9,1993,121827,110131,1,11696,9.60%
Adams,9/1/94,53001,9,1994,8822,8147,1,675,7.70%
Asotin,9/1/94,53003,9,1994,10662,10340,1,322,3.00%
Clallam,9/1/94,53009,9,1994,23437,21129,1,2308,9.80%
Columbia,9/1/94,53013,9,1994,1210,1059,1,151,12.50%
Cowlitz,9/1/94,53015,9,1994,38814,35963,1,2851,7.30%
Douglas,9/1/94,53017,9,1994,21574,20530,1,1044,4.80%
Ferry,9/1/94,53019,9,1994,2882,2619,1,263,9.10%
Franklin,9/1/94,53021,9,1994,22394,20941,1,1453,6.50%
Garfield,9/1/94,53023,9,1994,1012,974,1,38,3.80%
Grant,9/1/94,53025,9,1994,37300,34433,1,2867,7.70%
Grays Harbor,9/1/94,53027,9,1994,26997,24040,1,2957,11.00%
Island,9/1/94,53029,9,1994,24203,23053,1,1150,4.80%
Jefferson,9/1/94,53031,9,1994,9410,8629,1,781,8.30%
King,9/1/94,53033,9,1994,885159,843399,1,41760,4.70%
Kitsap,9/1/94,53035,9,1994,87976,82327,1,5649,6.40%
Kittitas,9/1/94,53037,9,1994,14551,13624,1,927,6.40%
Klickitat,9/1/94,53039,9,1994,8517,7737,1,780,9.20%
Lewis,9/1/94,53041,9,1994,28324,26202,1,2122,7.50%
Lincoln,9/1/94,53043,9,1994,4468,4251,1,217,4.90%
Mason,9/1/94,53045,9,1994,16925,15480,1,1445,8.50%
Okanogan,9/1/94,53047,9,1994,27964,26090,1,1874,6.70%
Pacific,9/1/94,53049,9,1994,8129,7247,1,882,10.90%
Pend Oreille,9/1/94,53051,9,1994,3676,3272,1,404,11.00%
Pierce,9/1/94,53053,9,1994,301491,282009,1,19482,6.50%
San Juan,9/1/94,53055,9,1994,5978,5729,1,249,4.20%
Skagit,9/1/94,53057,9,1994,49230,45316,1,3914,8.00%
Skamania,9/1/94,53059,9,1994,3976,3665,1,311,7.80%
Snohomish,9/1/94,53061,9,1994,274236,260181,1,14055,5.10%
Spokane,9/1/94,53063,9,1994,187302,178404,1,8898,4.80%
Stevens,9/1/94,53065,9,1994,16068,14864,1,1204,7.50%
Thurston,9/1/94,53067,9,1994,87717,82194,1,5523,6.30%
Wahkiakum,9/1/94,53069,9,1994,1636,1463,1,173,10.60%
Walla Walla,9/1/94,53071,9,1994,24891,23880,1,1011,4.10%
Whatcom,9/1/94,53073,9,1994,73089,67814,1,5275,7.20%
Whitman,9/1/94,53075,9,1994,18318,18013,1,305,1.70%
Yakima,9/1/94,53077,9,1994,123787,113494,1,10293,8.30%
Adams,9/1/95,53001,9,1995,8926,8276,1,650,7.30%
Asotin,9/1/95,53003,9,1995,11148,10729,1,419,3.80%
Clallam,9/1/95,53009,9,1995,24250,22495,1,1755,7.20%
Columbia,9/1/95,53013,9,1995,1223,1085,1,138,11.30%
Cowlitz,9/1/95,53015,9,1995,40252,37360,1,2892,7.20%
Douglas,9/1/95,53017,9,1995,21081,19949,1,1132,5.40%
Ferry,9/1/95,53019,9,1995,2852,2578,1,274,9.60%
Franklin,9/1/95,53021,9,1995,22397,20584,1,1813,8.10%
Garfield,9/1/95,53023,9,1995,1023,997,1,26,2.50%
Grant,9/1/95,53025,9,1995,36740,34085,1,2655,7.20%
Grays Harbor,9/1/95,53027,9,1995,27274,24520,1,2754,10.10%
Island,9/1/95,53029,9,1995,25301,24132,1,1169,4.60%
Jefferson,9/1/95,53031,9,1995,9802,9162,1,640,6.50%
King,9/1/95,53033,9,1995,900533,856216,1,44317,4.90%
Kitsap,9/1/95,53035,9,1995,88003,82006,1,5997,6.80%
Kittitas,9/1/95,53037,9,1995,15199,14138,1,1061,7.00%
Klickitat,9/1/95,53039,9,1995,8804,8043,1,761,8.60%
Lewis,9/1/95,53041,9,1995,29334,27074,1,2260,7.70%
Lincoln,9/1/95,53043,9,1995,4784,4529,1,255,5.30%
Mason,9/1/95,53045,9,1995,18448,17028,1,1420,7.70%
Okanogan,9/1/95,53047,9,1995,28098,26079,1,2019,7.20%
Pacific,9/1/95,53049,9,1995,8286,7576,1,710,8.60%
Pend Oreille,9/1/95,53051,9,1995,3901,3455,1,446,11.40%
Pierce,9/1/95,53053,9,1995,313686,294255,1,19431,6.20%
San Juan,9/1/95,53055,9,1995,6119,5845,1,274,4.50%
Skagit,9/1/95,53057,9,1995,51239,47517,1,3722,7.30%
Skamania,9/1/95,53059,9,1995,4026,3693,1,333,8.30%
Snohomish,9/1/95,53061,9,1995,281491,266408,1,15083,5.40%
Spokane,9/1/95,53063,9,1995,195741,185553,1,10188,5.20%
Stevens,9/1/95,53065,9,1995,16694,15340,1,1354,8.10%
Thurston,9/1/95,53067,9,1995,92018,85964,1,6054,6.60%
Wahkiakum,9/1/95,53069,9,1995,1657,1570,1,87,5.30%
Walla Walla,9/1/95,53071,9,1995,24933,23760,1,1173,4.70%
Whatcom,9/1/95,53073,9,1995,77531,72347,1,5184,6.70%
Whitman,9/1/95,53075,9,1995,18772,18414,1,358,1.90%
Yakima,9/1/95,53077,9,1995,124387,112688,1,11699,9.40%
Adams,9/1/96,53001,9,1996,9759,9107,1,652,6.70%
Asotin,9/1/96,53003,9,1996,11850,11465,1,385,3.20%
Clallam,9/1/96,53009,9,1996,24585,22825,1,1760,7.20%
Columbia,9/1/96,53013,9,1996,1263,1110,1,153,12.10%
Cowlitz,9/1/96,53015,9,1996,40907,37888,1,3019,7.40%
Douglas,9/1/96,53017,9,1996,21069,20003,1,1066,5.10%
Ferry,9/1/96,53019,9,1996,2954,2662,1,292,9.90%
Franklin,9/1/96,53021,9,1996,22760,21056,1,1704,7.50%
Garfield,9/1/96,53023,9,1996,1114,1089,1,25,2.20%
Grant,9/1/96,53025,9,1996,38654,36170,1,2484,6.40%
Grays Harbor,9/1/96,53027,9,1996,27555,24817,1,2738,9.90%
Island,9/1/96,53029,9,1996,26297,25189,1,1108,4.20%
Jefferson,9/1/96,53031,9,1996,10066,9410,1,656,6.50%
King,9/1/96,53033,9,1996,927956,886358,1,41598,4.50%
Kitsap,9/1/96,53035,9,1996,93208,87804,1,5404,5.80%
Kittitas,9/1/96,53037,9,1996,15035,14193,1,842,5.60%
Klickitat,9/1/96,53039,9,1996,9187,8517,1,670,7.30%
Lewis,9/1/96,53041,9,1996,30777,28286,1,2491,8.10%
Lincoln,9/1/96,53043,9,1996,5322,5125,1,197,3.70%
Mason,9/1/96,53045,9,1996,19025,17673,1,1352,7.10%
Okanogan,9/1/96,53047,9,1996,27770,25659,1,2111,7.60%
Pacific,9/1/96,53049,9,1996,8415,7723,1,692,8.20%
Pend Oreille,9/1/96,53051,9,1996,4090,3584,1,506,12.40%
Pierce,9/1/96,53053,9,1996,320240,303824,1,16416,5.10%
San Juan,9/1/96,53055,9,1996,6099,5830,1,269,4.40%
Skagit,9/1/96,53057,9,1996,48736,45323,1,3413,7.00%
Skamania,9/1/96,53059,9,1996,4065,3764,1,301,7.40%
Snohomish,9/1/96,53061,9,1996,292541,278973,1,13568,4.60%
Spokane,9/1/96,53063,9,1996,202869,193796,1,9073,4.50%
Stevens,9/1/96,53065,9,1996,16945,15662,1,1283,7.60%
Thurston,9/1/96,53067,9,1996,96837,91133,1,5704,5.90%
Wahkiakum,9/1/96,53069,9,1996,1760,1670,1,90,5.10%
Walla Walla,9/1/96,53071,9,1996,25728,24409,1,1319,5.10%
Whatcom,9/1/96,53073,9,1996,78061,73255,1,4806,6.20%
Whitman,9/1/96,53075,9,1996,19814,19509,1,305,1.50%
Yakima,9/1/96,53077,9,1996,123994,113253,1,10741,8.70%
Adams,9/1/97,53001,9,1997,9398,8847,1,551,5.90%
Asotin,9/1/97,53003,9,1997,12576,12264,1,312,2.50%
Clallam,9/1/97,53009,9,1997,25149,23545,1,1604,6.40%
Columbia,9/1/97,53013,9,1997,1225,1132,1,93,7.60%
Cowlitz,9/1/97,53015,9,1997,41684,39183,1,2501,6.00%
Douglas,9/1/97,53017,9,1997,21369,20399,1,970,4.50%
Ferry,9/1/97,53019,9,1997,2852,2663,1,189,6.60%
Franklin,9/1/97,53021,9,1997,22723,21288,1,1435,6.30%
Garfield,9/1/97,53023,9,1997,1126,1098,1,28,2.50%
Grant,9/1/97,53025,9,1997,39487,37351,1,2136,5.40%
Grays Harbor,9/1/97,53027,9,1997,28199,26016,1,2183,7.70%
Island,9/1/97,53029,9,1997,28341,27524,1,817,2.90%
Jefferson,9/1/97,53031,9,1997,10150,9624,1,526,5.20%
King,9/1/97,53033,9,1997,956710,920115,1,36595,3.80%
Kitsap,9/1/97,53035,9,1997,93461,88847,1,4614,4.90%
Kittitas,9/1/97,53037,9,1997,15092,14445,1,647,4.30%
Klickitat,9/1/97,53039,9,1997,9735,9092,1,643,6.60%
Lewis,9/1/97,53041,9,1997,32436,30440,1,1996,6.20%
Lincoln,9/1/97,53043,9,1997,5168,5013,1,155,3.00%
Mason,9/1/97,53045,9,1997,20663,19444,1,1219,5.90%
Okanogan,9/1/97,53047,9,1997,27766,25877,1,1889,6.80%
Pacific,9/1/97,53049,9,1997,9034,8382,1,652,7.20%
Pend Oreille,9/1/97,53051,9,1997,4325,3954,1,371,8.60%
Pierce,9/1/97,53053,9,1997,336501,323018,1,13483,4.00%
San Juan,9/1/97,53055,9,1997,6361,6148,1,213,3.30%
Skagit,9/1/97,53057,9,1997,50142,47319,1,2823,5.60%
Skamania,9/1/97,53059,9,1997,4280,3988,1,292,6.80%
Snohomish,9/1/97,53061,9,1997,309366,297730,1,11636,3.80%
Spokane,9/1/97,53063,9,1997,208626,200905,1,7721,3.70%
Stevens,9/1/97,53065,9,1997,17678,16558,1,1120,6.30%
Thurston,9/1/97,53067,9,1997,99848,95210,1,4638,4.60%
Wahkiakum,9/1/97,53069,9,1997,1922,1835,1,87,4.50%
Walla Walla,9/1/97,53071,9,1997,26578,25390,1,1188,4.50%
Whatcom,9/1/97,53073,9,1997,79862,75714,1,4148,5.20%
Whitman,9/1/97,53075,9,1997,20428,20175,1,253,1.20%
Yakima,9/1/97,53077,9,1997,124760,116675,1,8085,6.50%
Adams,9/1/98,53001,9,1998,10218,9648,1,570,5.60%
Asotin,9/1/98,53003,9,1998,13005,12632,1,373,2.90%
Clallam,9/1/98,53009,9,1998,25416,23721,1,1695,6.70%
Columbia,9/1/98,53013,9,1998,1269,1136,1,133,10.50%
Cowlitz,9/1/98,53015,9,1998,44084,40952,1,3132,7.10%
Douglas,9/1/98,53017,9,1998,23414,22307,1,1107,4.70%
Ferry,9/1/98,53019,9,1998,2741,2510,1,231,8.40%
Franklin,9/1/98,53021,9,1998,23126,21654,1,1472,6.40%
Garfield,9/1/98,53023,9,1998,1118,1088,1,30,2.70%
Grant,9/1/98,53025,9,1998,42215,39704,1,2511,5.90%
Grays Harbor,9/1/98,53027,9,1998,28179,25706,1,2473,8.80%
Island,9/1/98,53029,9,1998,29703,28771,1,932,3.10%
Jefferson,9/1/98,53031,9,1998,10331,9751,1,580,5.60%
King,9/1/98,53033,9,1998,971112,933485,1,37627,3.90%
Kitsap,9/1/98,53035,9,1998,93701,89084,1,4617,4.90%
Kittitas,9/1/98,53037,9,1998,15542,14929,1,613,3.90%
Klickitat,9/1/98,53039,9,1998,9441,8836,1,605,6.40%
Lewis,9/1/98,53041,9,1998,30764,28273,1,2491,8.10%
Lincoln,9/1/98,53043,9,1998,5063,4853,1,210,4.10%
Mason,9/1/98,53045,9,1998,20608,19402,1,1206,5.90%
Okanogan,9/1/98,53047,9,1998,28374,26373,1,2001,7.10%
Pacific,9/1/98,53049,9,1998,8578,7813,1,765,8.90%
Pend Oreille,9/1/98,53051,9,1998,4232,3870,1,362,8.60%
Pierce,9/1/98,53053,9,1998,344416,330012,1,14404,4.20%
San Juan,9/1/98,53055,9,1998,6603,6439,1,164,2.50%
Skagit,9/1/98,53057,9,1998,51035,48092,1,2943,5.80%
Skamania,9/1/98,53059,9,1998,4498,4179,1,319,7.10%
Snohomish,9/1/98,53061,9,1998,320216,308101,1,12115,3.80%
Spokane,9/1/98,53063,9,1998,212119,203723,1,8396,4.00%
Stevens,9/1/98,53065,9,1998,17903,16750,1,1153,6.40%
Thurston,9/1/98,53067,9,1998,103002,98454,1,4548,4.40%
Wahkiakum,9/1/98,53069,9,1998,1997,1872,1,125,6.30%
Walla Walla,9/1/98,53071,9,1998,26663,25282,1,1381,5.20%
Whatcom,9/1/98,53073,9,1998,81091,77002,1,4089,5.00%
Whitman,9/1/98,53075,9,1998,20440,20123,1,317,1.60%
Yakima,9/1/98,53077,9,1998,126909,117975,1,8934,7.00%
Adams,9/1/99,53001,9,1999,9568,9022,1,546,5.70%
Asotin,9/1/99,53003,9,1999,12648,12357,1,291,2.30%
Clallam,9/1/99,53009,9,1999,26163,24600,1,1563,6.00%
Columbia,9/1/99,53013,9,1999,1340,1212,1,128,9.60%
Cowlitz,9/1/99,53015,9,1999,43351,40690,1,2661,6.10%
Douglas,9/1/99,53017,9,1999,21720,20730,1,990,4.60%
Ferry,9/1/99,53019,9,1999,2690,2502,1,188,7.00%
Franklin,9/1/99,53021,9,1999,23349,21997,1,1352,5.80%
Garfield,9/1/99,53023,9,1999,1088,1063,1,25,2.30%
Grant,9/1/99,53025,9,1999,41789,39073,1,2716,6.50%
Grays Harbor,9/1/99,53027,9,1999,26179,24355,1,1824,7.00%
Island,9/1/99,53029,9,1999,30564,29340,1,1224,4.00%
Jefferson,9/1/99,53031,9,1999,11458,10943,1,515,4.50%
King,9/1/99,53033,9,1999,974818,938573,1,36245,3.70%
Kitsap,9/1/99,53035,9,1999,96542,91855,1,4687,4.90%
Kittitas,9/1/99,53037,9,1999,15215,14630,1,585,3.80%
Klickitat,9/1/99,53039,9,1999,9495,8912,1,583,6.10%
Lewis,9/1/99,53041,9,1999,31256,28925,1,2331,7.50%
Lincoln,9/1/99,53043,9,1999,4895,4723,1,172,3.50%
Mason,9/1/99,53045,9,1999,20684,19529,1,1155,5.60%
Okanogan,9/1/99,53047,9,1999,25054,23321,1,1733,6.90%
Pacific,9/1/99,53049,9,1999,7826,7233,1,593,7.60%
Pend Oreille,9/1/99,53051,9,1999,4513,4195,1,318,7.00%
Pierce,9/1/99,53053,9,1999,343642,328559,1,15083,4.40%
San Juan,9/1/99,53055,9,1999,7428,7270,1,158,2.10%
Skagit,9/1/99,53057,9,1999,54531,51752,1,2779,5.10%
Skamania,9/1/99,53059,9,1999,4142,3877,1,265,6.40%
Snohomish,9/1/99,53061,9,1999,328993,313666,1,15327,4.70%
Spokane,9/1/99,53063,9,1999,216826,206745,1,10081,4.60%
Stevens,9/1/99,53065,9,1999,17622,16440,1,1182,6.70%
Thurston,9/1/99,53067,9,1999,105401,100904,1,4497,4.30%
Wahkiakum,9/1/99,53069,9,1999,1991,1882,1,109,5.50%
Walla Walla,9/1/99,53071,9,1999,26451,25122,1,1329,5.00%
Whatcom,9/1/99,53073,9,1999,83701,79889,1,3812,4.60%
Whitman,9/1/99,53075,9,1999,20411,20125,1,286,1.40%
Yakima,9/1/99,53077,9,1999,121252,113292,1,7960,6.60%
Adams,9/1/00,53001,9,2000,8643,8243,1,400,4.60%
Asotin,9/1/00,53003,9,2000,9420,8974,1,446,4.70%
Clallam,9/1/00,53009,9,2000,25290,23637,1,1653,6.50%
Columbia,9/1/00,53013,9,2000,1755,1634,1,121,6.90%
Cowlitz,9/1/00,53015,9,2000,42146,39431,1,2715,6.40%
Douglas,9/1/00,53017,9,2000,19798,18872,1,926,4.70%
Ferry,9/1/00,53019,9,2000,2833,2611,1,222,7.80%
Franklin,9/1/00,53021,9,2000,23009,21739,1,1270,5.50%
Garfield,9/1/00,53023,9,2000,1041,995,1,46,4.40%
Grant,9/1/00,53025,9,2000,39084,36972,1,2112,5.40%
Grays Harbor,9/1/00,53027,9,2000,28900,26747,1,2153,7.40%
Island,9/1/00,53029,9,2000,28275,26853,1,1422,5.00%
Jefferson,9/1/00,53031,9,2000,11483,10880,1,603,5.30%
King,9/1/00,53033,9,2000,973748,936122,1,37626,3.90%
Kitsap,9/1/00,53035,9,2000,103462,97968,1,5494,5.30%
Kittitas,9/1/00,53037,9,2000,16630,15791,1,839,5.00%
Klickitat,9/1/00,53039,9,2000,9583,9059,1,524,5.50%
Lewis,9/1/00,53041,9,2000,29223,27183,1,2040,7.00%
Lincoln,9/1/00,53043,9,2000,4755,4556,1,199,4.20%
Mason,9/1/00,53045,9,2000,20525,19190,1,1335,6.50%
Okanogan,9/1/00,53047,9,2000,22883,21392,1,1491,6.50%
Pacific,9/1/00,53049,9,2000,8738,8154,1,584,6.70%
Pend Oreille,9/1/00,53051,9,2000,4608,4313,1,295,6.40%
Pierce,9/1/00,53053,9,2000,335017,317522,1,17495,5.20%
San Juan,9/1/00,53055,9,2000,7722,7465,1,257,3.30%
Skagit,9/1/00,53057,9,2000,52778,49933,1,2845,5.40%
Skamania,9/1/00,53059,9,2000,4656,4436,1,220,4.70%
Snohomish,9/1/00,53061,9,2000,318629,305560,1,13069,4.10%
Spokane,9/1/00,53063,9,2000,208114,197928,1,10186,4.90%
Stevens,9/1/00,53065,9,2000,17201,16174,1,1027,6.00%
Thurston,9/1/00,53067,9,2000,105837,100757,1,5080,4.80%
Wahkiakum,9/1/00,53069,9,2000,1675,1568,1,107,6.40%
Walla Walla,9/1/00,53071,9,2000,26591,25234,1,1357,5.10%
Whatcom,9/1/00,53073,9,2000,84506,79996,1,4510,5.30%
Whitman,9/1/00,53075,9,2000,19666,18907,1,759,3.90%
Yakima,9/1/00,53077,9,2000,118633,112012,1,6621,5.60%
Adams,9/1/01,53001,9,2001,8748,8254,1,494,5.60%
Asotin,9/1/01,53003,9,2001,9779,9291,1,488,5.00%
Clallam,9/1/01,53009,9,2001,25477,23717,1,1760,6.90%
Columbia,9/1/01,53013,9,2001,1486,1352,1,134,9.00%
Cowlitz,9/1/01,53015,9,2001,41540,37505,1,4035,9.70%
Douglas,9/1/01,53017,9,2001,18753,17699,1,1054,5.60%
Ferry,9/1/01,53019,9,2001,2838,2595,1,243,8.60%
Franklin,9/1/01,53021,9,2001,23043,21787,1,1256,5.50%
Garfield,9/1/01,53023,9,2001,1037,1000,1,37,3.60%
Grant,9/1/01,53025,9,2001,37661,35279,1,2382,6.30%
Grays Harbor,9/1/01,53027,9,2001,28058,25794,1,2264,8.10%
Island,9/1/01,53029,9,2001,28199,26469,1,1730,6.10%
Jefferson,9/1/01,53031,9,2001,12020,11319,1,701,5.80%
King,9/1/01,53033,9,2001,983824,933215,1,50609,5.10%
Kitsap,9/1/01,53035,9,2001,103103,96994,1,6109,5.90%
Kittitas,9/1/01,53037,9,2001,16884,15945,1,939,5.60%
Klickitat,9/1/01,53039,9,2001,9413,8600,1,813,8.60%
Lewis,9/1/01,53041,9,2001,28360,26221,1,2139,7.50%
Lincoln,9/1/01,53043,9,2001,4609,4383,1,226,4.90%
Mason,9/1/01,53045,9,2001,20016,18600,1,1416,7.10%
Okanogan,9/1/01,53047,9,2001,21448,20012,1,1436,6.70%
Pacific,9/1/01,53049,9,2001,8435,7806,1,629,7.50%
Pend Oreille,9/1/01,53051,9,2001,4669,4322,1,347,7.40%
Pierce,9/1/01,53053,9,2001,329598,308196,1,21402,6.50%
San Juan,9/1/01,53055,9,2001,7920,7615,1,305,3.90%
Skagit,9/1/01,53057,9,2001,50742,47434,1,3308,6.50%
Skamania,9/1/01,53059,9,2001,4738,4223,1,515,10.90%
Snohomish,9/1/01,53061,9,2001,325541,308796,1,16745,5.10%
Spokane,9/1/01,53063,9,2001,205067,192381,1,12686,6.20%
Stevens,9/1/01,53065,9,2001,16812,15565,1,1247,7.40%
Thurston,9/1/01,53067,9,2001,104248,98357,1,5891,5.70%
Wahkiakum,9/1/01,53069,9,2001,1519,1404,1,115,7.60%
Walla Walla,9/1/01,53071,9,2001,26539,25082,1,1457,5.50%
Whatcom,9/1/01,53073,9,2001,84078,78639,1,5439,6.50%
Whitman,9/1/01,53075,9,2001,18722,17938,1,784,4.20%
Yakima,9/1/01,53077,9,2001,114958,107078,1,7880,6.90%
Adams,9/1/02,53001,9,2002,8706,8250,1,456,5.20%
Asotin,9/1/02,53003,9,2002,10288,9656,1,632,6.10%
Clallam,9/1/02,53009,9,2002,26576,24646,1,1930,7.30%
Columbia,9/1/02,53013,9,2002,1522,1374,1,148,9.70%
Cowlitz,9/1/02,53015,9,2002,42108,38147,1,3961,9.40%
Douglas,9/1/02,53017,9,2002,19460,18442,1,1018,5.20%
Ferry,9/1/02,53019,9,2002,2998,2772,1,226,7.50%
Franklin,9/1/02,53021,9,2002,24682,23282,1,1400,5.70%
Garfield,9/1/02,53023,9,2002,1103,1042,1,61,5.50%
Grant,9/1/02,53025,9,2002,39143,36782,1,2361,6.00%
Grays Harbor,9/1/02,53027,9,2002,29017,26659,1,2358,8.10%
Island,9/1/02,53029,9,2002,30307,28256,1,2051,6.80%
Jefferson,9/1/02,53031,9,2002,12615,11765,1,850,6.70%
King,9/1/02,53033,9,2002,978841,917106,1,61735,6.30%
Kitsap,9/1/02,53035,9,2002,110640,103849,1,6791,6.10%
Kittitas,9/1/02,53037,9,2002,18123,17099,1,1024,5.70%
Klickitat,9/1/02,53039,9,2002,10162,9333,1,829,8.20%
Lewis,9/1/02,53041,9,2002,29232,26870,1,2362,8.10%
Lincoln,9/1/02,53043,9,2002,4740,4465,1,275,5.80%
Mason,9/1/02,53045,9,2002,21446,19844,1,1602,7.50%
Okanogan,9/1/02,53047,9,2002,20409,19038,1,1371,6.70%
Pacific,9/1/02,53049,9,2002,8794,8116,1,678,7.70%
Pend Oreille,9/1/02,53051,9,2002,4627,4280,1,347,7.50%
Pierce,9/1/02,53053,9,2002,345514,320461,1,25053,7.30%
San Juan,9/1/02,53055,9,2002,8198,7840,1,358,4.40%
Skagit,9/1/02,53057,9,2002,53116,49331,1,3785,7.10%
Skamania,9/1/02,53059,9,2002,4600,4259,1,341,7.40%
Snohomish,9/1/02,53061,9,2002,330720,306967,1,23753,7.20%
Spokane,9/1/02,53063,9,2002,210674,196832,1,13842,6.60%
Stevens,9/1/02,53065,9,2002,17325,16022,1,1303,7.50%
Thurston,9/1/02,53067,9,2002,110145,103708,1,6437,5.80%
Wahkiakum,9/1/02,53069,9,2002,1543,1416,1,127,8.20%
Walla Walla,9/1/02,53071,9,2002,27725,26214,1,1511,5.40%
Whatcom,9/1/02,53073,9,2002,88922,83445,1,5477,6.20%
Whitman,9/1/02,53075,9,2002,19780,18970,1,810,4.10%
Yakima,9/1/02,53077,9,2002,119795,112153,1,7642,6.40%
Adams,9/1/03,53001,9,2003,8900,8420,1,480,5.40%
Asotin,9/1/03,53003,9,2003,9909,9261,1,648,6.50%
Clallam,9/1/03,53009,9,2003,27053,25036,1,2017,7.50%
Columbia,9/1/03,53013,9,2003,1474,1340,1,134,9.10%
Cowlitz,9/1/03,53015,9,2003,41961,38128,1,3833,9.10%
Douglas,9/1/03,53017,9,2003,19948,18768,1,1180,5.90%
Ferry,9/1/03,53019,9,2003,2882,2589,1,293,10.20%
Franklin,9/1/03,53021,9,2003,26145,24441,1,1704,6.50%
Garfield,9/1/03,53023,9,2003,1075,1018,1,57,5.30%
Grant,9/1/03,53025,9,2003,39970,37350,1,2620,6.60%
Grays Harbor,9/1/03,53027,9,2003,29173,26729,1,2444,8.40%
Island,9/1/03,53029,9,2003,30574,28340,1,2234,7.30%
Jefferson,9/1/03,53031,9,2003,13023,12162,1,861,6.60%
King,9/1/03,53033,9,2003,981811,922211,1,59600,6.10%
Kitsap,9/1/03,53035,9,2003,112388,105418,1,6970,6.20%
Kittitas,9/1/03,53037,9,2003,18434,17275,1,1159,6.30%
Klickitat,9/1/03,53039,9,2003,9835,8890,1,945,9.60%
Lewis,9/1/03,53041,9,2003,29795,27250,1,2545,8.50%
Lincoln,9/1/03,53043,9,2003,4762,4461,1,301,6.30%
Mason,9/1/03,53045,9,2003,22187,20390,1,1797,8.10%
Okanogan,9/1/03,53047,9,2003,22724,21237,1,1487,6.50%
Pacific,9/1/03,53049,9,2003,9035,8304,1,731,8.10%
Pend Oreille,9/1/03,53051,9,2003,4814,4385,1,429,8.90%
Pierce,9/1/03,53053,9,2003,347670,320782,1,26888,7.70%
San Juan,9/1/03,53055,9,2003,8276,7908,1,368,4.40%
Skagit,9/1/03,53057,9,2003,53711,49799,1,3912,7.30%
Skamania,9/1/03,53059,9,2003,4616,4224,1,392,8.50%
Snohomish,9/1/03,53061,9,2003,334655,309911,1,24744,7.40%
Spokane,9/1/03,53063,9,2003,211299,196745,1,14554,6.90%
Stevens,9/1/03,53065,9,2003,17441,16088,1,1353,7.80%
Thurston,9/1/03,53067,9,2003,113401,106274,1,7127,6.30%
Wahkiakum,9/1/03,53069,9,2003,1577,1435,1,142,9.00%
Walla Walla,9/1/03,53071,9,2003,28383,26770,1,1613,5.70%
Whatcom,9/1/03,53073,9,2003,91272,85368,1,5904,6.50%
Whitman,9/1/03,53075,9,2003,19902,19049,1,853,4.30%
Yakima,9/1/03,53077,9,2003,119859,111689,1,8170,6.80%
Adams,9/1/04,53001,9,2004,8841,8449,1,392,4.40%
Asotin,9/1/04,53003,9,2004,10187,9610,1,577,5.70%
Clallam,9/1/04,53009,9,2004,28319,26623,1,1696,6.00%
Columbia,9/1/04,53013,9,2004,1537,1428,1,109,7.10%
Cowlitz,9/1/04,53015,9,2004,41953,38798,1,3155,7.50%
Douglas,9/1/04,53017,9,2004,21291,20368,1,923,4.30%
Ferry,9/1/04,53019,9,2004,3011,2780,1,231,7.70%
Franklin,9/1/04,53021,9,2004,27987,26599,1,1388,5.00%
Garfield,9/1/04,53023,9,2004,1106,1061,1,45,4.10%
Grant,9/1/04,53025,9,2004,40419,38264,1,2155,5.30%
Grays Harbor,9/1/04,53027,9,2004,30827,28590,1,2237,7.30%
Island,9/1/04,53029,9,2004,31278,29354,1,1924,6.20%
Jefferson,9/1/04,53031,9,2004,13446,12741,1,705,5.20%
King,9/1/04,53033,9,2004,989634,942110,1,47524,4.80%
Kitsap,9/1/04,53035,9,2004,116611,110404,1,6207,5.30%
Kittitas,9/1/04,53037,9,2004,18482,17487,1,995,5.40%
Klickitat,9/1/04,53039,9,2004,10161,9565,1,596,5.90%
Lewis,9/1/04,53041,9,2004,30363,28170,1,2193,7.20%
Lincoln,9/1/04,53043,9,2004,4709,4465,1,244,5.20%
Mason,9/1/04,53045,9,2004,23044,21487,1,1557,6.80%
Okanogan,9/1/04,53047,9,2004,22181,21013,1,1168,5.30%
Pacific,9/1/04,53049,9,2004,9297,8704,1,593,6.40%
Pend Oreille,9/1/04,53051,9,2004,4964,4617,1,347,7.00%
Pierce,9/1/04,53053,9,2004,357275,335070,1,22205,6.20%
San Juan,9/1/04,53055,9,2004,8858,8537,1,321,3.60%
Skagit,9/1/04,53057,9,2004,55681,52447,1,3234,5.80%
Skamania,9/1/04,53059,9,2004,4852,4506,1,346,7.10%
Snohomish,9/1/04,53061,9,2004,335184,318085,1,17099,5.10%
Spokane,9/1/04,53063,9,2004,215604,203506,1,12098,5.60%
Stevens,9/1/04,53065,9,2004,17786,16655,1,1131,6.40%
Thurston,9/1/04,53067,9,2004,117711,111499,1,6212,5.30%
Wahkiakum,9/1/04,53069,9,2004,1559,1455,1,104,6.70%
Walla Walla,9/1/04,53071,9,2004,29346,27981,1,1365,4.70%
Whatcom,9/1/04,53073,9,2004,96483,91255,1,5228,5.40%
Whitman,9/1/04,53075,9,2004,20543,19786,1,757,3.70%
Yakima,9/1/04,53077,9,2004,121191,114277,1,6914,5.70%
Adams,9/1/05,53001,9,2005,8859,8456,1,403,4.50%
Asotin,9/1/05,53003,9,2005,10325,9756,1,569,5.50%
Clallam,9/1/05,53009,9,2005,29468,27724,1,1744,5.90%
Columbia,9/1/05,53013,9,2005,1457,1343,1,114,7.80%
Cowlitz,9/1/05,53015,9,2005,42833,39847,1,2986,7.00%
Douglas,9/1/05,53017,9,2005,21820,20911,1,909,4.20%
Ferry,9/1/05,53019,9,2005,3013,2784,1,229,7.60%
Franklin,9/1/05,53021,9,2005,29237,27588,1,1649,5.60%
Garfield,9/1/05,53023,9,2005,1071,1016,1,55,5.10%
Grant,9/1/05,53025,9,2005,41592,39408,1,2184,5.30%
Grays Harbor,9/1/05,53027,9,2005,31183,28989,1,2194,7.00%
Island,9/1/05,53029,9,2005,31721,29899,1,1822,5.70%
Jefferson,9/1/05,53031,9,2005,13589,12874,1,715,5.30%
King,9/1/05,53033,9,2005,1011432,966822,1,44610,4.40%
Kitsap,9/1/05,53035,9,2005,120359,114359,1,6000,5.00%
Kittitas,9/1/05,53037,9,2005,18925,17985,1,940,5.00%
Klickitat,9/1/05,53039,9,2005,9641,9069,1,572,5.90%
Lewis,9/1/05,53041,9,2005,30182,28028,1,2154,7.10%
Lincoln,9/1/05,53043,9,2005,4669,4401,1,268,5.70%
Mason,9/1/05,53045,9,2005,23877,22415,1,1462,6.10%
Okanogan,9/1/05,53047,9,2005,23144,21972,1,1172,5.10%
Pacific,9/1/05,53049,9,2005,9075,8482,1,593,6.50%
Pend Oreille,9/1/05,53051,9,2005,5036,4676,1,360,7.10%
Pierce,9/1/05,53053,9,2005,368567,347602,1,20965,5.70%
San Juan,9/1/05,53055,9,2005,8710,8383,1,327,3.80%
Skagit,9/1/05,53057,9,2005,56721,53731,1,2990,5.30%
Skamania,9/1/05,53059,9,2005,4971,4623,1,348,7.00%
Snohomish,9/1/05,53061,9,2005,345956,329443,1,16513,4.80%
Spokane,9/1/05,53063,9,2005,222992,211058,1,11934,5.40%
Stevens,9/1/05,53065,9,2005,17777,16635,1,1142,6.40%
Thurston,9/1/05,53067,9,2005,120323,114363,1,5960,5.00%
Wahkiakum,9/1/05,53069,9,2005,1625,1517,1,108,6.60%
Walla Walla,9/1/05,53071,9,2005,28667,27175,1,1492,5.20%
Whatcom,9/1/05,53073,9,2005,99179,94342,1,4837,4.90%
Whitman,9/1/05,53075,9,2005,20828,20013,1,815,3.90%
Yakima,9/1/05,53077,9,2005,124235,117366,1,6869,5.50%
Adams,9/1/06,53001,9,2006,8592,8221,1,371,4.30%
Asotin,9/1/06,53003,9,2006,10167,9760,1,407,4.00%
Clallam,9/1/06,53009,9,2006,29542,27862,1,1680,5.70%
Columbia,9/1/06,53013,9,2006,1497,1379,1,118,7.90%
Cowlitz,9/1/06,53015,9,2006,42756,39955,1,2801,6.60%
Douglas,9/1/06,53017,9,2006,21258,20403,1,855,4.00%
Ferry,9/1/06,53019,9,2006,2968,2759,1,209,7.00%
Franklin,9/1/06,53021,9,2006,30030,28318,1,1712,5.70%
Garfield,9/1/06,53023,9,2006,1044,997,1,47,4.50%
Grant,9/1/06,53025,9,2006,41717,39715,1,2002,4.80%
Grays Harbor,9/1/06,53027,9,2006,30924,28831,1,2093,6.80%
Island,9/1/06,53029,9,2006,32396,30674,1,1722,5.30%
Jefferson,9/1/06,53031,9,2006,13488,12786,1,702,5.20%
King,9/1/06,53033,9,2006,1044701,1004314,1,40387,3.90%
Kitsap,9/1/06,53035,9,2006,120462,114550,1,5912,4.90%
Kittitas,9/1/06,53037,9,2006,19365,18464,1,901,4.70%
Klickitat,9/1/06,53039,9,2006,9967,9427,1,540,5.40%
Lewis,9/1/06,53041,9,2006,30661,28608,1,2053,6.70%
Lincoln,9/1/06,53043,9,2006,4653,4402,1,251,5.40%
Mason,9/1/06,53045,9,2006,24535,23093,1,1442,5.90%
Okanogan,9/1/06,53047,9,2006,23063,21897,1,1166,5.10%
Pacific,9/1/06,53049,9,2006,9081,8489,1,592,6.50%
Pend Oreille,9/1/06,53051,9,2006,5063,4746,1,317,6.30%
Pierce,9/1/06,53053,9,2006,372347,353018,1,19329,5.20%
San Juan,9/1/06,53055,9,2006,8653,8350,1,303,3.50%
Skagit,9/1/06,53057,9,2006,56016,53180,1,2836,5.10%
Skamania,9/1/06,53059,9,2006,5002,4666,1,336,6.70%
Snohomish,9/1/06,53061,9,2006,358118,343150,1,14968,4.20%
Spokane,9/1/06,53063,9,2006,225057,214186,1,10871,4.80%
Stevens,9/1/06,53065,9,2006,18006,16926,1,1080,6.00%
Thurston,9/1/06,53067,9,2006,122508,116649,1,5859,4.80%
Wahkiakum,9/1/06,53069,9,2006,1616,1508,1,108,6.70%
Walla Walla,9/1/06,53071,9,2006,28412,27031,1,1381,4.90%
Whatcom,9/1/06,53073,9,2006,100153,95541,1,4612,4.60%
Whitman,9/1/06,53075,9,2006,20650,19821,1,829,4.00%
Yakima,9/1/06,53077,9,2006,125044,118402,1,6642,5.30%
Adams,9/1/07,53001,9,2007,8354,7993,1,361,4.30%
Asotin,9/1/07,53003,9,2007,10188,9782,1,406,4.00%
Clallam,9/1/07,53009,9,2007,29985,28209,1,1776,5.90%
Columbia,9/1/07,53013,9,2007,1559,1463,1,96,6.20%
Cowlitz,9/1/07,53015,9,2007,44035,40891,1,3144,7.10%
Douglas,9/1/07,53017,9,2007,22432,21531,1,901,4.00%
Ferry,9/1/07,53019,9,2007,3011,2811,1,200,6.60%
Franklin,9/1/07,53021,9,2007,33110,31443,1,1667,5.00%
Garfield,9/1/07,53023,9,2007,1056,1003,1,53,5.00%
Grant,9/1/07,53025,9,2007,43811,41861,1,1950,4.50%
Grays Harbor,9/1/07,53027,9,2007,31349,29212,1,2137,6.80%
Island,9/1/07,53029,9,2007,32993,31282,1,1711,5.20%
Jefferson,9/1/07,53031,9,2007,13690,12996,1,694,5.10%
King,9/1/07,53033,9,2007,1069867,1035386,1,34481,3.20%
Kitsap,9/1/07,53035,9,2007,122406,116633,1,5773,4.70%
Kittitas,9/1/07,53037,9,2007,20295,19369,1,926,4.60%
Klickitat,9/1/07,53039,9,2007,10105,9540,1,565,5.60%
Lewis,9/1/07,53041,9,2007,30951,28809,1,2142,6.90%
Lincoln,9/1/07,53043,9,2007,4718,4476,1,242,5.10%
Mason,9/1/07,53045,9,2007,24792,23278,1,1514,6.10%
Okanogan,9/1/07,53047,9,2007,22958,21886,1,1072,4.70%
Pacific,9/1/07,53049,9,2007,9368,8768,1,600,6.40%
Pend Oreille,9/1/07,53051,9,2007,5290,4974,1,316,6.00%
Pierce,9/1/07,53053,9,2007,387201,367591,1,19610,5.10%
San Juan,9/1/07,53055,9,2007,9017,8714,1,303,3.40%
Skagit,9/1/07,53057,9,2007,58759,56034,1,2725,4.60%
Skamania,9/1/07,53059,9,2007,4973,4677,1,296,6.00%
Snohomish,9/1/07,53061,9,2007,363731,351210,1,12521,3.40%
Spokane,9/1/07,53063,9,2007,233055,221824,1,11231,4.80%
Stevens,9/1/07,53065,9,2007,18624,17466,1,1158,6.20%
Thurston,9/1/07,53067,9,2007,127253,121261,1,5992,4.70%
Wahkiakum,9/1/07,53069,9,2007,1623,1526,1,97,6.00%
Walla Walla,9/1/07,53071,9,2007,29470,28111,1,1359,4.60%
Whatcom,9/1/07,53073,9,2007,104828,100217,1,4611,4.40%
Whitman,9/1/07,53075,9,2007,20920,20096,1,824,3.90%
Yakima,9/1/07,53077,9,2007,126462,120156,1,6306,5.00%
Adams,9/1/08,53001,9,2008,8416,7998,1,418,5.00%
Asotin,9/1/08,53003,9,2008,10210,9599,1,611,6.00%
Clallam,9/1/08,53009,9,2008,29685,27722,1,1963,6.60%
Columbia,9/1/08,53013,9,2008,1582,1470,1,112,7.10%
Cowlitz,9/1/08,53015,9,2008,43828,40203,1,3625,8.30%
Douglas,9/1/08,53017,9,2008,22689,21745,1,944,4.20%
Ferry,9/1/08,53019,9,2008,3044,2841,1,203,6.70%
Franklin,9/1/08,53021,9,2008,34645,32938,1,1707,4.90%
Garfield,9/1/08,53023,9,2008,1026,991,1,35,3.40%
Grant,9/1/08,53025,9,2008,44671,42453,1,2218,5.00%
Grays Harbor,9/1/08,53027,9,2008,31660,29357,1,2303,7.30%
Island,9/1/08,53029,9,2008,32866,31087,1,1779,5.40%
Jefferson,9/1/08,53031,9,2008,13686,12942,1,744,5.40%
King,9/1/08,53033,9,2008,1093386,1047063,1,46323,4.20%
Kitsap,9/1/08,53035,9,2008,123409,117077,1,6332,5.10%
Kittitas,9/1/08,53037,9,2008,20723,19611,1,1112,5.40%
Klickitat,9/1/08,53039,9,2008,10681,10067,1,614,5.70%
Lewis,9/1/08,53041,9,2008,30772,28447,1,2325,7.60%
Lincoln,9/1/08,53043,9,2008,4960,4719,1,241,4.90%
Mason,9/1/08,53045,9,2008,25126,23458,1,1668,6.60%
Okanogan,9/1/08,53047,9,2008,23912,22732,1,1180,4.90%
Pacific,9/1/08,53049,9,2008,9180,8493,1,687,7.50%
Pend Oreille,9/1/08,53051,9,2008,5418,5030,1,388,7.20%
Pierce,9/1/08,53053,9,2008,393181,370591,1,22590,5.70%
San Juan,9/1/08,53055,9,2008,9311,8999,1,312,3.40%
Skagit,9/1/08,53057,9,2008,58449,55259,1,3190,5.50%
Skamania,9/1/08,53059,9,2008,5011,4668,1,343,6.80%
Snohomish,9/1/08,53061,9,2008,373576,355610,1,17966,4.80%
Spokane,9/1/08,53063,9,2008,236459,223853,1,12606,5.30%
Stevens,9/1/08,53065,9,2008,18746,17441,1,1305,7.00%
Thurston,9/1/08,53067,9,2008,130355,123811,1,6544,5.00%
Wahkiakum,9/1/08,53069,9,2008,1765,1648,1,117,6.60%
Walla Walla,9/1/08,53071,9,2008,31000,29633,1,1367,4.40%
Whatcom,9/1/08,53073,9,2008,106923,101459,1,5464,5.10%
Whitman,9/1/08,53075,9,2008,20468,19607,1,861,4.20%
Yakima,9/1/08,53077,9,2008,129365,122396,1,6969,5.40%
Adams,9/1/09,53001,9,2009,8944,8255,1,689,7.70%
Asotin,9/1/09,53003,9,2009,10257,9249,1,1008,9.80%
Clallam,9/1/09,53009,9,2009,30299,27233,1,3066,10.10%
Columbia,9/1/09,53013,9,2009,1612,1456,1,156,9.70%
Cowlitz,9/1/09,53015,9,2009,44572,38359,1,6213,13.90%
Douglas,9/1/09,53017,9,2009,24085,22361,1,1724,7.20%
Ferry,9/1/09,53019,9,2009,3114,2723,1,391,12.60%
Franklin,9/1/09,53021,9,2009,37424,34708,1,2716,7.30%
Garfield,9/1/09,53023,9,2009,1034,963,1,71,6.90%
Grant,9/1/09,53025,9,2009,47202,43296,1,3906,8.30%
Grays Harbor,9/1/09,53027,9,2009,31122,27020,1,4102,13.20%
Island,9/1/09,53029,9,2009,32759,29571,1,3188,9.70%
Jefferson,9/1/09,53031,9,2009,13109,11949,1,1160,8.80%
King,9/1/09,53033,9,2009,1124375,1019887,1,104488,9.30%
Kitsap,9/1/09,53035,9,2009,123826,113622,1,10204,8.20%
Kittitas,9/1/09,53037,9,2009,20922,19062,1,1860,8.90%
Klickitat,9/1/09,53039,9,2009,11419,10387,1,1032,9.00%
Lewis,9/1/09,53041,9,2009,31674,27394,1,4280,13.50%
Lincoln,9/1/09,53043,9,2009,4892,4476,1,416,8.50%
Mason,9/1/09,53045,9,2009,24933,22208,1,2725,10.90%
Okanogan,9/1/09,53047,9,2009,25970,23917,1,2053,7.90%
Pacific,9/1/09,53049,9,2009,9316,8131,1,1185,12.70%
Pend Oreille,9/1/09,53051,9,2009,5491,4711,1,780,14.20%
Pierce,9/1/09,53053,9,2009,394282,353326,1,40956,10.40%
San Juan,9/1/09,53055,9,2009,8874,8340,1,534,6.00%
Skagit,9/1/09,53057,9,2009,58510,52200,1,6310,10.80%
Skamania,9/1/09,53059,9,2009,4938,4355,1,583,11.80%
Snohomish,9/1/09,53061,9,2009,385412,344397,1,41015,10.60%
Spokane,9/1/09,53063,9,2009,236128,213287,1,22841,9.70%
Stevens,9/1/09,53065,9,2009,18851,16552,1,2299,12.20%
Thurston,9/1/09,53067,9,2009,129340,118391,1,10949,8.50%
Wahkiakum,9/1/09,53069,9,2009,1619,1394,1,225,13.90%
Walla Walla,9/1/09,53071,9,2009,31594,29578,1,2016,6.40%
Whatcom,9/1/09,53073,9,2009,104810,94979,1,9831,9.40%
Whitman,9/1/09,53075,9,2009,20751,19374,1,1377,6.60%
Yakima,9/1/09,53077,9,2009,135145,124666,1,10479,7.80%
Adams,9/1/10,53001,9,2010,8753,8071,1,682,7.80%
Asotin,9/1/10,53003,9,2010,10069,9198,1,871,8.70%
Clallam,9/1/10,53009,9,2010,29441,26471,1,2970,10.10%
Columbia,9/1/10,53013,9,2010,1933,1770,1,163,8.40%
Cowlitz,9/1/10,53015,9,2010,45793,40380,1,5413,11.80%
Douglas,9/1/10,53017,9,2010,20644,19069,1,1575,7.60%
Ferry,9/1/10,53019,9,2010,2606,2221,1,385,14.80%
Franklin,9/1/10,53021,9,2010,40126,37388,1,2738,6.80%
Garfield,9/1/10,53023,9,2010,1068,996,1,72,6.70%
Grant,9/1/10,53025,9,2010,45837,42088,1,3749,8.20%
Grays Harbor,9/1/10,53027,9,2010,30192,26403,1,3789,12.50%
Island,9/1/10,53029,9,2010,33108,30202,1,2906,8.80%
Jefferson,9/1/10,53031,9,2010,12405,11173,1,1232,9.90%
King,9/1/10,53033,9,2010,1103683,1005223,1,98460,8.90%
Kitsap,9/1/10,53035,9,2010,118197,108625,1,9572,8.10%
Kittitas,9/1/10,53037,9,2010,20753,18938,1,1815,8.70%
Klickitat,9/1/10,53039,9,2010,10550,9480,1,1070,10.10%
Lewis,9/1/10,53041,9,2010,33399,29445,1,3954,11.80%
Lincoln,9/1/10,53043,9,2010,5362,4982,1,380,7.10%
Mason,9/1/10,53045,9,2010,24319,21573,1,2746,11.30%
Okanogan,9/1/10,53047,9,2010,25348,23442,1,1906,7.50%
Pacific,9/1/10,53049,9,2010,8777,7697,1,1080,12.30%
Pend Oreille,9/1/10,53051,9,2010,4981,4322,1,659,13.20%
Pierce,9/1/10,53053,9,2010,391452,353653,1,37799,9.70%
San Juan,9/1/10,53055,9,2010,8727,8197,1,530,6.10%
Skagit,9/1/10,53057,9,2010,58757,52997,1,5760,9.80%
Skamania,9/1/10,53059,9,2010,5032,4471,1,561,11.10%
Snohomish,9/1/10,53061,9,2010,385376,345150,1,40226,10.40%
Spokane,9/1/10,53063,9,2010,233608,212343,1,21265,9.10%
Stevens,9/1/10,53065,9,2010,18577,16465,1,2112,11.40%
Thurston,9/1/10,53067,9,2010,124535,114071,1,10464,8.40%
Wahkiakum,9/1/10,53069,9,2010,1466,1267,1,199,13.60%
Walla Walla,9/1/10,53071,9,2010,30336,28191,1,2145,7.10%
Whatcom,9/1/10,53073,9,2010,102587,93684,1,8903,8.70%
Whitman,9/1/10,53075,9,2010,23132,21735,1,1397,6.00%
Yakima,9/1/10,53077,9,2010,129193,118618,1,10575,8.20%
Adams,9/1/11,53001,9,2011,8765,8122,1,643,7.30%
Asotin,9/1/11,53003,9,2011,9840,9058,1,782,7.90%
Clallam,9/1/11,53009,9,2011,28444,25594,1,2850,10.00%
Columbia,9/1/11,53013,9,2011,1831,1688,1,143,7.80%
Cowlitz,9/1/11,53015,9,2011,44310,39303,1,5007,11.30%
Douglas,9/1/11,53017,9,2011,19792,18244,1,1548,7.80%
Ferry,9/1/11,53019,9,2011,2526,2128,1,398,15.80%
Franklin,9/1/11,53021,9,2011,40241,37283,1,2958,7.40%
Garfield,9/1/11,53023,9,2011,1077,1011,1,66,6.10%
Grant,9/1/11,53025,9,2011,45769,42180,1,3589,7.80%
Grays Harbor,9/1/11,53027,9,2011,29647,25851,1,3796,12.80%
Island,9/1/11,53029,9,2011,31982,29214,1,2768,8.70%
Jefferson,9/1/11,53031,9,2011,11871,10696,1,1175,9.90%
King,9/1/11,53033,9,2011,1114335,1028654,1,85681,7.70%
Kitsap,9/1/11,53035,9,2011,115197,105819,1,9378,8.10%
Kittitas,9/1/11,53037,9,2011,20297,18586,1,1711,8.40%
Klickitat,9/1/11,53039,9,2011,10461,9412,1,1049,10.00%
Lewis,9/1/11,53041,9,2011,31922,28163,1,3759,11.80%
Lincoln,9/1/11,53043,9,2011,5342,4954,1,388,7.30%
Mason,9/1/11,53045,9,2011,23103,20471,1,2632,11.40%
Okanogan,9/1/11,53047,9,2011,23264,21447,1,1817,7.80%
Pacific,9/1/11,53049,9,2011,8169,7200,1,969,11.90%
Pend Oreille,9/1/11,53051,9,2011,4724,4132,1,592,12.50%
Pierce,9/1/11,53053,9,2011,382115,345067,1,37048,9.70%
San Juan,9/1/11,53055,9,2011,8406,7914,1,492,5.90%
Skagit,9/1/11,53057,9,2011,56815,51344,1,5471,9.60%
Skamania,9/1/11,53059,9,2011,4948,4417,1,531,10.70%
Snohomish,9/1/11,53061,9,2011,385282,350431,1,34851,9.00%
Spokane,9/1/11,53063,9,2011,226355,206123,1,20232,8.90%
Stevens,9/1/11,53065,9,2011,17822,15857,1,1965,11.00%
Thurston,9/1/11,53067,9,2011,120878,110297,1,10581,8.80%
Wahkiakum,9/1/11,53069,9,2011,1399,1225,1,174,12.40%
Walla Walla,9/1/11,53071,9,2011,29276,27173,1,2103,7.20%
Whatcom,9/1/11,53073,9,2011,100683,92103,1,8580,8.50%
Whitman,9/1/11,53075,9,2011,23242,21819,1,1423,6.10%
Yakima,9/1/11,53077,9,2011,125978,114636,1,11342,9.00%
Adams,9/1/12,53001,9,2012,8632,8054,1,578,6.70%
Asotin,9/1/12,53003,9,2012,9652,8966,1,686,7.10%
Clallam,9/1/12,53009,9,2012,27840,25302,1,2538,9.10%
Clark,9/1/12,53011,9,2012,204769,186875,1,17894,8.70%
Columbia,9/1/12,53013,9,2012,1792,1665,1,127,7.10%
Cowlitz,9/1/12,53015,9,2012,43554,39210,1,4344,10.00%
Douglas,9/1/12,53017,9,2012,19452,18048,1,1404,7.20%
Ferry,9/1/12,53019,9,2012,2397,2083,1,314,13.10%
Franklin,9/1/12,53021,9,2012,40154,37030,1,3124,7.80%
Garfield,9/1/12,53023,9,2012,1019,951,1,68,6.70%
Grant,9/1/12,53025,9,2012,46635,43364,1,3271,7.00%
Grays Harbor,9/1/12,53027,9,2012,28334,25027,1,3307,11.70%
Island,9/1/12,53029,9,2012,31947,29597,1,2350,7.40%
Jefferson,9/1/12,53031,9,2012,11833,10778,1,1055,8.90%
King,9/1/12,53033,9,2012,1131035,1064703,1,66332,5.90%
Kitsap,9/1/12,53035,9,2012,113338,105087,1,8251,7.30%
Kittitas,9/1/12,53037,9,2012,20706,19182,1,1524,7.40%
Klickitat,9/1/12,53039,9,2012,10073,9216,1,857,8.50%
Lewis,9/1/12,53041,9,2012,31498,28103,1,3395,10.80%
Lincoln,9/1/12,53043,9,2012,5199,4887,1,312,6.00%
Mason,9/1/12,53045,9,2012,22883,20562,1,2321,10.10%
Okanogan,9/1/12,53047,9,2012,23737,22152,1,1585,6.70%
Pacific,9/1/12,53049,9,2012,8130,7264,1,866,10.70%
Pend Oreille,9/1/12,53051,9,2012,4699,4177,1,522,11.10%
Pierce,9/1/12,53053,9,2012,380830,348087,1,32743,8.60%
San Juan,9/1/12,53055,9,2012,8380,7955,1,425,5.10%
Skagit,9/1/12,53057,9,2012,56479,51645,1,4834,8.60%
Skamania,9/1/12,53059,9,2012,4920,4460,1,460,9.30%
Snohomish,9/1/12,53061,9,2012,387505,360947,1,26558,6.90%
Spokane,9/1/12,53063,9,2012,226008,207721,1,18287,8.10%
Stevens,9/1/12,53065,9,2012,17811,15994,1,1817,10.20%
Thurston,9/1/12,53067,9,2012,120496,111108,1,9388,7.80%
Wahkiakum,9/1/12,53069,9,2012,1358,1199,1,159,11.70%
Walla Walla,9/1/12,53071,9,2012,29219,27303,1,1916,6.60%
Whatcom,9/1/12,53073,9,2012,100593,93001,1,7592,7.50%
Whitman,9/1/12,53075,9,2012,22833,21446,1,1387,6.10%
Yakima,9/1/12,53077,9,2012,126817,116423,1,10394,8.20%
Adams,9/1/13,53001,9,2013,8787,8282,1,505,5.70%
Asotin,9/1/13,53003,9,2013,9758,9205,1,553,5.70%
Clallam,9/1/13,53009,9,2013,26978,24685,1,2293,8.50%
Clark,9/1/13,53011,9,2013,205266,189705,1,15561,7.60%
Columbia,9/1/13,53013,9,2013,1754,1642,1,112,6.40%
Cowlitz,9/1/13,53015,9,2013,42981,39296,1,3685,8.60%
Douglas,9/1/13,53017,9,2013,19155,17915,1,1240,6.50%
Ferry,9/1/13,53019,9,2013,2416,2149,1,267,11.10%
Franklin,9/1/13,53021,9,2013,39809,37002,1,2807,7.10%
Garfield,9/1/13,53023,9,2013,963,910,1,53,5.50%
Grant,9/1/13,53025,9,2013,46090,43208,1,2882,6.30%
Grays Harbor,9/1/13,53027,9,2013,27682,24718,1,2964,10.70%
Island,9/1/13,53029,9,2013,31267,29148,1,2119,6.80%
Jefferson,9/1/13,53031,9,2013,11317,10374,1,943,8.30%
King,9/1/13,53033,9,2013,1145206,1085989,1,59217,5.20%
Kitsap,9/1/13,53035,9,2013,111740,104351,1,7389,6.60%
Kittitas,9/1/13,53037,9,2013,20268,18966,1,1302,6.40%
Klickitat,9/1/13,53039,9,2013,9842,9098,1,744,7.60%
Lewis,9/1/13,53041,9,2013,30863,28038,1,2825,9.20%
Lincoln,9/1/13,53043,9,2013,5084,4796,1,288,5.70%
Mason,9/1/13,53045,9,2013,22741,20661,1,2080,9.10%
Okanogan,9/1/13,53047,9,2013,23046,21709,1,1337,5.80%
Pacific,9/1/13,53049,9,2013,7986,7196,1,790,9.90%
Pend Oreille,9/1/13,53051,9,2013,4566,4114,1,452,9.90%
Pierce,9/1/13,53053,9,2013,381001,352167,1,28834,7.60%
San Juan,9/1/13,53055,9,2013,8058,7672,1,386,4.80%
Skagit,9/1/13,53057,9,2013,56565,52368,1,4197,7.40%
Skamania,9/1/13,53059,9,2013,4909,4502,1,407,8.30%
Snohomish,9/1/13,53061,9,2013,391054,368297,1,22757,5.80%
Spokane,9/1/13,53063,9,2013,224060,208220,1,15840,7.10%
Stevens,9/1/13,53065,9,2013,17335,15794,1,1541,8.90%
Thurston,9/1/13,53067,9,2013,120650,112280,1,8370,6.90%
Wahkiakum,9/1/13,53069,9,2013,1292,1173,1,119,9.20%
Walla Walla,9/1/13,53071,9,2013,28094,26390,1,1704,6.10%
Whatcom,9/1/13,53073,9,2013,99801,93180,1,6621,6.60%
Whitman,9/1/13,53075,9,2013,22545,21305,1,1240,5.50%
Yakima,9/1/13,53077,9,2013,125303,115931,1,9372,7.50%
Adams,9/1/14,53001,9,2014,9142,8694,1,448,4.90%
Asotin,9/1/14,53003,9,2014,9639,9175,1,464,4.80%
Clallam,9/1/14,53009,9,2014,26584,24593,1,1991,7.50%
Clark,9/1/14,53011,9,2014,206811,193531,1,13280,6.40%
Columbia,9/1/14,53013,9,2014,1728,1619,1,109,6.30%
Cowlitz,9/1/14,53015,9,2014,43853,40731,1,3122,7.10%
Douglas,9/1/14,53017,9,2014,20038,18930,1,1108,5.50%
Ferry,9/1/14,53019,9,2014,2438,2218,1,220,9.00%
Franklin,9/1/14,53021,9,2014,38965,36548,1,2417,6.20%
Garfield,9/1/14,53023,9,2014,955,908,1,47,4.90%
Grant,9/1/14,53025,9,2014,47528,44933,1,2595,5.50%
Grays Harbor,9/1/14,53027,9,2014,26850,24375,1,2475,9.20%
Island,9/1/14,53029,9,2014,31262,29334,1,1928,6.20%
Jefferson,9/1/14,53031,9,2014,11081,10276,1,805,7.30%
King,9/1/14,53033,9,2014,1167563,1112214,1,55349,4.70%
Kitsap,9/1/14,53035,9,2014,112829,106341,1,6488,5.80%
Kittitas,9/1/14,53037,9,2014,19811,18590,1,1221,6.20%
Klickitat,9/1/14,53039,9,2014,9992,9400,1,592,5.90%
Lewis,9/1/14,53041,9,2014,30087,27631,1,2456,8.20%
Lincoln,9/1/14,53043,9,2014,4990,4739,1,251,5.00%
Mason,9/1/14,53045,9,2014,22650,20921,1,1729,7.60%
Okanogan,9/1/14,53047,9,2014,23516,22385,1,1131,4.80%
Pacific,9/1/14,53049,9,2014,7892,7218,1,674,8.50%
Pend Oreille,9/1/14,53051,9,2014,4474,4103,1,371,8.30%
Pierce,9/1/14,53053,9,2014,383747,359134,1,24613,6.40%
San Juan,9/1/14,53055,9,2014,8007,7669,1,338,4.20%
Skagit,9/1/14,53057,9,2014,56485,52878,1,3607,6.40%
Skamania,9/1/14,53059,9,2014,4884,4542,1,342,7.00%
Snohomish,9/1/14,53061,9,2014,398323,377804,1,20519,5.20%
Spokane,9/1/14,53063,9,2014,222714,208936,1,13778,6.20%
Stevens,9/1/14,53065,9,2014,17032,15725,1,1307,7.70%
Thurston,9/1/14,53067,9,2014,122743,115389,1,7354,6.00%
Wahkiakum,9/1/14,53069,9,2014,1279,1170,1,109,8.50%
Walla Walla,9/1/14,53071,9,2014,27992,26520,1,1472,5.30%
Whatcom,9/1/14,53073,9,2014,98454,92573,1,5881,6.00%
Whitman,9/1/14,53075,9,2014,22902,21850,1,1052,4.60%
Yakima,9/1/14,53077,9,2014,126835,119101,1,7734,6.10%
Adams,9/1/15,53001,9,2015,9006,8576,1,430,4.80%
Asotin,9/1/15,53003,9,2015,9513,9103,1,410,4.30%
Clallam,9/1/15,53009,9,2015,26314,24429,1,1885,7.20%
Clark,9/1/15,53011,9,2015,210576,198299,1,12277,5.80%
Columbia,9/1/15,53013,9,2015,1646,1552,1,94,5.70%
Cowlitz,9/1/15,53015,9,2015,43461,40322,1,3139,7.20%
Douglas,9/1/15,53017,9,2015,20112,19133,1,979,4.90%
Ferry,9/1/15,53019,9,2015,2526,2301,1,225,8.90%
Franklin,9/1/15,53021,9,2015,39506,37291,1,2215,5.60%
Garfield,9/1/15,53023,9,2015,910,865,1,45,4.90%
Grant,9/1/15,53025,9,2015,46649,44147,1,2502,5.40%
Grays Harbor,9/1/15,53027,9,2015,26274,24159,1,2115,8.00%
Island,9/1/15,53029,9,2015,31072,29327,1,1745,5.60%
Jefferson,9/1/15,53031,9,2015,10831,10127,1,704,6.50%
King,9/1/15,53033,9,2015,1191188,1139787,1,51401,4.30%
Kitsap,9/1/15,53035,9,2015,113617,107833,1,5784,5.10%
Kittitas,9/1/15,53037,9,2015,20717,19639,1,1078,5.20%
Klickitat,9/1/15,53039,9,2015,9585,9036,1,549,5.70%
Lewis,9/1/15,53041,9,2015,30535,28267,1,2268,7.40%
Lincoln,9/1/15,53043,9,2015,4751,4514,1,237,5.00%
Mason,9/1/15,53045,9,2015,22181,20505,1,1676,7.60%
Okanogan,9/1/15,53047,9,2015,22683,21597,1,1086,4.80%
Pacific,9/1/15,53049,9,2015,8052,7451,1,601,7.50%
Pend Oreille,9/1/15,53051,9,2015,4482,4096,1,386,8.60%
Pierce,9/1/15,53053,9,2015,388596,365788,1,22808,5.90%
San Juan,9/1/15,53055,9,2015,7939,7626,1,313,3.90%
Skagit,9/1/15,53057,9,2015,56039,52588,1,3451,6.20%
Skamania,9/1/15,53059,9,2015,4838,4539,1,299,6.20%
Snohomish,9/1/15,53061,9,2015,406161,387344,1,18817,4.60%
Spokane,9/1/15,53063,9,2015,223402,210390,1,13012,5.80%
Stevens,9/1/15,53065,9,2015,16969,15676,1,1293,7.60%
Thurston,9/1/15,53067,9,2015,123658,116885,1,6773,5.50%
Wahkiakum,9/1/15,53069,9,2015,1282,1173,1,109,8.50%
Walla Walla,9/1/15,53071,9,2015,27344,25976,1,1368,5.00%
Whatcom,9/1/15,53073,9,2015,101599,95932,1,5667,5.60%
Whitman,9/1/15,53075,9,2015,23142,22143,1,999,4.30%
Yakima,9/1/15,53077,9,2015,127967,120861,1,7106,5.60%
Adams,9/1/16,53001,9,2016,9169,8782,1,387,4.20%
Asotin,9/1/16,53003,9,2016,9985,9553,1,432,4.30%
Clallam,9/1/16,53009,9,2016,27292,25482,1,1810,6.60%
Clark,9/1/16,53011,9,2016,218048,205804,1,12244,5.60%
Columbia,9/1/16,53013,9,2016,1717,1621,1,96,5.60%
Cowlitz,9/1/16,53015,9,2016,44460,41521,1,2939,6.60%
Douglas,9/1/16,53017,9,2016,21044,19931,1,1113,5.30%
Ferry,9/1/16,53019,9,2016,2470,2271,1,199,8.10%
Franklin,9/1/16,53021,9,2016,40468,38266,1,2202,5.40%
Garfield,9/1/16,53023,9,2016,976,934,1,42,4.30%
Grant,9/1/16,53025,9,2016,46539,44198,1,2341,5.00%
Grays Harbor,9/1/16,53027,9,2016,26905,24917,1,1988,7.40%
Island,9/1/16,53029,9,2016,32541,30758,1,1783,5.50%
Jefferson,9/1/16,53031,9,2016,11371,10610,1,761,6.70%
King,9/1/16,53033,9,2016,1225896,1176700,1,49196,4.00%
Kitsap,9/1/16,53035,9,2016,116166,110078,1,6088,5.20%
Kittitas,9/1/16,53037,9,2016,21303,20249,1,1054,4.90%
Klickitat,9/1/16,53039,9,2016,9824,9277,1,547,5.60%
Lewis,9/1/16,53041,9,2016,31634,29464,1,2170,6.90%
Lincoln,9/1/16,53043,9,2016,5018,4797,1,221,4.40%
Mason,9/1/16,53045,9,2016,22980,21320,1,1660,7.20%
Okanogan,9/1/16,53047,9,2016,23111,22070,1,1041,4.50%
Pacific,9/1/16,53049,9,2016,8405,7819,1,586,7.00%
Pend Oreille,9/1/16,53051,9,2016,4587,4233,1,354,7.70%
Pierce,9/1/16,53053,9,2016,403412,381308,1,22104,5.50%
San Juan,9/1/16,53055,9,2016,8171,7852,1,319,3.90%
Skagit,9/1/16,53057,9,2016,57821,54487,1,3334,5.80%
Skamania,9/1/16,53059,9,2016,4990,4695,1,295,5.90%
Snohomish,9/1/16,53061,9,2016,419964,401514,1,18450,4.40%
Spokane,9/1/16,53063,9,2016,232167,219865,1,12302,5.30%
Stevens,9/1/16,53065,9,2016,17519,16373,1,1146,6.50%
Thurston,9/1/16,53067,9,2016,129337,122742,1,6595,5.10%
Wahkiakum,9/1/16,53069,9,2016,1280,1181,1,99,7.70%
Walla Walla,9/1/16,53071,9,2016,28672,27383,1,1289,4.50%
Whatcom,9/1/16,53073,9,2016,105501,99932,1,5569,5.30%
Whitman,9/1/16,53075,9,2016,23508,22551,1,957,4.10%
Yakima,9/1/16,53077,9,2016,133750,126950,1,6800,5.10%
Adams,9/1/17,53001,9,2017,9505,9160,1,345,3.60%
Asotin,9/1/17,53003,9,2017,10228,9852,1,376,3.70%
Clallam,9/1/17,53009,9,2017,27727,26057,1,1670,6.00%
Clark,9/1/17,53011,9,2017,225844,215503,1,10341,4.60%
Columbia,9/1/17,53013,9,2017,1804,1720,1,84,4.70%
Cowlitz,9/1/17,53015,9,2017,45284,42812,1,2472,5.50%
Douglas,9/1/17,53017,9,2017,21861,20983,1,878,4.00%
Ferry,9/1/17,53019,9,2017,2525,2303,1,222,8.80%
Franklin,9/1/17,53021,9,2017,41783,39866,1,1917,4.60%
Garfield,9/1/17,53023,9,2017,946,905,1,41,4.30%
Grant,9/1/17,53025,9,2017,47828,45804,1,2024,4.20%
Grays Harbor,9/1/17,53027,9,2017,27778,26073,1,1705,6.10%
Island,9/1/17,53029,9,2017,33974,32264,1,1710,5.00%
Jefferson,9/1/17,53031,9,2017,11936,11249,1,687,5.80%
King,9/1/17,53033,9,2017,1251466,1205407,1,46059,3.70%
Kitsap,9/1/17,53035,9,2017,119268,113772,1,5496,4.60%
Kittitas,9/1/17,53037,9,2017,22157,21164,1,993,4.50%
Klickitat,9/1/17,53039,9,2017,10065,9608,1,457,4.50%
Lewis,9/1/17,53041,9,2017,32882,30982,1,1900,5.80%
Lincoln,9/1/17,53043,9,2017,5003,4800,1,203,4.10%
Mason,9/1/17,53045,9,2017,23429,22042,1,1387,5.90%
Okanogan,9/1/17,53047,9,2017,22546,21514,1,1032,4.60%
Pacific,9/1/17,53049,9,2017,8368,7847,1,521,6.20%
Pend Oreille,9/1/17,53051,9,2017,4661,4384,1,277,5.90%
Pierce,9/1/17,53053,9,2017,414549,394234,1,20315,4.90%
San Juan,9/1/17,53055,9,2017,8702,8400,1,302,3.50%
Skagit,9/1/17,53057,9,2017,59337,56499,1,2838,4.80%
Skamania,9/1/17,53059,9,2017,5239,4961,1,278,5.30%
Snohomish,9/1/17,53061,9,2017,428322,410981,1,17341,4.00%
Spokane,9/1/17,53063,9,2017,238077,226998,1,11079,4.70%
Stevens,9/1/17,53065,9,2017,17853,16821,1,1032,5.80%
Thurston,9/1/17,53067,9,2017,134422,128302,1,6120,4.60%
Wahkiakum,9/1/17,53069,9,2017,1297,1215,1,82,6.30%
Walla Walla,9/1/17,53071,9,2017,29253,28034,1,1219,4.20%
Whatcom,9/1/17,53073,9,2017,109078,104072,1,5006,4.60%
Whitman,9/1/17,53075,9,2017,24107,23202,1,905,3.80%
Yakima,9/1/17,53077,9,2017,132248,126268,1,5980,4.50%
Adams,9/1/18,53001,9,2018,10182,9837,1,345,3.40%
Asotin,9/1/18,53003,9,2018,10100,9708,1,392,3.90%
Clallam,9/1/18,53009,9,2018,28002,26452,1,1550,5.50%
Clark,9/1/18,53011,9,2018,231644,221559,1,10085,4.40%
Columbia,9/1/18,53013,9,2018,1797,1713,1,84,4.70%
Cowlitz,9/1/18,53015,9,2018,46138,43759,1,2379,5.20%
Douglas,9/1/18,53017,9,2018,22212,21342,1,870,3.90%
Ferry,9/1/18,53019,9,2018,2471,2284,1,187,7.60%
Franklin,9/1/18,53021,9,2018,41258,39363,1,1895,4.60%
Garfield,9/1/18,53023,9,2018,923,882,1,41,4.40%
Grant,9/1/18,53025,9,2018,48901,46786,1,2115,4.30%
Grays Harbor,9/1/18,53027,9,2018,28127,26483,1,1644,5.80%
Island,9/1/18,53029,9,2018,34312,32660,1,1652,4.80%
Jefferson,9/1/18,53031,9,2018,12268,11650,1,618,5.00%
King,9/1/18,53033,9,2018,1271889,1230580,1,41309,3.20%
Kitsap,9/1/18,53035,9,2018,122724,117540,1,5184,4.20%
Kittitas,9/1/18,53037,9,2018,22263,21256,1,1007,4.50%
Klickitat,9/1/18,53039,9,2018,10098,9631,1,467,4.60%
Lewis,9/1/18,53041,9,2018,33714,31901,1,1813,5.40%
Lincoln,9/1/18,53043,9,2018,5150,4959,1,191,3.70%
Mason,9/1/18,53045,9,2018,24096,22697,1,1399,5.80%
Okanogan,9/1/18,53047,9,2018,22192,21257,1,935,4.20%
Pacific,9/1/18,53049,9,2018,8443,7960,1,483,5.70%
Pend Oreille,9/1/18,53051,9,2018,4784,4503,1,281,5.90%
Pierce,9/1/18,53053,9,2018,424354,404577,1,19777,4.70%
San Juan,9/1/18,53055,9,2018,8713,8423,1,290,3.30%
Skagit,9/1/18,53057,9,2018,60909,58103,1,2806,4.60%
Skamania,9/1/18,53059,9,2018,5319,5058,1,261,4.90%
Snohomish,9/1/18,53061,9,2018,433119,418040,1,15079,3.50%
Spokane,9/1/18,53063,9,2018,243920,232919,1,11001,4.50%
Stevens,9/1/18,53065,9,2018,18109,17125,1,984,5.40%
Thurston,9/1/18,53067,9,2018,137704,131790,1,5914,4.30%
Wahkiakum,9/1/18,53069,9,2018,1308,1227,1,81,6.20%
Walla Walla,9/1/18,53071,9,2018,29898,28731,1,1167,3.90%
Whatcom,9/1/18,53073,9,2018,110006,105335,1,4671,4.20%
Whitman,9/1/18,53075,9,2018,24368,23433,1,935,3.80%
Yakima,9/1/18,53077,9,2018,134180,128300,1,5880,4.40%
Adams,9/1/19,53001,9,2019,10830,10448,1,382,3.50%
Asotin,9/1/19,53003,9,2019,10343,9996,1,347,3.40%
Clallam,9/1/19,53009,9,2019,28756,27213,1,1543,5.40%
Clark,9/1/19,53011,9,2019,240483,230467,1,10016,4.20%
Columbia,9/1/19,53013,9,2019,1835,1756,1,79,4.30%
Cowlitz,9/1/19,53015,9,2019,47521,45078,1,2443,5.10%
Douglas,9/1/19,53017,9,2019,22620,21742,1,878,3.90%
Ferry,9/1/19,53019,9,2019,2437,2226,1,211,8.70%
Franklin,9/1/19,53021,9,2019,43639,41721,1,1918,4.40%
Garfield,9/1/19,53023,9,2019,929,892,1,37,4.00%
Grant,9/1/19,53025,9,2019,48829,46608,1,2221,4.50%
Grays Harbor,9/1/19,53027,9,2019,28578,26931,1,1647,5.80%
Island,9/1/19,53029,9,2019,35896,34301,1,1595,4.40%
Jefferson,9/1/19,53031,9,2019,13073,12463,1,610,4.70%
King,9/1/19,53033,9,2019,1302772,1266525,1,36247,2.80%
Kitsap,9/1/19,53035,9,2019,127763,122770,1,4993,3.90%
Kittitas,9/1/19,53037,9,2019,23199,22186,1,1013,4.40%
Klickitat,9/1/19,53039,9,2019,10394,9945,1,449,4.30%
Lewis,9/1/19,53041,9,2019,34740,32995,1,1745,5.00%
Lincoln,9/1/19,53043,9,2019,5101,4903,1,198,3.90%
Mason,9/1/19,53045,9,2019,24795,23464,1,1331,5.40%
Okanogan,9/1/19,53047,9,2019,21356,20451,1,905,4.20%
Pacific,9/1/19,53049,9,2019,8733,8259,1,474,5.40%
Pend Oreille,9/1/19,53051,9,2019,5036,4694,1,342,6.80%
Pierce,9/1/19,53053,9,2019,441240,422011,1,19229,4.40%
San Juan,9/1/19,53055,9,2019,9226,8952,1,274,3.00%
Skagit,9/1/19,53057,9,2019,62815,59933,1,2882,4.60%
Skamania,9/1/19,53059,9,2019,5511,5276,1,235,4.30%
Snohomish,9/1/19,53061,9,2019,443684,430248,1,13436,3.00%
Spokane,9/1/19,53063,9,2019,253277,242651,1,10626,4.20%
Stevens,9/1/19,53065,9,2019,18782,17838,1,944,5.00%
Thurston,9/1/19,53067,9,2019,142510,136572,1,5938,4.20%
Wahkiakum,9/1/19,53069,9,2019,1382,1299,1,83,6.00%
Walla Walla,9/1/19,53071,9,2019,30473,29260,1,1213,4.00%
Whatcom,9/1/19,53073,9,2019,113899,108937,1,4962,4.40%
Whitman,9/1/19,53075,9,2019,24835,23870,1,965,3.90%
Yakima,9/1/19,53077,9,2019,139342,133205,1,6137,4.40%
Adams,10/1/90,53001,10,1990,8120,7713,1,407,5.00%
Asotin,10/1/90,53003,10,1990,9521,8991,1,530,5.60%
Clallam,10/1/90,53009,10,1990,22799,21309,1,1490,6.50%
Columbia,10/1/90,53013,10,1990,1214,1034,1,180,14.80%
Cowlitz,10/1/90,53015,10,1990,37535,34881,1,2654,7.10%
Douglas,10/1/90,53017,10,1990,17516,16575,1,941,5.40%
Ferry,10/1/90,53019,10,1990,2768,2533,1,235,8.50%
Franklin,10/1/90,53021,10,1990,18861,17362,1,1499,7.90%
Garfield,10/1/90,53023,10,1990,988,969,1,19,1.90%
Grant,10/1/90,53025,10,1990,29619,27720,1,1899,6.40%
Grays Harbor,10/1/90,53027,10,1990,26830,24448,1,2382,8.90%
Island,10/1/90,53029,10,1990,22719,21979,1,740,3.30%
Jefferson,10/1/90,53031,10,1990,8531,8124,1,407,4.80%
King,10/1/90,53033,10,1990,848820,823554,1,25266,3.00%
Kitsap,10/1/90,53035,10,1990,84121,80470,1,3651,4.30%
Kittitas,10/1/90,53037,10,1990,12956,12097,1,859,6.60%
Klickitat,10/1/90,53039,10,1990,7919,7195,1,724,9.10%
Lewis,10/1/90,53041,10,1990,26042,24352,1,1690,6.50%
Lincoln,10/1/90,53043,10,1990,3965,3845,1,120,3.00%
Mason,10/1/90,53045,10,1990,16404,15572,1,832,5.10%
Okanogan,10/1/90,53047,10,1990,23377,21905,1,1472,6.30%
Pacific,10/1/90,53049,10,1990,7509,6897,1,612,8.20%
Pend Oreille,10/1/90,53051,10,1990,3360,2934,1,426,12.70%
Pierce,10/1/90,53053,10,1990,278142,264482,1,13660,4.90%
San Juan,10/1/90,53055,10,1990,4995,4875,1,120,2.40%
Skagit,10/1/90,53057,10,1990,39134,36772,1,2362,6.00%
Skamania,10/1/90,53059,10,1990,3833,3538,1,295,7.70%
Snohomish,10/1/90,53061,10,1990,246694,238685,1,8009,3.20%
Spokane,10/1/90,53063,10,1990,173180,164060,1,9120,5.30%
Stevens,10/1/90,53065,10,1990,13298,12311,1,987,7.40%
Thurston,10/1/90,53067,10,1990,80010,76115,1,3895,4.90%
Wahkiakum,10/1/90,53069,10,1990,1501,1429,1,72,4.80%
Walla Walla,10/1/90,53071,10,1990,23403,22063,1,1340,5.70%
Whatcom,10/1/90,53073,10,1990,68139,64955,1,3184,4.70%
Whitman,10/1/90,53075,10,1990,18057,17807,1,250,1.40%
Yakima,10/1/90,53077,10,1990,107868,100155,1,7713,7.20%
Adams,10/1/91,53001,10,1991,8185,7643,1,542,6.60%
Asotin,10/1/91,53003,10,1991,9521,9002,1,519,5.50%
Clallam,10/1/91,53009,10,1991,22524,21039,1,1485,6.60%
Columbia,10/1/91,53013,10,1991,1094,939,1,155,14.20%
Cowlitz,10/1/91,53015,10,1991,37700,34180,1,3520,9.30%
Douglas,10/1/91,53017,10,1991,18175,17318,1,857,4.70%
Ferry,10/1/91,53019,10,1991,2662,2412,1,250,9.40%
Franklin,10/1/91,53021,10,1991,19466,17880,1,1586,8.10%
Garfield,10/1/91,53023,10,1991,955,940,1,15,1.60%
Grant,10/1/91,53025,10,1991,30876,28814,1,2062,6.70%
Grays Harbor,10/1/91,53027,10,1991,26528,23659,1,2869,10.80%
Island,10/1/91,53029,10,1991,22723,21619,1,1104,4.90%
Jefferson,10/1/91,53031,10,1991,8236,7655,1,581,7.10%
King,10/1/91,53033,10,1991,862072,821494,1,40578,4.70%
Kitsap,10/1/91,53035,10,1991,85470,81004,1,4466,5.20%
Kittitas,10/1/91,53037,10,1991,13198,12006,1,1192,9.00%
Klickitat,10/1/91,53039,10,1991,7663,6995,1,668,8.70%
Lewis,10/1/91,53041,10,1991,26213,23397,1,2816,10.70%
Lincoln,10/1/91,53043,10,1991,3958,3809,1,149,3.80%
Mason,10/1/91,53045,10,1991,16596,15461,1,1135,6.80%
Okanogan,10/1/91,53047,10,1991,24909,23483,1,1426,5.70%
Pacific,10/1/91,53049,10,1991,7589,6878,1,711,9.40%
Pend Oreille,10/1/91,53051,10,1991,3447,3050,1,397,11.50%
Pierce,10/1/91,53053,10,1991,277922,260345,1,17577,6.30%
San Juan,10/1/91,53055,10,1991,5183,5020,1,163,3.10%
Skagit,10/1/91,53057,10,1991,40952,37885,1,3067,7.50%
Skamania,10/1/91,53059,10,1991,3934,3437,1,497,12.60%
Snohomish,10/1/91,53061,10,1991,254867,241922,1,12945,5.10%
Spokane,10/1/91,53063,10,1991,175900,165538,1,10362,5.90%
Stevens,10/1/91,53065,10,1991,13773,12663,1,1110,8.10%
Thurston,10/1/91,53067,10,1991,81979,76818,1,5161,6.30%
Wahkiakum,10/1/91,53069,10,1991,1527,1417,1,110,7.20%
Walla Walla,10/1/91,53071,10,1991,23423,22022,1,1401,6.00%
Whatcom,10/1/91,53073,10,1991,69706,65509,1,4197,6.00%
Whitman,10/1/91,53075,10,1991,17557,17284,1,273,1.60%
Yakima,10/1/91,53077,10,1991,108543,99714,1,8829,8.10%
Adams,10/1/92,53001,10,1992,8073,7039,1,1034,12.80%
Asotin,10/1/92,53003,10,1992,10082,9654,1,428,4.20%
Clallam,10/1/92,53009,10,1992,23376,21559,1,1817,7.80%
Columbia,10/1/92,53013,10,1992,1229,1059,1,170,13.80%
Cowlitz,10/1/92,53015,10,1992,38290,34508,1,3782,9.90%
Douglas,10/1/92,53017,10,1992,17147,15886,1,1261,7.40%
Ferry,10/1/92,53019,10,1992,2840,2557,1,283,10.00%
Franklin,10/1/92,53021,10,1992,20183,18317,1,1866,9.20%
Garfield,10/1/92,53023,10,1992,1041,1011,1,30,2.90%
Grant,10/1/92,53025,10,1992,31399,28650,1,2749,8.80%
Grays Harbor,10/1/92,53027,10,1992,28430,25115,1,3315,11.70%
Island,10/1/92,53029,10,1992,24247,22881,1,1366,5.60%
Jefferson,10/1/92,53031,10,1992,8702,8022,1,680,7.80%
King,10/1/92,53033,10,1992,891755,839775,1,51980,5.80%
Kitsap,10/1/92,53035,10,1992,89271,84041,1,5230,5.90%
Kittitas,10/1/92,53037,10,1992,14166,12536,1,1630,11.50%
Klickitat,10/1/92,53039,10,1992,7897,7158,1,739,9.40%
Lewis,10/1/92,53041,10,1992,27545,24949,1,2596,9.40%
Lincoln,10/1/92,53043,10,1992,4201,4020,1,181,4.30%
Mason,10/1/92,53045,10,1992,16533,15236,1,1297,7.80%
Okanogan,10/1/92,53047,10,1992,23273,21110,1,2163,9.30%
Pacific,10/1/92,53049,10,1992,7895,7150,1,745,9.40%
Pend Oreille,10/1/92,53051,10,1992,3633,3210,1,423,11.60%
Pierce,10/1/92,53053,10,1992,292136,271508,1,20628,7.10%
San Juan,10/1/92,53055,10,1992,5365,5097,1,268,5.00%
Skagit,10/1/92,53057,10,1992,42839,39100,1,3739,8.70%
Skamania,10/1/92,53059,10,1992,3661,3111,1,550,15.00%
Snohomish,10/1/92,53061,10,1992,267953,251480,1,16473,6.10%
Spokane,10/1/92,53063,10,1992,184286,173513,1,10773,5.80%
Stevens,10/1/92,53065,10,1992,14700,13462,1,1238,8.40%
Thurston,10/1/92,53067,10,1992,86406,80930,1,5476,6.30%
Wahkiakum,10/1/92,53069,10,1992,1535,1440,1,95,6.20%
Walla Walla,10/1/92,53071,10,1992,24810,23353,1,1457,5.90%
Whatcom,10/1/92,53073,10,1992,74206,69273,1,4933,6.60%
Whitman,10/1/92,53075,10,1992,18136,17790,1,346,1.90%
Yakima,10/1/92,53077,10,1992,108792,95184,1,13608,12.50%
Adams,10/1/93,53001,10,1993,8676,7897,1,779,9.00%
Asotin,10/1/93,53003,10,1993,10423,10036,1,387,3.70%
Clallam,10/1/93,53009,10,1993,23795,21681,1,2114,8.90%
Columbia,10/1/93,53013,10,1993,1287,1103,1,184,14.30%
Cowlitz,10/1/93,53015,10,1993,38776,34803,1,3973,10.20%
Douglas,10/1/93,53017,10,1993,19243,18140,1,1103,5.70%
Ferry,10/1/93,53019,10,1993,2850,2487,1,363,12.70%
Franklin,10/1/93,53021,10,1993,21765,20044,1,1721,7.90%
Garfield,10/1/93,53023,10,1993,1086,1034,1,52,4.80%
Grant,10/1/93,53025,10,1993,34319,31771,1,2548,7.40%
Grays Harbor,10/1/93,53027,10,1993,28038,23921,1,4117,14.70%
Island,10/1/93,53029,10,1993,24169,22962,1,1207,5.00%
Jefferson,10/1/93,53031,10,1993,9425,8641,1,784,8.30%
King,10/1/93,53033,10,1993,893149,844583,1,48566,5.40%
Kitsap,10/1/93,53035,10,1993,88793,82733,1,6060,6.80%
Kittitas,10/1/93,53037,10,1993,14086,12974,1,1112,7.90%
Klickitat,10/1/93,53039,10,1993,8187,7342,1,845,10.30%
Lewis,10/1/93,53041,10,1993,28685,26079,1,2606,9.10%
Lincoln,10/1/93,53043,10,1993,4419,4144,1,275,6.20%
Mason,10/1/93,53045,10,1993,17668,16156,1,1512,8.60%
Okanogan,10/1/93,53047,10,1993,26356,24226,1,2130,8.10%
Pacific,10/1/93,53049,10,1993,8113,7265,1,848,10.50%
Pend Oreille,10/1/93,53051,10,1993,3736,3312,1,424,11.30%
Pierce,10/1/93,53053,10,1993,300227,277868,1,22359,7.40%
San Juan,10/1/93,53055,10,1993,5407,5085,1,322,6.00%
Skagit,10/1/93,53057,10,1993,44241,39908,1,4333,9.80%
Skamania,10/1/93,53059,10,1993,4183,3727,1,456,10.90%
Snohomish,10/1/93,53061,10,1993,272245,256725,1,15520,5.70%
Spokane,10/1/93,53063,10,1993,188709,179211,1,9498,5.00%
Stevens,10/1/93,53065,10,1993,15419,14203,1,1216,7.90%
Thurston,10/1/93,53067,10,1993,88839,82497,1,6342,7.10%
Wahkiakum,10/1/93,53069,10,1993,1650,1536,1,114,6.90%
Walla Walla,10/1/93,53071,10,1993,25273,24059,1,1214,4.80%
Whatcom,10/1/93,53073,10,1993,76059,70812,1,5247,6.90%
Whitman,10/1/93,53075,10,1993,18733,18395,1,338,1.80%
Yakima,10/1/93,53077,10,1993,117181,105399,1,11782,10.10%
Adams,10/1/94,53001,10,1994,8993,8306,1,687,7.60%
Asotin,10/1/94,53003,10,1994,10914,10562,1,352,3.20%
Clallam,10/1/94,53009,10,1994,23431,20992,1,2439,10.40%
Columbia,10/1/94,53013,10,1994,1222,1069,1,153,12.50%
Cowlitz,10/1/94,53015,10,1994,39525,36544,1,2981,7.50%
Douglas,10/1/94,53017,10,1994,20210,19122,1,1088,5.40%
Ferry,10/1/94,53019,10,1994,2962,2624,1,338,11.40%
Franklin,10/1/94,53021,10,1994,22578,20994,1,1584,7.00%
Garfield,10/1/94,53023,10,1994,1012,972,1,40,4.00%
Grant,10/1/94,53025,10,1994,35482,32865,1,2617,7.40%
Grays Harbor,10/1/94,53027,10,1994,27626,24408,1,3218,11.60%
Island,10/1/94,53029,10,1994,24908,23726,1,1182,4.70%
Jefferson,10/1/94,53031,10,1994,9422,8636,1,786,8.30%
King,10/1/94,53033,10,1994,886899,848704,1,38195,4.30%
Kitsap,10/1/94,53035,10,1994,90361,84746,1,5615,6.20%
Kittitas,10/1/94,53037,10,1994,15356,14377,1,979,6.40%
Klickitat,10/1/94,53039,10,1994,8476,7695,1,781,9.20%
Lewis,10/1/94,53041,10,1994,29134,26885,1,2249,7.70%
Lincoln,10/1/94,53043,10,1994,4350,4105,1,245,5.60%
Mason,10/1/94,53045,10,1994,18149,16685,1,1464,8.10%
Okanogan,10/1/94,53047,10,1994,28790,26875,1,1915,6.70%
Pacific,10/1/94,53049,10,1994,8150,7136,1,1014,12.40%
Pend Oreille,10/1/94,53051,10,1994,3731,3320,1,411,11.00%
Pierce,10/1/94,53053,10,1994,309149,288923,1,20226,6.50%
San Juan,10/1/94,53055,10,1994,5405,5114,1,291,5.40%
Skagit,10/1/94,53057,10,1994,47959,43857,1,4102,8.60%
Skamania,10/1/94,53059,10,1994,3868,3546,1,322,8.30%
Snohomish,10/1/94,53061,10,1994,274795,261818,1,12977,4.70%
Spokane,10/1/94,53063,10,1994,195657,186397,1,9260,4.70%
Stevens,10/1/94,53065,10,1994,16269,15045,1,1224,7.50%
Thurston,10/1/94,53067,10,1994,91173,85365,1,5808,6.40%
Wahkiakum,10/1/94,53069,10,1994,1629,1447,1,182,11.20%
Walla Walla,10/1/94,53071,10,1994,25624,24490,1,1134,4.40%
Whatcom,10/1/94,53073,10,1994,75223,69474,1,5749,7.60%
Whitman,10/1/94,53075,10,1994,19075,18751,1,324,1.70%
Yakima,10/1/94,53077,10,1994,119247,108126,1,11121,9.30%
Adams,10/1/95,53001,10,1995,9464,8880,1,584,6.20%
Asotin,10/1/95,53003,10,1995,11315,10893,1,422,3.70%
Clallam,10/1/95,53009,10,1995,24375,22437,1,1938,8.00%
Columbia,10/1/95,53013,10,1995,1239,1061,1,178,14.40%
Cowlitz,10/1/95,53015,10,1995,40738,37553,1,3185,7.80%
Douglas,10/1/95,53017,10,1995,20193,19110,1,1083,5.40%
Ferry,10/1/95,53019,10,1995,2822,2539,1,283,10.00%
Franklin,10/1/95,53021,10,1995,21975,20350,1,1625,7.40%
Garfield,10/1/95,53023,10,1995,984,958,1,26,2.60%
Grant,10/1/95,53025,10,1995,36340,33802,1,2538,7.00%
Grays Harbor,10/1/95,53027,10,1995,28152,25164,1,2988,10.60%
Island,10/1/95,53029,10,1995,25732,24515,1,1217,4.70%
Jefferson,10/1/95,53031,10,1995,9885,9205,1,680,6.90%
King,10/1/95,53033,10,1995,895409,853876,1,41533,4.60%
Kitsap,10/1/95,53035,10,1995,90504,83889,1,6615,7.30%
Kittitas,10/1/95,53037,10,1995,15710,14591,1,1119,7.10%
Klickitat,10/1/95,53039,10,1995,8789,7989,1,800,9.10%
Lewis,10/1/95,53041,10,1995,29961,27605,1,2356,7.90%
Lincoln,10/1/95,53043,10,1995,4666,4391,1,275,5.90%
Mason,10/1/95,53045,10,1995,19559,18090,1,1469,7.50%
Okanogan,10/1/95,53047,10,1995,28456,26558,1,1898,6.70%
Pacific,10/1/95,53049,10,1995,8425,7619,1,806,9.60%
Pend Oreille,10/1/95,53051,10,1995,3962,3492,1,470,11.90%
Pierce,10/1/95,53053,10,1995,317089,297553,1,19536,6.20%
San Juan,10/1/95,53055,10,1995,5539,5201,1,338,6.10%
Skagit,10/1/95,53057,10,1995,48996,44805,1,4191,8.60%
Skamania,10/1/95,53059,10,1995,4102,3765,1,337,8.20%
Snohomish,10/1/95,53061,10,1995,280006,265680,1,14326,5.10%
Spokane,10/1/95,53063,10,1995,201423,191359,1,10064,5.00%
Stevens,10/1/95,53065,10,1995,16610,15272,1,1338,8.10%
Thurston,10/1/95,53067,10,1995,94538,88330,1,6208,6.60%
Wahkiakum,10/1/95,53069,10,1995,1663,1545,1,118,7.10%
Walla Walla,10/1/95,53071,10,1995,26219,25011,1,1208,4.60%
Whatcom,10/1/95,53073,10,1995,79527,74082,1,5445,6.80%
Whitman,10/1/95,53075,10,1995,19239,18891,1,348,1.80%
Yakima,10/1/95,53077,10,1995,121036,110054,1,10982,9.10%
Adams,10/1/96,53001,10,1996,9698,9108,1,590,6.10%
Asotin,10/1/96,53003,10,1996,11781,11417,1,364,3.10%
Clallam,10/1/96,53009,10,1996,24654,22597,1,2057,8.30%
Columbia,10/1/96,53013,10,1996,1248,1081,1,167,13.40%
Cowlitz,10/1/96,53015,10,1996,41011,37953,1,3058,7.50%
Douglas,10/1/96,53017,10,1996,21768,20768,1,1000,4.60%
Ferry,10/1/96,53019,10,1996,2799,2545,1,254,9.10%
Franklin,10/1/96,53021,10,1996,22208,20725,1,1483,6.70%
Garfield,10/1/96,53023,10,1996,1057,1028,1,29,2.70%
Grant,10/1/96,53025,10,1996,40512,38129,1,2383,5.90%
Grays Harbor,10/1/96,53027,10,1996,27775,25028,1,2747,9.90%
Island,10/1/96,53029,10,1996,26518,25396,1,1122,4.20%
Jefferson,10/1/96,53031,10,1996,9994,9311,1,683,6.80%
King,10/1/96,53033,10,1996,932147,894164,1,37983,4.10%
Kitsap,10/1/96,53035,10,1996,95072,89485,1,5587,5.90%
Kittitas,10/1/96,53037,10,1996,16148,15308,1,840,5.20%
Klickitat,10/1/96,53039,10,1996,8936,8302,1,634,7.10%
Lewis,10/1/96,53041,10,1996,30811,28280,1,2531,8.20%
Lincoln,10/1/96,53043,10,1996,4898,4684,1,214,4.40%
Mason,10/1/96,53045,10,1996,19699,18290,1,1409,7.20%
Okanogan,10/1/96,53047,10,1996,28890,27122,1,1768,6.10%
Pacific,10/1/96,53049,10,1996,8286,7525,1,761,9.20%
Pend Oreille,10/1/96,53051,10,1996,4059,3526,1,533,13.10%
Pierce,10/1/96,53053,10,1996,324443,307743,1,16700,5.10%
San Juan,10/1/96,53055,10,1996,5468,5178,1,290,5.30%
Skagit,10/1/96,53057,10,1996,47238,43757,1,3481,7.40%
Skamania,10/1/96,53059,10,1996,4016,3740,1,276,6.90%
Snohomish,10/1/96,53061,10,1996,294043,281431,1,12612,4.30%
Spokane,10/1/96,53063,10,1996,204862,195573,1,9289,4.50%
Stevens,10/1/96,53065,10,1996,16897,15622,1,1275,7.50%
Thurston,10/1/96,53067,10,1996,96901,91193,1,5708,5.90%
Wahkiakum,10/1/96,53069,10,1996,1733,1636,1,97,5.60%
Walla Walla,10/1/96,53071,10,1996,26689,25249,1,1440,5.40%
Whatcom,10/1/96,53073,10,1996,79541,74646,1,4895,6.20%
Whitman,10/1/96,53075,10,1996,19844,19540,1,304,1.50%
Yakima,10/1/96,53077,10,1996,128361,118511,1,9850,7.70%
Adams,10/1/97,53001,10,1997,9816,9236,1,580,5.90%
Asotin,10/1/97,53003,10,1997,12509,12157,1,352,2.80%
Clallam,10/1/97,53009,10,1997,25022,23313,1,1709,6.80%
Columbia,10/1/97,53013,10,1997,1264,1123,1,141,11.20%
Cowlitz,10/1/97,53015,10,1997,41581,38990,1,2591,6.20%
Douglas,10/1/97,53017,10,1997,21043,20239,1,804,3.80%
Ferry,10/1/97,53019,10,1997,2781,2598,1,183,6.60%
Franklin,10/1/97,53021,10,1997,22540,21270,1,1270,5.60%
Garfield,10/1/97,53023,10,1997,1045,1013,1,32,3.10%
Grant,10/1/97,53025,10,1997,41595,39503,1,2092,5.00%
Grays Harbor,10/1/97,53027,10,1997,28321,26029,1,2292,8.10%
Island,10/1/97,53029,10,1997,28746,27746,1,1000,3.50%
Jefferson,10/1/97,53031,10,1997,10204,9597,1,607,5.90%
King,10/1/97,53033,10,1997,960136,929624,1,30512,3.20%
Kitsap,10/1/97,53035,10,1997,95008,90087,1,4921,5.20%
Kittitas,10/1/97,53037,10,1997,16108,15399,1,709,4.40%
Klickitat,10/1/97,53039,10,1997,9516,8850,1,666,7.00%
Lewis,10/1/97,53041,10,1997,32492,30407,1,2085,6.40%
Lincoln,10/1/97,53043,10,1997,4874,4702,1,172,3.50%
Mason,10/1/97,53045,10,1997,21252,20001,1,1251,5.90%
Okanogan,10/1/97,53047,10,1997,29663,28087,1,1576,5.30%
Pacific,10/1/97,53049,10,1997,8872,8120,1,752,8.50%
Pend Oreille,10/1/97,53051,10,1997,4314,3887,1,427,9.90%
Pierce,10/1/97,53053,10,1997,336740,322833,1,13907,4.10%
San Juan,10/1/97,53055,10,1997,5809,5555,1,254,4.40%
Skagit,10/1/97,53057,10,1997,48623,45810,1,2813,5.80%
Skamania,10/1/97,53059,10,1997,4172,3865,1,307,7.40%
Snohomish,10/1/97,53061,10,1997,310828,300807,1,10021,3.20%
Spokane,10/1/97,53063,10,1997,210349,202713,1,7636,3.60%
Stevens,10/1/97,53065,10,1997,17463,16298,1,1165,6.70%
Thurston,10/1/97,53067,10,1997,101423,96566,1,4857,4.80%
Wahkiakum,10/1/97,53069,10,1997,1809,1715,1,94,5.20%
Walla Walla,10/1/97,53071,10,1997,27538,26314,1,1224,4.40%
Whatcom,10/1/97,53073,10,1997,81375,77280,1,4095,5.00%
Whitman,10/1/97,53075,10,1997,20358,20082,1,276,1.40%
Yakima,10/1/97,53077,10,1997,125178,117519,1,7659,6.10%
Adams,10/1/98,53001,10,1998,10155,9539,1,616,6.10%
Asotin,10/1/98,53003,10,1998,12895,12486,1,409,3.20%
Clallam,10/1/98,53009,10,1998,25443,23612,1,1831,7.20%
Columbia,10/1/98,53013,10,1998,1262,1110,1,152,12.00%
Cowlitz,10/1/98,53015,10,1998,44379,41199,1,3180,7.20%
Douglas,10/1/98,53017,10,1998,22208,21217,1,991,4.50%
Ferry,10/1/98,53019,10,1998,2803,2545,1,258,9.20%
Franklin,10/1/98,53021,10,1998,23254,21641,1,1613,6.90%
Garfield,10/1/98,53023,10,1998,1066,1031,1,35,3.30%
Grant,10/1/98,53025,10,1998,42824,40252,1,2572,6.00%
Grays Harbor,10/1/98,53027,10,1998,28231,25672,1,2559,9.10%
Island,10/1/98,53029,10,1998,30073,29020,1,1053,3.50%
Jefferson,10/1/98,53031,10,1998,10269,9633,1,636,6.20%
King,10/1/98,53033,10,1998,972619,941016,1,31603,3.20%
Kitsap,10/1/98,53035,10,1998,94518,89847,1,4671,4.90%
Kittitas,10/1/98,53037,10,1998,16258,15603,1,655,4.00%
Klickitat,10/1/98,53039,10,1998,9452,8858,1,594,6.30%
Lewis,10/1/98,53041,10,1998,31030,28612,1,2418,7.80%
Lincoln,10/1/98,53043,10,1998,4922,4705,1,217,4.40%
Mason,10/1/98,53045,10,1998,21590,20404,1,1186,5.50%
Okanogan,10/1/98,53047,10,1998,29662,27765,1,1897,6.40%
Pacific,10/1/98,53049,10,1998,8427,7586,1,841,10.00%
Pend Oreille,10/1/98,53051,10,1998,4343,3940,1,403,9.30%
Pierce,10/1/98,53053,10,1998,347013,332039,1,14974,4.30%
San Juan,10/1/98,53055,10,1998,6041,5824,1,217,3.60%
Skagit,10/1/98,53057,10,1998,49463,46355,1,3108,6.30%
Skamania,10/1/98,53059,10,1998,4346,4012,1,334,7.70%
Snohomish,10/1/98,53061,10,1998,321375,310588,1,10787,3.40%
Spokane,10/1/98,53063,10,1998,218236,207277,1,10959,5.00%
Stevens,10/1/98,53065,10,1998,17816,16524,1,1292,7.30%
Thurston,10/1/98,53067,10,1998,104651,99823,1,4828,4.60%
Wahkiakum,10/1/98,53069,10,1998,1924,1810,1,114,5.90%
Walla Walla,10/1/98,53071,10,1998,27607,26148,1,1459,5.30%
Whatcom,10/1/98,53073,10,1998,82207,78024,1,4183,5.10%
Whitman,10/1/98,53075,10,1998,20758,20442,1,316,1.50%
Yakima,10/1/98,53077,10,1998,128932,120450,1,8482,6.60%
Adams,10/1/99,53001,10,1999,9364,8857,1,507,5.40%
Asotin,10/1/99,53003,10,1999,12316,12141,1,175,1.40%
Clallam,10/1/99,53009,10,1999,25759,24236,1,1523,5.90%
Columbia,10/1/99,53013,10,1999,1279,1148,1,131,10.20%
Cowlitz,10/1/99,53015,10,1999,43384,40888,1,2496,5.80%
Douglas,10/1/99,53017,10,1999,21757,20853,1,904,4.20%
Ferry,10/1/99,53019,10,1999,2698,2496,1,202,7.50%
Franklin,10/1/99,53021,10,1999,23439,22144,1,1295,5.50%
Garfield,10/1/99,53023,10,1999,1046,1020,1,26,2.50%
Grant,10/1/99,53025,10,1999,43118,40687,1,2431,5.60%
Grays Harbor,10/1/99,53027,10,1999,26132,24264,1,1868,7.10%
Island,10/1/99,53029,10,1999,30664,29504,1,1160,3.80%
Jefferson,10/1/99,53031,10,1999,11040,10515,1,525,4.80%
King,10/1/99,53033,10,1999,975858,942616,1,33242,3.40%
Kitsap,10/1/99,53035,10,1999,98060,93377,1,4683,4.80%
Kittitas,10/1/99,53037,10,1999,16354,15766,1,588,3.60%
Klickitat,10/1/99,53039,10,1999,9224,8680,1,544,5.90%
Lewis,10/1/99,53041,10,1999,30690,28462,1,2228,7.30%
Lincoln,10/1/99,53043,10,1999,4681,4498,1,183,3.90%
Mason,10/1/99,53045,10,1999,20829,19728,1,1101,5.30%
Okanogan,10/1/99,53047,10,1999,25937,24509,1,1428,5.50%
Pacific,10/1/99,53049,10,1999,7712,7158,1,554,7.20%
Pend Oreille,10/1/99,53051,10,1999,4249,3934,1,315,7.40%
Pierce,10/1/99,53053,10,1999,343666,328597,1,15069,4.40%
San Juan,10/1/99,53055,10,1999,6545,6383,1,162,2.50%
Skagit,10/1/99,53057,10,1999,52657,49967,1,2690,5.10%
Skamania,10/1/99,53059,10,1999,4212,3952,1,260,6.20%
Snohomish,10/1/99,53061,10,1999,329429,315017,1,14412,4.40%
Spokane,10/1/99,53063,10,1999,219829,209991,1,9838,4.50%
Stevens,10/1/99,53065,10,1999,17100,15942,1,1158,6.80%
Thurston,10/1/99,53067,10,1999,105805,101292,1,4513,4.30%
Wahkiakum,10/1/99,53069,10,1999,1886,1786,1,100,5.30%
Walla Walla,10/1/99,53071,10,1999,27374,26093,1,1281,4.70%
Whatcom,10/1/99,53073,10,1999,84444,80865,1,3579,4.20%
Whitman,10/1/99,53075,10,1999,20209,19915,1,294,1.50%
Yakima,10/1/99,53077,10,1999,122620,115092,1,7528,6.10%
Adams,10/1/00,53001,10,2000,9124,8740,1,384,4.20%
Asotin,10/1/00,53003,10,2000,9465,8927,1,538,5.70%
Clallam,10/1/00,53009,10,2000,25340,23642,1,1698,6.70%
Columbia,10/1/00,53013,10,2000,1482,1365,1,117,7.90%
Cowlitz,10/1/00,53015,10,2000,42316,39551,1,2765,6.50%
Douglas,10/1/00,53017,10,2000,19140,18252,1,888,4.60%
Ferry,10/1/00,53019,10,2000,2868,2644,1,224,7.80%
Franklin,10/1/00,53021,10,2000,22878,21682,1,1196,5.20%
Garfield,10/1/00,53023,10,2000,991,945,1,46,4.60%
Grant,10/1/00,53025,10,2000,39284,37204,1,2080,5.30%
Grays Harbor,10/1/00,53027,10,2000,28721,26475,1,2246,7.80%
Island,10/1/00,53029,10,2000,28164,26792,1,1372,4.90%
Jefferson,10/1/00,53031,10,2000,11454,10832,1,622,5.40%
King,10/1/00,53033,10,2000,981379,945597,1,35782,3.60%
Kitsap,10/1/00,53035,10,2000,104301,98771,1,5530,5.30%
Kittitas,10/1/00,53037,10,2000,17875,17061,1,814,4.60%
Klickitat,10/1/00,53039,10,2000,9107,8512,1,595,6.50%
Lewis,10/1/00,53041,10,2000,29339,27254,1,2085,7.10%
Lincoln,10/1/00,53043,10,2000,4427,4222,1,205,4.60%
Mason,10/1/00,53045,10,2000,20891,19565,1,1326,6.30%
Okanogan,10/1/00,53047,10,2000,23591,22135,1,1456,6.20%
Pacific,10/1/00,53049,10,2000,8433,7830,1,603,7.20%
Pend Oreille,10/1/00,53051,10,2000,4466,4165,1,301,6.70%
Pierce,10/1/00,53053,10,2000,334787,317261,1,17526,5.20%
San Juan,10/1/00,53055,10,2000,7381,7091,1,290,3.90%
Skagit,10/1/00,53057,10,2000,50957,48186,1,2771,5.40%
Skamania,10/1/00,53059,10,2000,4774,4465,1,309,6.50%
Snohomish,10/1/00,53061,10,2000,320815,308653,1,12162,3.80%
Spokane,10/1/00,53063,10,2000,209661,199245,1,10416,5.00%
Stevens,10/1/00,53065,10,2000,17043,15960,1,1083,6.40%
Thurston,10/1/00,53067,10,2000,106245,101192,1,5053,4.80%
Wahkiakum,10/1/00,53069,10,2000,1631,1525,1,106,6.50%
Walla Walla,10/1/00,53071,10,2000,27783,26455,1,1328,4.80%
Whatcom,10/1/00,53073,10,2000,86963,82472,1,4491,5.20%
Whitman,10/1/00,53075,10,2000,19663,18974,1,689,3.50%
Yakima,10/1/00,53077,10,2000,119962,113559,1,6403,5.30%
Adams,10/1/01,53001,10,2001,8649,8226,1,423,4.90%
Asotin,10/1/01,53003,10,2001,9834,9265,1,569,5.80%
Clallam,10/1/01,53009,10,2001,25362,23507,1,1855,7.30%
Columbia,10/1/01,53013,10,2001,1444,1309,1,135,9.30%
Cowlitz,10/1/01,53015,10,2001,41729,37768,1,3961,9.50%
Douglas,10/1/01,53017,10,2001,18014,17028,1,986,5.50%
Ferry,10/1/01,53019,10,2001,2773,2530,1,243,8.80%
Franklin,10/1/01,53021,10,2001,23409,22130,1,1279,5.50%
Garfield,10/1/01,53023,10,2001,1012,974,1,38,3.80%
Grant,10/1/01,53025,10,2001,38044,35752,1,2292,6.00%
Grays Harbor,10/1/01,53027,10,2001,27999,25489,1,2510,9.00%
Island,10/1/01,53029,10,2001,28363,26508,1,1855,6.50%
Jefferson,10/1/01,53031,10,2001,11898,11114,1,784,6.60%
King,10/1/01,53033,10,2001,984872,933009,1,51863,5.30%
Kitsap,10/1/01,53035,10,2001,104388,97876,1,6512,6.20%
Kittitas,10/1/01,53037,10,2001,17964,16989,1,975,5.40%
Klickitat,10/1/01,53039,10,2001,8699,7881,1,818,9.40%
Lewis,10/1/01,53041,10,2001,28643,26327,1,2316,8.10%
Lincoln,10/1/01,53043,10,2001,4361,4107,1,254,5.80%
Mason,10/1/01,53045,10,2001,20839,19311,1,1528,7.30%
Okanogan,10/1/01,53047,10,2001,21358,19950,1,1408,6.60%
Pacific,10/1/01,53049,10,2001,8315,7626,1,689,8.30%
Pend Oreille,10/1/01,53051,10,2001,4643,4276,1,367,7.90%
Pierce,10/1/01,53053,10,2001,330600,307519,1,23081,7.00%
San Juan,10/1/01,53055,10,2001,7154,6814,1,340,4.80%
Skagit,10/1/01,53057,10,2001,50485,46824,1,3661,7.30%
Skamania,10/1/01,53059,10,2001,4720,4244,1,476,10.10%
Snohomish,10/1/01,53061,10,2001,326133,308728,1,17405,5.30%
Spokane,10/1/01,53063,10,2001,208670,195004,1,13666,6.50%
Stevens,10/1/01,53065,10,2001,16993,15444,1,1549,9.10%
Thurston,10/1/01,53067,10,2001,106416,100144,1,6272,5.90%
Wahkiakum,10/1/01,53069,10,2001,1559,1430,1,129,8.30%
Walla Walla,10/1/01,53071,10,2001,27331,25795,1,1536,5.60%
Whatcom,10/1/01,53073,10,2001,87183,81358,1,5825,6.70%
Whitman,10/1/01,53075,10,2001,19064,18236,1,828,4.30%
Yakima,10/1/01,53077,10,2001,115259,107361,1,7898,6.90%
Adams,10/1/02,53001,10,2002,8895,8449,1,446,5.00%
Asotin,10/1/02,53003,10,2002,10239,9598,1,641,6.30%
Clallam,10/1/02,53009,10,2002,26609,24655,1,1954,7.30%
Columbia,10/1/02,53013,10,2002,1458,1311,1,147,10.10%
Cowlitz,10/1/02,53015,10,2002,42102,38153,1,3949,9.40%
Douglas,10/1/02,53017,10,2002,19295,18407,1,888,4.60%
Ferry,10/1/02,53019,10,2002,2957,2730,1,227,7.70%
Franklin,10/1/02,53021,10,2002,24706,23325,1,1381,5.60%
Garfield,10/1/02,53023,10,2002,1019,963,1,56,5.50%
Grant,10/1/02,53025,10,2002,39844,37518,1,2326,5.80%
Grays Harbor,10/1/02,53027,10,2002,29357,26800,1,2557,8.70%
Island,10/1/02,53029,10,2002,30218,28163,1,2055,6.80%
Jefferson,10/1/02,53031,10,2002,12497,11650,1,847,6.80%
King,10/1/02,53033,10,2002,976414,916571,1,59843,6.10%
Kitsap,10/1/02,53035,10,2002,110944,104179,1,6765,6.10%
Kittitas,10/1/02,53037,10,2002,19124,18046,1,1078,5.60%
Klickitat,10/1/02,53039,10,2002,9766,8995,1,771,7.90%
Lewis,10/1/02,53041,10,2002,29965,27566,1,2399,8.00%
Lincoln,10/1/02,53043,10,2002,4545,4271,1,274,6.00%
Mason,10/1/02,53045,10,2002,22622,21002,1,1620,7.20%
Okanogan,10/1/02,53047,10,2002,22164,20791,1,1373,6.20%
Pacific,10/1/02,53049,10,2002,8783,8071,1,712,8.10%
Pend Oreille,10/1/02,53051,10,2002,4638,4274,1,364,7.80%
Pierce,10/1/02,53053,10,2002,345108,319975,1,25133,7.30%
San Juan,10/1/02,53055,10,2002,7484,7098,1,386,5.20%
Skagit,10/1/02,53057,10,2002,52175,48396,1,3779,7.20%
Skamania,10/1/02,53059,10,2002,4647,4291,1,356,7.70%
Snohomish,10/1/02,53061,10,2002,329793,306787,1,23006,7.00%
Spokane,10/1/02,53063,10,2002,211724,197984,1,13740,6.50%
Stevens,10/1/02,53065,10,2002,17197,15886,1,1311,7.60%
Thurston,10/1/02,53067,10,2002,112199,105753,1,6446,5.70%
Wahkiakum,10/1/02,53069,10,2002,1518,1389,1,129,8.50%
Walla Walla,10/1/02,53071,10,2002,28799,27285,1,1514,5.30%
Whatcom,10/1/02,53073,10,2002,91720,86343,1,5377,5.90%
Whitman,10/1/02,53075,10,2002,19571,18777,1,794,4.10%
Yakima,10/1/02,53077,10,2002,119708,112405,1,7303,6.10%
Adams,10/1/03,53001,10,2003,9108,8617,1,491,5.40%
Asotin,10/1/03,53003,10,2003,9998,9328,1,670,6.70%
Clallam,10/1/03,53009,10,2003,27184,25178,1,2006,7.40%
Columbia,10/1/03,53013,10,2003,1459,1335,1,124,8.50%
Cowlitz,10/1/03,53015,10,2003,42513,38710,1,3803,8.90%
Douglas,10/1/03,53017,10,2003,19606,18520,1,1086,5.50%
Ferry,10/1/03,53019,10,2003,2917,2607,1,310,10.60%
Franklin,10/1/03,53021,10,2003,26523,24655,1,1868,7.00%
Garfield,10/1/03,53023,10,2003,1057,1001,1,56,5.30%
Grant,10/1/03,53025,10,2003,41506,38829,1,2677,6.40%
Grays Harbor,10/1/03,53027,10,2003,29671,27053,1,2618,8.80%
Island,10/1/03,53029,10,2003,30655,28490,1,2165,7.10%
Jefferson,10/1/03,53031,10,2003,13096,12247,1,849,6.50%
King,10/1/03,53033,10,2003,980990,924619,1,56371,5.70%
Kitsap,10/1/03,53035,10,2003,114794,107986,1,6808,5.90%
Kittitas,10/1/03,53037,10,2003,19610,18430,1,1180,6.00%
Klickitat,10/1/03,53039,10,2003,9631,8698,1,933,9.70%
Lewis,10/1/03,53041,10,2003,30164,27684,1,2480,8.20%
Lincoln,10/1/03,53043,10,2003,4657,4374,1,283,6.10%
Mason,10/1/03,53045,10,2003,23780,22001,1,1779,7.50%
Okanogan,10/1/03,53047,10,2003,23253,21850,1,1403,6.00%
Pacific,10/1/03,53049,10,2003,9073,8334,1,739,8.10%
Pend Oreille,10/1/03,53051,10,2003,4836,4409,1,427,8.80%
Pierce,10/1/03,53053,10,2003,350260,323789,1,26471,7.60%
San Juan,10/1/03,53055,10,2003,7722,7329,1,393,5.10%
Skagit,10/1/03,53057,10,2003,53486,49571,1,3915,7.30%
Skamania,10/1/03,53059,10,2003,4734,4308,1,426,9.00%
Snohomish,10/1/03,53061,10,2003,333512,310721,1,22791,6.80%
Spokane,10/1/03,53063,10,2003,215606,201295,1,14311,6.60%
Stevens,10/1/03,53065,10,2003,17494,16166,1,1328,7.60%
Thurston,10/1/03,53067,10,2003,115679,108757,1,6922,6.00%
Wahkiakum,10/1/03,53069,10,2003,1602,1474,1,128,8.00%
Walla Walla,10/1/03,53071,10,2003,29338,27749,1,1589,5.40%
Whatcom,10/1/03,53073,10,2003,95333,89500,1,5833,6.10%
Whitman,10/1/03,53075,10,2003,20242,19419,1,823,4.10%
Yakima,10/1/03,53077,10,2003,118318,109965,1,8353,7.10%
Adams,10/1/04,53001,10,2004,8828,8427,1,401,4.50%
Asotin,10/1/04,53003,10,2004,10197,9632,1,565,5.50%
Clallam,10/1/04,53009,10,2004,28415,26703,1,1712,6.00%
Columbia,10/1/04,53013,10,2004,1470,1360,1,110,7.50%
Cowlitz,10/1/04,53015,10,2004,42190,39071,1,3119,7.40%
Douglas,10/1/04,53017,10,2004,20520,19592,1,928,4.50%
Ferry,10/1/04,53019,10,2004,2996,2766,1,230,7.70%
Franklin,10/1/04,53021,10,2004,28496,26909,1,1587,5.60%
Garfield,10/1/04,53023,10,2004,1049,999,1,50,4.80%
Grant,10/1/04,53025,10,2004,40663,38478,1,2185,5.40%
Grays Harbor,10/1/04,53027,10,2004,31072,28779,1,2293,7.40%
Island,10/1/04,53029,10,2004,31635,29671,1,1964,6.20%
Jefferson,10/1/04,53031,10,2004,13360,12641,1,719,5.40%
King,10/1/04,53033,10,2004,991382,944028,1,47354,4.80%
Kitsap,10/1/04,53035,10,2004,118830,112585,1,6245,5.30%
Kittitas,10/1/04,53037,10,2004,19485,18497,1,988,5.10%
Klickitat,10/1/04,53039,10,2004,9502,8873,1,629,6.60%
Lewis,10/1/04,53041,10,2004,30514,28319,1,2195,7.20%
Lincoln,10/1/04,53043,10,2004,4701,4444,1,257,5.50%
Mason,10/1/04,53045,10,2004,24519,22996,1,1523,6.20%
Okanogan,10/1/04,53047,10,2004,22351,21157,1,1194,5.30%
Pacific,10/1/04,53049,10,2004,9133,8521,1,612,6.70%
Pend Oreille,10/1/04,53051,10,2004,5011,4675,1,336,6.70%
Pierce,10/1/04,53053,10,2004,361175,339000,1,22175,6.10%
San Juan,10/1/04,53055,10,2004,8143,7800,1,343,4.20%
Skagit,10/1/04,53057,10,2004,55169,51884,1,3285,6.00%
Skamania,10/1/04,53059,10,2004,4905,4582,1,323,6.60%
Snohomish,10/1/04,53061,10,2004,335883,318734,1,17149,5.10%
Spokane,10/1/04,53063,10,2004,220354,208417,1,11937,5.40%
Stevens,10/1/04,53065,10,2004,17875,16700,1,1175,6.60%
Thurston,10/1/04,53067,10,2004,119197,112981,1,6216,5.20%
Wahkiakum,10/1/04,53069,10,2004,1564,1464,1,100,6.40%
Walla Walla,10/1/04,53071,10,2004,29733,28315,1,1418,4.80%
Whatcom,10/1/04,53073,10,2004,99892,94712,1,5180,5.20%
Whitman,10/1/04,53075,10,2004,20974,20189,1,785,3.70%
Yakima,10/1/04,53077,10,2004,122179,115298,1,6881,5.60%
Adams,10/1/05,53001,10,2005,8778,8377,1,401,4.60%
Asotin,10/1/05,53003,10,2005,10657,10101,1,556,5.20%
Clallam,10/1/05,53009,10,2005,29433,27613,1,1820,6.20%
Columbia,10/1/05,53013,10,2005,1480,1354,1,126,8.50%
Cowlitz,10/1/05,53015,10,2005,43020,39999,1,3021,7.00%
Douglas,10/1/05,53017,10,2005,21198,20329,1,869,4.10%
Ferry,10/1/05,53019,10,2005,2951,2734,1,217,7.40%
Franklin,10/1/05,53021,10,2005,29115,27442,1,1673,5.70%
Garfield,10/1/05,53023,10,2005,1019,970,1,49,4.80%
Grant,10/1/05,53025,10,2005,41703,39499,1,2204,5.30%
Grays Harbor,10/1/05,53027,10,2005,31004,28777,1,2227,7.20%
Island,10/1/05,53029,10,2005,31991,30193,1,1798,5.60%
Jefferson,10/1/05,53031,10,2005,13599,12869,1,730,5.40%
King,10/1/05,53033,10,2005,1017793,975239,1,42554,4.20%
Kitsap,10/1/05,53035,10,2005,121831,115743,1,6088,5.00%
Kittitas,10/1/05,53037,10,2005,20052,19082,1,970,4.80%
Klickitat,10/1/05,53039,10,2005,9635,9044,1,591,6.10%
Lewis,10/1/05,53041,10,2005,30574,28438,1,2136,7.00%
Lincoln,10/1/05,53043,10,2005,4631,4365,1,266,5.70%
Mason,10/1/05,53045,10,2005,24561,23104,1,1457,5.90%
Okanogan,10/1/05,53047,10,2005,23161,22008,1,1153,5.00%
Pacific,10/1/05,53049,10,2005,9041,8410,1,631,7.00%
Pend Oreille,10/1/05,53051,10,2005,5003,4670,1,333,6.70%
Pierce,10/1/05,53053,10,2005,370778,350358,1,20420,5.50%
San Juan,10/1/05,53055,10,2005,7973,7635,1,338,4.20%
Skagit,10/1/05,53057,10,2005,56640,53711,1,2929,5.20%
Skamania,10/1/05,53059,10,2005,5002,4693,1,309,6.20%
Snohomish,10/1/05,53061,10,2005,347920,332310,1,15610,4.50%
Spokane,10/1/05,53063,10,2005,225964,214394,1,11570,5.10%
Stevens,10/1/05,53065,10,2005,17750,16594,1,1156,6.50%
Thurston,10/1/05,53067,10,2005,122375,116494,1,5881,4.80%
Wahkiakum,10/1/05,53069,10,2005,1614,1509,1,105,6.50%
Walla Walla,10/1/05,53071,10,2005,29830,28331,1,1499,5.00%
Whatcom,10/1/05,53073,10,2005,103132,98395,1,4737,4.60%
Whitman,10/1/05,53075,10,2005,21070,20226,1,844,4.00%
Yakima,10/1/05,53077,10,2005,124105,117363,1,6742,5.40%
Adams,10/1/06,53001,10,2006,8738,8395,1,343,3.90%
Asotin,10/1/06,53003,10,2006,10109,9723,1,386,3.80%
Clallam,10/1/06,53009,10,2006,29527,27932,1,1595,5.40%
Columbia,10/1/06,53013,10,2006,1441,1337,1,104,7.20%
Cowlitz,10/1/06,53015,10,2006,42837,40040,1,2797,6.50%
Douglas,10/1/06,53017,10,2006,20898,20142,1,756,3.60%
Ferry,10/1/06,53019,10,2006,2947,2742,1,205,7.00%
Franklin,10/1/06,53021,10,2006,30151,28515,1,1636,5.40%
Garfield,10/1/06,53023,10,2006,1024,976,1,48,4.70%
Grant,10/1/06,53025,10,2006,42299,40381,1,1918,4.50%
Grays Harbor,10/1/06,53027,10,2006,30808,28637,1,2171,7.00%
Island,10/1/06,53029,10,2006,32227,30623,1,1604,5.00%
Jefferson,10/1/06,53031,10,2006,13614,12955,1,659,4.80%
King,10/1/06,53033,10,2006,1045679,1008010,1,37669,3.60%
Kitsap,10/1/06,53035,10,2006,121634,116143,1,5491,4.50%
Kittitas,10/1/06,53037,10,2006,20290,19433,1,857,4.20%
Klickitat,10/1/06,53039,10,2006,9662,9173,1,489,5.10%
Lewis,10/1/06,53041,10,2006,30691,28741,1,1950,6.40%
Lincoln,10/1/06,53043,10,2006,4631,4393,1,238,5.10%
Mason,10/1/06,53045,10,2006,25707,24353,1,1354,5.30%
Okanogan,10/1/06,53047,10,2006,22720,21604,1,1116,4.90%
Pacific,10/1/06,53049,10,2006,9031,8449,1,582,6.40%
Pend Oreille,10/1/06,53051,10,2006,5129,4832,1,297,5.80%
Pierce,10/1/06,53053,10,2006,375010,356645,1,18365,4.90%
San Juan,10/1/06,53055,10,2006,8101,7820,1,281,3.50%
Skagit,10/1/06,53057,10,2006,56263,53658,1,2605,4.60%
Skamania,10/1/06,53059,10,2006,5040,4759,1,281,5.60%
Snohomish,10/1/06,53061,10,2006,358560,344411,1,14149,3.90%
Spokane,10/1/06,53063,10,2006,228619,218393,1,10226,4.50%
Stevens,10/1/06,53065,10,2006,17925,16891,1,1034,5.80%
Thurston,10/1/06,53067,10,2006,124506,119039,1,5467,4.40%
Wahkiakum,10/1/06,53069,10,2006,1605,1497,1,108,6.70%
Walla Walla,10/1/06,53071,10,2006,29532,28252,1,1280,4.30%
Whatcom,10/1/06,53073,10,2006,103372,99029,1,4343,4.20%
Whitman,10/1/06,53075,10,2006,21128,20363,1,765,3.60%
Yakima,10/1/06,53077,10,2006,124709,118449,1,6260,5.00%
Adams,10/1/07,53001,10,2007,8994,8661,1,333,3.70%
Asotin,10/1/07,53003,10,2007,10201,9793,1,408,4.00%
Clallam,10/1/07,53009,10,2007,30266,28477,1,1789,5.90%
Columbia,10/1/07,53013,10,2007,1458,1362,1,96,6.60%
Cowlitz,10/1/07,53015,10,2007,44047,41055,1,2992,6.80%
Douglas,10/1/07,53017,10,2007,21905,21014,1,891,4.10%
Ferry,10/1/07,53019,10,2007,3006,2822,1,184,6.10%
Franklin,10/1/07,53021,10,2007,32963,31337,1,1626,4.90%
Garfield,10/1/07,53023,10,2007,981,932,1,49,5.00%
Grant,10/1/07,53025,10,2007,44108,42159,1,1949,4.40%
Grays Harbor,10/1/07,53027,10,2007,31674,29471,1,2203,7.00%
Island,10/1/07,53029,10,2007,33123,31451,1,1672,5.00%
Jefferson,10/1/07,53031,10,2007,13908,13246,1,662,4.80%
King,10/1/07,53033,10,2007,1068644,1035802,1,32842,3.10%
Kitsap,10/1/07,53035,10,2007,123746,118051,1,5695,4.60%
Kittitas,10/1/07,53037,10,2007,21144,20206,1,938,4.40%
Klickitat,10/1/07,53039,10,2007,9819,9264,1,555,5.70%
Lewis,10/1/07,53041,10,2007,30722,28659,1,2063,6.70%
Lincoln,10/1/07,53043,10,2007,4604,4352,1,252,5.50%
Mason,10/1/07,53045,10,2007,25858,24353,1,1505,5.80%
Okanogan,10/1/07,53047,10,2007,22869,21816,1,1053,4.60%
Pacific,10/1/07,53049,10,2007,9218,8595,1,623,6.80%
Pend Oreille,10/1/07,53051,10,2007,5278,4933,1,345,6.50%
Pierce,10/1/07,53053,10,2007,392358,372970,1,19388,4.90%
San Juan,10/1/07,53055,10,2007,8354,8054,1,300,3.60%
Skagit,10/1/07,53057,10,2007,58237,55514,1,2723,4.70%
Skamania,10/1/07,53059,10,2007,5028,4737,1,291,5.80%
Snohomish,10/1/07,53061,10,2007,363598,351351,1,12247,3.40%
Spokane,10/1/07,53063,10,2007,236200,225133,1,11067,4.70%
Stevens,10/1/07,53065,10,2007,18397,17240,1,1157,6.30%
Thurston,10/1/07,53067,10,2007,129111,123216,1,5895,4.60%
Wahkiakum,10/1/07,53069,10,2007,1636,1533,1,103,6.30%
Walla Walla,10/1/07,53071,10,2007,30065,28789,1,1276,4.20%
Whatcom,10/1/07,53073,10,2007,107704,103199,1,4505,4.20%
Whitman,10/1/07,53075,10,2007,21038,20222,1,816,3.90%
Yakima,10/1/07,53077,10,2007,126031,119966,1,6065,4.80%
Adams,10/1/08,53001,10,2008,8890,8510,1,380,4.30%
Asotin,10/1/08,53003,10,2008,10308,9645,1,663,6.40%
Clallam,10/1/08,53009,10,2008,29924,27906,1,2018,6.70%
Columbia,10/1/08,53013,10,2008,1561,1453,1,108,6.90%
Cowlitz,10/1/08,53015,10,2008,44052,40420,1,3632,8.20%
Douglas,10/1/08,53017,10,2008,22599,21655,1,944,4.20%
Ferry,10/1/08,53019,10,2008,2989,2768,1,221,7.40%
Franklin,10/1/08,53021,10,2008,34871,33095,1,1776,5.10%
Garfield,10/1/08,53023,10,2008,1010,963,1,47,4.70%
Grant,10/1/08,53025,10,2008,44363,42168,1,2195,4.90%
Grays Harbor,10/1/08,53027,10,2008,32140,29541,1,2599,8.10%
Island,10/1/08,53029,10,2008,33018,31128,1,1890,5.70%
Jefferson,10/1/08,53031,10,2008,13480,12714,1,766,5.70%
King,10/1/08,53033,10,2008,1091712,1041836,1,49876,4.60%
Kitsap,10/1/08,53035,10,2008,124657,118138,1,6519,5.20%
Kittitas,10/1/08,53037,10,2008,21572,20367,1,1205,5.60%
Klickitat,10/1/08,53039,10,2008,10321,9695,1,626,6.10%
Lewis,10/1/08,53041,10,2008,31167,28763,1,2404,7.70%
Lincoln,10/1/08,53043,10,2008,4893,4655,1,238,4.90%
Mason,10/1/08,53045,10,2008,26299,24444,1,1855,7.10%
Okanogan,10/1/08,53047,10,2008,24314,23149,1,1165,4.80%
Pacific,10/1/08,53049,10,2008,9161,8393,1,768,8.40%
Pend Oreille,10/1/08,53051,10,2008,5562,5109,1,453,8.10%
Pierce,10/1/08,53053,10,2008,396391,372514,1,23877,6.00%
San Juan,10/1/08,53055,10,2008,8648,8335,1,313,3.60%
Skagit,10/1/08,53057,10,2008,58704,55348,1,3356,5.70%
Skamania,10/1/08,53059,10,2008,5086,4700,1,386,7.60%
Snohomish,10/1/08,53061,10,2008,374163,353835,1,20328,5.40%
Spokane,10/1/08,53063,10,2008,240236,227288,1,12948,5.40%
Stevens,10/1/08,53065,10,2008,18578,17214,1,1364,7.30%
Thurston,10/1/08,53067,10,2008,131971,125040,1,6931,5.30%
Wahkiakum,10/1/08,53069,10,2008,1754,1629,1,125,7.10%
Walla Walla,10/1/08,53071,10,2008,32365,30960,1,1405,4.30%
Whatcom,10/1/08,53073,10,2008,108253,102807,1,5446,5.00%
Whitman,10/1/08,53075,10,2008,21844,20971,1,873,4.00%
Yakima,10/1/08,53077,10,2008,131559,124654,1,6905,5.20%
Adams,10/1/09,53001,10,2009,8764,8095,1,669,7.60%
Asotin,10/1/09,53003,10,2009,10257,9298,1,959,9.30%
Clallam,10/1/09,53009,10,2009,30131,27089,1,3042,10.10%
Columbia,10/1/09,53013,10,2009,1560,1395,1,165,10.60%
Cowlitz,10/1/09,53015,10,2009,44844,38645,1,6199,13.80%
Douglas,10/1/09,53017,10,2009,22890,21257,1,1633,7.10%
Ferry,10/1/09,53019,10,2009,3074,2688,1,386,12.60%
Franklin,10/1/09,53021,10,2009,37362,34591,1,2771,7.40%
Garfield,10/1/09,53023,10,2009,997,929,1,68,6.80%
Grant,10/1/09,53025,10,2009,44900,40780,1,4120,9.20%
Grays Harbor,10/1/09,53027,10,2009,31369,27187,1,4182,13.30%
Island,10/1/09,53029,10,2009,32644,29498,1,3146,9.60%
Jefferson,10/1/09,53031,10,2009,13076,11894,1,1182,9.00%
King,10/1/09,53033,10,2009,1115239,1012599,1,102640,9.20%
Kitsap,10/1/09,53035,10,2009,124688,114525,1,10163,8.20%
Kittitas,10/1/09,53037,10,2009,21645,19754,1,1891,8.70%
Klickitat,10/1/09,53039,10,2009,10959,9965,1,994,9.10%
Lewis,10/1/09,53041,10,2009,31490,27281,1,4209,13.40%
Lincoln,10/1/09,53043,10,2009,4835,4420,1,415,8.60%
Mason,10/1/09,53045,10,2009,26644,23696,1,2948,11.10%
Okanogan,10/1/09,53047,10,2009,25913,23854,1,2059,7.90%
Pacific,10/1/09,53049,10,2009,9123,7962,1,1161,12.70%
Pend Oreille,10/1/09,53051,10,2009,5432,4682,1,750,13.80%
Pierce,10/1/09,53053,10,2009,394555,353986,1,40569,10.30%
San Juan,10/1/09,53055,10,2009,8222,7659,1,563,6.80%
Skagit,10/1/09,53057,10,2009,58434,52142,1,6292,10.80%
Skamania,10/1/09,53059,10,2009,5054,4403,1,651,12.90%
Snohomish,10/1/09,53061,10,2009,382577,341937,1,40640,10.60%
Spokane,10/1/09,53063,10,2009,238915,216405,1,22510,9.40%
Stevens,10/1/09,53065,10,2009,18618,16333,1,2285,12.30%
Thurston,10/1/09,53067,10,2009,130616,119748,1,10868,8.30%
Wahkiakum,10/1/09,53069,10,2009,1585,1369,1,216,13.60%
Walla Walla,10/1/09,53071,10,2009,32488,30385,1,2103,6.50%
Whatcom,10/1/09,53073,10,2009,107052,97569,1,9483,8.90%
Whitman,10/1/09,53075,10,2009,22116,20790,1,1326,6.00%
Yakima,10/1/09,53077,10,2009,132652,122325,1,10327,7.80%
Adams,10/1/10,53001,10,2010,8808,8132,1,676,7.70%
Asotin,10/1/10,53003,10,2010,10131,9288,1,843,8.30%
Clallam,10/1/10,53009,10,2010,29189,26252,1,2937,10.10%
Columbia,10/1/10,53013,10,2010,1942,1786,1,156,8.00%
Cowlitz,10/1/10,53015,10,2010,45632,40337,1,5295,11.60%
Douglas,10/1/10,53017,10,2010,20210,18629,1,1581,7.80%
Ferry,10/1/10,53019,10,2010,2556,2182,1,374,14.60%
Franklin,10/1/10,53021,10,2010,39391,36700,1,2691,6.80%
Garfield,10/1/10,53023,10,2010,1040,971,1,69,6.60%
Grant,10/1/10,53025,10,2010,45584,41894,1,3690,8.10%
Grays Harbor,10/1/10,53027,10,2010,30274,26473,1,3801,12.60%
Island,10/1/10,53029,10,2010,33225,30416,1,2809,8.50%
Jefferson,10/1/10,53031,10,2010,12313,11139,1,1174,9.50%
King,10/1/10,53033,10,2010,1096612,999898,1,96714,8.80%
Kitsap,10/1/10,53035,10,2010,118845,109449,1,9396,7.90%
Kittitas,10/1/10,53037,10,2010,21839,20079,1,1760,8.10%
Klickitat,10/1/10,53039,10,2010,10321,9311,1,1010,9.80%
Lewis,10/1/10,53041,10,2010,33533,29611,1,3922,11.70%
Lincoln,10/1/10,53043,10,2010,5287,4911,1,376,7.10%
Mason,10/1/10,53045,10,2010,25209,22552,1,2657,10.50%
Okanogan,10/1/10,53047,10,2010,24324,22490,1,1834,7.50%
Pacific,10/1/10,53049,10,2010,8576,7477,1,1099,12.80%
Pend Oreille,10/1/10,53051,10,2010,4977,4353,1,624,12.50%
Pierce,10/1/10,53053,10,2010,391042,353938,1,37104,9.50%
San Juan,10/1/10,53055,10,2010,8131,7588,1,543,6.70%
Skagit,10/1/10,53057,10,2010,58450,52697,1,5753,9.80%
Skamania,10/1/10,53059,10,2010,5090,4540,1,550,10.80%
Snohomish,10/1/10,53061,10,2010,383391,343524,1,39867,10.40%
Spokane,10/1/10,53063,10,2010,235754,214934,1,20820,8.80%
Stevens,10/1/10,53065,10,2010,18642,16558,1,2084,11.20%
Thurston,10/1/10,53067,10,2010,125074,114760,1,10314,8.20%
Wahkiakum,10/1/10,53069,10,2010,1466,1254,1,212,14.50%
Walla Walla,10/1/10,53071,10,2010,31448,29365,1,2083,6.60%
Whatcom,10/1/10,53073,10,2010,103021,94266,1,8755,8.50%
Whitman,10/1/10,53075,10,2010,23170,21781,1,1389,6.00%
Yakima,10/1/10,53077,10,2010,128573,118395,1,10178,7.90%
Adams,10/1/11,53001,10,2011,8714,8104,1,610,7.00%
Asotin,10/1/11,53003,10,2011,9941,9160,1,781,7.90%
Clallam,10/1/11,53009,10,2011,28029,25195,1,2834,10.10%
Columbia,10/1/11,53013,10,2011,1854,1710,1,144,7.80%
Cowlitz,10/1/11,53015,10,2011,44300,39394,1,4906,11.10%
Douglas,10/1/11,53017,10,2011,20034,18524,1,1510,7.50%
Ferry,10/1/11,53019,10,2011,2473,2085,1,388,15.70%
Franklin,10/1/11,53021,10,2011,39699,36482,1,3217,8.10%
Garfield,10/1/11,53023,10,2011,1009,940,1,69,6.80%
Grant,10/1/11,53025,10,2011,44725,41197,1,3528,7.90%
Grays Harbor,10/1/11,53027,10,2011,29497,25623,1,3874,13.10%
Island,10/1/11,53029,10,2011,32416,29691,1,2725,8.40%
Jefferson,10/1/11,53031,10,2011,11732,10571,1,1161,9.90%
King,10/1/11,53033,10,2011,1107481,1024463,1,83018,7.50%
Kitsap,10/1/11,53035,10,2011,116000,106714,1,9286,8.00%
Kittitas,10/1/11,53037,10,2011,21403,19700,1,1703,8.00%
Klickitat,10/1/11,53039,10,2011,10389,9337,1,1052,10.10%
Lewis,10/1/11,53041,10,2011,32298,28480,1,3818,11.80%
Lincoln,10/1/11,53043,10,2011,5236,4859,1,377,7.20%
Mason,10/1/11,53045,10,2011,24100,21504,1,2596,10.80%
Okanogan,10/1/11,53047,10,2011,23121,21375,1,1746,7.60%
Pacific,10/1/11,53049,10,2011,8053,7035,1,1018,12.60%
Pend Oreille,10/1/11,53051,10,2011,4787,4190,1,597,12.50%
Pierce,10/1/11,53053,10,2011,385531,348675,1,36856,9.60%
San Juan,10/1/11,53055,10,2011,7779,7265,1,514,6.60%
Skagit,10/1/11,53057,10,2011,57246,51921,1,5325,9.30%
Skamania,10/1/11,53059,10,2011,5046,4510,1,536,10.60%
Snohomish,10/1/11,53061,10,2011,382951,349319,1,33632,8.80%
Spokane,10/1/11,53063,10,2011,230207,210146,1,20061,8.70%
Stevens,10/1/11,53065,10,2011,18029,16059,1,1970,10.90%
Thurston,10/1/11,53067,10,2011,122170,111708,1,10462,8.60%
Wahkiakum,10/1/11,53069,10,2011,1403,1225,1,178,12.70%
Walla Walla,10/1/11,53071,10,2011,30181,28131,1,2050,6.80%
Whatcom,10/1/11,53073,10,2011,102118,93769,1,8349,8.20%
Whitman,10/1/11,53075,10,2011,22902,21575,1,1327,5.80%
Yakima,10/1/11,53077,10,2011,126324,115233,1,11091,8.80%
Adams,10/1/12,53001,10,2012,8631,8068,1,563,6.50%
Asotin,10/1/12,53003,10,2012,9757,9097,1,660,6.80%
Clallam,10/1/12,53009,10,2012,27795,25212,1,2583,9.30%
Clark,10/1/12,53011,10,2012,208501,190434,1,18067,8.70%
Columbia,10/1/12,53013,10,2012,1814,1687,1,127,7.00%
Cowlitz,10/1/12,53015,10,2012,44079,39737,1,4342,9.90%
Douglas,10/1/12,53017,10,2012,19553,18159,1,1394,7.10%
Ferry,10/1/12,53019,10,2012,2358,2056,1,302,12.80%
Franklin,10/1/12,53021,10,2012,39683,36575,1,3108,7.80%
Garfield,10/1/12,53023,10,2012,989,916,1,73,7.40%
Grant,10/1/12,53025,10,2012,46244,42935,1,3309,7.20%
Grays Harbor,10/1/12,53027,10,2012,28596,25288,1,3308,11.60%
Island,10/1/12,53029,10,2012,32025,29695,1,2330,7.30%
Jefferson,10/1/12,53031,10,2012,11702,10650,1,1052,9.00%
King,10/1/12,53033,10,2012,1124048,1060354,1,63694,5.70%
Kitsap,10/1/12,53035,10,2012,115010,106766,1,8244,7.20%
Kittitas,10/1/12,53037,10,2012,20936,19425,1,1511,7.20%
Klickitat,10/1/12,53039,10,2012,10067,9209,1,858,8.50%
Lewis,10/1/12,53041,10,2012,31969,28502,1,3467,10.80%
Lincoln,10/1/12,53043,10,2012,5207,4882,1,325,6.20%
Mason,10/1/12,53045,10,2012,23846,21576,1,2270,9.50%
Okanogan,10/1/12,53047,10,2012,22269,20695,1,1574,7.10%
Pacific,10/1/12,53049,10,2012,8006,7111,1,895,11.20%
Pend Oreille,10/1/12,53051,10,2012,4727,4218,1,509,10.80%
Pierce,10/1/12,53053,10,2012,385569,352653,1,32916,8.50%
San Juan,10/1/12,53055,10,2012,7833,7398,1,435,5.60%
Skagit,10/1/12,53057,10,2012,57340,52455,1,4885,8.50%
Skamania,10/1/12,53059,10,2012,4987,4518,1,469,9.40%
Snohomish,10/1/12,53061,10,2012,385573,360108,1,25465,6.60%
Spokane,10/1/12,53063,10,2012,229941,211660,1,18281,8.00%
Stevens,10/1/12,53065,10,2012,17978,16149,1,1829,10.20%
Thurston,10/1/12,53067,10,2012,123031,113650,1,9381,7.60%
Wahkiakum,10/1/12,53069,10,2012,1348,1183,1,165,12.20%
Walla Walla,10/1/12,53071,10,2012,30381,28503,1,1878,6.20%
Whatcom,10/1/12,53073,10,2012,102157,94713,1,7444,7.30%
Whitman,10/1/12,53075,10,2012,23260,21979,1,1281,5.50%
Yakima,10/1/12,53077,10,2012,126559,116302,1,10257,8.10%
Adams,10/1/13,53001,10,2013,8681,8176,1,505,5.80%
Asotin,10/1/13,53003,10,2013,9695,9127,1,568,5.90%
Clallam,10/1/13,53009,10,2013,27060,24615,1,2445,9.00%
Clark,10/1/13,53011,10,2013,207865,191584,1,16281,7.80%
Columbia,10/1/13,53013,10,2013,1739,1624,1,115,6.60%
Cowlitz,10/1/13,53015,10,2013,43228,39383,1,3845,8.90%
Douglas,10/1/13,53017,10,2013,19843,18557,1,1286,6.50%
Ferry,10/1/13,53019,10,2013,2464,2181,1,283,11.50%
Franklin,10/1/13,53021,10,2013,38684,35801,1,2883,7.50%
Garfield,10/1/13,53023,10,2013,945,885,1,60,6.30%
Grant,10/1/13,53025,10,2013,45258,42297,1,2961,6.50%
Grays Harbor,10/1/13,53027,10,2013,27499,24416,1,3083,11.20%
Island,10/1/13,53029,10,2013,31621,29327,1,2294,7.30%
Jefferson,10/1/13,53031,10,2013,11260,10252,1,1008,9.00%
King,10/1/13,53033,10,2013,1134301,1075844,1,58457,5.20%
Kitsap,10/1/13,53035,10,2013,113151,105489,1,7662,6.80%
Kittitas,10/1/13,53037,10,2013,20477,19117,1,1360,6.60%
Klickitat,10/1/13,53039,10,2013,9704,8931,1,773,8.00%
Lewis,10/1/13,53041,10,2013,31248,28259,1,2989,9.60%
Lincoln,10/1/13,53043,10,2013,5040,4733,1,307,6.10%
Mason,10/1/13,53045,10,2013,23633,21494,1,2139,9.10%
Okanogan,10/1/13,53047,10,2013,22124,20672,1,1452,6.60%
Pacific,10/1/13,53049,10,2013,7975,7111,1,864,10.80%
Pend Oreille,10/1/13,53051,10,2013,4605,4134,1,471,10.20%
Pierce,10/1/13,53053,10,2013,382682,352580,1,30102,7.90%
San Juan,10/1/13,53055,10,2013,7598,7197,1,401,5.30%
Skagit,10/1/13,53057,10,2013,56888,52474,1,4414,7.80%
Skamania,10/1/13,53059,10,2013,4991,4540,1,451,9.00%
Snohomish,10/1/13,53061,10,2013,387779,365244,1,22535,5.80%
Spokane,10/1/13,53063,10,2013,226280,209879,1,16401,7.20%
Stevens,10/1/13,53065,10,2013,17452,15832,1,1620,9.30%
Thurston,10/1/13,53067,10,2013,122121,113371,1,8750,7.20%
Wahkiakum,10/1/13,53069,10,2013,1274,1153,1,121,9.50%
Walla Walla,10/1/13,53071,10,2013,28779,27040,1,1739,6.00%
Whatcom,10/1/13,53073,10,2013,101452,94679,1,6773,6.70%
Whitman,10/1/13,53075,10,2013,22703,21497,1,1206,5.30%
Yakima,10/1/13,53077,10,2013,123825,114375,1,9450,7.60%
Adams,10/1/14,53001,10,2014,8517,8062,1,455,5.30%
Asotin,10/1/14,53003,10,2014,9759,9311,1,448,4.60%
Clallam,10/1/14,53009,10,2014,26686,24581,1,2105,7.90%
Clark,10/1/14,53011,10,2014,211194,197518,1,13676,6.50%
Columbia,10/1/14,53013,10,2014,1760,1640,1,120,6.80%
Cowlitz,10/1/14,53015,10,2014,44157,40876,1,3281,7.40%
Douglas,10/1/14,53017,10,2014,19937,18826,1,1111,5.60%
Ferry,10/1/14,53019,10,2014,2417,2186,1,231,9.60%
Franklin,10/1/14,53021,10,2014,38140,35594,1,2546,6.70%
Garfield,10/1/14,53023,10,2014,953,899,1,54,5.70%
Grant,10/1/14,53025,10,2014,46998,44332,1,2666,5.70%
Grays Harbor,10/1/14,53027,10,2014,27255,24710,1,2545,9.30%
Island,10/1/14,53029,10,2014,31888,29875,1,2013,6.30%
Jefferson,10/1/14,53031,10,2014,11123,10284,1,839,7.50%
King,10/1/14,53033,10,2014,1164528,1112715,1,51813,4.40%
Kitsap,10/1/14,53035,10,2014,114616,107973,1,6643,5.80%
Kittitas,10/1/14,53037,10,2014,21367,20131,1,1236,5.80%
Klickitat,10/1/14,53039,10,2014,9793,9199,1,594,6.10%
Lewis,10/1/14,53041,10,2014,30601,28076,1,2525,8.30%
Lincoln,10/1/14,53043,10,2014,4915,4650,1,265,5.40%
Mason,10/1/14,53045,10,2014,23593,21809,1,1784,7.60%
Okanogan,10/1/14,53047,10,2014,22354,21171,1,1183,5.30%
Pacific,10/1/14,53049,10,2014,7905,7166,1,739,9.30%
Pend Oreille,10/1/14,53051,10,2014,4552,4176,1,376,8.30%
Pierce,10/1/14,53053,10,2014,388833,363556,1,25277,6.50%
San Juan,10/1/14,53055,10,2014,7646,7296,1,350,4.60%
Skagit,10/1/14,53057,10,2014,56736,53019,1,3717,6.60%
Skamania,10/1/14,53059,10,2014,4965,4610,1,355,7.20%
Snohomish,10/1/14,53061,10,2014,397612,378377,1,19235,4.80%
Spokane,10/1/14,53063,10,2014,227407,213348,1,14059,6.20%
Stevens,10/1/14,53065,10,2014,17347,15989,1,1358,7.80%
Thurston,10/1/14,53067,10,2014,124899,117343,1,7556,6.00%
Wahkiakum,10/1/14,53069,10,2014,1284,1171,1,113,8.80%
Walla Walla,10/1/14,53071,10,2014,29635,28152,1,1483,5.00%
Whatcom,10/1/14,53073,10,2014,102065,95970,1,6095,6.00%
Whitman,10/1/14,53075,10,2014,23073,22001,1,1072,4.60%
Yakima,10/1/14,53077,10,2014,125543,117500,1,8043,6.40%
Adams,10/1/15,53001,10,2015,8692,8219,1,473,5.40%
Asotin,10/1/15,53003,10,2015,9739,9305,1,434,4.50%
Clallam,10/1/15,53009,10,2015,26734,24753,1,1981,7.40%
Clark,10/1/15,53011,10,2015,216458,203842,1,12616,5.80%
Columbia,10/1/15,53013,10,2015,1705,1605,1,100,5.90%
Cowlitz,10/1/15,53015,10,2015,44118,40924,1,3194,7.20%
Douglas,10/1/15,53017,10,2015,20167,19113,1,1054,5.20%
Ferry,10/1/15,53019,10,2015,2493,2271,1,222,8.90%
Franklin,10/1/15,53021,10,2015,38666,36263,1,2403,6.20%
Garfield,10/1/15,53023,10,2015,897,848,1,49,5.50%
Grant,10/1/15,53025,10,2015,45263,42559,1,2704,6.00%
Grays Harbor,10/1/15,53027,10,2015,26880,24659,1,2221,8.30%
Island,10/1/15,53029,10,2015,31692,29836,1,1856,5.90%
Jefferson,10/1/15,53031,10,2015,11088,10343,1,745,6.70%
King,10/1/15,53033,10,2015,1183815,1134381,1,49434,4.20%
Kitsap,10/1/15,53035,10,2015,116099,110053,1,6046,5.20%
Kittitas,10/1/15,53037,10,2015,21213,20085,1,1128,5.30%
Klickitat,10/1/15,53039,10,2015,9446,8877,1,569,6.00%
Lewis,10/1/15,53041,10,2015,31370,29013,1,2357,7.50%
Lincoln,10/1/15,53043,10,2015,4854,4602,1,252,5.20%
Mason,10/1/15,53045,10,2015,23421,21683,1,1738,7.40%
Okanogan,10/1/15,53047,10,2015,21458,20218,1,1240,5.80%
Pacific,10/1/15,53049,10,2015,8007,7329,1,678,8.50%
Pend Oreille,10/1/15,53051,10,2015,4581,4190,1,391,8.50%
Pierce,10/1/15,53053,10,2015,395075,371302,1,23773,6.00%
San Juan,10/1/15,53055,10,2015,7513,7172,1,341,4.50%
Skagit,10/1/15,53057,10,2015,56469,52934,1,3535,6.30%
Skamania,10/1/15,53059,10,2015,4942,4631,1,311,6.30%
Snohomish,10/1/15,53061,10,2015,404218,385904,1,18314,4.50%
Spokane,10/1/15,53063,10,2015,229627,216099,1,13528,5.90%
Stevens,10/1/15,53065,10,2015,17351,16074,1,1277,7.40%
Thurston,10/1/15,53067,10,2015,127084,120073,1,7011,5.50%
Wahkiakum,10/1/15,53069,10,2015,1298,1189,1,109,8.40%
Walla Walla,10/1/15,53071,10,2015,29315,27943,1,1372,4.70%
Whatcom,10/1/15,53073,10,2015,104980,99164,1,5816,5.50%
Whitman,10/1/15,53075,10,2015,23786,22765,1,1021,4.30%
Yakima,10/1/15,53077,10,2015,123559,115390,1,8169,6.60%
Adams,10/1/16,53001,10,2016,8954,8535,1,419,4.70%
Asotin,10/1/16,53003,10,2016,10105,9658,1,447,4.40%
Clallam,10/1/16,53009,10,2016,27275,25453,1,1822,6.70%
Clark,10/1/16,53011,10,2016,223180,210891,1,12289,5.50%
Columbia,10/1/16,53013,10,2016,1716,1616,1,100,5.80%
Cowlitz,10/1/16,53015,10,2016,45241,42317,1,2924,6.50%
Douglas,10/1/16,53017,10,2016,21118,19997,1,1121,5.30%
Ferry,10/1/16,53019,10,2016,2492,2291,1,201,8.10%
Franklin,10/1/16,53021,10,2016,39528,37272,1,2256,5.70%
Garfield,10/1/16,53023,10,2016,905,859,1,46,5.10%
Grant,10/1/16,53025,10,2016,45339,42975,1,2364,5.20%
Grays Harbor,10/1/16,53027,10,2016,27430,25399,1,2031,7.40%
Island,10/1/16,53029,10,2016,32974,31184,1,1790,5.40%
Jefferson,10/1/16,53031,10,2016,11495,10729,1,766,6.70%
King,10/1/16,53033,10,2016,1214261,1168417,1,45844,3.80%
Kitsap,10/1/16,53035,10,2016,118746,112605,1,6141,5.20%
Kittitas,10/1/16,53037,10,2016,22035,20941,1,1094,5.00%
Klickitat,10/1/16,53039,10,2016,9818,9254,1,564,5.70%
Lewis,10/1/16,53041,10,2016,32119,29964,1,2155,6.70%
Lincoln,10/1/16,53043,10,2016,4807,4576,1,231,4.80%
Mason,10/1/16,53045,10,2016,23960,22328,1,1632,6.80%
Okanogan,10/1/16,53047,10,2016,21557,20486,1,1071,5.00%
Pacific,10/1/16,53049,10,2016,8335,7737,1,598,7.20%
Pend Oreille,10/1/16,53051,10,2016,4660,4321,1,339,7.30%
Pierce,10/1/16,53053,10,2016,409632,387379,1,22253,5.40%
San Juan,10/1/16,53055,10,2016,7641,7318,1,323,4.20%
Skagit,10/1/16,53057,10,2016,58561,55205,1,3356,5.70%
Skamania,10/1/16,53059,10,2016,5126,4807,1,319,6.20%
Snohomish,10/1/16,53061,10,2016,416002,398832,1,17170,4.10%
Spokane,10/1/16,53063,10,2016,237603,225256,1,12347,5.20%
Stevens,10/1/16,53065,10,2016,17902,16727,1,1175,6.60%
Thurston,10/1/16,53067,10,2016,131522,124859,1,6663,5.10%
Wahkiakum,10/1/16,53069,10,2016,1290,1192,1,98,7.60%
Walla Walla,10/1/16,53071,10,2016,29652,28347,1,1305,4.40%
Whatcom,10/1/16,53073,10,2016,107760,102156,1,5604,5.20%
Whitman,10/1/16,53075,10,2016,24177,23112,1,1065,4.40%
Yakima,10/1/16,53077,10,2016,130347,123086,1,7261,5.60%
Adams,10/1/17,53001,10,2017,9272,8925,1,347,3.70%
Asotin,10/1/17,53003,10,2017,10282,9927,1,355,3.50%
Clallam,10/1/17,53009,10,2017,27689,26076,1,1613,5.80%
Clark,10/1/17,53011,10,2017,229288,218981,1,10307,4.50%
Columbia,10/1/17,53013,10,2017,1791,1707,1,84,4.70%
Cowlitz,10/1/17,53015,10,2017,45609,43185,1,2424,5.30%
Douglas,10/1/17,53017,10,2017,21520,20626,1,894,4.20%
Ferry,10/1/17,53019,10,2017,2507,2271,1,236,9.40%
Franklin,10/1/17,53021,10,2017,40556,38560,1,1996,4.90%
Garfield,10/1/17,53023,10,2017,909,860,1,49,5.40%
Grant,10/1/17,53025,10,2017,46291,44237,1,2054,4.40%
Grays Harbor,10/1/17,53027,10,2017,28025,26299,1,1726,6.20%
Island,10/1/17,53029,10,2017,34033,32355,1,1678,4.90%
Jefferson,10/1/17,53031,10,2017,12094,11415,1,679,5.60%
King,10/1/17,53033,10,2017,1234963,1192645,1,42318,3.40%
Kitsap,10/1/17,53035,10,2017,120897,115522,1,5375,4.40%
Kittitas,10/1/17,53037,10,2017,22842,21826,1,1016,4.40%
Klickitat,10/1/17,53039,10,2017,9821,9362,1,459,4.70%
Lewis,10/1/17,53041,10,2017,33240,31343,1,1897,5.70%
Lincoln,10/1/17,53043,10,2017,4908,4699,1,209,4.30%
Mason,10/1/17,53045,10,2017,24356,22985,1,1371,5.60%
Okanogan,10/1/17,53047,10,2017,21325,20300,1,1025,4.80%
Pacific,10/1/17,53049,10,2017,8249,7727,1,522,6.30%
Pend Oreille,10/1/17,53051,10,2017,4721,4438,1,283,6.00%
Pierce,10/1/17,53053,10,2017,418303,397975,1,20328,4.90%
San Juan,10/1/17,53055,10,2017,8114,7828,1,286,3.50%
Skagit,10/1/17,53057,10,2017,59864,57068,1,2796,4.70%
Skamania,10/1/17,53059,10,2017,5307,5041,1,266,5.00%
Snohomish,10/1/17,53061,10,2017,422896,406848,1,16048,3.80%
Spokane,10/1/17,53063,10,2017,241272,230242,1,11030,4.60%
Stevens,10/1/17,53065,10,2017,18055,16999,1,1056,5.80%
Thurston,10/1/17,53067,10,2017,135548,129433,1,6115,4.50%
Wahkiakum,10/1/17,53069,10,2017,1322,1237,1,85,6.40%
Walla Walla,10/1/17,53071,10,2017,29849,28591,1,1258,4.20%
Whatcom,10/1/17,53073,10,2017,110506,105705,1,4801,4.30%
Whitman,10/1/17,53075,10,2017,24155,23209,1,946,3.90%
Yakima,10/1/17,53077,10,2017,130864,124660,1,6204,4.70%
Adams,10/1/18,53001,10,2018,9481,9103,1,378,4.00%
Asotin,10/1/18,53003,10,2018,10329,9940,1,389,3.80%
Clallam,10/1/18,53009,10,2018,28341,26709,1,1632,5.80%
Clark,10/1/18,53011,10,2018,237504,226835,1,10669,4.50%
Columbia,10/1/18,53013,10,2018,1834,1750,1,84,4.60%
Cowlitz,10/1/18,53015,10,2018,47089,44570,1,2519,5.30%
Douglas,10/1/18,53017,10,2018,21948,20974,1,974,4.40%
Ferry,10/1/18,53019,10,2018,2616,2410,1,206,7.90%
Franklin,10/1/18,53021,10,2018,41615,39579,1,2036,4.90%
Garfield,10/1/18,53023,10,2018,913,867,1,46,5.00%
Grant,10/1/18,53025,10,2018,47384,45095,1,2289,4.80%
Grays Harbor,10/1/18,53027,10,2018,28509,26720,1,1789,6.30%
Island,10/1/18,53029,10,2018,35181,33455,1,1726,4.90%
Jefferson,10/1/18,53031,10,2018,12523,11895,1,628,5.00%
King,10/1/18,53033,10,2018,1262536,1223228,1,39308,3.10%
Kitsap,10/1/18,53035,10,2018,125697,120239,1,5458,4.30%
Kittitas,10/1/18,53037,10,2018,22784,21699,1,1085,4.80%
Klickitat,10/1/18,53039,10,2018,10031,9533,1,498,5.00%
Lewis,10/1/18,53041,10,2018,34353,32429,1,1924,5.60%
Lincoln,10/1/18,53043,10,2018,5096,4879,1,217,4.30%
Mason,10/1/18,53045,10,2018,25275,23822,1,1453,5.70%
Okanogan,10/1/18,53047,10,2018,20685,19639,1,1046,5.10%
Pacific,10/1/18,53049,10,2018,8315,7768,1,547,6.60%
Pend Oreille,10/1/18,53051,10,2018,4902,4600,1,302,6.20%
Pierce,10/1/18,53053,10,2018,432638,411905,1,20733,4.80%
San Juan,10/1/18,53055,10,2018,8435,8133,1,302,3.60%
Skagit,10/1/18,53057,10,2018,61864,58866,1,2998,4.80%
Skamania,10/1/18,53059,10,2018,5439,5171,1,268,4.90%
Snohomish,10/1/18,53061,10,2018,429942,415528,1,14414,3.40%
Spokane,10/1/18,53063,10,2018,249501,237972,1,11529,4.60%
Stevens,10/1/18,53065,10,2018,18514,17470,1,1044,5.60%
Thurston,10/1/18,53067,10,2018,140534,134322,1,6212,4.40%
Wahkiakum,10/1/18,53069,10,2018,1375,1288,1,87,6.30%
Walla Walla,10/1/18,53071,10,2018,30964,29692,1,1272,4.10%
Whatcom,10/1/18,53073,10,2018,113500,108511,1,4989,4.40%
Whitman,10/1/18,53075,10,2018,24767,23727,1,1040,4.20%
Yakima,10/1/18,53077,10,2018,133753,126968,1,6785,5.10%
Adams,10/1/19,53001,10,2019,10414,10025,1,389,3.70%
Asotin,10/1/19,53003,10,2019,10609,10250,1,359,3.40%
Clallam,10/1/19,53009,10,2019,29300,27703,1,1597,5.50%
Clark,10/1/19,53011,10,2019,244960,234661,1,10299,4.20%
Columbia,10/1/19,53013,10,2019,1883,1800,1,83,4.40%
Cowlitz,10/1/19,53015,10,2019,48321,45832,1,2489,5.20%
Douglas,10/1/19,53017,10,2019,22452,21534,1,918,4.10%
Ferry,10/1/19,53019,10,2019,2413,2200,1,213,8.80%
Franklin,10/1/19,53021,10,2019,43354,41360,1,1994,4.60%
Garfield,10/1/19,53023,10,2019,945,902,1,43,4.60%
Grant,10/1/19,53025,10,2019,47617,45227,1,2390,5.00%
Grays Harbor,10/1/19,53027,10,2019,29248,27518,1,1730,5.90%
Island,10/1/19,53029,10,2019,36951,35358,1,1593,4.30%
Jefferson,10/1/19,53031,10,2019,13304,12681,1,623,4.70%
King,10/1/19,53033,10,2019,1290236,1256592,1,33644,2.60%
Kitsap,10/1/19,53035,10,2019,130423,125361,1,5062,3.90%
Kittitas,10/1/19,53037,10,2019,24612,23542,1,1070,4.30%
Klickitat,10/1/19,53039,10,2019,10417,9945,1,472,4.50%
Lewis,10/1/19,53041,10,2019,35291,33470,1,1821,5.20%
Lincoln,10/1/19,53043,10,2019,5022,4812,1,210,4.20%
Mason,10/1/19,53045,10,2019,26530,25169,1,1361,5.10%
Okanogan,10/1/19,53047,10,2019,20564,19604,1,960,4.70%
Pacific,10/1/19,53049,10,2019,8636,8110,1,526,6.10%
Pend Oreille,10/1/19,53051,10,2019,5144,4793,1,351,6.80%
Pierce,10/1/19,53053,10,2019,448395,428436,1,19959,4.50%
San Juan,10/1/19,53055,10,2019,8751,8471,1,280,3.20%
Skagit,10/1/19,53057,10,2019,63801,60862,1,2939,4.60%
Skamania,10/1/19,53059,10,2019,5602,5357,1,245,4.40%
Snohomish,10/1/19,53061,10,2019,439529,426954,1,12575,2.90%
Spokane,10/1/19,53063,10,2019,258979,248088,1,10891,4.20%
Stevens,10/1/19,53065,10,2019,19167,18194,1,973,5.10%
Thurston,10/1/19,53067,10,2019,145859,139729,1,6130,4.20%
Wahkiakum,10/1/19,53069,10,2019,1389,1306,1,83,6.00%
Walla Walla,10/1/19,53071,10,2019,31865,30626,1,1239,3.90%
Whatcom,10/1/19,53073,10,2019,116357,111328,1,5029,4.30%
Whitman,10/1/19,53075,10,2019,25031,24041,1,990,4.00%
Yakima,10/1/19,53077,10,2019,137142,130792,1,6350,4.60%
Adams,11/1/90,53001,11,1990,7393,6363,1,1030,13.90%
Asotin,11/1/90,53003,11,1990,9727,9119,1,608,6.30%
Clallam,11/1/90,53009,11,1990,23121,21076,1,2045,8.80%
Columbia,11/1/90,53013,11,1990,1156,929,1,227,19.60%
Cowlitz,11/1/90,53015,11,1990,38079,35329,1,2750,7.20%
Douglas,11/1/90,53017,11,1990,14751,13386,1,1365,9.30%
Ferry,11/1/90,53019,11,1990,2722,2461,1,261,9.60%
Franklin,11/1/90,53021,11,1990,19002,16453,1,2549,13.40%
Garfield,11/1/90,53023,11,1990,974,938,1,36,3.70%
Grant,11/1/90,53025,11,1990,26247,23521,1,2726,10.40%
Grays Harbor,11/1/90,53027,11,1990,27413,24315,1,3098,11.30%
Island,11/1/90,53029,11,1990,23251,22460,1,791,3.40%
Jefferson,11/1/90,53031,11,1990,8606,8083,1,523,6.10%
King,11/1/90,53033,11,1990,852712,822623,1,30089,3.50%
Kitsap,11/1/90,53035,11,1990,85409,81795,1,3614,4.20%
Kittitas,11/1/90,53037,11,1990,12806,11782,1,1024,8.00%
Klickitat,11/1/90,53039,11,1990,7815,6914,1,901,11.50%
Lewis,11/1/90,53041,11,1990,26815,24477,1,2338,8.70%
Lincoln,11/1/90,53043,11,1990,3932,3729,1,203,5.20%
Mason,11/1/90,53045,11,1990,17375,16477,1,898,5.20%
Okanogan,11/1/90,53047,11,1990,17403,15313,1,2090,12.00%
Pacific,11/1/90,53049,11,1990,7385,6572,1,813,11.00%
Pend Oreille,11/1/90,53051,11,1990,3364,2879,1,485,14.40%
Pierce,11/1/90,53053,11,1990,280656,266199,1,14457,5.20%
San Juan,11/1/90,53055,11,1990,4905,4754,1,151,3.10%
Skagit,11/1/90,53057,11,1990,39184,36012,1,3172,8.10%
Skamania,11/1/90,53059,11,1990,3911,3568,1,343,8.80%
Snohomish,11/1/90,53061,11,1990,248857,238415,1,10442,4.20%
Spokane,11/1/90,53063,11,1990,176292,166612,1,9680,5.50%
Stevens,11/1/90,53065,11,1990,13510,12293,1,1217,9.00%
Thurston,11/1/90,53067,11,1990,81895,77728,1,4167,5.10%
Wahkiakum,11/1/90,53069,11,1990,1477,1379,1,98,6.60%
Walla Walla,11/1/90,53071,11,1990,23973,22344,1,1629,6.80%
Whatcom,11/1/90,53073,11,1990,69178,65473,1,3705,5.40%
Whitman,11/1/90,53075,11,1990,17566,17252,1,314,1.80%
Yakima,11/1/90,53077,11,1990,97877,84323,1,13554,13.80%
Adams,11/1/91,53001,11,1991,7704,6220,1,1484,19.30%
Asotin,11/1/91,53003,11,1991,9765,9132,1,633,6.50%
Clallam,11/1/91,53009,11,1991,22844,21094,1,1750,7.70%
Columbia,11/1/91,53013,11,1991,1108,916,1,192,17.30%
Cowlitz,11/1/91,53015,11,1991,37997,34515,1,3482,9.20%
Douglas,11/1/91,53017,11,1991,15317,13945,1,1372,9.00%
Ferry,11/1/91,53019,11,1991,2713,2400,1,313,11.50%
Franklin,11/1/91,53021,11,1991,19687,17019,1,2668,13.60%
Garfield,11/1/91,53023,11,1991,956,931,1,25,2.60%
Grant,11/1/91,53025,11,1991,27800,24784,1,3016,10.80%
Grays Harbor,11/1/91,53027,11,1991,26916,23598,1,3318,12.30%
Island,11/1/91,53029,11,1991,23300,22169,1,1131,4.90%
Jefferson,11/1/91,53031,11,1991,8229,7628,1,601,7.30%
King,11/1/91,53033,11,1991,868143,823649,1,44494,5.10%
Kitsap,11/1/91,53035,11,1991,87111,82613,1,4498,5.20%
Kittitas,11/1/91,53037,11,1991,12885,11607,1,1278,9.90%
Klickitat,11/1/91,53039,11,1991,7718,6842,1,876,11.40%
Lewis,11/1/91,53041,11,1991,26457,23844,1,2613,9.90%
Lincoln,11/1/91,53043,11,1991,3861,3651,1,210,5.40%
Mason,11/1/91,53045,11,1991,16940,15757,1,1183,7.00%
Okanogan,11/1/91,53047,11,1991,18956,16612,1,2344,12.40%
Pacific,11/1/91,53049,11,1991,7826,6998,1,828,10.60%
Pend Oreille,11/1/91,53051,11,1991,3489,3069,1,420,12.00%
Pierce,11/1/91,53053,11,1991,280109,262615,1,17494,6.20%
San Juan,11/1/91,53055,11,1991,5116,4893,1,223,4.40%
Skagit,11/1/91,53057,11,1991,41565,37659,1,3906,9.40%
Skamania,11/1/91,53059,11,1991,4042,3532,1,510,12.60%
Snohomish,11/1/91,53061,11,1991,257861,242557,1,15304,5.90%
Spokane,11/1/91,53063,11,1991,179722,169135,1,10587,5.90%
Stevens,11/1/91,53065,11,1991,14052,12793,1,1259,9.00%
Thurston,11/1/91,53067,11,1991,83697,78642,1,5055,6.00%
Wahkiakum,11/1/91,53069,11,1991,1537,1447,1,90,5.90%
Walla Walla,11/1/91,53071,11,1991,23840,21887,1,1953,8.20%
Whatcom,11/1/91,53073,11,1991,71498,66844,1,4654,6.50%
Whitman,11/1/91,53075,11,1991,17689,17359,1,330,1.90%
Yakima,11/1/91,53077,11,1991,98295,83768,1,14527,14.80%
Adams,11/1/92,53001,11,1992,7675,6192,1,1483,19.30%
Asotin,11/1/92,53003,11,1992,10176,9630,1,546,5.40%
Clallam,11/1/92,53009,11,1992,23456,21377,1,2079,8.90%
Columbia,11/1/92,53013,11,1992,1191,987,1,204,17.10%
Cowlitz,11/1/92,53015,11,1992,38333,34321,1,4012,10.50%
Douglas,11/1/92,53017,11,1992,15652,14151,1,1501,9.60%
Ferry,11/1/92,53019,11,1992,2841,2499,1,342,12.00%
Franklin,11/1/92,53021,11,1992,20426,17606,1,2820,13.80%
Garfield,11/1/92,53023,11,1992,1012,971,1,41,4.10%
Grant,11/1/92,53025,11,1992,28826,25594,1,3232,11.20%
Grays Harbor,11/1/92,53027,11,1992,28414,24547,1,3867,13.60%
Island,11/1/92,53029,11,1992,24551,23133,1,1418,5.80%
Jefferson,11/1/92,53031,11,1992,8768,7947,1,821,9.40%
King,11/1/92,53033,11,1992,900718,843268,1,57450,6.40%
Kitsap,11/1/92,53035,11,1992,90512,85137,1,5375,5.90%
Kittitas,11/1/92,53037,11,1992,13772,12040,1,1732,12.60%
Klickitat,11/1/92,53039,11,1992,7815,6762,1,1053,13.50%
Lewis,11/1/92,53041,11,1992,27957,25066,1,2891,10.30%
Lincoln,11/1/92,53043,11,1992,4089,3866,1,223,5.50%
Mason,11/1/92,53045,11,1992,17068,15761,1,1307,7.70%
Okanogan,11/1/92,53047,11,1992,18990,16318,1,2672,14.10%
Pacific,11/1/92,53049,11,1992,7772,6849,1,923,11.90%
Pend Oreille,11/1/92,53051,11,1992,3595,3163,1,432,12.00%
Pierce,11/1/92,53053,11,1992,292008,270727,1,21281,7.30%
San Juan,11/1/92,53055,11,1992,5202,4836,1,366,7.00%
Skagit,11/1/92,53057,11,1992,42230,37924,1,4306,10.20%
Skamania,11/1/92,53059,11,1992,3766,3126,1,640,17.00%
Snohomish,11/1/92,53061,11,1992,271646,252525,1,19121,7.00%
Spokane,11/1/92,53063,11,1992,185510,174239,1,11271,6.10%
Stevens,11/1/92,53065,11,1992,14713,13406,1,1307,8.90%
Thurston,11/1/92,53067,11,1992,87205,81408,1,5797,6.60%
Wahkiakum,11/1/92,53069,11,1992,1494,1377,1,117,7.80%
Walla Walla,11/1/92,53071,11,1992,24562,22627,1,1935,7.90%
Whatcom,11/1/92,53073,11,1992,74283,69016,1,5267,7.10%
Whitman,11/1/92,53075,11,1992,18104,17703,1,401,2.20%
Yakima,11/1/92,53077,11,1992,102727,86493,1,16234,15.80%
Adams,11/1/93,53001,11,1993,7676,6658,1,1018,13.30%
Asotin,11/1/93,53003,11,1993,10637,10256,1,381,3.60%
Clallam,11/1/93,53009,11,1993,23784,21641,1,2143,9.00%
Columbia,11/1/93,53013,11,1993,1235,1041,1,194,15.70%
Cowlitz,11/1/93,53015,11,1993,38799,34833,1,3966,10.20%
Douglas,11/1/93,53017,11,1993,16477,15202,1,1275,7.70%
Ferry,11/1/93,53019,11,1993,2943,2572,1,371,12.60%
Franklin,11/1/93,53021,11,1993,21406,19089,1,2317,10.80%
Garfield,11/1/93,53023,11,1993,1042,985,1,57,5.50%
Grant,11/1/93,53025,11,1993,31091,27901,1,3190,10.30%
Grays Harbor,11/1/93,53027,11,1993,27971,23810,1,4161,14.90%
Island,11/1/93,53029,11,1993,24952,23467,1,1485,6.00%
Jefferson,11/1/93,53031,11,1993,9554,8790,1,764,8.00%
King,11/1/93,53033,11,1993,901811,852472,1,49339,5.50%
Kitsap,11/1/93,53035,11,1993,90396,84779,1,5617,6.20%
Kittitas,11/1/93,53037,11,1993,13845,12720,1,1125,8.10%
Klickitat,11/1/93,53039,11,1993,7959,7148,1,811,10.20%
Lewis,11/1/93,53041,11,1993,28612,25894,1,2718,9.50%
Lincoln,11/1/93,53043,11,1993,4412,4110,1,302,6.80%
Mason,11/1/93,53045,11,1993,18872,17385,1,1487,7.90%
Okanogan,11/1/93,53047,11,1993,20343,17969,1,2374,11.70%
Pacific,11/1/93,53049,11,1993,7754,6774,1,980,12.60%
Pend Oreille,11/1/93,53051,11,1993,3725,3310,1,415,11.10%
Pierce,11/1/93,53053,11,1993,303098,281582,1,21516,7.10%
San Juan,11/1/93,53055,11,1993,5192,4822,1,370,7.10%
Skagit,11/1/93,53057,11,1993,44204,39698,1,4506,10.20%
Skamania,11/1/93,53059,11,1993,4240,3795,1,445,10.50%
Snohomish,11/1/93,53061,11,1993,275159,259124,1,16035,5.80%
Spokane,11/1/93,53063,11,1993,191387,182124,1,9263,4.80%
Stevens,11/1/93,53065,11,1993,15350,14018,1,1332,8.70%
Thurston,11/1/93,53067,11,1993,90872,84798,1,6074,6.70%
Wahkiakum,11/1/93,53069,11,1993,1587,1477,1,110,6.90%
Walla Walla,11/1/93,53071,11,1993,24985,23664,1,1321,5.30%
Whatcom,11/1/93,53073,11,1993,77164,72038,1,5126,6.60%
Whitman,11/1/93,53075,11,1993,18949,18583,1,366,1.90%
Yakima,11/1/93,53077,11,1993,106366,92028,1,14338,13.50%
Adams,11/1/94,53001,11,1994,7483,6495,1,988,13.20%
Asotin,11/1/94,53003,11,1994,11192,10773,1,419,3.70%
Clallam,11/1/94,53009,11,1994,23905,21344,1,2561,10.70%
Columbia,11/1/94,53013,11,1994,1297,1084,1,213,16.40%
Cowlitz,11/1/94,53015,11,1994,40761,37616,1,3145,7.70%
Douglas,11/1/94,53017,11,1994,17491,16146,1,1345,7.70%
Ferry,11/1/94,53019,11,1994,2973,2596,1,377,12.70%
Franklin,11/1/94,53021,11,1994,22355,20077,1,2278,10.20%
Garfield,11/1/94,53023,11,1994,1016,956,1,60,5.90%
Grant,11/1/94,53025,11,1994,32138,28802,1,3336,10.40%
Grays Harbor,11/1/94,53027,11,1994,27951,24567,1,3384,12.10%
Island,11/1/94,53029,11,1994,26116,24500,1,1616,6.20%
Jefferson,11/1/94,53031,11,1994,9767,8920,1,847,8.70%
King,11/1/94,53033,11,1994,895839,855827,1,40012,4.50%
Kitsap,11/1/94,53035,11,1994,92705,86882,1,5823,6.30%
Kittitas,11/1/94,53037,11,1994,14909,13687,1,1222,8.20%
Klickitat,11/1/94,53039,11,1994,8361,7372,1,989,11.80%
Lewis,11/1/94,53041,11,1994,30039,27547,1,2492,8.30%
Lincoln,11/1/94,53043,11,1994,4443,4146,1,297,6.70%
Mason,11/1/94,53045,11,1994,18588,17081,1,1507,8.10%
Okanogan,11/1/94,53047,11,1994,20762,18351,1,2411,11.60%
Pacific,11/1/94,53049,11,1994,8200,7211,1,989,12.10%
Pend Oreille,11/1/94,53051,11,1994,3809,3330,1,479,12.60%
Pierce,11/1/94,53053,11,1994,315154,294947,1,20207,6.40%
San Juan,11/1/94,53055,11,1994,5310,4942,1,368,6.90%
Skagit,11/1/94,53057,11,1994,47593,42868,1,4725,9.90%
Skamania,11/1/94,53059,11,1994,4210,3752,1,458,10.90%
Snohomish,11/1/94,53061,11,1994,277506,264015,1,13491,4.90%
Spokane,11/1/94,53063,11,1994,200329,190368,1,9961,5.00%
Stevens,11/1/94,53065,11,1994,16631,15241,1,1390,8.40%
Thurston,11/1/94,53067,11,1994,94240,88241,1,5999,6.40%
Wahkiakum,11/1/94,53069,11,1994,1654,1455,1,199,12.00%
Walla Walla,11/1/94,53071,11,1994,26053,24534,1,1519,5.80%
Whatcom,11/1/94,53073,11,1994,77272,70997,1,6275,8.10%
Whitman,11/1/94,53075,11,1994,19132,18768,1,364,1.90%
Yakima,11/1/94,53077,11,1994,107836,92820,1,15016,13.90%
Adams,11/1/95,53001,11,1995,8469,7419,1,1050,12.40%
Asotin,11/1/95,53003,11,1995,11416,10953,1,463,4.10%
Clallam,11/1/95,53009,11,1995,24813,22621,1,2192,8.80%
Columbia,11/1/95,53013,11,1995,1259,1039,1,220,17.50%
Cowlitz,11/1/95,53015,11,1995,41427,38096,1,3331,8.00%
Douglas,11/1/95,53017,11,1995,17342,15758,1,1584,9.10%
Ferry,11/1/95,53019,11,1995,2973,2657,1,316,10.60%
Franklin,11/1/95,53021,11,1995,22221,19405,1,2816,12.70%
Garfield,11/1/95,53023,11,1995,990,942,1,48,4.80%
Grant,11/1/95,53025,11,1995,33851,30244,1,3607,10.70%
Grays Harbor,11/1/95,53027,11,1995,28565,25287,1,3278,11.50%
Island,11/1/95,53029,11,1995,26641,25128,1,1513,5.70%
Jefferson,11/1/95,53031,11,1995,9973,9188,1,785,7.90%
King,11/1/95,53033,11,1995,904104,858679,1,45425,5.00%
Kitsap,11/1/95,53035,11,1995,92092,85668,1,6424,7.00%
Kittitas,11/1/95,53037,11,1995,15528,14224,1,1304,8.40%
Klickitat,11/1/95,53039,11,1995,8562,7625,1,937,10.90%
Lewis,11/1/95,53041,11,1995,30369,27749,1,2620,8.60%
Lincoln,11/1/95,53043,11,1995,4579,4290,1,289,6.30%
Mason,11/1/95,53045,11,1995,19915,18456,1,1459,7.30%
Okanogan,11/1/95,53047,11,1995,21126,18435,1,2691,12.70%
Pacific,11/1/95,53049,11,1995,8479,7457,1,1022,12.10%
Pend Oreille,11/1/95,53051,11,1995,3975,3454,1,521,13.10%
Pierce,11/1/95,53053,11,1995,321172,301587,1,19585,6.10%
San Juan,11/1/95,53055,11,1995,5352,4929,1,423,7.90%
Skagit,11/1/95,53057,11,1995,49056,44376,1,4680,9.50%
Skamania,11/1/95,53059,11,1995,4018,3611,1,407,10.10%
Snohomish,11/1/95,53061,11,1995,283233,267175,1,16058,5.70%
Spokane,11/1/95,53063,11,1995,204676,193991,1,10685,5.20%
Stevens,11/1/95,53065,11,1995,16727,15210,1,1517,9.10%
Thurston,11/1/95,53067,11,1995,96354,90068,1,6286,6.50%
Wahkiakum,11/1/95,53069,11,1995,1680,1543,1,137,8.20%
Walla Walla,11/1/95,53071,11,1995,26726,25023,1,1703,6.40%
Whatcom,11/1/95,53073,11,1995,80591,74797,1,5794,7.20%
Whitman,11/1/95,53075,11,1995,19278,18891,1,387,2.00%
Yakima,11/1/95,53077,11,1995,109428,93375,1,16053,14.70%
Adams,11/1/96,53001,11,1996,8024,7038,1,986,12.30%
Asotin,11/1/96,53003,11,1996,12078,11647,1,431,3.60%
Clallam,11/1/96,53009,11,1996,24743,22693,1,2050,8.30%
Columbia,11/1/96,53013,11,1996,1244,1053,1,191,15.40%
Cowlitz,11/1/96,53015,11,1996,41760,38827,1,2933,7.00%
Douglas,11/1/96,53017,11,1996,18042,16722,1,1320,7.30%
Ferry,11/1/96,53019,11,1996,2835,2574,1,261,9.20%
Franklin,11/1/96,53021,11,1996,22418,19785,1,2633,11.70%
Garfield,11/1/96,53023,11,1996,1018,991,1,27,2.70%
Grant,11/1/96,53025,11,1996,35313,32009,1,3304,9.40%
Grays Harbor,11/1/96,53027,11,1996,28210,25235,1,2975,10.50%
Island,11/1/96,53029,11,1996,27619,26360,1,1259,4.60%
Jefferson,11/1/96,53031,11,1996,10044,9263,1,781,7.80%
King,11/1/96,53033,11,1996,941004,900751,1,40253,4.30%
Kitsap,11/1/96,53035,11,1996,97418,91810,1,5608,5.80%
Kittitas,11/1/96,53037,11,1996,15521,14616,1,905,5.80%
Klickitat,11/1/96,53039,11,1996,8750,7969,1,781,8.90%
Lewis,11/1/96,53041,11,1996,31401,28688,1,2713,8.60%
Lincoln,11/1/96,53043,11,1996,4851,4629,1,222,4.60%
Mason,11/1/96,53045,11,1996,20162,18747,1,1415,7.00%
Okanogan,11/1/96,53047,11,1996,21853,19562,1,2291,10.50%
Pacific,11/1/96,53049,11,1996,8347,7433,1,914,11.00%
Pend Oreille,11/1/96,53051,11,1996,4217,3568,1,649,15.40%
Pierce,11/1/96,53053,11,1996,330815,314388,1,16427,5.00%
San Juan,11/1/96,53055,11,1996,5284,4906,1,378,7.20%
Skagit,11/1/96,53057,11,1996,47604,43703,1,3901,8.20%
Skamania,11/1/96,53059,11,1996,3960,3612,1,348,8.80%
Snohomish,11/1/96,53061,11,1996,296922,283504,1,13418,4.50%
Spokane,11/1/96,53063,11,1996,209202,199783,1,9419,4.50%
Stevens,11/1/96,53065,11,1996,17352,15822,1,1530,8.80%
Thurston,11/1/96,53067,11,1996,99327,93627,1,5700,5.70%
Wahkiakum,11/1/96,53069,11,1996,1741,1647,1,94,5.40%
Walla Walla,11/1/96,53071,11,1996,26670,24827,1,1843,6.90%
Whatcom,11/1/96,53073,11,1996,80366,75358,1,5008,6.20%
Whitman,11/1/96,53075,11,1996,20186,19856,1,330,1.60%
Yakima,11/1/96,53077,11,1996,109463,96259,1,13204,12.10%
Adams,11/1/97,53001,11,1997,8190,7195,1,995,12.10%
Asotin,11/1/97,53003,11,1997,12757,12356,1,401,3.10%
Clallam,11/1/97,53009,11,1997,25188,23354,1,1834,7.30%
Columbia,11/1/97,53013,11,1997,1230,1049,1,181,14.70%
Cowlitz,11/1/97,53015,11,1997,42470,39757,1,2713,6.40%
Douglas,11/1/97,53017,11,1997,18511,17404,1,1107,6.00%
Ferry,11/1/97,53019,11,1997,2834,2602,1,232,8.20%
Franklin,11/1/97,53021,11,1997,22539,20283,1,2256,10.00%
Garfield,11/1/97,53023,11,1997,1029,980,1,49,4.80%
Grant,11/1/97,53025,11,1997,36302,33335,1,2967,8.20%
Grays Harbor,11/1/97,53027,11,1997,28600,26110,1,2490,8.70%
Island,11/1/97,53029,11,1997,29611,28642,1,969,3.30%
Jefferson,11/1/97,53031,11,1997,10169,9551,1,618,6.10%
King,11/1/97,53033,11,1997,972374,942126,1,30248,3.10%
Kitsap,11/1/97,53035,11,1997,96927,92274,1,4653,4.80%
Kittitas,11/1/97,53037,11,1997,15206,14456,1,750,4.90%
Klickitat,11/1/97,53039,11,1997,9087,8353,1,734,8.10%
Lewis,11/1/97,53041,11,1997,33379,31054,1,2325,7.00%
Lincoln,11/1/97,53043,11,1997,4809,4617,1,192,4.00%
Mason,11/1/97,53045,11,1997,22198,20969,1,1229,5.50%
Okanogan,11/1/97,53047,11,1997,22165,20006,1,2159,9.70%
Pacific,11/1/97,53049,11,1997,8910,8064,1,846,9.50%
Pend Oreille,11/1/97,53051,11,1997,4339,3898,1,441,10.20%
Pierce,11/1/97,53053,11,1997,342160,328639,1,13521,4.00%
San Juan,11/1/97,53055,11,1997,5589,5285,1,304,5.40%
Skagit,11/1/97,53057,11,1997,49146,46029,1,3117,6.30%
Skamania,11/1/97,53059,11,1997,4161,3800,1,361,8.70%
Snohomish,11/1/97,53061,11,1997,314999,304853,1,10146,3.20%
Spokane,11/1/97,53063,11,1997,214834,206841,1,7993,3.70%
Stevens,11/1/97,53065,11,1997,17708,16440,1,1268,7.20%
Thurston,11/1/97,53067,11,1997,103890,99137,1,4753,4.60%
Wahkiakum,11/1/97,53069,11,1997,1913,1804,1,109,5.70%
Walla Walla,11/1/97,53071,11,1997,27446,25845,1,1601,5.80%
Whatcom,11/1/97,53073,11,1997,82085,77943,1,4142,5.00%
Whitman,11/1/97,53075,11,1997,20596,20305,1,291,1.40%
Yakima,11/1/97,53077,11,1997,112221,101459,1,10762,9.60%
Adams,11/1/98,53001,11,1998,8423,7328,1,1095,13.00%
Asotin,11/1/98,53003,11,1998,13044,12607,1,437,3.40%
Clallam,11/1/98,53009,11,1998,25929,24033,1,1896,7.30%
Columbia,11/1/98,53013,11,1998,1292,1090,1,202,15.60%
Cowlitz,11/1/98,53015,11,1998,45676,42484,1,3192,7.00%
Douglas,11/1/98,53017,11,1998,19058,17814,1,1244,6.50%
Ferry,11/1/98,53019,11,1998,2756,2503,1,253,9.20%
Franklin,11/1/98,53021,11,1998,23834,20825,1,3009,12.60%
Garfield,11/1/98,53023,11,1998,989,946,1,43,4.30%
Grant,11/1/98,53025,11,1998,38392,34813,1,3579,9.30%
Grays Harbor,11/1/98,53027,11,1998,28454,25826,1,2628,9.20%
Island,11/1/98,53029,11,1998,30851,29889,1,962,3.10%
Jefferson,11/1/98,53031,11,1998,10376,9703,1,673,6.50%
King,11/1/98,53033,11,1998,978170,945772,1,32398,3.30%
Kitsap,11/1/98,53035,11,1998,96021,91628,1,4393,4.60%
Kittitas,11/1/98,53037,11,1998,15825,15177,1,648,4.10%
Klickitat,11/1/98,53039,11,1998,9011,8341,1,670,7.40%
Lewis,11/1/98,53041,11,1998,31802,29211,1,2591,8.10%
Lincoln,11/1/98,53043,11,1998,4898,4645,1,253,5.20%
Mason,11/1/98,53045,11,1998,22288,21075,1,1213,5.40%
Okanogan,11/1/98,53047,11,1998,22214,20011,1,2203,9.90%
Pacific,11/1/98,53049,11,1998,8463,7550,1,913,10.80%
Pend Oreille,11/1/98,53051,11,1998,4360,3952,1,408,9.40%
Pierce,11/1/98,53053,11,1998,352497,338489,1,14008,4.00%
San Juan,11/1/98,53055,11,1998,5861,5585,1,276,4.70%
Skagit,11/1/98,53057,11,1998,50040,46717,1,3323,6.60%
Skamania,11/1/98,53059,11,1998,4299,3880,1,419,9.70%
Snohomish,11/1/98,53061,11,1998,323360,312158,1,11202,3.50%
Spokane,11/1/98,53063,11,1998,221912,211352,1,10560,4.80%
Stevens,11/1/98,53065,11,1998,17827,16490,1,1337,7.50%
Thurston,11/1/98,53067,11,1998,107345,102829,1,4516,4.20%
Wahkiakum,11/1/98,53069,11,1998,1923,1802,1,121,6.30%
Walla Walla,11/1/98,53071,11,1998,28163,26154,1,2009,7.10%
Whatcom,11/1/98,53073,11,1998,83839,79615,1,4224,5.00%
Whitman,11/1/98,53075,11,1998,21012,20652,1,360,1.70%
Yakima,11/1/98,53077,11,1998,114864,102823,1,12041,10.50%
Adams,11/1/99,53001,11,1999,8019,7044,1,975,12.20%
Asotin,11/1/99,53003,11,1999,12705,12396,1,309,2.40%
Clallam,11/1/99,53009,11,1999,26150,24448,1,1702,6.50%
Columbia,11/1/99,53013,11,1999,1299,1122,1,177,13.60%
Cowlitz,11/1/99,53015,11,1999,43866,41263,1,2603,5.90%
Douglas,11/1/99,53017,11,1999,18889,17693,1,1196,6.30%
Ferry,11/1/99,53019,11,1999,2710,2480,1,230,8.50%
Franklin,11/1/99,53021,11,1999,23294,20967,1,2327,10.00%
Garfield,11/1/99,53023,11,1999,1057,1019,1,38,3.60%
Grant,11/1/99,53025,11,1999,37688,34475,1,3213,8.50%
Grays Harbor,11/1/99,53027,11,1999,26690,24571,1,2119,7.90%
Island,11/1/99,53029,11,1999,31412,30249,1,1163,3.70%
Jefferson,11/1/99,53031,11,1999,11216,10647,1,569,5.10%
King,11/1/99,53033,11,1999,978872,944387,1,34485,3.50%
Kitsap,11/1/99,53035,11,1999,98868,94361,1,4507,4.60%
Kittitas,11/1/99,53037,11,1999,15427,14783,1,644,4.20%
Klickitat,11/1/99,53039,11,1999,8869,8233,1,636,7.20%
Lewis,11/1/99,53041,11,1999,31333,28896,1,2437,7.80%
Lincoln,11/1/99,53043,11,1999,4589,4376,1,213,4.60%
Mason,11/1/99,53045,11,1999,21209,20063,1,1146,5.40%
Okanogan,11/1/99,53047,11,1999,21748,19784,1,1964,9.00%
Pacific,11/1/99,53049,11,1999,7832,7209,1,623,8.00%
Pend Oreille,11/1/99,53051,11,1999,4196,3876,1,320,7.60%
Pierce,11/1/99,53053,11,1999,348334,333829,1,14505,4.20%
San Juan,11/1/99,53055,11,1999,6400,6191,1,209,3.30%
Skagit,11/1/99,53057,11,1999,52305,49265,1,3040,5.80%
Skamania,11/1/99,53059,11,1999,4157,3850,1,307,7.40%
Snohomish,11/1/99,53061,11,1999,330723,315609,1,15114,4.60%
Spokane,11/1/99,53063,11,1999,223319,213650,1,9669,4.30%
Stevens,11/1/99,53065,11,1999,17296,16067,1,1229,7.10%
Thurston,11/1/99,53067,11,1999,107461,102932,1,4529,4.20%
Wahkiakum,11/1/99,53069,11,1999,1952,1835,1,117,6.00%
Walla Walla,11/1/99,53071,11,1999,28017,26549,1,1468,5.20%
Whatcom,11/1/99,53073,11,1999,85477,81566,1,3911,4.60%
Whitman,11/1/99,53075,11,1999,20513,20206,1,307,1.50%
Yakima,11/1/99,53077,11,1999,109116,98923,1,10193,9.30%
Adams,11/1/00,53001,11,2000,7898,7086,1,812,10.30%
Asotin,11/1/00,53003,11,2000,9448,8889,1,559,5.90%
Clallam,11/1/00,53009,11,2000,25468,23517,1,1951,7.70%
Columbia,11/1/00,53013,11,2000,1482,1338,1,144,9.70%
Cowlitz,11/1/00,53015,11,2000,42647,39734,1,2913,6.80%
Douglas,11/1/00,53017,11,2000,17051,15849,1,1202,7.00%
Ferry,11/1/00,53019,11,2000,2878,2603,1,275,9.60%
Franklin,11/1/00,53021,11,2000,22921,20693,1,2228,9.70%
Garfield,11/1/00,53023,11,2000,984,927,1,57,5.80%
Grant,11/1/00,53025,11,2000,34625,31456,1,3169,9.20%
Grays Harbor,11/1/00,53027,11,2000,28978,26454,1,2524,8.70%
Island,11/1/00,53029,11,2000,28625,27129,1,1496,5.20%
Jefferson,11/1/00,53031,11,2000,11538,10850,1,688,6.00%
King,11/1/00,53033,11,2000,984701,946661,1,38040,3.90%
Kitsap,11/1/00,53035,11,2000,105699,99880,1,5819,5.50%
Kittitas,11/1/00,53037,11,2000,17218,16209,1,1009,5.90%
Klickitat,11/1/00,53039,11,2000,9333,8601,1,732,7.80%
Lewis,11/1/00,53041,11,2000,29485,27040,1,2445,8.30%
Lincoln,11/1/00,53043,11,2000,4389,4137,1,252,5.70%
Mason,11/1/00,53045,11,2000,21441,19965,1,1476,6.90%
Okanogan,11/1/00,53047,11,2000,18924,17058,1,1866,9.90%
Pacific,11/1/00,53049,11,2000,8461,7762,1,699,8.30%
Pend Oreille,11/1/00,53051,11,2000,4507,4163,1,344,7.60%
Pierce,11/1/00,53053,11,2000,339746,321279,1,18467,5.40%
San Juan,11/1/00,53055,11,2000,7145,6803,1,342,4.80%
Skagit,11/1/00,53057,11,2000,50970,47703,1,3267,6.40%
Skamania,11/1/00,53059,11,2000,4832,4532,1,300,6.20%
Snohomish,11/1/00,53061,11,2000,322232,309000,1,13232,4.10%
Spokane,11/1/00,53063,11,2000,213068,200881,1,12187,5.70%
Stevens,11/1/00,53065,11,2000,17120,15785,1,1335,7.80%
Thurston,11/1/00,53067,11,2000,108134,102552,1,5582,5.20%
Wahkiakum,11/1/00,53069,11,2000,1608,1488,1,120,7.50%
Walla Walla,11/1/00,53071,11,2000,27846,26222,1,1624,5.80%
Whatcom,11/1/00,53073,11,2000,88616,83633,1,4983,5.60%
Whitman,11/1/00,53075,11,2000,19785,18960,1,825,4.20%
Yakima,11/1/00,53077,11,2000,107938,97913,1,10025,9.30%
Adams,11/1/01,53001,11,2001,7831,6970,1,861,11.00%
Asotin,11/1/01,53003,11,2001,9817,9215,1,602,6.10%
Clallam,11/1/01,53009,11,2001,25688,23495,1,2193,8.50%
Columbia,11/1/01,53013,11,2001,1448,1283,1,165,11.40%
Cowlitz,11/1/01,53015,11,2001,42340,37984,1,4356,10.30%
Douglas,11/1/01,53017,11,2001,16178,14818,1,1360,8.40%
Ferry,11/1/01,53019,11,2001,2794,2518,1,276,9.90%
Franklin,11/1/01,53021,11,2001,23445,21169,1,2276,9.70%
Garfield,11/1/01,53023,11,2001,1012,956,1,56,5.50%
Grant,11/1/01,53025,11,2001,34022,30628,1,3394,10.00%
Grays Harbor,11/1/01,53027,11,2001,28266,25384,1,2882,10.20%
Island,11/1/01,53029,11,2001,28995,26935,1,2060,7.10%
Jefferson,11/1/01,53031,11,2001,11997,11113,1,884,7.40%
King,11/1/01,53033,11,2001,986213,929642,1,56571,5.70%
Kitsap,11/1/01,53035,11,2001,106603,99512,1,7091,6.70%
Kittitas,11/1/01,53037,11,2001,17261,16111,1,1150,6.70%
Klickitat,11/1/01,53039,11,2001,8552,7572,1,980,11.50%
Lewis,11/1/01,53041,11,2001,29033,26363,1,2670,9.20%
Lincoln,11/1/01,53043,11,2001,4326,4033,1,293,6.80%
Mason,11/1/01,53045,11,2001,21383,19692,1,1691,7.90%
Okanogan,11/1/01,53047,11,2001,17340,15413,1,1927,11.10%
Pacific,11/1/01,53049,11,2001,8338,7549,1,789,9.50%
Pend Oreille,11/1/01,53051,11,2001,4692,4286,1,406,8.70%
Pierce,11/1/01,53053,11,2001,336026,311054,1,24972,7.40%
San Juan,11/1/01,53055,11,2001,6970,6554,1,416,6.00%
Skagit,11/1/01,53057,11,2001,50607,46339,1,4268,8.40%
Skamania,11/1/01,53059,11,2001,5025,4293,1,732,14.60%
Snohomish,11/1/01,53061,11,2001,327843,307614,1,20229,6.20%
Spokane,11/1/01,53063,11,2001,212758,197567,1,15191,7.10%
Stevens,11/1/01,53065,11,2001,16998,15321,1,1677,9.90%
Thurston,11/1/01,53067,11,2001,108323,101378,1,6945,6.40%
Wahkiakum,11/1/01,53069,11,2001,1547,1396,1,151,9.80%
Walla Walla,11/1/01,53071,11,2001,27988,26084,1,1904,6.80%
Whatcom,11/1/01,53073,11,2001,88732,82367,1,6365,7.20%
Whitman,11/1/01,53075,11,2001,19207,18350,1,857,4.50%
Yakima,11/1/01,53077,11,2001,103643,92168,1,11475,11.10%
Adams,11/1/02,53001,11,2002,7789,6929,1,860,11.00%
Asotin,11/1/02,53003,11,2002,10255,9579,1,676,6.60%
Clallam,11/1/02,53009,11,2002,26487,24284,1,2203,8.30%
Columbia,11/1/02,53013,11,2002,1451,1292,1,159,11.00%
Cowlitz,11/1/02,53015,11,2002,42348,38114,1,4234,10.00%
Douglas,11/1/02,53017,11,2002,17010,15760,1,1250,7.30%
Ferry,11/1/02,53019,11,2002,3008,2698,1,310,10.30%
Franklin,11/1/02,53021,11,2002,24700,22179,1,2521,10.20%
Garfield,11/1/02,53023,11,2002,1007,941,1,66,6.60%
Grant,11/1/02,53025,11,2002,35458,32064,1,3394,9.60%
Grays Harbor,11/1/02,53027,11,2002,29405,26644,1,2761,9.40%
Island,11/1/02,53029,11,2002,30479,28335,1,2144,7.00%
Jefferson,11/1/02,53031,11,2002,12577,11599,1,978,7.80%
King,11/1/02,53033,11,2002,977267,914845,1,62422,6.40%
Kitsap,11/1/02,53035,11,2002,112740,105424,1,7316,6.50%
Kittitas,11/1/02,53037,11,2002,18630,17432,1,1198,6.40%
Klickitat,11/1/02,53039,11,2002,9283,8321,1,962,10.40%
Lewis,11/1/02,53041,11,2002,30255,27565,1,2690,8.90%
Lincoln,11/1/02,53043,11,2002,4480,4166,1,314,7.00%
Mason,11/1/02,53045,11,2002,23072,21228,1,1844,8.00%
Okanogan,11/1/02,53047,11,2002,17782,15875,1,1907,10.70%
Pacific,11/1/02,53049,11,2002,8675,7849,1,826,9.50%
Pend Oreille,11/1/02,53051,11,2002,4668,4250,1,418,9.00%
Pierce,11/1/02,53053,11,2002,349608,322607,1,27001,7.70%
San Juan,11/1/02,53055,11,2002,7276,6829,1,447,6.10%
Skagit,11/1/02,53057,11,2002,51913,47669,1,4244,8.20%
Skamania,11/1/02,53059,11,2002,4716,4310,1,406,8.60%
Snohomish,11/1/02,53061,11,2002,330267,306210,1,24057,7.30%
Spokane,11/1/02,53063,11,2002,214427,199370,1,15057,7.00%
Stevens,11/1/02,53065,11,2002,17203,15694,1,1509,8.80%
Thurston,11/1/02,53067,11,2002,113412,106348,1,7064,6.20%
Wahkiakum,11/1/02,53069,11,2002,1540,1388,1,152,9.90%
Walla Walla,11/1/02,53071,11,2002,28400,26560,1,1840,6.50%
Whatcom,11/1/02,53073,11,2002,93033,87089,1,5944,6.40%
Whitman,11/1/02,53075,11,2002,19822,18922,1,900,4.50%
Yakima,11/1/02,53077,11,2002,108287,97375,1,10912,10.10%
Adams,11/1/03,53001,11,2003,7683,6860,1,823,10.70%
Asotin,11/1/03,53003,11,2003,10066,9328,1,738,7.30%
Clallam,11/1/03,53009,11,2003,27437,25209,1,2228,8.10%
Columbia,11/1/03,53013,11,2003,1427,1281,1,146,10.20%
Cowlitz,11/1/03,53015,11,2003,43085,39057,1,4028,9.30%
Douglas,11/1/03,53017,11,2003,17910,16510,1,1400,7.80%
Ferry,11/1/03,53019,11,2003,2960,2605,1,355,12.00%
Franklin,11/1/03,53021,11,2003,26532,23596,1,2936,11.10%
Garfield,11/1/03,53023,11,2003,1058,996,1,62,5.90%
Grant,11/1/03,53025,11,2003,36096,32477,1,3619,10.00%
Grays Harbor,11/1/03,53027,11,2003,30232,27446,1,2786,9.20%
Island,11/1/03,53029,11,2003,31130,28769,1,2361,7.60%
Jefferson,11/1/03,53031,11,2003,13169,12268,1,901,6.80%
King,11/1/03,53033,11,2003,988630,931752,1,56878,5.80%
Kitsap,11/1/03,53035,11,2003,117129,109894,1,7235,6.20%
Kittitas,11/1/03,53037,11,2003,19242,17857,1,1385,7.20%
Klickitat,11/1/03,53039,11,2003,9121,8076,1,1045,11.50%
Lewis,11/1/03,53041,11,2003,30768,28038,1,2730,8.90%
Lincoln,11/1/03,53043,11,2003,4665,4334,1,331,7.10%
Mason,11/1/03,53045,11,2003,24207,22333,1,1874,7.70%
Okanogan,11/1/03,53047,11,2003,18839,17082,1,1757,9.30%
Pacific,11/1/03,53049,11,2003,8969,8125,1,844,9.40%
Pend Oreille,11/1/03,53051,11,2003,4935,4469,1,466,9.40%
Pierce,11/1/03,53053,11,2003,357728,329522,1,28206,7.90%
San Juan,11/1/03,53055,11,2003,7603,7165,1,438,5.80%
Skagit,11/1/03,53057,11,2003,53673,49363,1,4310,8.00%
Skamania,11/1/03,53059,11,2003,4862,4381,1,481,9.90%
Snohomish,11/1/03,53061,11,2003,336160,313119,1,23041,6.90%
Spokane,11/1/03,53063,11,2003,219418,203856,1,15562,7.10%
Stevens,11/1/03,53065,11,2003,17662,16096,1,1566,8.90%
Thurston,11/1/03,53067,11,2003,117992,110634,1,7358,6.20%
Wahkiakum,11/1/03,53069,11,2003,1588,1453,1,135,8.50%
Walla Walla,11/1/03,53071,11,2003,28808,26763,1,2045,7.10%
Whatcom,11/1/03,53073,11,2003,97737,91498,1,6239,6.40%
Whitman,11/1/03,53075,11,2003,20450,19531,1,919,4.50%
Yakima,11/1/03,53077,11,2003,109861,98193,1,11668,10.60%
Adams,11/1/04,53001,11,2004,7546,6870,1,676,9.00%
Asotin,11/1/04,53003,11,2004,10371,9670,1,701,6.80%
Clallam,11/1/04,53009,11,2004,28553,26630,1,1923,6.70%
Columbia,11/1/04,53013,11,2004,1461,1334,1,127,8.70%
Cowlitz,11/1/04,53015,11,2004,42747,39355,1,3392,7.90%
Douglas,11/1/04,53017,11,2004,18456,17285,1,1171,6.30%
Ferry,11/1/04,53019,11,2004,3042,2775,1,267,8.80%
Franklin,11/1/04,53021,11,2004,28023,25774,1,2249,8.00%
Garfield,11/1/04,53023,11,2004,1054,987,1,67,6.40%
Grant,11/1/04,53025,11,2004,35734,32833,1,2901,8.10%
Grays Harbor,11/1/04,53027,11,2004,31475,28916,1,2559,8.10%
Island,11/1/04,53029,11,2004,32041,29962,1,2079,6.50%
Jefferson,11/1/04,53031,11,2004,13583,12755,1,828,6.10%
King,11/1/04,53033,11,2004,997877,950216,1,47661,4.80%
Kitsap,11/1/04,53035,11,2004,121349,114751,1,6598,5.40%
Kittitas,11/1/04,53037,11,2004,18813,17663,1,1150,6.10%
Klickitat,11/1/04,53039,11,2004,9236,8527,1,709,7.70%
Lewis,11/1/04,53041,11,2004,31108,28625,1,2483,8.00%
Lincoln,11/1/04,53043,11,2004,4690,4378,1,312,6.70%
Mason,11/1/04,53045,11,2004,25133,23480,1,1653,6.60%
Okanogan,11/1/04,53047,11,2004,18702,17131,1,1571,8.40%
Pacific,11/1/04,53049,11,2004,9137,8405,1,732,8.00%
Pend Oreille,11/1/04,53051,11,2004,5099,4708,1,391,7.70%
Pierce,11/1/04,53053,11,2004,368672,345260,1,23412,6.40%
San Juan,11/1/04,53055,11,2004,7941,7552,1,389,4.90%
Skagit,11/1/04,53057,11,2004,55466,51774,1,3692,6.70%
Skamania,11/1/04,53059,11,2004,4993,4655,1,338,6.80%
Snohomish,11/1/04,53061,11,2004,338208,320821,1,17387,5.10%
Spokane,11/1/04,53063,11,2004,224190,211123,1,13067,5.80%
Stevens,11/1/04,53065,11,2004,17971,16640,1,1331,7.40%
Thurston,11/1/04,53067,11,2004,121603,114948,1,6655,5.50%
Wahkiakum,11/1/04,53069,11,2004,1564,1444,1,120,7.70%
Walla Walla,11/1/04,53071,11,2004,29753,28043,1,1710,5.70%
Whatcom,11/1/04,53073,11,2004,101972,96462,1,5510,5.40%
Whitman,11/1/04,53075,11,2004,21232,20376,1,856,4.00%
Yakima,11/1/04,53077,11,2004,110669,101186,1,9483,8.60%
Adams,11/1/05,53001,11,2005,7719,7109,1,610,7.90%
Asotin,11/1/05,53003,11,2005,10741,10129,1,612,5.70%
Clallam,11/1/05,53009,11,2005,29491,27554,1,1937,6.60%
Columbia,11/1/05,53013,11,2005,1453,1318,1,135,9.30%
Cowlitz,11/1/05,53015,11,2005,43259,39990,1,3269,7.60%
Douglas,11/1/05,53017,11,2005,19162,18067,1,1095,5.70%
Ferry,11/1/05,53019,11,2005,2980,2727,1,253,8.50%
Franklin,11/1/05,53021,11,2005,28755,26325,1,2430,8.50%
Garfield,11/1/05,53023,11,2005,1027,968,1,59,5.70%
Grant,11/1/05,53025,11,2005,37036,34123,1,2913,7.90%
Grays Harbor,11/1/05,53027,11,2005,30950,28422,1,2528,8.20%
Island,11/1/05,53029,11,2005,32353,30411,1,1942,6.00%
Jefferson,11/1/05,53031,11,2005,13665,12885,1,780,5.70%
King,11/1/05,53033,11,2005,1022969,978985,1,43984,4.30%
Kitsap,11/1/05,53035,11,2005,123133,116768,1,6365,5.20%
Kittitas,11/1/05,53037,11,2005,19345,18200,1,1145,5.90%
Klickitat,11/1/05,53039,11,2005,9169,8483,1,686,7.50%
Lewis,11/1/05,53041,11,2005,31181,28783,1,2398,7.70%
Lincoln,11/1/05,53043,11,2005,4636,4325,1,311,6.70%
Mason,11/1/05,53045,11,2005,25019,23476,1,1543,6.20%
Okanogan,11/1/05,53047,11,2005,18779,17384,1,1395,7.40%
Pacific,11/1/05,53049,11,2005,8978,8227,1,751,8.40%
Pend Oreille,11/1/05,53051,11,2005,5044,4641,1,403,8.00%
Pierce,11/1/05,53053,11,2005,375774,354230,1,21544,5.70%
San Juan,11/1/05,53055,11,2005,7712,7344,1,368,4.80%
Skagit,11/1/05,53057,11,2005,56339,52914,1,3425,6.10%
Skamania,11/1/05,53059,11,2005,5137,4746,1,391,7.60%
Snohomish,11/1/05,53061,11,2005,349805,333586,1,16219,4.60%
Spokane,11/1/05,53063,11,2005,228982,216648,1,12334,5.40%
Stevens,11/1/05,53065,11,2005,17882,16598,1,1284,7.20%
Thurston,11/1/05,53067,11,2005,124136,117895,1,6241,5.00%
Wahkiakum,11/1/05,53069,11,2005,1624,1494,1,130,8.00%
Walla Walla,11/1/05,53071,11,2005,29738,28010,1,1728,5.80%
Whatcom,11/1/05,53073,11,2005,104230,99083,1,5147,4.90%
Whitman,11/1/05,53075,11,2005,21084,20209,1,875,4.20%
Yakima,11/1/05,53077,11,2005,112512,103368,1,9144,8.10%
Adams,11/1/06,53001,11,2006,7867,7253,1,614,7.80%
Asotin,11/1/06,53003,11,2006,10229,9835,1,394,3.90%
Clallam,11/1/06,53009,11,2006,29863,27923,1,1940,6.50%
Columbia,11/1/06,53013,11,2006,1430,1305,1,125,8.70%
Cowlitz,11/1/06,53015,11,2006,43627,40479,1,3148,7.20%
Douglas,11/1/06,53017,11,2006,19091,18005,1,1086,5.70%
Ferry,11/1/06,53019,11,2006,3003,2762,1,241,8.00%
Franklin,11/1/06,53021,11,2006,30492,27812,1,2680,8.80%
Garfield,11/1/06,53023,11,2006,999,940,1,59,5.90%
Grant,11/1/06,53025,11,2006,38048,35296,1,2752,7.20%
Grays Harbor,11/1/06,53027,11,2006,30998,28480,1,2518,8.10%
Island,11/1/06,53029,11,2006,32603,30791,1,1812,5.60%
Jefferson,11/1/06,53031,11,2006,13667,12958,1,709,5.20%
King,11/1/06,53033,11,2006,1048334,1007696,1,40638,3.90%
Kitsap,11/1/06,53035,11,2006,123846,117830,1,6016,4.90%
Kittitas,11/1/06,53037,11,2006,19702,18637,1,1065,5.40%
Klickitat,11/1/06,53039,11,2006,9270,8612,1,658,7.10%
Lewis,11/1/06,53041,11,2006,31367,29085,1,2282,7.30%
Lincoln,11/1/06,53043,11,2006,4658,4381,1,277,5.90%
Mason,11/1/06,53045,11,2006,26181,24604,1,1577,6.00%
Okanogan,11/1/06,53047,11,2006,18631,17144,1,1487,8.00%
Pacific,11/1/06,53049,11,2006,9102,8432,1,670,7.40%
Pend Oreille,11/1/06,53051,11,2006,5175,4789,1,386,7.50%
Pierce,11/1/06,53053,11,2006,382990,362976,1,20014,5.20%
San Juan,11/1/06,53055,11,2006,7851,7533,1,318,4.10%
Skagit,11/1/06,53057,11,2006,56371,53325,1,3046,5.40%
Skamania,11/1/06,53059,11,2006,5188,4838,1,350,6.70%
Snohomish,11/1/06,53061,11,2006,359720,344305,1,15415,4.30%
Spokane,11/1/06,53063,11,2006,233510,221878,1,11632,5.00%
Stevens,11/1/06,53065,11,2006,18294,16966,1,1328,7.30%
Thurston,11/1/06,53067,11,2006,126791,120728,1,6063,4.80%
Wahkiakum,11/1/06,53069,11,2006,1611,1477,1,134,8.30%
Walla Walla,11/1/06,53071,11,2006,28801,27271,1,1530,5.30%
Whatcom,11/1/06,53073,11,2006,105254,100353,1,4901,4.70%
Whitman,11/1/06,53075,11,2006,21553,20675,1,878,4.10%
Yakima,11/1/06,53077,11,2006,114259,105367,1,8892,7.80%
Adams,11/1/07,53001,11,2007,8140,7533,1,607,7.50%
Asotin,11/1/07,53003,11,2007,10380,9881,1,499,4.80%
Clallam,11/1/07,53009,11,2007,30493,28403,1,2090,6.90%
Columbia,11/1/07,53013,11,2007,1425,1314,1,111,7.80%
Cowlitz,11/1/07,53015,11,2007,44320,41210,1,3110,7.00%
Douglas,11/1/07,53017,11,2007,19892,18811,1,1081,5.40%
Ferry,11/1/07,53019,11,2007,3002,2770,1,232,7.70%
Franklin,11/1/07,53021,11,2007,33078,30576,1,2502,7.60%
Garfield,11/1/07,53023,11,2007,946,896,1,50,5.30%
Grant,11/1/07,53025,11,2007,39509,36709,1,2800,7.10%
Grays Harbor,11/1/07,53027,11,2007,32048,29550,1,2498,7.80%
Island,11/1/07,53029,11,2007,33587,31623,1,1964,5.80%
Jefferson,11/1/07,53031,11,2007,13890,13195,1,695,5.00%
King,11/1/07,53033,11,2007,1075082,1041967,1,33115,3.10%
Kitsap,11/1/07,53035,11,2007,125687,119682,1,6005,4.80%
Kittitas,11/1/07,53037,11,2007,20604,19468,1,1136,5.50%
Klickitat,11/1/07,53039,11,2007,9348,8719,1,629,6.70%
Lewis,11/1/07,53041,11,2007,31367,28978,1,2389,7.60%
Lincoln,11/1/07,53043,11,2007,4659,4377,1,282,6.10%
Mason,11/1/07,53045,11,2007,26306,24688,1,1618,6.20%
Okanogan,11/1/07,53047,11,2007,18680,17331,1,1349,7.20%
Pacific,11/1/07,53049,11,2007,9261,8534,1,727,7.90%
Pend Oreille,11/1/07,53051,11,2007,5433,5034,1,399,7.30%
Pierce,11/1/07,53053,11,2007,400562,379880,1,20682,5.20%
San Juan,11/1/07,53055,11,2007,8101,7775,1,326,4.00%
Skagit,11/1/07,53057,11,2007,58529,55427,1,3102,5.30%
Skamania,11/1/07,53059,11,2007,5179,4799,1,380,7.30%
Snohomish,11/1/07,53061,11,2007,366128,353443,1,12685,3.50%
Spokane,11/1/07,53063,11,2007,240194,227889,1,12305,5.10%
Stevens,11/1/07,53065,11,2007,18695,17331,1,1364,7.30%
Thurston,11/1/07,53067,11,2007,131330,125100,1,6230,4.70%
Wahkiakum,11/1/07,53069,11,2007,1661,1533,1,128,7.70%
Walla Walla,11/1/07,53071,11,2007,29393,27895,1,1498,5.10%
Whatcom,11/1/07,53073,11,2007,109291,104419,1,4872,4.50%
Whitman,11/1/07,53075,11,2007,21350,20458,1,892,4.20%
Yakima,11/1/07,53077,11,2007,116450,107703,1,8747,7.50%
Adams,11/1/08,53001,11,2008,7883,7330,1,553,7.00%
Asotin,11/1/08,53003,11,2008,10463,9760,1,703,6.70%
Clallam,11/1/08,53009,11,2008,30050,27755,1,2295,7.60%
Columbia,11/1/08,53013,11,2008,1507,1372,1,135,9.00%
Cowlitz,11/1/08,53015,11,2008,44757,40631,1,4126,9.20%
Douglas,11/1/08,53017,11,2008,20481,19251,1,1230,6.00%
Ferry,11/1/08,53019,11,2008,3049,2809,1,240,7.90%
Franklin,11/1/08,53021,11,2008,34546,32214,1,2332,6.80%
Garfield,11/1/08,53023,11,2008,1006,948,1,58,5.80%
Grant,11/1/08,53025,11,2008,40725,37797,1,2928,7.20%
Grays Harbor,11/1/08,53027,11,2008,32150,29330,1,2820,8.80%
Island,11/1/08,53029,11,2008,33199,31202,1,1997,6.00%
Jefferson,11/1/08,53031,11,2008,13522,12676,1,846,6.30%
King,11/1/08,53033,11,2008,1094050,1040280,1,53770,4.90%
Kitsap,11/1/08,53035,11,2008,126511,119667,1,6844,5.40%
Kittitas,11/1/08,53037,11,2008,21180,19876,1,1304,6.20%
Klickitat,11/1/08,53039,11,2008,9927,9208,1,719,7.20%
Lewis,11/1/08,53041,11,2008,31903,28881,1,3022,9.50%
Lincoln,11/1/08,53043,11,2008,4890,4600,1,290,5.90%
Mason,11/1/08,53045,11,2008,26348,24424,1,1924,7.30%
Okanogan,11/1/08,53047,11,2008,19982,18588,1,1394,7.00%
Pacific,11/1/08,53049,11,2008,9105,8252,1,853,9.40%
Pend Oreille,11/1/08,53051,11,2008,5660,5126,1,534,9.40%
Pierce,11/1/08,53053,11,2008,400845,375306,1,25539,6.40%
San Juan,11/1/08,53055,11,2008,8190,7801,1,389,4.70%
Skagit,11/1/08,53057,11,2008,58462,54625,1,3837,6.60%
Skamania,11/1/08,53059,11,2008,5218,4736,1,482,9.20%
Snohomish,11/1/08,53061,11,2008,375126,353307,1,21819,5.80%
Spokane,11/1/08,53063,11,2008,244556,229754,1,14802,6.10%
Stevens,11/1/08,53065,11,2008,18771,17177,1,1594,8.50%
Thurston,11/1/08,53067,11,2008,133673,126258,1,7415,5.50%
Wahkiakum,11/1/08,53069,11,2008,1757,1620,1,137,7.80%
Walla Walla,11/1/08,53071,11,2008,32071,30555,1,1516,4.70%
Whatcom,11/1/08,53073,11,2008,109059,103083,1,5976,5.50%
Whitman,11/1/08,53075,11,2008,22388,21479,1,909,4.10%
Yakima,11/1/08,53077,11,2008,120525,111835,1,8690,7.20%
Adams,11/1/09,53001,11,2009,7768,6915,1,853,11.00%
Asotin,11/1/09,53003,11,2009,10383,9437,1,946,9.10%
Clallam,11/1/09,53009,11,2009,30255,27070,1,3185,10.50%
Columbia,11/1/09,53013,11,2009,1530,1357,1,173,11.30%
Cowlitz,11/1/09,53015,11,2009,45234,38910,1,6324,14.00%
Douglas,11/1/09,53017,11,2009,20726,18932,1,1794,8.70%
Ferry,11/1/09,53019,11,2009,3050,2632,1,418,13.70%
Franklin,11/1/09,53021,11,2009,36783,33299,1,3484,9.50%
Garfield,11/1/09,53023,11,2009,974,891,1,83,8.50%
Grant,11/1/09,53025,11,2009,39930,35178,1,4752,11.90%
Grays Harbor,11/1/09,53027,11,2009,31423,26990,1,4433,14.10%
Island,11/1/09,53029,11,2009,33025,29897,1,3128,9.50%
Jefferson,11/1/09,53031,11,2009,13037,11842,1,1195,9.20%
King,11/1/09,53033,11,2009,1110970,1011341,1,99629,9.00%
Kitsap,11/1/09,53035,11,2009,125897,115882,1,10015,8.00%
Kittitas,11/1/09,53037,11,2009,21002,19051,1,1951,9.30%
Klickitat,11/1/09,53039,11,2009,10769,9614,1,1155,10.70%
Lewis,11/1/09,53041,11,2009,31958,27296,1,4662,14.60%
Lincoln,11/1/09,53043,11,2009,4784,4371,1,413,8.60%
Mason,11/1/09,53045,11,2009,26602,23628,1,2974,11.20%
Okanogan,11/1/09,53047,11,2009,19920,17651,1,2269,11.40%
Pacific,11/1/09,53049,11,2009,9080,7812,1,1268,14.00%
Pend Oreille,11/1/09,53051,11,2009,5535,4723,1,812,14.70%
Pierce,11/1/09,53053,11,2009,398473,357850,1,40623,10.20%
San Juan,11/1/09,53055,11,2009,7948,7339,1,609,7.70%
Skagit,11/1/09,53057,11,2009,58181,51644,1,6537,11.20%
Skamania,11/1/09,53059,11,2009,5209,4459,1,750,14.40%
Snohomish,11/1/09,53061,11,2009,382153,341513,1,40640,10.60%
Spokane,11/1/09,53063,11,2009,241312,218307,1,23005,9.50%
Stevens,11/1/09,53065,11,2009,18737,16311,1,2426,12.90%
Thurston,11/1/09,53067,11,2009,132171,121288,1,10883,8.20%
Wahkiakum,11/1/09,53069,11,2009,1560,1315,1,245,15.70%
Walla Walla,11/1/09,53071,11,2009,31599,29433,1,2166,6.90%
Whatcom,11/1/09,53073,11,2009,108004,98358,1,9646,8.90%
Whitman,11/1/09,53075,11,2009,22361,21089,1,1272,5.70%
Yakima,11/1/09,53077,11,2009,122091,109851,1,12240,10.00%
Adams,11/1/10,53001,11,2010,7886,6992,1,894,11.30%
Asotin,11/1/10,53003,11,2010,10178,9248,1,930,9.10%
Clallam,11/1/10,53009,11,2010,29315,26170,1,3145,10.70%
Columbia,11/1/10,53013,11,2010,1939,1755,1,184,9.50%
Cowlitz,11/1/10,53015,11,2010,46175,40474,1,5701,12.30%
Douglas,11/1/10,53017,11,2010,18690,16883,1,1807,9.70%
Ferry,11/1/10,53019,11,2010,2638,2227,1,411,15.60%
Franklin,11/1/10,53021,11,2010,38236,34908,1,3328,8.70%
Garfield,11/1/10,53023,11,2010,994,922,1,72,7.20%
Grant,11/1/10,53025,11,2010,41869,37328,1,4541,10.80%
Grays Harbor,11/1/10,53027,11,2010,30290,26183,1,4107,13.60%
Island,11/1/10,53029,11,2010,33438,30436,1,3002,9.00%
Jefferson,11/1/10,53031,11,2010,12406,11143,1,1263,10.20%
King,11/1/10,53033,11,2010,1096897,996947,1,99950,9.10%
Kitsap,11/1/10,53035,11,2010,120129,110295,1,9834,8.20%
Kittitas,11/1/10,53037,11,2010,21457,19579,1,1878,8.80%
Klickitat,11/1/10,53039,11,2010,9754,8605,1,1149,11.80%
Lewis,11/1/10,53041,11,2010,33785,29496,1,4289,12.70%
Lincoln,11/1/10,53043,11,2010,5338,4915,1,423,7.90%
Mason,11/1/10,53045,11,2010,25444,22625,1,2819,11.10%
Okanogan,11/1/10,53047,11,2010,20160,17877,1,2283,11.30%
Pacific,11/1/10,53049,11,2010,8657,7453,1,1204,13.90%
Pend Oreille,11/1/10,53051,11,2010,5081,4373,1,708,13.90%
Pierce,11/1/10,53053,11,2010,395665,356624,1,39041,9.90%
San Juan,11/1/10,53055,11,2010,7880,7287,1,593,7.50%
Skagit,11/1/10,53057,11,2010,58536,52215,1,6321,10.80%
Skamania,11/1/10,53059,11,2010,5201,4553,1,648,12.50%
Snohomish,11/1/10,53061,11,2010,383640,342232,1,41408,10.80%
Spokane,11/1/10,53063,11,2010,238585,216302,1,22283,9.30%
Stevens,11/1/10,53065,11,2010,18874,16627,1,2247,11.90%
Thurston,11/1/10,53067,11,2010,126995,116154,1,10841,8.50%
Wahkiakum,11/1/10,53069,11,2010,1458,1240,1,218,15.00%
Walla Walla,11/1/10,53071,11,2010,31460,29199,1,2261,7.20%
Whatcom,11/1/10,53073,11,2010,104055,94685,1,9370,9.00%
Whitman,11/1/10,53075,11,2010,23120,21765,1,1355,5.90%
Yakima,11/1/10,53077,11,2010,117670,105115,1,12555,10.70%
Adams,11/1/11,53001,11,2011,7889,7138,1,751,9.50%
Asotin,11/1/11,53003,11,2011,10025,9178,1,847,8.40%
Clallam,11/1/11,53009,11,2011,27995,25071,1,2924,10.40%
Columbia,11/1/11,53013,11,2011,1836,1678,1,158,8.60%
Cowlitz,11/1/11,53015,11,2011,44580,39630,1,4950,11.10%
Douglas,11/1/11,53017,11,2011,18773,17113,1,1660,8.80%
Ferry,11/1/11,53019,11,2011,2457,2071,1,386,15.70%
Franklin,11/1/11,53021,11,2011,37705,34098,1,3607,9.60%
Garfield,11/1/11,53023,11,2011,978,904,1,74,7.60%
Grant,11/1/11,53025,11,2011,42398,38340,1,4058,9.60%
Grays Harbor,11/1/11,53027,11,2011,29336,25356,1,3980,13.60%
Island,11/1/11,53029,11,2011,32456,29753,1,2703,8.30%
Jefferson,11/1/11,53031,11,2011,11717,10558,1,1159,9.90%
King,11/1/11,53033,11,2011,1106358,1024180,1,82178,7.40%
Kitsap,11/1/11,53035,11,2011,116762,107574,1,9188,7.90%
Kittitas,11/1/11,53037,11,2011,20673,18935,1,1738,8.40%
Klickitat,11/1/11,53039,11,2011,9864,8789,1,1075,10.90%
Lewis,11/1/11,53041,11,2011,32324,28347,1,3977,12.30%
Lincoln,11/1/11,53043,11,2011,5205,4834,1,371,7.10%
Mason,11/1/11,53045,11,2011,24366,21752,1,2614,10.70%
Okanogan,11/1/11,53047,11,2011,20463,18423,1,2040,10.00%
Pacific,11/1/11,53049,11,2011,8018,6943,1,1075,13.40%
Pend Oreille,11/1/11,53051,11,2011,4825,4214,1,611,12.70%
Pierce,11/1/11,53053,11,2011,387609,351305,1,36304,9.40%
San Juan,11/1/11,53055,11,2011,7556,7006,1,550,7.30%
Skagit,11/1/11,53057,11,2011,56669,51029,1,5640,10.00%
Skamania,11/1/11,53059,11,2011,5070,4522,1,548,10.80%
Snohomish,11/1/11,53061,11,2011,382640,348917,1,33723,8.80%
Spokane,11/1/11,53063,11,2011,231578,211476,1,20102,8.70%
Stevens,11/1/11,53065,11,2011,18115,16118,1,1997,11.00%
Thurston,11/1/11,53067,11,2011,123278,112900,1,10378,8.40%
Wahkiakum,11/1/11,53069,11,2011,1392,1210,1,182,13.10%
Walla Walla,11/1/11,53071,11,2011,30460,28355,1,2105,6.90%
Whatcom,11/1/11,53073,11,2011,102107,93726,1,8381,8.20%
Whitman,11/1/11,53075,11,2011,23114,21911,1,1203,5.20%
Yakima,11/1/11,53077,11,2011,119795,107883,1,11912,9.90%
Adams,11/1/12,53001,11,2012,7600,6909,1,691,9.10%
Asotin,11/1/12,53003,11,2012,9807,9145,1,662,6.80%
Clallam,11/1/12,53009,11,2012,27739,25095,1,2644,9.50%
Clark,11/1/12,53011,11,2012,209746,191937,1,17809,8.50%
Columbia,11/1/12,53013,11,2012,1815,1672,1,143,7.90%
Cowlitz,11/1/12,53015,11,2012,44304,40019,1,4285,9.70%
Douglas,11/1/12,53017,11,2012,18271,16784,1,1487,8.10%
Ferry,11/1/12,53019,11,2012,2326,2015,1,311,13.40%
Franklin,11/1/12,53021,11,2012,37631,34140,1,3491,9.30%
Garfield,11/1/12,53023,11,2012,973,897,1,76,7.80%
Grant,11/1/12,53025,11,2012,42316,38717,1,3599,8.50%
Grays Harbor,11/1/12,53027,11,2012,28329,25011,1,3318,11.70%
Island,11/1/12,53029,11,2012,32304,29919,1,2385,7.40%
Jefferson,11/1/12,53031,11,2012,11832,10769,1,1063,9.00%
King,11/1/12,53033,11,2012,1120972,1057645,1,63327,5.60%
Kitsap,11/1/12,53035,11,2012,115722,107631,1,8091,7.00%
Kittitas,11/1/12,53037,11,2012,20679,19154,1,1525,7.40%
Klickitat,11/1/12,53039,11,2012,9627,8748,1,879,9.10%
Lewis,11/1/12,53041,11,2012,32133,28653,1,3480,10.80%
Lincoln,11/1/12,53043,11,2012,5169,4838,1,331,6.40%
Mason,11/1/12,53045,11,2012,24079,21806,1,2273,9.40%
Okanogan,11/1/12,53047,11,2012,19114,17267,1,1847,9.70%
Pacific,11/1/12,53049,11,2012,7983,7058,1,925,11.60%
Pend Oreille,11/1/12,53051,11,2012,4795,4251,1,544,11.30%
Pierce,11/1/12,53053,11,2012,387441,355109,1,32332,8.30%
San Juan,11/1/12,53055,11,2012,7648,7169,1,479,6.30%
Skagit,11/1/12,53057,11,2012,56509,51549,1,4960,8.80%
Skamania,11/1/12,53059,11,2012,5011,4539,1,472,9.40%
Snohomish,11/1/12,53061,11,2012,384105,358796,1,25309,6.60%
Spokane,11/1/12,53063,11,2012,231424,213119,1,18305,7.90%
Stevens,11/1/12,53065,11,2012,18117,16250,1,1867,10.30%
Thurston,11/1/12,53067,11,2012,123934,114634,1,9300,7.50%
Wahkiakum,11/1/12,53069,11,2012,1331,1167,1,164,12.30%
Walla Walla,11/1/12,53071,11,2012,30332,28452,1,1880,6.20%
Whatcom,11/1/12,53073,11,2012,102786,95345,1,7441,7.20%
Whitman,11/1/12,53075,11,2012,23229,22007,1,1222,5.30%
Yakima,11/1/12,53077,11,2012,116123,105195,1,10928,9.40%
Adams,11/1/13,53001,11,2013,7870,7204,1,666,8.50%
Asotin,11/1/13,53003,11,2013,9707,9159,1,548,5.60%
Clallam,11/1/13,53009,11,2013,26957,24586,1,2371,8.80%
Clark,11/1/13,53011,11,2013,210244,194579,1,15665,7.50%
Columbia,11/1/13,53013,11,2013,1771,1641,1,130,7.30%
Cowlitz,11/1/13,53015,11,2013,43416,39652,1,3764,8.70%
Douglas,11/1/13,53017,11,2013,18129,16679,1,1450,8.00%
Ferry,11/1/13,53019,11,2013,2442,2138,1,304,12.40%
Franklin,11/1/13,53021,11,2013,38032,34501,1,3531,9.30%
Garfield,11/1/13,53023,11,2013,919,862,1,57,6.20%
Grant,11/1/13,53025,11,2013,42178,38472,1,3706,8.80%
Grays Harbor,11/1/13,53027,11,2013,27519,24446,1,3073,11.20%
Island,11/1/13,53029,11,2013,31733,29599,1,2134,6.70%
Jefferson,11/1/13,53031,11,2013,11205,10245,1,960,8.60%
King,11/1/13,53033,11,2013,1139687,1081133,1,58554,5.10%
Kitsap,11/1/13,53035,11,2013,114418,107220,1,7198,6.30%
Kittitas,11/1/13,53037,11,2013,19685,18318,1,1367,6.90%
Klickitat,11/1/13,53039,11,2013,9296,8504,1,792,8.50%
Lewis,11/1/13,53041,11,2013,31551,28592,1,2959,9.40%
Lincoln,11/1/13,53043,11,2013,5054,4754,1,300,5.90%
Mason,11/1/13,53045,11,2013,23796,21712,1,2084,8.80%
Okanogan,11/1/13,53047,11,2013,19216,17510,1,1706,8.90%
Pacific,11/1/13,53049,11,2013,8000,7123,1,877,11.00%
Pend Oreille,11/1/13,53051,11,2013,4657,4172,1,485,10.40%
Pierce,11/1/13,53053,11,2013,387230,358566,1,28664,7.40%
San Juan,11/1/13,53055,11,2013,7275,6879,1,396,5.40%
Skagit,11/1/13,53057,11,2013,56519,52094,1,4425,7.80%
Skamania,11/1/13,53059,11,2013,5024,4575,1,449,8.90%
Snohomish,11/1/13,53061,11,2013,389736,366892,1,22844,5.90%
Spokane,11/1/13,53063,11,2013,228613,212430,1,16183,7.10%
Stevens,11/1/13,53065,11,2013,17649,15955,1,1694,9.60%
Thurston,11/1/13,53067,11,2013,123577,115244,1,8333,6.70%
Wahkiakum,11/1/13,53069,11,2013,1271,1136,1,135,10.60%
Walla Walla,11/1/13,53071,11,2013,28850,27095,1,1755,6.10%
Whatcom,11/1/13,53073,11,2013,101995,95381,1,6614,6.50%
Whitman,11/1/13,53075,11,2013,22728,21671,1,1057,4.70%
Yakima,11/1/13,53077,11,2013,113509,102347,1,11162,9.80%
Adams,11/1/14,53001,11,2014,8058,7394,1,664,8.20%
Asotin,11/1/14,53003,11,2014,9808,9322,1,486,5.00%
Clallam,11/1/14,53009,11,2014,26906,24638,1,2268,8.40%
Clark,11/1/14,53011,11,2014,213534,199218,1,14316,6.70%
Columbia,11/1/14,53013,11,2014,1738,1609,1,129,7.40%
Cowlitz,11/1/14,53015,11,2014,44470,41043,1,3427,7.70%
Douglas,11/1/14,53017,11,2014,19009,17669,1,1340,7.00%
Ferry,11/1/14,53019,11,2014,2515,2266,1,249,9.90%
Franklin,11/1/14,53021,11,2014,37617,34384,1,3233,8.60%
Garfield,11/1/14,53023,11,2014,930,874,1,56,6.00%
Grant,11/1/14,53025,11,2014,44868,41545,1,3323,7.40%
Grays Harbor,11/1/14,53027,11,2014,27402,24689,1,2713,9.90%
Island,11/1/14,53029,11,2014,32126,30026,1,2100,6.50%
Jefferson,11/1/14,53031,11,2014,11118,10230,1,888,8.00%
King,11/1/14,53033,11,2014,1163836,1110128,1,53708,4.60%
Kitsap,11/1/14,53035,11,2014,115338,108622,1,6716,5.80%
Kittitas,11/1/14,53037,11,2014,20976,19676,1,1300,6.20%
Klickitat,11/1/14,53039,11,2014,9342,8614,1,728,7.80%
Lewis,11/1/14,53041,11,2014,30792,28045,1,2747,8.90%
Lincoln,11/1/14,53043,11,2014,4971,4674,1,297,6.00%
Mason,11/1/14,53045,11,2014,23826,21941,1,1885,7.90%
Okanogan,11/1/14,53047,11,2014,20035,18463,1,1572,7.80%
Pacific,11/1/14,53049,11,2014,7865,7090,1,775,9.90%
Pend Oreille,11/1/14,53051,11,2014,4599,4187,1,412,9.00%
Pierce,11/1/14,53053,11,2014,393307,367001,1,26306,6.70%
San Juan,11/1/14,53055,11,2014,7396,7001,1,395,5.30%
Skagit,11/1/14,53057,11,2014,56586,52650,1,3936,7.00%
Skamania,11/1/14,53059,11,2014,5018,4623,1,395,7.90%
Snohomish,11/1/14,53061,11,2014,397230,377183,1,20047,5.00%
Spokane,11/1/14,53063,11,2014,229353,214272,1,15081,6.60%
Stevens,11/1/14,53065,11,2014,17515,16002,1,1513,8.60%
Thurston,11/1/14,53067,11,2014,125992,118166,1,7826,6.20%
Wahkiakum,11/1/14,53069,11,2014,1280,1152,1,128,10.00%
Walla Walla,11/1/14,53071,11,2014,29204,27568,1,1636,5.60%
Whatcom,11/1/14,53073,11,2014,102705,96422,1,6283,6.10%
Whitman,11/1/14,53075,11,2014,23050,22059,1,991,4.30%
Yakima,11/1/14,53077,11,2014,117938,107654,1,10284,8.70%
Adams,11/1/15,53001,11,2015,8303,7611,1,692,8.30%
Asotin,11/1/15,53003,11,2015,9755,9312,1,443,4.50%
Clallam,11/1/15,53009,11,2015,26751,24542,1,2209,8.30%
Clark,11/1/15,53011,11,2015,218844,205448,1,13396,6.10%
Columbia,11/1/15,53013,11,2015,1700,1587,1,113,6.60%
Cowlitz,11/1/15,53015,11,2015,44675,41322,1,3353,7.50%
Douglas,11/1/15,53017,11,2015,19117,17833,1,1284,6.70%
Ferry,11/1/15,53019,11,2015,2482,2249,1,233,9.40%
Franklin,11/1/15,53021,11,2015,38259,35102,1,3157,8.30%
Garfield,11/1/15,53023,11,2015,895,836,1,59,6.60%
Grant,11/1/15,53025,11,2015,42950,39440,1,3510,8.20%
Grays Harbor,11/1/15,53027,11,2015,27023,24637,1,2386,8.80%
Island,11/1/15,53029,11,2015,31850,29926,1,1924,6.00%
Jefferson,11/1/15,53031,11,2015,11110,10326,1,784,7.10%
King,11/1/15,53033,11,2015,1186256,1136893,1,49363,4.20%
Kitsap,11/1/15,53035,11,2015,117497,111177,1,6320,5.40%
Kittitas,11/1/15,53037,11,2015,21083,19850,1,1233,5.80%
Klickitat,11/1/15,53039,11,2015,9188,8520,1,668,7.30%
Lewis,11/1/15,53041,11,2015,31877,29236,1,2641,8.30%
Lincoln,11/1/15,53043,11,2015,4750,4470,1,280,5.90%
Mason,11/1/15,53045,11,2015,23631,21790,1,1841,7.80%
Okanogan,11/1/15,53047,11,2015,19830,18287,1,1543,7.80%
Pacific,11/1/15,53049,11,2015,8037,7278,1,759,9.40%
Pend Oreille,11/1/15,53051,11,2015,4638,4220,1,418,9.00%
Pierce,11/1/15,53053,11,2015,400303,375174,1,25129,6.30%
San Juan,11/1/15,53055,11,2015,7374,7003,1,371,5.00%
Skagit,11/1/15,53057,11,2015,56907,52975,1,3932,6.90%
Skamania,11/1/15,53059,11,2015,5017,4656,1,361,7.20%
Snohomish,11/1/15,53061,11,2015,404831,386283,1,18548,4.60%
Spokane,11/1/15,53063,11,2015,232054,217773,1,14281,6.20%
Stevens,11/1/15,53065,11,2015,17602,16132,1,1470,8.40%
Thurston,11/1/15,53067,11,2015,128395,120933,1,7462,5.80%
Wahkiakum,11/1/15,53069,11,2015,1295,1169,1,126,9.70%
Walla Walla,11/1/15,53071,11,2015,28521,26928,1,1593,5.60%
Whatcom,11/1/15,53073,11,2015,105434,99252,1,6182,5.90%
Whitman,11/1/15,53075,11,2015,23834,22798,1,1036,4.30%
Yakima,11/1/15,53077,11,2015,116684,106197,1,10487,9.00%
Adams,11/1/16,53001,11,2016,8425,7865,1,560,6.60%
Asotin,11/1/16,53003,11,2016,10133,9683,1,450,4.40%
Clallam,11/1/16,53009,11,2016,27286,25390,1,1896,6.90%
Clark,11/1/16,53011,11,2016,224522,212192,1,12330,5.50%
Columbia,11/1/16,53013,11,2016,1724,1609,1,115,6.70%
Cowlitz,11/1/16,53015,11,2016,45954,42972,1,2982,6.50%
Douglas,11/1/16,53017,11,2016,20036,18772,1,1264,6.30%
Ferry,11/1/16,53019,11,2016,2579,2340,1,239,9.30%
Franklin,11/1/16,53021,11,2016,38848,36020,1,2828,7.30%
Garfield,11/1/16,53023,11,2016,883,834,1,49,5.50%
Grant,11/1/16,53025,11,2016,42841,39899,1,2942,6.90%
Grays Harbor,11/1/16,53027,11,2016,27564,25433,1,2131,7.70%
Island,11/1/16,53029,11,2016,33326,31506,1,1820,5.50%
Jefferson,11/1/16,53031,11,2016,11548,10762,1,786,6.80%
King,11/1/16,53033,11,2016,1217579,1173235,1,44344,3.60%
Kitsap,11/1/16,53035,11,2016,119569,113302,1,6267,5.20%
Kittitas,11/1/16,53037,11,2016,21873,20703,1,1170,5.30%
Klickitat,11/1/16,53039,11,2016,9508,8893,1,615,6.50%
Lewis,11/1/16,53041,11,2016,32505,30180,1,2325,7.20%
Lincoln,11/1/16,53043,11,2016,4733,4495,1,238,5.00%
Mason,11/1/16,53045,11,2016,24111,22440,1,1671,6.90%
Okanogan,11/1/16,53047,11,2016,20111,18808,1,1303,6.50%
Pacific,11/1/16,53049,11,2016,8262,7625,1,637,7.70%
Pend Oreille,11/1/16,53051,11,2016,4701,4345,1,356,7.60%
Pierce,11/1/16,53053,11,2016,413125,390610,1,22515,5.40%
San Juan,11/1/16,53055,11,2016,7536,7202,1,334,4.40%
Skagit,11/1/16,53057,11,2016,57999,54457,1,3542,6.10%
Skamania,11/1/16,53059,11,2016,5151,4810,1,341,6.60%
Snohomish,11/1/16,53061,11,2016,416926,400112,1,16814,4.00%
Spokane,11/1/16,53063,11,2016,239010,226317,1,12693,5.30%
Stevens,11/1/16,53065,11,2016,18084,16767,1,1317,7.30%
Thurston,11/1/16,53067,11,2016,132640,125818,1,6822,5.10%
Wahkiakum,11/1/16,53069,11,2016,1279,1174,1,105,8.20%
Walla Walla,11/1/16,53071,11,2016,29386,27978,1,1408,4.80%
Whatcom,11/1/16,53073,11,2016,108280,102603,1,5677,5.20%
Whitman,11/1/16,53075,11,2016,24265,23246,1,1019,4.20%
Yakima,11/1/16,53077,11,2016,120799,111560,1,9239,7.60%
Adams,11/1/17,53001,11,2017,8627,8137,1,490,5.70%
Asotin,11/1/17,53003,11,2017,10273,9849,1,424,4.10%
Clallam,11/1/17,53009,11,2017,27770,25962,1,1808,6.50%
Clark,11/1/17,53011,11,2017,230594,219454,1,11140,4.80%
Columbia,11/1/17,53013,11,2017,1756,1662,1,94,5.40%
Cowlitz,11/1/17,53015,11,2017,45787,43062,1,2725,6.00%
Douglas,11/1/17,53017,11,2017,20543,19440,1,1103,5.40%
Ferry,11/1/17,53019,11,2017,2527,2240,1,287,11.40%
Franklin,11/1/17,53021,11,2017,39787,37314,1,2473,6.20%
Garfield,11/1/17,53023,11,2017,891,836,1,55,6.20%
Grant,11/1/17,53025,11,2017,43646,41112,1,2534,5.80%
Grays Harbor,11/1/17,53027,11,2017,27971,26092,1,1879,6.70%
Island,11/1/17,53029,11,2017,34135,32340,1,1795,5.30%
Jefferson,11/1/17,53031,11,2017,12000,11281,1,719,6.00%
King,11/1/17,53033,11,2017,1242117,1199573,1,42544,3.40%
Kitsap,11/1/17,53035,11,2017,121562,115783,1,5779,4.80%
Kittitas,11/1/17,53037,11,2017,22550,21424,1,1126,5.00%
Klickitat,11/1/17,53039,11,2017,9554,9010,1,544,5.70%
Lewis,11/1/17,53041,11,2017,33509,31343,1,2166,6.50%
Lincoln,11/1/17,53043,11,2017,4911,4674,1,237,4.80%
Mason,11/1/17,53045,11,2017,24596,23093,1,1503,6.10%
Okanogan,11/1/17,53047,11,2017,19370,18075,1,1295,6.70%
Pacific,11/1/17,53049,11,2017,8247,7667,1,580,7.00%
Pend Oreille,11/1/17,53051,11,2017,4773,4454,1,319,6.70%
Pierce,11/1/17,53053,11,2017,421433,399567,1,21866,5.20%
San Juan,11/1/17,53055,11,2017,7829,7506,1,323,4.10%
Skagit,11/1/17,53057,11,2017,59127,56024,1,3103,5.20%
Skamania,11/1/17,53059,11,2017,5344,5035,1,309,5.80%
Snohomish,11/1/17,53061,11,2017,424878,408745,1,16133,3.80%
Spokane,11/1/17,53063,11,2017,243107,230906,1,12201,5.00%
Stevens,11/1/17,53065,11,2017,18235,17002,1,1233,6.80%
Thurston,11/1/17,53067,11,2017,136293,129783,1,6510,4.80%
Wahkiakum,11/1/17,53069,11,2017,1296,1213,1,83,6.40%
Walla Walla,11/1/17,53071,11,2017,29860,28488,1,1372,4.60%
Whatcom,11/1/17,53073,11,2017,111155,105901,1,5254,4.70%
Whitman,11/1/17,53075,11,2017,24102,23085,1,1017,4.20%
Yakima,11/1/17,53077,11,2017,123231,115456,1,7775,6.30%
Adams,11/1/18,53001,11,2018,8546,8040,1,506,5.90%
Asotin,11/1/18,53003,11,2018,10402,9934,1,468,4.50%
Clallam,11/1/18,53009,11,2018,28355,26520,1,1835,6.50%
Clark,11/1/18,53011,11,2018,239859,228479,1,11380,4.70%
Columbia,11/1/18,53013,11,2018,1825,1719,1,106,5.80%
Cowlitz,11/1/18,53015,11,2018,47598,44828,1,2770,5.80%
Douglas,11/1/18,53017,11,2018,21096,19902,1,1194,5.70%
Ferry,11/1/18,53019,11,2018,2519,2271,1,248,9.80%
Franklin,11/1/18,53021,11,2018,40743,38201,1,2542,6.20%
Garfield,11/1/18,53023,11,2018,906,848,1,58,6.40%
Grant,11/1/18,53025,11,2018,45807,42994,1,2813,6.10%
Grays Harbor,11/1/18,53027,11,2018,28556,26602,1,1954,6.80%
Island,11/1/18,53029,11,2018,35400,33524,1,1876,5.30%
Jefferson,11/1/18,53031,11,2018,12549,11853,1,696,5.50%
King,11/1/18,53033,11,2018,1270156,1231070,1,39086,3.10%
Kitsap,11/1/18,53035,11,2018,126870,120995,1,5875,4.60%
Kittitas,11/1/18,53037,11,2018,22642,21401,1,1241,5.50%
Klickitat,11/1/18,53039,11,2018,9846,9275,1,571,5.80%
Lewis,11/1/18,53041,11,2018,34550,32373,1,2177,6.30%
Lincoln,11/1/18,53043,11,2018,5087,4839,1,248,4.90%
Mason,11/1/18,53045,11,2018,25503,23903,1,1600,6.30%
Okanogan,11/1/18,53047,11,2018,19420,18095,1,1325,6.80%
Pacific,11/1/18,53049,11,2018,8353,7729,1,624,7.50%
Pend Oreille,11/1/18,53051,11,2018,4965,4624,1,341,6.90%
Pierce,11/1/18,53053,11,2018,437082,414580,1,22502,5.10%
San Juan,11/1/18,53055,11,2018,8181,7843,1,338,4.10%
Skagit,11/1/18,53057,11,2018,61635,58367,1,3268,5.30%
Skamania,11/1/18,53059,11,2018,5474,5176,1,298,5.40%
Snohomish,11/1/18,53061,11,2018,432212,417903,1,14309,3.30%
Spokane,11/1/18,53063,11,2018,251861,239132,1,12729,5.10%
Stevens,11/1/18,53065,11,2018,18733,17501,1,1232,6.60%
Thurston,11/1/18,53067,11,2018,141592,134735,1,6857,4.80%
Wahkiakum,11/1/18,53069,11,2018,1379,1282,1,97,7.00%
Walla Walla,11/1/18,53071,11,2018,30533,29160,1,1373,4.50%
Whatcom,11/1/18,53073,11,2018,114082,108560,1,5522,4.80%
Whitman,11/1/18,53075,11,2018,24730,23646,1,1084,4.40%
Yakima,11/1/18,53077,11,2018,123619,114776,1,8843,7.20%
Adams,11/1/19,53001,11,2019,9257,8748,1,509,5.50%
Asotin,11/1/19,53003,11,2019,10682,10291,1,391,3.70%
Clallam,11/1/19,53009,11,2019,29296,27577,1,1719,5.90%
Clark,11/1/19,53011,11,2019,246005,235364,1,10641,4.30%
Columbia,11/1/19,53013,11,2019,1878,1778,1,100,5.30%
Cowlitz,11/1/19,53015,11,2019,48596,45978,1,2618,5.40%
Douglas,11/1/19,53017,11,2019,21483,20336,1,1147,5.30%
Ferry,11/1/19,53019,11,2019,2430,2188,1,242,10.00%
Franklin,11/1/19,53021,11,2019,42399,39964,1,2435,5.70%
Garfield,11/1/19,53023,11,2019,927,874,1,53,5.70%
Grant,11/1/19,53025,11,2019,45380,42446,1,2934,6.50%
Grays Harbor,11/1/19,53027,11,2019,29213,27290,1,1923,6.60%
Island,11/1/19,53029,11,2019,37238,35577,1,1661,4.50%
Jefferson,11/1/19,53031,11,2019,13339,12658,1,681,5.10%
King,11/1/19,53033,11,2019,1298436,1265360,1,33076,2.50%
Kitsap,11/1/19,53035,11,2019,131624,126391,1,5233,4.00%
Kittitas,11/1/19,53037,11,2019,24220,23088,1,1132,4.70%
Klickitat,11/1/19,53039,11,2019,10027,9514,1,513,5.10%
Lewis,11/1/19,53041,11,2019,35428,33422,1,2006,5.70%
Lincoln,11/1/19,53043,11,2019,4992,4768,1,224,4.50%
Mason,11/1/19,53045,11,2019,26705,25248,1,1457,5.50%
Okanogan,11/1/19,53047,11,2019,19224,17978,1,1246,6.50%
Pacific,11/1/19,53049,11,2019,8556,7977,1,579,6.80%
Pend Oreille,11/1/19,53051,11,2019,5171,4791,1,380,7.30%
Pierce,11/1/19,53053,11,2019,449788,428706,1,21082,4.70%
San Juan,11/1/19,53055,11,2019,8533,8235,1,298,3.50%
Skagit,11/1/19,53057,11,2019,63525,60306,1,3219,5.10%
Skamania,11/1/19,53059,11,2019,5622,5349,1,273,4.90%
Snohomish,11/1/19,53061,11,2019,441899,429513,1,12386,2.80%
Spokane,11/1/19,53063,11,2019,259520,247834,1,11686,4.50%
Stevens,11/1/19,53065,11,2019,19276,18141,1,1135,5.90%
Thurston,11/1/19,53067,11,2019,146356,139933,1,6423,4.40%
Wahkiakum,11/1/19,53069,11,2019,1384,1296,1,88,6.40%
Walla Walla,11/1/19,53071,11,2019,31486,30193,1,1293,4.10%
Whatcom,11/1/19,53073,11,2019,116639,111274,1,5365,4.60%
Whitman,11/1/19,53075,11,2019,24734,23794,1,940,3.80%
Yakima,11/1/19,53077,11,2019,129158,120859,1,8299,6.40%
Adams,12/1/90,53001,12,1990,7353,6086,1,1267,17.20%
Asotin,12/1/90,53003,12,1990,9410,9008,1,402,4.30%
Clallam,12/1/90,53009,12,1990,23283,21000,1,2283,9.80%
Columbia,12/1/90,53013,12,1990,1219,950,1,269,22.10%
Cowlitz,12/1/90,53015,12,1990,38398,35314,1,3084,8.00%
Douglas,12/1/90,53017,12,1990,14972,13380,1,1592,10.60%
Ferry,12/1/90,53019,12,1990,2746,2445,1,301,11.00%
Franklin,12/1/90,53021,12,1990,18952,16184,1,2768,14.60%
Garfield,12/1/90,53023,12,1990,1021,971,1,50,4.90%
Grant,12/1/90,53025,12,1990,25717,22363,1,3354,13.00%
Grays Harbor,12/1/90,53027,12,1990,27466,24089,1,3377,12.30%
Island,12/1/90,53029,12,1990,23270,22402,1,868,3.70%
Jefferson,12/1/90,53031,12,1990,8416,7799,1,617,7.30%
King,12/1/90,53033,12,1990,852388,824221,1,28167,3.30%
Kitsap,12/1/90,53035,12,1990,85856,81926,1,3930,4.60%
Kittitas,12/1/90,53037,12,1990,12587,11374,1,1213,9.60%
Klickitat,12/1/90,53039,12,1990,7857,6794,1,1063,13.50%
Lewis,12/1/90,53041,12,1990,26851,24034,1,2817,10.50%
Lincoln,12/1/90,53043,12,1990,3915,3670,1,245,6.30%
Mason,12/1/90,53045,12,1990,17170,15788,1,1382,8.00%
Okanogan,12/1/90,53047,12,1990,17342,14902,1,2440,14.10%
Pacific,12/1/90,53049,12,1990,7334,6626,1,708,9.70%
Pend Oreille,12/1/90,53051,12,1990,3439,2852,1,587,17.10%
Pierce,12/1/90,53053,12,1990,282966,267410,1,15556,5.50%
San Juan,12/1/90,53055,12,1990,4870,4705,1,165,3.40%
Skagit,12/1/90,53057,12,1990,39162,35476,1,3686,9.40%
Skamania,12/1/90,53059,12,1990,3966,3511,1,455,11.50%
Snohomish,12/1/90,53061,12,1990,249089,238878,1,10211,4.10%
Spokane,12/1/90,53063,12,1990,177587,166202,1,11385,6.40%
Stevens,12/1/90,53065,12,1990,13673,12286,1,1387,10.10%
Thurston,12/1/90,53067,12,1990,82361,77871,1,4490,5.50%
Wahkiakum,12/1/90,53069,12,1990,1443,1336,1,107,7.40%
Walla Walla,12/1/90,53071,12,1990,23038,20925,1,2113,9.20%
Whatcom,12/1/90,53073,12,1990,70015,65547,1,4468,6.40%
Whitman,12/1/90,53075,12,1990,17822,17469,1,353,2.00%
Yakima,12/1/90,53077,12,1990,98123,83765,1,14358,14.60%
Adams,12/1/91,53001,12,1991,7604,6061,1,1543,20.30%
Asotin,12/1/91,53003,12,1991,9703,9084,1,619,6.40%
Clallam,12/1/91,53009,12,1991,22920,20811,1,2109,9.20%
Columbia,12/1/91,53013,12,1991,1134,919,1,215,19.00%
Cowlitz,12/1/91,53015,12,1991,38270,34484,1,3786,9.90%
Douglas,12/1/91,53017,12,1991,15135,13720,1,1415,9.30%
Ferry,12/1/91,53019,12,1991,2719,2378,1,341,12.50%
Franklin,12/1/91,53021,12,1991,19786,16787,1,2999,15.20%
Garfield,12/1/91,53023,12,1991,951,918,1,33,3.50%
Grant,12/1/91,53025,12,1991,26918,23221,1,3697,13.70%
Grays Harbor,12/1/91,53027,12,1991,27233,23557,1,3676,13.50%
Island,12/1/91,53029,12,1991,23432,22185,1,1247,5.30%
Jefferson,12/1/91,53031,12,1991,8263,7573,1,690,8.40%
King,12/1/91,53033,12,1991,866781,824443,1,42338,4.90%
Kitsap,12/1/91,53035,12,1991,87840,83206,1,4634,5.30%
Kittitas,12/1/91,53037,12,1991,12508,11004,1,1504,12.00%
Klickitat,12/1/91,53039,12,1991,7694,6622,1,1072,13.90%
Lewis,12/1/91,53041,12,1991,26959,23851,1,3108,11.50%
Lincoln,12/1/91,53043,12,1991,3845,3591,1,254,6.60%
Mason,12/1/91,53045,12,1991,16907,15214,1,1693,10.00%
Okanogan,12/1/91,53047,12,1991,18387,15730,1,2657,14.50%
Pacific,12/1/91,53049,12,1991,8034,6978,1,1056,13.10%
Pend Oreille,12/1/91,53051,12,1991,3553,3032,1,521,14.70%
Pierce,12/1/91,53053,12,1991,282019,263214,1,18805,6.70%
San Juan,12/1/91,53055,12,1991,5053,4766,1,287,5.70%
Skagit,12/1/91,53057,12,1991,41146,36639,1,4507,11.00%
Skamania,12/1/91,53059,12,1991,3958,3329,1,629,15.90%
Snohomish,12/1/91,53061,12,1991,257836,242791,1,15045,5.80%
Spokane,12/1/91,53063,12,1991,180958,169225,1,11733,6.50%
Stevens,12/1/91,53065,12,1991,14128,12613,1,1515,10.70%
Thurston,12/1/91,53067,12,1991,85722,80230,1,5492,6.40%
Wahkiakum,12/1/91,53069,12,1991,1477,1374,1,103,7.00%
Walla Walla,12/1/91,53071,12,1991,23290,21012,1,2278,9.80%
Whatcom,12/1/91,53073,12,1991,71510,66437,1,5073,7.10%
Whitman,12/1/91,53075,12,1991,17502,17143,1,359,2.10%
Yakima,12/1/91,53077,12,1991,98470,82720,1,15750,16.00%
Adams,12/1/92,53001,12,1992,7384,5800,1,1584,21.50%
Asotin,12/1/92,53003,12,1992,10226,9657,1,569,5.60%
Clallam,12/1/92,53009,12,1992,23347,21105,1,2242,9.60%
Columbia,12/1/92,53013,12,1992,1245,1013,1,232,18.60%
Cowlitz,12/1/92,53015,12,1992,38696,34434,1,4262,11.00%
Douglas,12/1/92,53017,12,1992,15565,13978,1,1587,10.20%
Ferry,12/1/92,53019,12,1992,2803,2408,1,395,14.10%
Franklin,12/1/92,53021,12,1992,20849,17689,1,3160,15.20%
Garfield,12/1/92,53023,12,1992,1029,963,1,66,6.40%
Grant,12/1/92,53025,12,1992,27926,24154,1,3772,13.50%
Grays Harbor,12/1/92,53027,12,1992,28524,24492,1,4032,14.10%
Island,12/1/92,53029,12,1992,24751,23252,1,1499,6.10%
Jefferson,12/1/92,53031,12,1992,8626,7852,1,774,9.00%
King,12/1/92,53033,12,1992,899134,846163,1,52971,5.90%
Kitsap,12/1/92,53035,12,1992,90886,85507,1,5379,5.90%
Kittitas,12/1/92,53037,12,1992,13635,11751,1,1884,13.80%
Klickitat,12/1/92,53039,12,1992,7722,6413,1,1309,17.00%
Lewis,12/1/92,53041,12,1992,28273,25076,1,3197,11.30%
Lincoln,12/1/92,53043,12,1992,4060,3788,1,272,6.70%
Mason,12/1/92,53045,12,1992,17184,15770,1,1414,8.20%
Okanogan,12/1/92,53047,12,1992,19047,16081,1,2966,15.60%
Pacific,12/1/92,53049,12,1992,7662,6830,1,832,10.90%
Pend Oreille,12/1/92,53051,12,1992,3687,3150,1,537,14.60%
Pierce,12/1/92,53053,12,1992,294240,272935,1,21305,7.20%
San Juan,12/1/92,53055,12,1992,4984,4583,1,401,8.00%
Skagit,12/1/92,53057,12,1992,41942,37156,1,4786,11.40%
Skamania,12/1/92,53059,12,1992,3738,3030,1,708,18.90%
Snohomish,12/1/92,53061,12,1992,271606,253392,1,18214,6.70%
Spokane,12/1/92,53063,12,1992,185808,173378,1,12430,6.70%
Stevens,12/1/92,53065,12,1992,14839,13338,1,1501,10.10%
Thurston,12/1/92,53067,12,1992,87958,82092,1,5866,6.70%
Wahkiakum,12/1/92,53069,12,1992,1568,1443,1,125,8.00%
Walla Walla,12/1/92,53071,12,1992,24372,21930,1,2442,10.00%
Whatcom,12/1/92,53073,12,1992,74177,68466,1,5711,7.70%
Whitman,12/1/92,53075,12,1992,17786,17348,1,438,2.50%
Yakima,12/1/92,53077,12,1992,103924,85526,1,18398,17.70%
Adams,12/1/93,53001,12,1993,7698,6252,1,1446,18.80%
Asotin,12/1/93,53003,12,1993,10787,10345,1,442,4.10%
Clallam,12/1/93,53009,12,1993,24358,21727,1,2631,10.80%
Columbia,12/1/93,53013,12,1993,1306,1079,1,227,17.40%
Cowlitz,12/1/93,53015,12,1993,39275,35172,1,4103,10.40%
Douglas,12/1/93,53017,12,1993,16469,14993,1,1476,9.00%
Ferry,12/1/93,53019,12,1993,2837,2410,1,427,15.10%
Franklin,12/1/93,53021,12,1993,21598,19099,1,2499,11.60%
Garfield,12/1/93,53023,12,1993,1047,968,1,79,7.50%
Grant,12/1/93,53025,12,1993,29230,25854,1,3376,11.50%
Grays Harbor,12/1/93,53027,12,1993,28383,24344,1,4039,14.20%
Island,12/1/93,53029,12,1993,25113,23831,1,1282,5.10%
Jefferson,12/1/93,53031,12,1993,9588,8762,1,826,8.60%
King,12/1/93,53033,12,1993,896755,852174,1,44581,5.00%
Kitsap,12/1/93,53035,12,1993,91232,85534,1,5698,6.20%
Kittitas,12/1/93,53037,12,1993,13456,12097,1,1359,10.10%
Klickitat,12/1/93,53039,12,1993,7953,6923,1,1030,13.00%
Lewis,12/1/93,53041,12,1993,28470,25499,1,2971,10.40%
Lincoln,12/1/93,53043,12,1993,4253,3943,1,310,7.30%
Mason,12/1/93,53045,12,1993,18551,17004,1,1547,8.30%
Okanogan,12/1/93,53047,12,1993,19953,17179,1,2774,13.90%
Pacific,12/1/93,53049,12,1993,7876,6983,1,893,11.30%
Pend Oreille,12/1/93,53051,12,1993,3795,3327,1,468,12.30%
Pierce,12/1/93,53053,12,1993,309472,287680,1,21792,7.00%
San Juan,12/1/93,53055,12,1993,5185,4768,1,417,8.00%
Skagit,12/1/93,53057,12,1993,43922,39045,1,4877,11.10%
Skamania,12/1/93,53059,12,1993,4015,3492,1,523,13.00%
Snohomish,12/1/93,53061,12,1993,275216,259034,1,16182,5.90%
Spokane,12/1/93,53063,12,1993,194250,183692,1,10558,5.40%
Stevens,12/1/93,53065,12,1993,15899,14299,1,1600,10.10%
Thurston,12/1/93,53067,12,1993,92066,85792,1,6274,6.80%
Wahkiakum,12/1/93,53069,12,1993,1641,1490,1,151,9.20%
Walla Walla,12/1/93,53071,12,1993,24605,22753,1,1852,7.50%
Whatcom,12/1/93,53073,12,1993,77117,71655,1,5462,7.10%
Whitman,12/1/93,53075,12,1993,18569,18138,1,431,2.30%
Yakima,12/1/93,53077,12,1993,106295,89841,1,16454,15.50%
Adams,12/1/94,53001,12,1994,7835,6421,1,1414,18.00%
Asotin,12/1/94,53003,12,1994,11203,10860,1,343,3.10%
Clallam,12/1/94,53009,12,1994,23775,21297,1,2478,10.40%
Columbia,12/1/94,53013,12,1994,1343,1106,1,237,17.60%
Cowlitz,12/1/94,53015,12,1994,40737,37542,1,3195,7.80%
Douglas,12/1/94,53017,12,1994,17226,15711,1,1515,8.80%
Ferry,12/1/94,53019,12,1994,2948,2553,1,395,13.40%
Franklin,12/1/94,53021,12,1994,22885,20273,1,2612,11.40%
Garfield,12/1/94,53023,12,1994,1011,944,1,67,6.60%
Grant,12/1/94,53025,12,1994,30885,27110,1,3775,12.20%
Grays Harbor,12/1/94,53027,12,1994,28203,24531,1,3672,13.00%
Island,12/1/94,53029,12,1994,26125,24820,1,1305,5.00%
Jefferson,12/1/94,53031,12,1994,9664,8810,1,854,8.80%
King,12/1/94,53033,12,1994,890157,856806,1,33351,3.70%
Kitsap,12/1/94,53035,12,1994,93718,88061,1,5657,6.00%
Kittitas,12/1/94,53037,12,1994,14435,13240,1,1195,8.30%
Klickitat,12/1/94,53039,12,1994,8287,7231,1,1056,12.70%
Lewis,12/1/94,53041,12,1994,29799,27010,1,2789,9.40%
Lincoln,12/1/94,53043,12,1994,4355,4036,1,319,7.30%
Mason,12/1/94,53045,12,1994,19151,17555,1,1596,8.30%
Okanogan,12/1/94,53047,12,1994,20330,17549,1,2781,13.70%
Pacific,12/1/94,53049,12,1994,8189,7198,1,991,12.10%
Pend Oreille,12/1/94,53051,12,1994,3864,3333,1,531,13.70%
Pierce,12/1/94,53053,12,1994,319824,299579,1,20245,6.30%
San Juan,12/1/94,53055,12,1994,5180,4726,1,454,8.80%
Skagit,12/1/94,53057,12,1994,46609,41640,1,4969,10.70%
Skamania,12/1/94,53059,12,1994,3943,3488,1,455,11.50%
Snohomish,12/1/94,53061,12,1994,276781,264317,1,12464,4.50%
Spokane,12/1/94,53063,12,1994,201639,190497,1,11142,5.50%
Stevens,12/1/94,53065,12,1994,16814,15249,1,1565,9.30%
Thurston,12/1/94,53067,12,1994,95085,88889,1,6196,6.50%
Wahkiakum,12/1/94,53069,12,1994,1590,1462,1,128,8.10%
Walla Walla,12/1/94,53071,12,1994,25295,23462,1,1833,7.20%
Whatcom,12/1/94,53073,12,1994,78017,71273,1,6744,8.60%
Whitman,12/1/94,53075,12,1994,19246,18802,1,444,2.30%
Yakima,12/1/94,53077,12,1994,108883,92296,1,16587,15.20%
Adams,12/1/95,53001,12,1995,8397,7196,1,1201,14.30%
Asotin,12/1/95,53003,12,1995,11535,11139,1,396,3.40%
Clallam,12/1/95,53009,12,1995,24846,22591,1,2255,9.10%
Columbia,12/1/95,53013,12,1995,1312,1067,1,245,18.70%
Cowlitz,12/1/95,53015,12,1995,41845,38407,1,3438,8.20%
Douglas,12/1/95,53017,12,1995,16973,15408,1,1565,9.20%
Ferry,12/1/95,53019,12,1995,2828,2480,1,348,12.30%
Franklin,12/1/95,53021,12,1995,22255,19191,1,3064,13.80%
Garfield,12/1/95,53023,12,1995,1014,949,1,65,6.40%
Grant,12/1/95,53025,12,1995,32287,28446,1,3841,11.90%
Grays Harbor,12/1/95,53027,12,1995,28536,25299,1,3237,11.30%
Island,12/1/95,53029,12,1995,26623,25420,1,1203,4.50%
Jefferson,12/1/95,53031,12,1995,9865,9059,1,806,8.20%
King,12/1/95,53033,12,1995,902220,861963,1,40257,4.50%
Kitsap,12/1/95,53035,12,1995,92909,86738,1,6171,6.60%
Kittitas,12/1/95,53037,12,1995,15017,13543,1,1474,9.80%
Klickitat,12/1/95,53039,12,1995,8506,7454,1,1052,12.40%
Lewis,12/1/95,53041,12,1995,30654,27766,1,2888,9.40%
Lincoln,12/1/95,53043,12,1995,4577,4284,1,293,6.40%
Mason,12/1/95,53045,12,1995,20406,18891,1,1515,7.40%
Okanogan,12/1/95,53047,12,1995,20406,17636,1,2770,13.60%
Pacific,12/1/95,53049,12,1995,8483,7494,1,989,11.70%
Pend Oreille,12/1/95,53051,12,1995,4063,3477,1,586,14.40%
Pierce,12/1/95,53053,12,1995,324673,304952,1,19721,6.10%
San Juan,12/1/95,53055,12,1995,5306,4835,1,471,8.90%
Skagit,12/1/95,53057,12,1995,48698,43756,1,4942,10.10%
Skamania,12/1/95,53059,12,1995,4051,3621,1,430,10.60%
Snohomish,12/1/95,53061,12,1995,283214,268197,1,15017,5.30%
Spokane,12/1/95,53063,12,1995,205472,193858,1,11614,5.70%
Stevens,12/1/95,53065,12,1995,17028,15375,1,1653,9.70%
Thurston,12/1/95,53067,12,1995,97705,91501,1,6204,6.30%
Wahkiakum,12/1/95,53069,12,1995,1676,1550,1,126,7.50%
Walla Walla,12/1/95,53071,12,1995,25976,24096,1,1880,7.20%
Whatcom,12/1/95,53073,12,1995,81046,75134,1,5912,7.30%
Whitman,12/1/95,53075,12,1995,19205,18751,1,454,2.40%
Yakima,12/1/95,53077,12,1995,109674,92705,1,16969,15.50%
Adams,12/1/96,53001,12,1996,7800,6670,1,1130,14.50%
Asotin,12/1/96,53003,12,1996,12305,11824,1,481,3.90%
Clallam,12/1/96,53009,12,1996,24875,22784,1,2091,8.40%
Columbia,12/1/96,53013,12,1996,1307,1087,1,220,16.80%
Cowlitz,12/1/96,53015,12,1996,42332,39407,1,2925,6.90%
Douglas,12/1/96,53017,12,1996,17627,16139,1,1488,8.40%
Ferry,12/1/96,53019,12,1996,2828,2524,1,304,10.70%
Franklin,12/1/96,53021,12,1996,22348,19359,1,2989,13.40%
Garfield,12/1/96,53023,12,1996,1041,1013,1,28,2.70%
Grant,12/1/96,53025,12,1996,33208,29366,1,3842,11.60%
Grays Harbor,12/1/96,53027,12,1996,28341,25426,1,2915,10.30%
Island,12/1/96,53029,12,1996,28039,26804,1,1235,4.40%
Jefferson,12/1/96,53031,12,1996,10106,9300,1,806,8.00%
King,12/1/96,53033,12,1996,939623,904894,1,34729,3.70%
Kitsap,12/1/96,53035,12,1996,98554,93100,1,5454,5.50%
Kittitas,12/1/96,53037,12,1996,15591,14493,1,1098,7.00%
Klickitat,12/1/96,53039,12,1996,8917,7787,1,1130,12.70%
Lewis,12/1/96,53041,12,1996,31311,28586,1,2725,8.70%
Lincoln,12/1/96,53043,12,1996,4794,4525,1,269,5.60%
Mason,12/1/96,53045,12,1996,20768,19269,1,1499,7.20%
Okanogan,12/1/96,53047,12,1996,21022,18411,1,2611,12.40%
Pacific,12/1/96,53049,12,1996,8261,7403,1,858,10.40%
Pend Oreille,12/1/96,53051,12,1996,4286,3543,1,743,17.30%
Pierce,12/1/96,53053,12,1996,335963,319567,1,16396,4.90%
San Juan,12/1/96,53055,12,1996,5218,4790,1,428,8.20%
Skagit,12/1/96,53057,12,1996,47647,43512,1,4135,8.70%
Skamania,12/1/96,53059,12,1996,3970,3504,1,466,11.70%
Snohomish,12/1/96,53061,12,1996,296676,284808,1,11868,4.00%
Spokane,12/1/96,53063,12,1996,211567,201020,1,10547,5.00%
Stevens,12/1/96,53065,12,1996,17694,15899,1,1795,10.10%
Thurston,12/1/96,53067,12,1996,100728,95017,1,5711,5.70%
Wahkiakum,12/1/96,53069,12,1996,1751,1628,1,123,7.00%
Walla Walla,12/1/96,53071,12,1996,26232,24185,1,2047,7.80%
Whatcom,12/1/96,53073,12,1996,80613,75405,1,5208,6.50%
Whitman,12/1/96,53075,12,1996,19816,19433,1,383,1.90%
Yakima,12/1/96,53077,12,1996,109223,94088,1,15135,13.90%
Adams,12/1/97,53001,12,1997,7916,6730,1,1186,15.00%
Asotin,12/1/97,53003,12,1997,12829,12275,1,554,4.30%
Clallam,12/1/97,53009,12,1997,25287,23280,1,2007,7.90%
Columbia,12/1/97,53013,12,1997,1296,1110,1,186,14.40%
Cowlitz,12/1/97,53015,12,1997,43218,40321,1,2897,6.70%
Douglas,12/1/97,53017,12,1997,18473,17161,1,1312,7.10%
Ferry,12/1/97,53019,12,1997,2751,2490,1,261,9.50%
Franklin,12/1/97,53021,12,1997,22814,20153,1,2661,11.70%
Garfield,12/1/97,53023,12,1997,1026,963,1,63,6.10%
Grant,12/1/97,53025,12,1997,35333,31598,1,3735,10.60%
Grays Harbor,12/1/97,53027,12,1997,28795,26134,1,2661,9.20%
Island,12/1/97,53029,12,1997,30014,28941,1,1073,3.60%
Jefferson,12/1/97,53031,12,1997,10250,9561,1,689,6.70%
King,12/1/97,53033,12,1997,967263,941500,1,25763,2.70%
Kitsap,12/1/97,53035,12,1997,97758,92893,1,4865,5.00%
Kittitas,12/1/97,53037,12,1997,15587,14549,1,1038,6.70%
Klickitat,12/1/97,53039,12,1997,9153,8159,1,994,10.90%
Lewis,12/1/97,53041,12,1997,33199,30640,1,2559,7.70%
Lincoln,12/1/97,53043,12,1997,4874,4619,1,255,5.20%
Mason,12/1/97,53045,12,1997,22925,21602,1,1323,5.80%
Okanogan,12/1/97,53047,12,1997,21502,19022,1,2480,11.50%
Pacific,12/1/97,53049,12,1997,8963,8084,1,879,9.80%
Pend Oreille,12/1/97,53051,12,1997,4354,3856,1,498,11.40%
Pierce,12/1/97,53053,12,1997,346434,332652,1,13782,4.00%
San Juan,12/1/97,53055,12,1997,5516,5164,1,352,6.40%
Skagit,12/1/97,53057,12,1997,49051,45556,1,3495,7.10%
Skamania,12/1/97,53059,12,1997,4256,3787,1,469,11.00%
Snohomish,12/1/97,53061,12,1997,313478,304650,1,8828,2.80%
Spokane,12/1/97,53063,12,1997,217272,207730,1,9542,4.40%
Stevens,12/1/97,53065,12,1997,18012,16531,1,1481,8.20%
Thurston,12/1/97,53067,12,1997,104902,100027,1,4875,4.60%
Wahkiakum,12/1/97,53069,12,1997,1921,1808,1,113,5.90%
Walla Walla,12/1/97,53071,12,1997,26968,24950,1,2018,7.50%
Whatcom,12/1/97,53073,12,1997,83088,78563,1,4525,5.40%
Whitman,12/1/97,53075,12,1997,20187,19779,1,408,2.00%
Yakima,12/1/97,53077,12,1997,112739,99617,1,13122,11.60%
Adams,12/1/98,53001,12,1998,7991,6701,1,1290,16.10%
Asotin,12/1/98,53003,12,1998,13228,12705,1,523,4.00%
Clallam,12/1/98,53009,12,1998,26081,24109,1,1972,7.60%
Columbia,12/1/98,53013,12,1998,1365,1143,1,222,16.30%
Cowlitz,12/1/98,53015,12,1998,45746,42415,1,3331,7.30%
Douglas,12/1/98,53017,12,1998,18796,17229,1,1567,8.30%
Ferry,12/1/98,53019,12,1998,2784,2450,1,334,12.00%
Franklin,12/1/98,53021,12,1998,24114,20829,1,3285,13.60%
Garfield,12/1/98,53023,12,1998,1068,1008,1,60,5.60%
Grant,12/1/98,53025,12,1998,37454,32747,1,4707,12.60%
Grays Harbor,12/1/98,53027,12,1998,28706,26062,1,2644,9.20%
Island,12/1/98,53029,12,1998,31201,30243,1,958,3.10%
Jefferson,12/1/98,53031,12,1998,10315,9634,1,681,6.60%
King,12/1/98,53033,12,1998,977538,950477,1,27061,2.80%
Kitsap,12/1/98,53035,12,1998,96463,91979,1,4484,4.60%
Kittitas,12/1/98,53037,12,1998,15985,15048,1,937,5.90%
Klickitat,12/1/98,53039,12,1998,8758,7768,1,990,11.30%
Lewis,12/1/98,53041,12,1998,31595,28880,1,2715,8.60%
Lincoln,12/1/98,53043,12,1998,4895,4579,1,316,6.50%
Mason,12/1/98,53045,12,1998,22523,21166,1,1357,6.00%
Okanogan,12/1/98,53047,12,1998,21715,19102,1,2613,12.00%
Pacific,12/1/98,53049,12,1998,8394,7560,1,834,9.90%
Pend Oreille,12/1/98,53051,12,1998,4465,3955,1,510,11.40%
Pierce,12/1/98,53053,12,1998,358265,344129,1,14136,3.90%
San Juan,12/1/98,53055,12,1998,5819,5497,1,322,5.50%
Skagit,12/1/98,53057,12,1998,50541,46833,1,3708,7.30%
Skamania,12/1/98,53059,12,1998,4311,3878,1,433,10.00%
Snohomish,12/1/98,53061,12,1998,323661,313709,1,9952,3.10%
Spokane,12/1/98,53063,12,1998,225079,213741,1,11338,5.00%
Stevens,12/1/98,53065,12,1998,18388,16850,1,1538,8.40%
Thurston,12/1/98,53067,12,1998,109196,104512,1,4684,4.30%
Wahkiakum,12/1/98,53069,12,1998,1987,1831,1,156,7.90%
Walla Walla,12/1/98,53071,12,1998,27678,25260,1,2418,8.70%
Whatcom,12/1/98,53073,12,1998,84610,80048,1,4562,5.40%
Whitman,12/1/98,53075,12,1998,20527,20113,1,414,2.00%
Yakima,12/1/98,53077,12,1998,113194,99289,1,13905,12.30%
Adams,12/1/99,53001,12,1999,7678,6587,1,1091,14.20%
Asotin,12/1/99,53003,12,1999,12951,12516,1,435,3.40%
Clallam,12/1/99,53009,12,1999,26225,24407,1,1818,6.90%
Columbia,12/1/99,53013,12,1999,1357,1158,1,199,14.70%
Cowlitz,12/1/99,53015,12,1999,44217,41301,1,2916,6.60%
Douglas,12/1/99,53017,12,1999,18660,17267,1,1393,7.50%
Ferry,12/1/99,53019,12,1999,2673,2411,1,262,9.80%
Franklin,12/1/99,53021,12,1999,23413,20683,1,2730,11.70%
Garfield,12/1/99,53023,12,1999,1035,983,1,52,5.00%
Grant,12/1/99,53025,12,1999,36370,32518,1,3852,10.60%
Grays Harbor,12/1/99,53027,12,1999,26767,24569,1,2198,8.20%
Island,12/1/99,53029,12,1999,31784,30533,1,1251,3.90%
Jefferson,12/1/99,53031,12,1999,11207,10559,1,648,5.80%
King,12/1/99,53033,12,1999,979941,949715,1,30226,3.10%
Kitsap,12/1/99,53035,12,1999,99703,95116,1,4587,4.60%
Kittitas,12/1/99,53037,12,1999,14822,14053,1,769,5.20%
Klickitat,12/1/99,53039,12,1999,8595,7682,1,913,10.60%
Lewis,12/1/99,53041,12,1999,30486,28044,1,2442,8.00%
Lincoln,12/1/99,53043,12,1999,4576,4318,1,258,5.60%
Mason,12/1/99,53045,12,1999,21314,20067,1,1247,5.90%
Okanogan,12/1/99,53047,12,1999,19658,17379,1,2279,11.60%
Pacific,12/1/99,53049,12,1999,7753,7152,1,601,7.80%
Pend Oreille,12/1/99,53051,12,1999,4266,3882,1,384,9.00%
Pierce,12/1/99,53053,12,1999,352375,337312,1,15063,4.30%
San Juan,12/1/99,53055,12,1999,6449,6213,1,236,3.70%
Skagit,12/1/99,53057,12,1999,52027,48692,1,3335,6.40%
Skamania,12/1/99,53059,12,1999,4187,3843,1,344,8.20%
Snohomish,12/1/99,53061,12,1999,331042,317389,1,13653,4.10%
Spokane,12/1/99,53063,12,1999,225508,214493,1,11015,4.90%
Stevens,12/1/99,53065,12,1999,17608,16125,1,1483,8.40%
Thurston,12/1/99,53067,12,1999,108490,103836,1,4654,4.30%
Wahkiakum,12/1/99,53069,12,1999,1926,1824,1,102,5.30%
Walla Walla,12/1/99,53071,12,1999,27124,25237,1,1887,7.00%
Whatcom,12/1/99,53073,12,1999,86965,82704,1,4261,4.90%
Whitman,12/1/99,53075,12,1999,19894,19522,1,372,1.90%
Yakima,12/1/99,53077,12,1999,107690,95899,1,11791,10.90%
Adams,12/1/00,53001,12,2000,7349,6363,1,986,13.40%
Asotin,12/1/00,53003,12,2000,9551,8955,1,596,6.20%
Clallam,12/1/00,53009,12,2000,25650,23559,1,2091,8.20%
Columbia,12/1/00,53013,12,2000,1542,1385,1,157,10.20%
Cowlitz,12/1/00,53015,12,2000,42935,39907,1,3028,7.10%
Douglas,12/1/00,53017,12,2000,16578,15196,1,1382,8.30%
Ferry,12/1/00,53019,12,2000,2882,2580,1,302,10.50%
Franklin,12/1/00,53021,12,2000,22804,20302,1,2502,11.00%
Garfield,12/1/00,53023,12,2000,982,922,1,60,6.10%
Grant,12/1/00,53025,12,2000,33342,29598,1,3744,11.20%
Grays Harbor,12/1/00,53027,12,2000,29319,26558,1,2761,9.40%
Island,12/1/00,53029,12,2000,29019,27495,1,1524,5.30%
Jefferson,12/1/00,53031,12,2000,11586,10856,1,730,6.30%
King,12/1/00,53033,12,2000,987555,954297,1,33258,3.40%
Kitsap,12/1/00,53035,12,2000,106567,100754,1,5813,5.50%
Kittitas,12/1/00,53037,12,2000,16883,15740,1,1143,6.80%
Klickitat,12/1/00,53039,12,2000,9057,8187,1,870,9.60%
Lewis,12/1/00,53041,12,2000,29591,27083,1,2508,8.50%
Lincoln,12/1/00,53043,12,2000,4379,4102,1,277,6.30%
Mason,12/1/00,53045,12,2000,20848,19289,1,1559,7.50%
Okanogan,12/1/00,53047,12,2000,18245,16061,1,2184,12.00%
Pacific,12/1/00,53049,12,2000,8498,7718,1,780,9.20%
Pend Oreille,12/1/00,53051,12,2000,4552,4155,1,397,8.70%
Pierce,12/1/00,53053,12,2000,344063,325262,1,18801,5.50%
San Juan,12/1/00,53055,12,2000,7144,6764,1,380,5.30%
Skagit,12/1/00,53057,12,2000,51475,47958,1,3517,6.80%
Skamania,12/1/00,53059,12,2000,4914,4573,1,341,6.90%
Snohomish,12/1/00,53061,12,2000,323346,311493,1,11853,3.70%
Spokane,12/1/00,53063,12,2000,214706,201511,1,13195,6.10%
Stevens,12/1/00,53065,12,2000,17422,15906,1,1516,8.70%
Thurston,12/1/00,53067,12,2000,109226,103584,1,5642,5.20%
Wahkiakum,12/1/00,53069,12,2000,1635,1506,1,129,7.90%
Walla Walla,12/1/00,53071,12,2000,26681,24730,1,1951,7.30%
Whatcom,12/1/00,53073,12,2000,88509,83186,1,5323,6.00%
Whitman,12/1/00,53075,12,2000,19634,18817,1,817,4.20%
Yakima,12/1/00,53077,12,2000,105883,94495,1,11388,10.80%
Adams,12/1/01,53001,12,2001,7423,6374,1,1049,14.10%
Asotin,12/1/01,53003,12,2001,9799,9252,1,547,5.60%
Clallam,12/1/01,53009,12,2001,25873,23533,1,2340,9.00%
Columbia,12/1/01,53013,12,2001,1530,1352,1,178,11.60%
Cowlitz,12/1/01,53015,12,2001,42558,38036,1,4522,10.60%
Douglas,12/1/01,53017,12,2001,16147,14549,1,1598,9.90%
Ferry,12/1/01,53019,12,2001,2806,2482,1,324,11.50%
Franklin,12/1/01,53021,12,2001,23460,20794,1,2666,11.40%
Garfield,12/1/01,53023,12,2001,1023,944,1,79,7.70%
Grant,12/1/01,53025,12,2001,32758,28701,1,4057,12.40%
Grays Harbor,12/1/01,53027,12,2001,28626,25547,1,3079,10.80%
Island,12/1/01,53029,12,2001,29288,27195,1,2093,7.10%
Jefferson,12/1/01,53031,12,2001,12127,11162,1,965,8.00%
King,12/1/01,53033,12,2001,989833,935425,1,54408,5.50%
Kitsap,12/1/01,53035,12,2001,107494,100163,1,7331,6.80%
Kittitas,12/1/01,53037,12,2001,16626,15275,1,1351,8.10%
Klickitat,12/1/01,53039,12,2001,8499,7404,1,1095,12.90%
Lewis,12/1/01,53041,12,2001,29009,26123,1,2886,9.90%
Lincoln,12/1/01,53043,12,2001,4343,4003,1,340,7.80%
Mason,12/1/01,53045,12,2001,21029,19133,1,1896,9.00%
Okanogan,12/1/01,53047,12,2001,16580,14197,1,2383,14.40%
Pacific,12/1/01,53049,12,2001,8453,7601,1,852,10.10%
Pend Oreille,12/1/01,53051,12,2001,4760,4278,1,482,10.10%
Pierce,12/1/01,53053,12,2001,340701,314464,1,26237,7.70%
San Juan,12/1/01,53055,12,2001,6861,6420,1,441,6.40%
Skagit,12/1/01,53057,12,2001,50659,46098,1,4561,9.00%
Skamania,12/1/01,53059,12,2001,5199,4321,1,878,16.90%
Snohomish,12/1/01,53061,12,2001,329365,309528,1,19837,6.00%
Spokane,12/1/01,53063,12,2001,213974,196905,1,17069,8.00%
Stevens,12/1/01,53065,12,2001,17421,15460,1,1961,11.30%
Thurston,12/1/01,53067,12,2001,109449,102141,1,7308,6.70%
Wahkiakum,12/1/01,53069,12,2001,1578,1430,1,148,9.40%
Walla Walla,12/1/01,53071,12,2001,27163,25014,1,2149,7.90%
Whatcom,12/1/01,53073,12,2001,89218,82435,1,6783,7.60%
Whitman,12/1/01,53075,12,2001,19069,18174,1,895,4.70%
Yakima,12/1/01,53077,12,2001,103302,89881,1,13421,13.00%
Adams,12/1/02,53001,12,2002,7472,6425,1,1047,14.00%
Asotin,12/1/02,53003,12,2002,10203,9599,1,604,5.90%
Clallam,12/1/02,53009,12,2002,26794,24252,1,2542,9.50%
Columbia,12/1/02,53013,12,2002,1483,1298,1,185,12.50%
Cowlitz,12/1/02,53015,12,2002,42607,38297,1,4310,10.10%
Douglas,12/1/02,53017,12,2002,16873,15417,1,1456,8.60%
Ferry,12/1/02,53019,12,2002,3030,2692,1,338,11.20%
Franklin,12/1/02,53021,12,2002,25055,22106,1,2949,11.80%
Garfield,12/1/02,53023,12,2002,990,923,1,67,6.80%
Grant,12/1/02,53025,12,2002,33637,29623,1,4014,11.90%
Grays Harbor,12/1/02,53027,12,2002,29742,26878,1,2864,9.60%
Island,12/1/02,53029,12,2002,30649,28494,1,2155,7.00%
Jefferson,12/1/02,53031,12,2002,12662,11638,1,1024,8.10%
King,12/1/02,53033,12,2002,976748,917943,1,58805,6.00%
Kitsap,12/1/02,53035,12,2002,113317,105704,1,7613,6.70%
Kittitas,12/1/02,53037,12,2002,17444,16049,1,1395,8.00%
Klickitat,12/1/02,53039,12,2002,9036,7957,1,1079,11.90%
Lewis,12/1/02,53041,12,2002,30020,27246,1,2774,9.20%
Lincoln,12/1/02,53043,12,2002,4507,4174,1,333,7.40%
Mason,12/1/02,53045,12,2002,22672,20791,1,1881,8.30%
Okanogan,12/1/02,53047,12,2002,17175,15079,1,2096,12.20%
Pacific,12/1/02,53049,12,2002,8738,7880,1,858,9.80%
Pend Oreille,12/1/02,53051,12,2002,4720,4271,1,449,9.50%
Pierce,12/1/02,53053,12,2002,352966,325363,1,27603,7.80%
San Juan,12/1/02,53055,12,2002,7158,6651,1,507,7.10%
Skagit,12/1/02,53057,12,2002,51776,47331,1,4445,8.60%
Skamania,12/1/02,53059,12,2002,4819,4329,1,490,10.20%
Snohomish,12/1/02,53061,12,2002,329966,307247,1,22719,6.90%
Spokane,12/1/02,53063,12,2002,216350,200222,1,16128,7.50%
Stevens,12/1/02,53065,12,2002,17311,15665,1,1646,9.50%
Thurston,12/1/02,53067,12,2002,114613,107432,1,7181,6.30%
Wahkiakum,12/1/02,53069,12,2002,1533,1371,1,162,10.60%
Walla Walla,12/1/02,53071,12,2002,28284,26249,1,2035,7.20%
Whatcom,12/1/02,53073,12,2002,94089,87948,1,6141,6.50%
Whitman,12/1/02,53075,12,2002,19776,18895,1,881,4.50%
Yakima,12/1/02,53077,12,2002,107646,95078,1,12568,11.70%
Adams,12/1/03,53001,12,2003,7445,6532,1,913,12.30%
Asotin,12/1/03,53003,12,2003,10069,9364,1,705,7.00%
Clallam,12/1/03,53009,12,2003,27368,25172,1,2196,8.00%
Columbia,12/1/03,53013,12,2003,1520,1370,1,150,9.90%
Cowlitz,12/1/03,53015,12,2003,43204,39127,1,4077,9.40%
Douglas,12/1/03,53017,12,2003,17687,16166,1,1521,8.60%
Ferry,12/1/03,53019,12,2003,2961,2572,1,389,13.10%
Franklin,12/1/03,53021,12,2003,26507,23510,1,2997,11.30%
Garfield,12/1/03,53023,12,2003,1047,984,1,63,6.00%
Grant,12/1/03,53025,12,2003,35065,30962,1,4103,11.70%
Grays Harbor,12/1/03,53027,12,2003,30511,27809,1,2702,8.90%
Island,12/1/03,53029,12,2003,31103,28800,1,2303,7.40%
Jefferson,12/1/03,53031,12,2003,13171,12274,1,897,6.80%
King,12/1/03,53033,12,2003,987814,937091,1,50723,5.10%
Kitsap,12/1/03,53035,12,2003,117641,110620,1,7021,6.00%
Kittitas,12/1/03,53037,12,2003,18090,16617,1,1473,8.10%
Klickitat,12/1/03,53039,12,2003,9037,7870,1,1167,12.90%
Lewis,12/1/03,53041,12,2003,30632,27851,1,2781,9.10%
Lincoln,12/1/03,53043,12,2003,4644,4289,1,355,7.60%
Mason,12/1/03,53045,12,2003,23410,21477,1,1933,8.30%
Okanogan,12/1/03,53047,12,2003,18436,16521,1,1915,10.40%
Pacific,12/1/03,53049,12,2003,9174,8385,1,789,8.60%
Pend Oreille,12/1/03,53051,12,2003,4938,4418,1,520,10.50%
Pierce,12/1/03,53053,12,2003,360254,332224,1,28030,7.80%
San Juan,12/1/03,53055,12,2003,7535,7078,1,457,6.10%
Skagit,12/1/03,53057,12,2003,53407,48943,1,4464,8.40%
Skamania,12/1/03,53059,12,2003,4947,4407,1,540,10.90%
Snohomish,12/1/03,53061,12,2003,335949,314912,1,21037,6.30%
Spokane,12/1/03,53063,12,2003,220354,203973,1,16381,7.40%
Stevens,12/1/03,53065,12,2003,17960,16290,1,1670,9.30%
Thurston,12/1/03,53067,12,2003,118760,111557,1,7203,6.10%
Wahkiakum,12/1/03,53069,12,2003,1613,1488,1,125,7.70%
Walla Walla,12/1/03,53071,12,2003,28849,26567,1,2282,7.90%
Whatcom,12/1/03,53073,12,2003,98486,92260,1,6226,6.30%
Whitman,12/1/03,53075,12,2003,20116,19263,1,853,4.20%
Yakima,12/1/03,53077,12,2003,110820,97738,1,13082,11.80%
Adams,12/1/04,53001,12,2004,7527,6676,1,851,11.30%
Asotin,12/1/04,53003,12,2004,10419,9682,1,737,7.10%
Clallam,12/1/04,53009,12,2004,28478,26414,1,2064,7.20%
Columbia,12/1/04,53013,12,2004,1465,1311,1,154,10.50%
Cowlitz,12/1/04,53015,12,2004,43024,39383,1,3641,8.50%
Douglas,12/1/04,53017,12,2004,18411,17086,1,1325,7.20%
Ferry,12/1/04,53019,12,2004,2981,2679,1,302,10.10%
Franklin,12/1/04,53021,12,2004,28145,25467,1,2678,9.50%
Garfield,12/1/04,53023,12,2004,1046,972,1,74,7.10%
Grant,12/1/04,53025,12,2004,35155,31617,1,3538,10.10%
Grays Harbor,12/1/04,53027,12,2004,31679,28950,1,2729,8.60%
Island,12/1/04,53029,12,2004,31880,29832,1,2048,6.40%
Jefferson,12/1/04,53031,12,2004,13519,12644,1,875,6.50%
King,12/1/04,53033,12,2004,999366,955763,1,43603,4.40%
Kitsap,12/1/04,53035,12,2004,121750,115065,1,6685,5.50%
Kittitas,12/1/04,53037,12,2004,18153,16873,1,1280,7.10%
Klickitat,12/1/04,53039,12,2004,8919,8071,1,848,9.50%
Lewis,12/1/04,53041,12,2004,31153,28468,1,2685,8.60%
Lincoln,12/1/04,53043,12,2004,4737,4378,1,359,7.60%
Mason,12/1/04,53045,12,2004,24442,22733,1,1709,7.00%
Okanogan,12/1/04,53047,12,2004,18617,16698,1,1919,10.30%
Pacific,12/1/04,53049,12,2004,9456,8722,1,734,7.80%
Pend Oreille,12/1/04,53051,12,2004,5097,4640,1,457,9.00%
Pierce,12/1/04,53053,12,2004,371241,347485,1,23756,6.40%
San Juan,12/1/04,53055,12,2004,7800,7381,1,419,5.40%
Skagit,12/1/04,53057,12,2004,55741,51793,1,3948,7.10%
Skamania,12/1/04,53059,12,2004,5150,4676,1,474,9.20%
Snohomish,12/1/04,53061,12,2004,339345,322695,1,16650,4.90%
Spokane,12/1/04,53063,12,2004,225776,211255,1,14521,6.40%
Stevens,12/1/04,53065,12,2004,18189,16613,1,1576,8.70%
Thurston,12/1/04,53067,12,2004,122386,115642,1,6744,5.50%
Wahkiakum,12/1/04,53069,12,2004,1570,1440,1,130,8.30%
Walla Walla,12/1/04,53071,12,2004,28881,26978,1,1903,6.60%
Whatcom,12/1/04,53073,12,2004,102643,96876,1,5767,5.60%
Whitman,12/1/04,53075,12,2004,20783,19933,1,850,4.10%
Yakima,12/1/04,53077,12,2004,111387,100160,1,11227,10.10%
Adams,12/1/05,53001,12,2005,7557,6804,1,753,10.00%
Asotin,12/1/05,53003,12,2005,10696,10136,1,560,5.20%
Clallam,12/1/05,53009,12,2005,29443,27530,1,1913,6.50%
Columbia,12/1/05,53013,12,2005,1517,1376,1,141,9.30%
Cowlitz,12/1/05,53015,12,2005,42993,39981,1,3012,7.00%
Douglas,12/1/05,53017,12,2005,18848,17558,1,1290,6.80%
Ferry,12/1/05,53019,12,2005,2956,2630,1,326,11.00%
Franklin,12/1/05,53021,12,2005,28669,25872,1,2797,9.80%
Garfield,12/1/05,53023,12,2005,1018,954,1,64,6.30%
Grant,12/1/05,53025,12,2005,36024,32429,1,3595,10.00%
Grays Harbor,12/1/05,53027,12,2005,30933,28403,1,2530,8.20%
Island,12/1/05,53029,12,2005,32199,30401,1,1798,5.60%
Jefferson,12/1/05,53031,12,2005,13588,12843,1,745,5.50%
King,12/1/05,53033,12,2005,1025402,988702,1,36700,3.60%
Kitsap,12/1/05,53035,12,2005,123380,117376,1,6004,4.90%
Kittitas,12/1/05,53037,12,2005,18904,17759,1,1145,6.10%
Klickitat,12/1/05,53039,12,2005,8964,8192,1,772,8.60%
Lewis,12/1/05,53041,12,2005,30966,28534,1,2432,7.90%
Lincoln,12/1/05,53043,12,2005,4553,4236,1,317,7.00%
Mason,12/1/05,53045,12,2005,24179,22685,1,1494,6.20%
Okanogan,12/1/05,53047,12,2005,18453,16786,1,1667,9.00%
Pacific,12/1/05,53049,12,2005,8752,8031,1,721,8.20%
Pend Oreille,12/1/05,53051,12,2005,5005,4580,1,425,8.50%
Pierce,12/1/05,53053,12,2005,376917,356604,1,20313,5.40%
San Juan,12/1/05,53055,12,2005,7656,7291,1,365,4.80%
Skagit,12/1/05,53057,12,2005,56041,52627,1,3414,6.10%
Skamania,12/1/05,53059,12,2005,5222,4768,1,454,8.70%
Snohomish,12/1/05,53061,12,2005,350761,336898,1,13863,4.00%
Spokane,12/1/05,53063,12,2005,229882,216416,1,13466,5.90%
Stevens,12/1/05,53065,12,2005,17904,16445,1,1459,8.10%
Thurston,12/1/05,53067,12,2005,124435,118491,1,5944,4.80%
Wahkiakum,12/1/05,53069,12,2005,1579,1460,1,119,7.50%
Walla Walla,12/1/05,53071,12,2005,28282,26502,1,1780,6.30%
Whatcom,12/1/05,53073,12,2005,104113,99131,1,4982,4.80%
Whitman,12/1/05,53075,12,2005,20485,19677,1,808,3.90%
Yakima,12/1/05,53077,12,2005,111243,100283,1,10960,9.90%
Adams,12/1/06,53001,12,2006,7810,6993,1,817,10.50%
Asotin,12/1/06,53003,12,2006,10246,9824,1,422,4.10%
Clallam,12/1/06,53009,12,2006,29796,27802,1,1994,6.70%
Columbia,12/1/06,53013,12,2006,1494,1364,1,130,8.70%
Cowlitz,12/1/06,53015,12,2006,43990,41048,1,2942,6.70%
Douglas,12/1/06,53017,12,2006,18961,17714,1,1247,6.60%
Ferry,12/1/06,53019,12,2006,2956,2694,1,262,8.90%
Franklin,12/1/06,53021,12,2006,30351,27275,1,3076,10.10%
Garfield,12/1/06,53023,12,2006,1000,941,1,59,5.90%
Grant,12/1/06,53025,12,2006,36524,33211,1,3313,9.10%
Grays Harbor,12/1/06,53027,12,2006,30974,28367,1,2607,8.40%
Island,12/1/06,53029,12,2006,32721,30967,1,1754,5.40%
Jefferson,12/1/06,53031,12,2006,13675,12950,1,725,5.30%
King,12/1/06,53033,12,2006,1052432,1017396,1,35036,3.30%
Kitsap,12/1/06,53035,12,2006,124037,118128,1,5909,4.80%
Kittitas,12/1/06,53037,12,2006,18698,17556,1,1142,6.10%
Klickitat,12/1/06,53039,12,2006,9240,8523,1,717,7.80%
Lewis,12/1/06,53041,12,2006,31797,28966,1,2831,8.90%
Lincoln,12/1/06,53043,12,2006,4646,4336,1,310,6.70%
Mason,12/1/06,53045,12,2006,25343,23684,1,1659,6.50%
Okanogan,12/1/06,53047,12,2006,18662,16899,1,1763,9.40%
Pacific,12/1/06,53049,12,2006,9084,8423,1,661,7.30%
Pend Oreille,12/1/06,53051,12,2006,5184,4742,1,442,8.50%
Pierce,12/1/06,53053,12,2006,386042,366210,1,19832,5.10%
San Juan,12/1/06,53055,12,2006,7789,7459,1,330,4.20%
Skagit,12/1/06,53057,12,2006,56705,53581,1,3124,5.50%
Skamania,12/1/06,53059,12,2006,5230,4862,1,368,7.00%
Snohomish,12/1/06,53061,12,2006,361246,347619,1,13627,3.80%
Spokane,12/1/06,53063,12,2006,235146,222280,1,12866,5.50%
Stevens,12/1/06,53065,12,2006,18693,17049,1,1644,8.80%
Thurston,12/1/06,53067,12,2006,127342,121145,1,6197,4.90%
Wahkiakum,12/1/06,53069,12,2006,1606,1491,1,115,7.20%
Walla Walla,12/1/06,53071,12,2006,28155,26542,1,1613,5.70%
Whatcom,12/1/06,53073,12,2006,105582,100481,1,5101,4.80%
Whitman,12/1/06,53075,12,2006,20921,20110,1,811,3.90%
Yakima,12/1/06,53077,12,2006,114537,103883,1,10654,9.30%
Adams,12/1/07,53001,12,2007,7986,7237,1,749,9.40%
Asotin,12/1/07,53003,12,2007,10385,9809,1,576,5.50%
Clallam,12/1/07,53009,12,2007,30545,28179,1,2366,7.70%
Columbia,12/1/07,53013,12,2007,1452,1329,1,123,8.50%
Cowlitz,12/1/07,53015,12,2007,44419,41024,1,3395,7.60%
Douglas,12/1/07,53017,12,2007,19799,18488,1,1311,6.60%
Ferry,12/1/07,53019,12,2007,2981,2721,1,260,8.70%
Franklin,12/1/07,53021,12,2007,32837,29969,1,2868,8.70%
Garfield,12/1/07,53023,12,2007,927,876,1,51,5.50%
Grant,12/1/07,53025,12,2007,37681,34362,1,3319,8.80%
Grays Harbor,12/1/07,53027,12,2007,32832,29288,1,3544,10.80%
Island,12/1/07,53029,12,2007,33390,31491,1,1899,5.70%
Jefferson,12/1/07,53031,12,2007,13779,13057,1,722,5.20%
King,12/1/07,53033,12,2007,1076667,1046450,1,30217,2.80%
Kitsap,12/1/07,53035,12,2007,125506,119551,1,5955,4.70%
Kittitas,12/1/07,53037,12,2007,20039,18787,1,1252,6.20%
Klickitat,12/1/07,53039,12,2007,9385,8620,1,765,8.20%
Lewis,12/1/07,53041,12,2007,31822,28751,1,3071,9.70%
Lincoln,12/1/07,53043,12,2007,4534,4259,1,275,6.10%
Mason,12/1/07,53045,12,2007,25490,23720,1,1770,6.90%
Okanogan,12/1/07,53047,12,2007,18441,16770,1,1671,9.10%
Pacific,12/1/07,53049,12,2007,9675,8572,1,1103,11.40%
Pend Oreille,12/1/07,53051,12,2007,5399,4947,1,452,8.40%
Pierce,12/1/07,53053,12,2007,399565,378371,1,21194,5.30%
San Juan,12/1/07,53055,12,2007,7971,7646,1,325,4.10%
Skagit,12/1/07,53057,12,2007,58291,55020,1,3271,5.60%
Skamania,12/1/07,53059,12,2007,5256,4786,1,470,8.90%
Snohomish,12/1/07,53061,12,2007,366824,354964,1,11860,3.20%
Spokane,12/1/07,53063,12,2007,240819,227021,1,13798,5.70%
Stevens,12/1/07,53065,12,2007,18917,17292,1,1625,8.60%
Thurston,12/1/07,53067,12,2007,131457,124956,1,6501,4.90%
Wahkiakum,12/1/07,53069,12,2007,1695,1546,1,149,8.80%
Walla Walla,12/1/07,53071,12,2007,28616,27037,1,1579,5.50%
Whatcom,12/1/07,53073,12,2007,108853,103868,1,4985,4.60%
Whitman,12/1/07,53075,12,2007,20741,19934,1,807,3.90%
Yakima,12/1/07,53077,12,2007,116678,106435,1,10243,8.80%
Adams,12/1/08,53001,12,2008,7727,6962,1,765,9.90%
Asotin,12/1/08,53003,12,2008,10634,9734,1,900,8.50%
Clallam,12/1/08,53009,12,2008,29848,27358,1,2490,8.30%
Columbia,12/1/08,53013,12,2008,1544,1386,1,158,10.20%
Cowlitz,12/1/08,53015,12,2008,45262,40398,1,4864,10.70%
Douglas,12/1/08,53017,12,2008,20286,18866,1,1420,7.00%
Ferry,12/1/08,53019,12,2008,3001,2703,1,298,9.90%
Franklin,12/1/08,53021,12,2008,34403,31470,1,2933,8.50%
Garfield,12/1/08,53023,12,2008,1030,971,1,59,5.70%
Grant,12/1/08,53025,12,2008,39371,35627,1,3744,9.50%
Grays Harbor,12/1/08,53027,12,2008,32343,28986,1,3357,10.40%
Island,12/1/08,53029,12,2008,32883,30819,1,2064,6.30%
Jefferson,12/1/08,53031,12,2008,13677,12739,1,938,6.90%
King,12/1/08,53033,12,2008,1096010,1041128,1,54882,5.00%
Kitsap,12/1/08,53035,12,2008,126312,119275,1,7037,5.60%
Kittitas,12/1/08,53037,12,2008,20680,19178,1,1502,7.30%
Klickitat,12/1/08,53039,12,2008,9981,9067,1,914,9.20%
Lewis,12/1/08,53041,12,2008,31625,28238,1,3387,10.70%
Lincoln,12/1/08,53043,12,2008,4801,4503,1,298,6.20%
Mason,12/1/08,53045,12,2008,25654,23391,1,2263,8.80%
Okanogan,12/1/08,53047,12,2008,19827,18107,1,1720,8.70%
Pacific,12/1/08,53049,12,2008,9127,8243,1,884,9.70%
Pend Oreille,12/1/08,53051,12,2008,5674,5035,1,639,11.30%
Pierce,12/1/08,53053,12,2008,401901,374475,1,27426,6.80%
San Juan,12/1/08,53055,12,2008,8172,7737,1,435,5.30%
Skagit,12/1/08,53057,12,2008,58110,53920,1,4190,7.20%
Skamania,12/1/08,53059,12,2008,5329,4703,1,626,11.70%
Snohomish,12/1/08,53061,12,2008,377177,353595,1,23582,6.30%
Spokane,12/1/08,53063,12,2008,244973,227887,1,17086,7.00%
Stevens,12/1/08,53065,12,2008,19074,17112,1,1962,10.30%
Thurston,12/1/08,53067,12,2008,133857,126039,1,7818,5.80%
Wahkiakum,12/1/08,53069,12,2008,1752,1588,1,164,9.40%
Walla Walla,12/1/08,53071,12,2008,30015,28338,1,1677,5.60%
Whatcom,12/1/08,53073,12,2008,108663,102257,1,6406,5.90%
Whitman,12/1/08,53075,12,2008,21759,20995,1,764,3.50%
Yakima,12/1/08,53077,12,2008,119058,108547,1,10511,8.80%
Adams,12/1/09,53001,12,2009,7753,6724,1,1029,13.30%
Asotin,12/1/09,53003,12,2009,10526,9404,1,1122,10.70%
Clallam,12/1/09,53009,12,2009,30258,26803,1,3455,11.40%
Columbia,12/1/09,53013,12,2009,1603,1409,1,194,12.10%
Cowlitz,12/1/09,53015,12,2009,45701,38976,1,6725,14.70%
Douglas,12/1/09,53017,12,2009,20326,18239,1,2087,10.30%
Ferry,12/1/09,53019,12,2009,3065,2573,1,492,16.10%
Franklin,12/1/09,53021,12,2009,36546,32496,1,4050,11.10%
Garfield,12/1/09,53023,12,2009,1018,911,1,107,10.50%
Grant,12/1/09,53025,12,2009,38901,33331,1,5570,14.30%
Grays Harbor,12/1/09,53027,12,2009,31535,26868,1,4667,14.80%
Island,12/1/09,53029,12,2009,33246,29870,1,3376,10.20%
Jefferson,12/1/09,53031,12,2009,13082,11746,1,1336,10.20%
King,12/1/09,53033,12,2009,1108799,1009164,1,99635,9.00%
Kitsap,12/1/09,53035,12,2009,125939,115394,1,10545,8.40%
Kittitas,12/1/09,53037,12,2009,20737,18612,1,2125,10.20%
Klickitat,12/1/09,53039,12,2009,10707,9306,1,1401,13.10%
Lewis,12/1/09,53041,12,2009,31688,26811,1,4877,15.40%
Lincoln,12/1/09,53043,12,2009,4739,4272,1,467,9.90%
Mason,12/1/09,53045,12,2009,25596,22536,1,3060,12.00%
Okanogan,12/1/09,53047,12,2009,19518,16721,1,2797,14.30%
Pacific,12/1/09,53049,12,2009,9461,8165,1,1296,13.70%
Pend Oreille,12/1/09,53051,12,2009,5565,4650,1,915,16.40%
Pierce,12/1/09,53053,12,2009,401356,358166,1,43190,10.80%
San Juan,12/1/09,53055,12,2009,7855,7170,1,685,8.70%
Skagit,12/1/09,53057,12,2009,58299,51252,1,7047,12.10%
Skamania,12/1/09,53059,12,2009,5223,4446,1,777,14.90%
Snohomish,12/1/09,53061,12,2009,381863,340777,1,41086,10.80%
Spokane,12/1/09,53063,12,2009,242023,216295,1,25728,10.60%
Stevens,12/1/09,53065,12,2009,18881,16084,1,2797,14.80%
Thurston,12/1/09,53067,12,2009,132541,120912,1,11629,8.80%
Wahkiakum,12/1/09,53069,12,2009,1554,1297,1,257,16.50%
Walla Walla,12/1/09,53071,12,2009,30082,27586,1,2496,8.30%
Whatcom,12/1/09,53073,12,2009,107299,97064,1,10235,9.50%
Whitman,12/1/09,53075,12,2009,21937,20637,1,1300,5.90%
Yakima,12/1/09,53077,12,2009,118999,104387,1,14612,12.30%
Adams,12/1/10,53001,12,2010,7750,6729,1,1021,13.20%
Asotin,12/1/10,53003,12,2010,10060,9279,1,781,7.80%
Clallam,12/1/10,53009,12,2010,28979,25790,1,3189,11.00%
Columbia,12/1/10,53013,12,2010,1904,1718,1,186,9.80%
Cowlitz,12/1/10,53015,12,2010,45609,40292,1,5317,11.70%
Douglas,12/1/10,53017,12,2010,18207,16267,1,1940,10.70%
Ferry,12/1/10,53019,12,2010,2560,2130,1,430,16.80%
Franklin,12/1/10,53021,12,2010,36748,33039,1,3709,10.10%
Garfield,12/1/10,53023,12,2010,986,910,1,76,7.70%
Grant,12/1/10,53025,12,2010,39712,34605,1,5107,12.90%
Grays Harbor,12/1/10,53027,12,2010,30106,25967,1,4139,13.70%
Island,12/1/10,53029,12,2010,33190,30231,1,2959,8.90%
Jefferson,12/1/10,53031,12,2010,12329,11073,1,1256,10.20%
King,12/1/10,53033,12,2010,1099571,1005817,1,93754,8.50%
Kitsap,12/1/10,53035,12,2010,120059,110368,1,9691,8.10%
Kittitas,12/1/10,53037,12,2010,20684,18736,1,1948,9.40%
Klickitat,12/1/10,53039,12,2010,9553,8401,1,1152,12.10%
Lewis,12/1/10,53041,12,2010,33051,28721,1,4330,13.10%
Lincoln,12/1/10,53043,12,2010,5185,4741,1,444,8.60%
Mason,12/1/10,53045,12,2010,24644,21869,1,2775,11.30%
Okanogan,12/1/10,53047,12,2010,19522,17024,1,2498,12.80%
Pacific,12/1/10,53049,12,2010,8530,7405,1,1125,13.20%
Pend Oreille,12/1/10,53051,12,2010,5035,4326,1,709,14.10%
Pierce,12/1/10,53053,12,2010,394781,356311,1,38470,9.70%
San Juan,12/1/10,53055,12,2010,7714,7093,1,621,8.10%
Skagit,12/1/10,53057,12,2010,57855,51617,1,6238,10.80%
Skamania,12/1/10,53059,12,2010,5169,4532,1,637,12.30%
Snohomish,12/1/10,53061,12,2010,384467,345188,1,39279,10.20%
Spokane,12/1/10,53063,12,2010,237170,214043,1,23127,9.80%
Stevens,12/1/10,53065,12,2010,18852,16444,1,2408,12.80%
Thurston,12/1/10,53067,12,2010,126198,115527,1,10671,8.50%
Wahkiakum,12/1/10,53069,12,2010,1433,1212,1,221,15.40%
Walla Walla,12/1/10,53071,12,2010,29248,26951,1,2297,7.90%
Whatcom,12/1/10,53073,12,2010,103498,94194,1,9304,9.00%
Whitman,12/1/10,53075,12,2010,22690,21405,1,1285,5.70%
Yakima,12/1/10,53077,12,2010,114826,100992,1,13834,12.00%
Adams,12/1/11,53001,12,2011,7672,6709,1,963,12.60%
Asotin,12/1/11,53003,12,2011,9978,9183,1,795,8.00%
Clallam,12/1/11,53009,12,2011,28412,25199,1,3213,11.30%
Columbia,12/1/11,53013,12,2011,1844,1666,1,178,9.70%
Cowlitz,12/1/11,53015,12,2011,44834,39738,1,5096,11.40%
Douglas,12/1/11,53017,12,2011,18222,16287,1,1935,10.60%
Ferry,12/1/11,53019,12,2011,2506,2061,1,445,17.80%
Franklin,12/1/11,53021,12,2011,37135,32842,1,4293,11.60%
Garfield,12/1/11,53023,12,2011,966,890,1,76,7.90%
Grant,12/1/11,53025,12,2011,40094,35148,1,4946,12.30%
Grays Harbor,12/1/11,53027,12,2011,29330,25130,1,4200,14.30%
Island,12/1/11,53029,12,2011,32792,29913,1,2879,8.80%
Jefferson,12/1/11,53031,12,2011,11861,10584,1,1277,10.80%
King,12/1/11,53033,12,2011,1110805,1033453,1,77352,7.00%
Kitsap,12/1/11,53035,12,2011,118006,108327,1,9679,8.20%
Kittitas,12/1/11,53037,12,2011,20359,18446,1,1913,9.40%
Klickitat,12/1/11,53039,12,2011,9487,8394,1,1093,11.50%
Lewis,12/1/11,53041,12,2011,32450,28245,1,4205,13.00%
Lincoln,12/1/11,53043,12,2011,5179,4752,1,427,8.20%
Mason,12/1/11,53045,12,2011,23701,20943,1,2758,11.60%
Okanogan,12/1/11,53047,12,2011,19431,17088,1,2343,12.10%
Pacific,12/1/11,53049,12,2011,8179,7106,1,1073,13.10%
Pend Oreille,12/1/11,53051,12,2011,4865,4215,1,650,13.40%
Pierce,12/1/11,53053,12,2011,391898,353904,1,37994,9.70%
San Juan,12/1/11,53055,12,2011,7546,6959,1,587,7.80%
Skagit,12/1/11,53057,12,2011,56862,50753,1,6109,10.70%
Skamania,12/1/11,53059,12,2011,5106,4530,1,576,11.30%
Snohomish,12/1/11,53061,12,2011,383409,351898,1,31511,8.20%
Spokane,12/1/11,53063,12,2011,233396,211310,1,22086,9.50%
Stevens,12/1/11,53065,12,2011,18408,16110,1,2298,12.50%
Thurston,12/1/11,53067,12,2011,124279,113287,1,10992,8.80%
Wahkiakum,12/1/11,53069,12,2011,1393,1203,1,190,13.60%
Walla Walla,12/1/11,53071,12,2011,29078,26806,1,2272,7.80%
Whatcom,12/1/11,53073,12,2011,102877,93953,1,8924,8.70%
Whitman,12/1/11,53075,12,2011,22755,21509,1,1246,5.50%
Yakima,12/1/11,53077,12,2011,115596,100872,1,14724,12.70%
Adams,12/1/12,53001,12,2012,7600,6721,1,879,11.60%
Asotin,12/1/12,53003,12,2012,9928,9210,1,718,7.20%
Clallam,12/1/12,53009,12,2012,27938,25089,1,2849,10.20%
Clark,12/1/12,53011,12,2012,211352,192439,1,18913,8.90%
Columbia,12/1/12,53013,12,2012,1773,1625,1,148,8.30%
Cowlitz,12/1/12,53015,12,2012,44318,39804,1,4514,10.20%
Douglas,12/1/12,53017,12,2012,18071,16272,1,1799,10.00%
Ferry,12/1/12,53019,12,2012,2353,1987,1,366,15.60%
Franklin,12/1/12,53021,12,2012,37234,33059,1,4175,11.20%
Garfield,12/1/12,53023,12,2012,970,886,1,84,8.70%
Grant,12/1/12,53025,12,2012,40563,36042,1,4521,11.10%
Grays Harbor,12/1/12,53027,12,2012,28242,24658,1,3584,12.70%
Island,12/1/12,53029,12,2012,32468,29927,1,2541,7.80%
Jefferson,12/1/12,53031,12,2012,11863,10712,1,1151,9.70%
King,12/1/12,53033,12,2012,1120738,1061745,1,58993,5.30%
Kitsap,12/1/12,53035,12,2012,116271,107619,1,8652,7.40%
Kittitas,12/1/12,53037,12,2012,19901,18215,1,1686,8.50%
Klickitat,12/1/12,53039,12,2012,9322,8280,1,1042,11.20%
Lewis,12/1/12,53041,12,2012,31947,28302,1,3645,11.40%
Lincoln,12/1/12,53043,12,2012,5129,4736,1,393,7.70%
Mason,12/1/12,53045,12,2012,23579,21108,1,2471,10.50%
Okanogan,12/1/12,53047,12,2012,18959,16889,1,2070,10.90%
Pacific,12/1/12,53049,12,2012,7942,6933,1,1009,12.70%
Pend Oreille,12/1/12,53051,12,2012,4846,4226,1,620,12.80%
Pierce,12/1/12,53053,12,2012,390552,356328,1,34224,8.80%
San Juan,12/1/12,53055,12,2012,7662,7107,1,555,7.20%
Skagit,12/1/12,53057,12,2012,56692,51302,1,5390,9.50%
Skamania,12/1/12,53059,12,2012,5093,4535,1,558,11.00%
Snohomish,12/1/12,53061,12,2012,383582,359988,1,23594,6.20%
Spokane,12/1/12,53063,12,2012,232317,211868,1,20449,8.80%
Stevens,12/1/12,53065,12,2012,18347,16134,1,2213,12.10%
Thurston,12/1/12,53067,12,2012,124641,114748,1,9893,7.90%
Wahkiakum,12/1/12,53069,12,2012,1343,1164,1,179,13.30%
Walla Walla,12/1/12,53071,12,2012,28650,26508,1,2142,7.50%
Whatcom,12/1/12,53073,12,2012,103798,95947,1,7851,7.60%
Whitman,12/1/12,53075,12,2012,22579,21338,1,1241,5.50%
Yakima,12/1/12,53077,12,2012,114403,100803,1,13600,11.90%
Adams,12/1/13,53001,12,2013,7838,7042,1,796,10.20%
Asotin,12/1/13,53003,12,2013,9644,9063,1,581,6.00%
Clallam,12/1/13,53009,12,2013,26804,24267,1,2537,9.50%
Clark,12/1/13,53011,12,2013,210249,194330,1,15919,7.60%
Columbia,12/1/13,53013,12,2013,1711,1582,1,129,7.50%
Cowlitz,12/1/13,53015,12,2013,43442,39537,1,3905,9.00%
Douglas,12/1/13,53017,12,2013,17772,16154,1,1618,9.10%
Ferry,12/1/13,53019,12,2013,2360,2042,1,318,13.50%
Franklin,12/1/13,53021,12,2013,36398,32421,1,3977,10.90%
Garfield,12/1/13,53023,12,2013,915,848,1,67,7.30%
Grant,12/1/13,53025,12,2013,40585,36370,1,4215,10.40%
Grays Harbor,12/1/13,53027,12,2013,27395,24106,1,3289,12.00%
Island,12/1/13,53029,12,2013,31675,29464,1,2211,7.00%
Jefferson,12/1/13,53031,12,2013,11211,10219,1,992,8.80%
King,12/1/13,53033,12,2013,1139815,1086880,1,52935,4.60%
Kitsap,12/1/13,53035,12,2013,114345,107031,1,7314,6.40%
Kittitas,12/1/13,53037,12,2013,19369,17875,1,1494,7.70%
Klickitat,12/1/13,53039,12,2013,8971,8093,1,878,9.80%
Lewis,12/1/13,53041,12,2013,31273,28137,1,3136,10.00%
Lincoln,12/1/13,53043,12,2013,4991,4640,1,351,7.00%
Mason,12/1/13,53045,12,2013,23381,21130,1,2251,9.60%
Okanogan,12/1/13,53047,12,2013,18762,16912,1,1850,9.90%
Pacific,12/1/13,53049,12,2013,7972,7053,1,919,11.50%
Pend Oreille,12/1/13,53051,12,2013,4679,4144,1,535,11.40%
Pierce,12/1/13,53053,12,2013,388427,359135,1,29292,7.50%
San Juan,12/1/13,53055,12,2013,7158,6729,1,429,6.00%
Skagit,12/1/13,53057,12,2013,56194,51564,1,4630,8.20%
Skamania,12/1/13,53059,12,2013,5035,4552,1,483,9.60%
Snohomish,12/1/13,53061,12,2013,389238,368543,1,20695,5.30%
Spokane,12/1/13,53063,12,2013,228642,210969,1,17673,7.70%
Stevens,12/1/13,53065,12,2013,17697,15830,1,1867,10.50%
Thurston,12/1/13,53067,12,2013,123801,115152,1,8649,7.00%
Wahkiakum,12/1/13,53069,12,2013,1290,1138,1,152,11.80%
Walla Walla,12/1/13,53071,12,2013,27445,25479,1,1966,7.20%
Whatcom,12/1/13,53073,12,2013,102337,95385,1,6952,6.80%
Whitman,12/1/13,53075,12,2013,22114,21025,1,1089,4.90%
Yakima,12/1/13,53077,12,2013,112408,99456,1,12952,11.50%
Adams,12/1/14,53001,12,2014,8047,7245,1,802,10.00%
Asotin,12/1/14,53003,12,2014,9831,9332,1,499,5.10%
Clallam,12/1/14,53009,12,2014,26676,24324,1,2352,8.80%
Clark,12/1/14,53011,12,2014,214313,200034,1,14279,6.70%
Columbia,12/1/14,53013,12,2014,1746,1604,1,142,8.10%
Cowlitz,12/1/14,53015,12,2014,44662,41151,1,3511,7.90%
Douglas,12/1/14,53017,12,2014,18640,17168,1,1472,7.90%
Ferry,12/1/14,53019,12,2014,2404,2118,1,286,11.90%
Franklin,12/1/14,53021,12,2014,37330,33484,1,3846,10.30%
Garfield,12/1/14,53023,12,2014,925,859,1,66,7.10%
Grant,12/1/14,53025,12,2014,42917,38790,1,4127,9.60%
Grays Harbor,12/1/14,53027,12,2014,27247,24533,1,2714,10.00%
Island,12/1/14,53029,12,2014,32070,29951,1,2119,6.60%
Jefferson,12/1/14,53031,12,2014,11143,10214,1,929,8.30%
King,12/1/14,53033,12,2014,1162308,1115302,1,47006,4.00%
Kitsap,12/1/14,53035,12,2014,115712,108962,1,6750,5.80%
Kittitas,12/1/14,53037,12,2014,20578,19189,1,1389,6.70%
Klickitat,12/1/14,53039,12,2014,9111,8342,1,769,8.40%
Lewis,12/1/14,53041,12,2014,30661,27833,1,2828,9.20%
Lincoln,12/1/14,53043,12,2014,4873,4561,1,312,6.40%
Mason,12/1/14,53045,12,2014,23278,21377,1,1901,8.20%
Okanogan,12/1/14,53047,12,2014,19754,17990,1,1764,8.90%
Pacific,12/1/14,53049,12,2014,7864,7094,1,770,9.80%
Pend Oreille,12/1/14,53051,12,2014,4658,4177,1,481,10.30%
Pierce,12/1/14,53053,12,2014,395345,369012,1,26333,6.70%
San Juan,12/1/14,53055,12,2014,7381,6968,1,413,5.60%
Skagit,12/1/14,53057,12,2014,56627,52575,1,4052,7.20%
Skamania,12/1/14,53059,12,2014,5050,4630,1,420,8.30%
Snohomish,12/1/14,53061,12,2014,396384,378774,1,17610,4.40%
Spokane,12/1/14,53063,12,2014,230289,213944,1,16345,7.10%
Stevens,12/1/14,53065,12,2014,17684,15949,1,1735,9.80%
Thurston,12/1/14,53067,12,2014,126561,118669,1,7892,6.20%
Wahkiakum,12/1/14,53069,12,2014,1285,1161,1,124,9.60%
Walla Walla,12/1/14,53071,12,2014,27701,25887,1,1814,6.50%
Whatcom,12/1/14,53073,12,2014,103164,96715,1,6449,6.30%
Whitman,12/1/14,53075,12,2014,22826,21817,1,1009,4.40%
Yakima,12/1/14,53077,12,2014,115915,103473,1,12442,10.70%
Adams,12/1/15,53001,12,2015,8241,7458,1,783,9.50%
Asotin,12/1/15,53003,12,2015,9868,9357,1,511,5.20%
Clallam,12/1/15,53009,12,2015,26915,24621,1,2294,8.50%
Clark,12/1/15,53011,12,2015,220854,207283,1,13571,6.10%
Columbia,12/1/15,53013,12,2015,1684,1569,1,115,6.80%
Cowlitz,12/1/15,53015,12,2015,44696,41238,1,3458,7.70%
Douglas,12/1/15,53017,12,2015,19190,17737,1,1453,7.60%
Ferry,12/1/15,53019,12,2015,2552,2266,1,286,11.20%
Franklin,12/1/15,53021,12,2015,37896,34216,1,3680,9.70%
Garfield,12/1/15,53023,12,2015,881,820,1,61,6.90%
Grant,12/1/15,53025,12,2015,42140,38002,1,4138,9.80%
Grays Harbor,12/1/15,53027,12,2015,27115,24501,1,2614,9.60%
Island,12/1/15,53029,12,2015,32194,30172,1,2022,6.30%
Jefferson,12/1/15,53031,12,2015,11276,10449,1,827,7.30%
King,12/1/15,53033,12,2015,1184109,1136675,1,47434,4.00%
Kitsap,12/1/15,53035,12,2015,118511,111998,1,6513,5.50%
Kittitas,12/1/15,53037,12,2015,20995,19654,1,1341,6.40%
Klickitat,12/1/15,53039,12,2015,9126,8357,1,769,8.40%
Lewis,12/1/15,53041,12,2015,31748,29036,1,2712,8.50%
Lincoln,12/1/15,53043,12,2015,4782,4477,1,305,6.40%
Mason,12/1/15,53045,12,2015,23591,21685,1,1906,8.10%
Okanogan,12/1/15,53047,12,2015,19430,17627,1,1803,9.30%
Pacific,12/1/15,53049,12,2015,8052,7252,1,800,9.90%
Pend Oreille,12/1/15,53051,12,2015,4700,4236,1,464,9.90%
Pierce,12/1/15,53053,12,2015,404089,378646,1,25443,6.30%
San Juan,12/1/15,53055,12,2015,7383,6968,1,415,5.60%
Skagit,12/1/15,53057,12,2015,57144,53085,1,4059,7.10%
Skamania,12/1/15,53059,12,2015,5086,4696,1,390,7.70%
Snohomish,12/1/15,53061,12,2015,403807,385968,1,17839,4.40%
Spokane,12/1/15,53063,12,2015,233980,218360,1,15620,6.70%
Stevens,12/1/15,53065,12,2015,17824,16144,1,1680,9.40%
Thurston,12/1/15,53067,12,2015,129219,121554,1,7665,5.90%
Wahkiakum,12/1/15,53069,12,2015,1291,1162,1,129,10.00%
Walla Walla,12/1/15,53071,12,2015,27831,26039,1,1792,6.40%
Whatcom,12/1/15,53073,12,2015,106402,99977,1,6425,6.00%
Whitman,12/1/15,53075,12,2015,23528,22427,1,1101,4.70%
Yakima,12/1/15,53077,12,2015,116743,104395,1,12348,10.60%
Adams,12/1/16,53001,12,2016,7972,7290,1,682,8.60%
Asotin,12/1/16,53003,12,2016,10266,9784,1,482,4.70%
Clallam,12/1/16,53009,12,2016,27448,25467,1,1981,7.20%
Clark,12/1/16,53011,12,2016,226362,213716,1,12646,5.60%
Columbia,12/1/16,53013,12,2016,1718,1597,1,121,7.00%
Cowlitz,12/1/16,53015,12,2016,45813,42723,1,3090,6.70%
Douglas,12/1/16,53017,12,2016,19791,18413,1,1378,7.00%
Ferry,12/1/16,53019,12,2016,2451,2186,1,265,10.80%
Franklin,12/1/16,53021,12,2016,38433,35072,1,3361,8.70%
Garfield,12/1/16,53023,12,2016,880,823,1,57,6.50%
Grant,12/1/16,53025,12,2016,42113,38498,1,3615,8.60%
Grays Harbor,12/1/16,53027,12,2016,27578,25359,1,2219,8.00%
Island,12/1/16,53029,12,2016,33671,31833,1,1838,5.50%
Jefferson,12/1/16,53031,12,2016,11753,10970,1,783,6.70%
King,12/1/16,53033,12,2016,1210049,1167119,1,42930,3.50%
Kitsap,12/1/16,53035,12,2016,120688,114475,1,6213,5.10%
Kittitas,12/1/16,53037,12,2016,21516,20272,1,1244,5.80%
Klickitat,12/1/16,53039,12,2016,9364,8704,1,660,7.00%
Lewis,12/1/16,53041,12,2016,32421,30017,1,2404,7.40%
Lincoln,12/1/16,53043,12,2016,4857,4584,1,273,5.60%
Mason,12/1/16,53045,12,2016,24025,22314,1,1711,7.10%
Okanogan,12/1/16,53047,12,2016,19471,17992,1,1479,7.60%
Pacific,12/1/16,53049,12,2016,8326,7692,1,634,7.60%
Pend Oreille,12/1/16,53051,12,2016,4750,4348,1,402,8.50%
Pierce,12/1/16,53053,12,2016,416941,394025,1,22916,5.50%
San Juan,12/1/16,53055,12,2016,7585,7217,1,368,4.90%
Skagit,12/1/16,53057,12,2016,58789,55146,1,3643,6.20%
Skamania,12/1/16,53059,12,2016,5204,4839,1,365,7.00%
Snohomish,12/1/16,53061,12,2016,414062,397699,1,16363,4.00%
Spokane,12/1/16,53063,12,2016,240287,226475,1,13812,5.70%
Stevens,12/1/16,53065,12,2016,18224,16760,1,1464,8.00%
Thurston,12/1/16,53067,12,2016,133527,126623,1,6904,5.20%
Wahkiakum,12/1/16,53069,12,2016,1297,1183,1,114,8.80%
Walla Walla,12/1/16,53071,12,2016,28162,26567,1,1595,5.70%
Whatcom,12/1/16,53073,12,2016,108836,102926,1,5910,5.40%
Whitman,12/1/16,53075,12,2016,23976,22870,1,1106,4.60%
Yakima,12/1/16,53077,12,2016,119089,108536,1,10553,8.90%
Adams,12/1/17,53001,12,2017,8366,7717,1,649,7.80%
Asotin,12/1/17,53003,12,2017,10329,9866,1,463,4.50%
Clallam,12/1/17,53009,12,2017,27753,25811,1,1942,7.00%
Clark,12/1/17,53011,12,2017,232475,221074,1,11401,4.90%
Columbia,12/1/17,53013,12,2017,1760,1658,1,102,5.80%
Cowlitz,12/1/17,53015,12,2017,46023,43149,1,2874,6.20%
Douglas,12/1/17,53017,12,2017,20420,19121,1,1299,6.40%
Ferry,12/1/17,53019,12,2017,2508,2155,1,353,14.10%
Franklin,12/1/17,53021,12,2017,39504,36385,1,3119,7.90%
Garfield,12/1/17,53023,12,2017,872,810,1,62,7.10%
Grant,12/1/17,53025,12,2017,43111,39699,1,3412,7.90%
Grays Harbor,12/1/17,53027,12,2017,28102,26095,1,2007,7.10%
Island,12/1/17,53029,12,2017,34409,32543,1,1866,5.40%
Jefferson,12/1/17,53031,12,2017,12016,11274,1,742,6.20%
King,12/1/17,53033,12,2017,1237342,1195692,1,41650,3.40%
Kitsap,12/1/17,53035,12,2017,122396,116484,1,5912,4.80%
Kittitas,12/1/17,53037,12,2017,22281,21029,1,1252,5.60%
Klickitat,12/1/17,53039,12,2017,9536,8924,1,612,6.40%
Lewis,12/1/17,53041,12,2017,33534,31294,1,2240,6.70%
Lincoln,12/1/17,53043,12,2017,4907,4637,1,270,5.50%
Mason,12/1/17,53045,12,2017,24419,22817,1,1602,6.60%
Okanogan,12/1/17,53047,12,2017,19337,17824,1,1513,7.80%
Pacific,12/1/17,53049,12,2017,8174,7573,1,601,7.40%
Pend Oreille,12/1/17,53051,12,2017,4807,4434,1,373,7.80%
Pierce,12/1/17,53053,12,2017,424901,402136,1,22765,5.40%
San Juan,12/1/17,53055,12,2017,7807,7460,1,347,4.40%
Skagit,12/1/17,53057,12,2017,59396,56018,1,3378,5.70%
Skamania,12/1/17,53059,12,2017,5400,5062,1,338,6.30%
Snohomish,12/1/17,53061,12,2017,423195,407368,1,15827,3.70%
Spokane,12/1/17,53063,12,2017,243959,230370,1,13589,5.60%
Stevens,12/1/17,53065,12,2017,18316,16892,1,1424,7.80%
Thurston,12/1/17,53067,12,2017,137262,130439,1,6823,5.00%
Wahkiakum,12/1/17,53069,12,2017,1296,1210,1,86,6.60%
Walla Walla,12/1/17,53071,12,2017,28298,26763,1,1535,5.40%
Whatcom,12/1/17,53073,12,2017,111296,105822,1,5474,4.90%
Whitman,12/1/17,53075,12,2017,24036,22997,1,1039,4.30%
Yakima,12/1/17,53077,12,2017,121256,111456,1,9800,8.10%
Adams,12/1/18,53001,12,2018,8439,7715,1,724,8.60%
Asotin,12/1/18,53003,12,2018,10455,9942,1,513,4.90%
Clallam,12/1/18,53009,12,2018,28514,26537,1,1977,6.90%
Clark,12/1/18,53011,12,2018,242316,230358,1,11958,4.90%
Columbia,12/1/18,53013,12,2018,1843,1718,1,125,6.80%
Cowlitz,12/1/18,53015,12,2018,47998,45016,1,2982,6.20%
Douglas,12/1/18,53017,12,2018,20972,19569,1,1403,6.70%
Ferry,12/1/18,53019,12,2018,2566,2270,1,296,11.50%
Franklin,12/1/18,53021,12,2018,40869,37602,1,3267,8.00%
Garfield,12/1/18,53023,12,2018,894,827,1,67,7.50%
Grant,12/1/18,53025,12,2018,45071,41343,1,3728,8.30%
Grays Harbor,12/1/18,53027,12,2018,28835,26667,1,2168,7.50%
Island,12/1/18,53029,12,2018,35610,33655,1,1955,5.50%
Jefferson,12/1/18,53031,12,2018,12615,11875,1,740,5.90%
King,12/1/18,53033,12,2018,1261960,1223205,1,38755,3.10%
Kitsap,12/1/18,53035,12,2018,128183,121986,1,6197,4.80%
Kittitas,12/1/18,53037,12,2018,22319,20910,1,1409,6.30%
Klickitat,12/1/18,53039,12,2018,9800,9154,1,646,6.60%
Lewis,12/1/18,53041,12,2018,34757,32368,1,2389,6.90%
Lincoln,12/1/18,53043,12,2018,5100,4812,1,288,5.60%
Mason,12/1/18,53045,12,2018,25301,23610,1,1691,6.70%
Okanogan,12/1/18,53047,12,2018,19452,17834,1,1618,8.30%
Pacific,12/1/18,53049,12,2018,8403,7727,1,676,8.00%
Pend Oreille,12/1/18,53051,12,2018,5031,4625,1,406,8.10%
Pierce,12/1/18,53053,12,2018,440506,416868,1,23638,5.40%
San Juan,12/1/18,53055,12,2018,8087,7725,1,362,4.50%
Skagit,12/1/18,53057,12,2018,62090,58580,1,3510,5.70%
Skamania,12/1/18,53059,12,2018,5555,5221,1,334,6.00%
Snohomish,12/1/18,53061,12,2018,429273,415064,1,14209,3.30%
Spokane,12/1/18,53063,12,2018,254661,240046,1,14615,5.70%
Stevens,12/1/18,53065,12,2018,18962,17485,1,1477,7.80%
Thurston,12/1/18,53067,12,2018,142299,135113,1,7186,5.00%
Wahkiakum,12/1/18,53069,12,2018,1393,1290,1,103,7.40%
Walla Walla,12/1/18,53071,12,2018,29568,27969,1,1599,5.40%
Whatcom,12/1/18,53073,12,2018,114950,109090,1,5860,5.10%
Whitman,12/1/18,53075,12,2018,24589,23449,1,1140,4.60%
Yakima,12/1/18,53077,12,2018,124890,114141,1,10749,8.60%
Adams,12/1/19,53001,12,2019,8916,8238,1,678,7.60%
Asotin,12/1/19,53003,12,2019,10718,10305,1,413,3.90%
Clallam,12/1/19,53009,12,2019,29222,27467,1,1755,6.00%
Clark,12/1/19,53011,12,2019,248649,238263,1,10386,4.20%
Columbia,12/1/19,53013,12,2019,1872,1769,1,103,5.50%
Cowlitz,12/1/19,53015,12,2019,48780,46121,1,2659,5.50%
Douglas,12/1/19,53017,12,2019,21388,20127,1,1261,5.90%
Ferry,12/1/19,53019,12,2019,2415,2143,1,272,11.30%
Franklin,12/1/19,53021,12,2019,42375,39338,1,3037,7.20%
Garfield,12/1/19,53023,12,2019,906,854,1,52,5.70%
Grant,12/1/19,53025,12,2019,44287,40334,1,3953,8.90%
Grays Harbor,12/1/19,53027,12,2019,29407,27344,1,2063,7.00%
Island,12/1/19,53029,12,2019,37517,35849,1,1668,4.40%
Jefferson,12/1/19,53031,12,2019,13335,12673,1,662,5.00%
King,12/1/19,53033,12,2019,1287339,1255653,1,31686,2.50%
Kitsap,12/1/19,53035,12,2019,133330,128105,1,5225,3.90%
Kittitas,12/1/19,53037,12,2019,23687,22459,1,1228,5.20%
Klickitat,12/1/19,53039,12,2019,9826,9253,1,573,5.80%
Lewis,12/1/19,53041,12,2019,35394,33329,1,2065,5.80%
Lincoln,12/1/19,53043,12,2019,5003,4755,1,248,5.00%
Mason,12/1/19,53045,12,2019,26437,24974,1,1463,5.50%
Okanogan,12/1/19,53047,12,2019,19101,17564,1,1537,8.00%
Pacific,12/1/19,53049,12,2019,8596,8008,1,588,6.80%
Pend Oreille,12/1/19,53051,12,2019,5262,4824,1,438,8.30%
Pierce,12/1/19,53053,12,2019,454337,433261,1,21076,4.60%
San Juan,12/1/19,53055,12,2019,8396,8096,1,300,3.60%
Skagit,12/1/19,53057,12,2019,64046,60677,1,3369,5.30%
Skamania,12/1/19,53059,12,2019,5684,5404,1,280,4.90%
Snohomish,12/1/19,53061,12,2019,438317,426131,1,12186,2.80%
Spokane,12/1/19,53063,12,2019,262855,250149,1,12706,4.80%
Stevens,12/1/19,53065,12,2019,19605,18238,1,1367,7.00%
Thurston,12/1/19,53067,12,2019,146960,140647,1,6313,4.30%
Wahkiakum,12/1/19,53069,12,2019,1387,1296,1,91,6.60%
Walla Walla,12/1/19,53071,12,2019,30288,28840,1,1448,4.80%
Whatcom,12/1/19,53073,12,2019,117044,111560,1,5484,4.70%
Whitman,12/1/19,53075,12,2019,24593,23662,1,931,3.80%
Yakima,12/1/19,53077,12,2019,128962,118684,1,10278,8.00%