Control Date Filter,County,Date,Date Comparison Filter-Month/Year Ago (copy),Date Comparison Filter-Year Ago,Month,Year,Employed,EMPLOYED U.S. ADJUSTMENT,Labor Force,LABOR FORCE U.S. ADJUSTMENT,Number of Records,Unemployed,UNEMPLOYED U.S. ADJUSTMENT,Unemployment Rate,Unemployment Rate for Tooltip
FALSE,Beaver County,1/1/90,Hide,Hide,1,1990,1716,1716,1788,1788,1,72,72,0.040268456,0.040268456
FALSE,Box Elder County,1/1/90,Hide,Hide,1,1990,15439,15439,16158,16158,1,719,719,0.044498081,0.044498081
FALSE,Cache County,1/1/90,Hide,Hide,1,1990,31737,31737,32974,32974,1,1237,1237,0.037514405,0.037514405
FALSE,Carbon County,1/1/90,Hide,Hide,1,1990,7894,7894,8685,8685,1,791,791,0.091076569,0.091076569
FALSE,Daggett County,1/1/90,Hide,Hide,1,1990,363,363,365,365,1,2,2,0.005479452,0.005479452
FALSE,Davis County,1/1/90,Hide,Hide,1,1990,82035,82035,85357,85357,1,3322,3322,0.038918894,0.038918894
FALSE,Duchesne County,1/1/90,Hide,Hide,1,1990,4599,4599,5025,5025,1,426,426,0.084776119,0.084776119
FALSE,Emery County,1/1/90,Hide,Hide,1,1990,3933,3933,4271,4271,1,338,338,0.079138375,0.079138375
FALSE,Garfield County,1/1/90,Hide,Hide,1,1990,1941,1941,2127,2127,1,186,186,0.087447109,0.087447109
FALSE,Grand County,1/1/90,Hide,Hide,1,1990,3075,3075,3288,3288,1,213,213,0.064781022,0.064781022
FALSE,Iron County,1/1/90,Hide,Hide,1,1990,8777,8777,9256,9256,1,479,479,0.051750216,0.051750216
FALSE,Juab County,1/1/90,Hide,Hide,1,1990,2450,2450,2577,2577,1,127,127,0.049282111,0.049282111
FALSE,Kane County,1/1/90,Hide,Hide,1,1990,2460,2460,2619,2619,1,159,159,0.060710195,0.060710195
FALSE,Millard County,1/1/90,Hide,Hide,1,1990,4485,4485,4695,4695,1,210,210,0.044728435,0.044728435
FALSE,Morgan County,1/1/90,Hide,Hide,1,1990,2347,2347,2492,2492,1,145,145,0.058186196,0.058186196
FALSE,Piute County,1/1/90,Hide,Hide,1,1990,431,431,470,470,1,39,39,0.082978723,0.082978723
FALSE,Rich County,1/1/90,Hide,Hide,1,1990,717,717,735,735,1,18,18,0.024489796,0.024489796
FALSE,Salt Lake County,1/1/90,Hide,Hide,1,1990,350837,350837,364788,364788,1,13951,13951,0.038244131,0.038244131
FALSE,San Juan County,1/1/90,Hide,Hide,1,1990,3838,3838,4124,4124,1,286,286,0.069350145,0.069350145
FALSE,Sanpete County,1/1/90,Hide,Hide,1,1990,5711,5711,6406,6406,1,695,695,0.108492039,0.108492039
FALSE,Sevier County,1/1/90,Hide,Hide,1,1990,5956,5956,6359,6359,1,403,403,0.063374744,0.063374744
FALSE,State of Utah,1/1/90,Hide,Hide,1,1990,771214,771214,807244,807244,1,36030,36030,0.044633345,0.044633345
FALSE,Summit County,1/1/90,Hide,Hide,1,1990,7347,7347,7812,7812,1,465,465,0.05952381,0.05952381
FALSE,Tooele County,1/1/90,Hide,Hide,1,1990,11632,11632,12202,12202,1,570,570,0.046713653,0.046713653
FALSE,Uintah County,1/1/90,Hide,Hide,1,1990,33275,33275,34217,34217,1,942,942,0.027530175,0.027530175
FALSE,United States,1/1/90,Hide,Hide,1,1990,119081,119081000,125833,125833000,1,6752,6752000,0.054,0.054
FALSE,Utah County,1/1/90,Hide,Hide,1,1990,108028,108028,113312,113312,1,5284,5284,0.046632307,0.046632307
FALSE,Wasatch County,1/1/90,Hide,Hide,1,1990,4320,4320,4584,4584,1,264,264,0.057591623,0.057591623
FALSE,Washington County,1/1/90,Hide,Hide,1,1990,17571,17571,18287,18287,1,716,716,0.039153497,0.039153497
FALSE,Wayne County,1/1/90,Hide,Hide,1,1990,922,922,996,996,1,74,74,0.074297189,0.074297189
FALSE,Weber County,1/1/90,Hide,Hide,1,1990,72803,72803,76633,76633,1,3830,3830,0.049978469,0.049978469
FALSE,Beaver County,2/1/90,Hide,Hide,2,1990,1740,1740,1811,1811,1,71,71,0.039204859,0.039204859
FALSE,Box Elder County,2/1/90,Hide,Hide,2,1990,15440,15440,16187,16187,1,747,747,0.046148144,0.046148144
FALSE,Cache County,2/1/90,Hide,Hide,2,1990,31706,31706,32974,32974,1,1268,1268,0.03845454,0.03845454
FALSE,Carbon County,2/1/90,Hide,Hide,2,1990,7913,7913,8679,8679,1,766,766,0.088259016,0.088259016
FALSE,Daggett County,2/1/90,Hide,Hide,2,1990,355,355,358,358,1,3,3,0.008379888,0.008379888
FALSE,Davis County,2/1/90,Hide,Hide,2,1990,82146,82146,85532,85532,1,3386,3386,0.039587523,0.039587523
FALSE,Duchesne County,2/1/90,Hide,Hide,2,1990,4641,4641,5071,5071,1,430,430,0.084795898,0.084795898
FALSE,Emery County,2/1/90,Hide,Hide,2,1990,3936,3936,4267,4267,1,331,331,0.077572065,0.077572065
FALSE,Garfield County,2/1/90,Hide,Hide,2,1990,1930,1930,2110,2110,1,180,180,0.085308057,0.085308057
FALSE,Grand County,2/1/90,Hide,Hide,2,1990,3067,3067,3289,3289,1,222,222,0.06749772,0.06749772
FALSE,Iron County,2/1/90,Hide,Hide,2,1990,8794,8794,9253,9253,1,459,459,0.049605533,0.049605533
FALSE,Juab County,2/1/90,Hide,Hide,2,1990,2473,2473,2599,2599,1,126,126,0.048480185,0.048480185
FALSE,Kane County,2/1/90,Hide,Hide,2,1990,2446,2446,2605,2605,1,159,159,0.061036468,0.061036468
FALSE,Millard County,2/1/90,Hide,Hide,2,1990,4496,4496,4705,4705,1,209,209,0.044420829,0.044420829
FALSE,Morgan County,2/1/90,Hide,Hide,2,1990,2358,2358,2502,2502,1,144,144,0.057553957,0.057553957
FALSE,Piute County,2/1/90,Hide,Hide,2,1990,435,435,473,473,1,38,38,0.080338266,0.080338266
FALSE,Rich County,2/1/90,Hide,Hide,2,1990,723,723,740,740,1,17,17,0.022972973,0.022972973
FALSE,Salt Lake County,2/1/90,Hide,Hide,2,1990,351314,351314,365509,365509,1,14195,14195,0.038836253,0.038836253
FALSE,San Juan County,2/1/90,Hide,Hide,2,1990,3838,3838,4134,4134,1,296,296,0.071601355,0.071601355
FALSE,Sanpete County,2/1/90,Hide,Hide,2,1990,5707,5707,6406,6406,1,699,699,0.109116453,0.109116453
FALSE,Sevier County,2/1/90,Hide,Hide,2,1990,5959,5959,6342,6342,1,383,383,0.060391044,0.060391044
FALSE,State of Utah,2/1/90,Hide,Hide,2,1990,773972,773972,810108,810108,1,36136,36136,0.044606398,0.044606398
FALSE,Summit County,2/1/90,Hide,Hide,2,1990,7360,7360,7833,7833,1,473,473,0.060385548,0.060385548
FALSE,Tooele County,2/1/90,Hide,Hide,2,1990,11666,11666,12277,12277,1,611,611,0.049767859,0.049767859
FALSE,Uintah County,2/1/90,Hide,Hide,2,1990,8089,8089,8663,8663,1,574,574,0.066258802,0.066258802
FALSE,United States,2/1/90,Hide,Hide,2,1990,119059,119059000,125710,125710000,1,6651,6651000,0.053,0.053
FALSE,Utah County,2/1/90,Hide,Hide,2,1990,108872,108872,114151,114151,1,5279,5279,0.046245762,0.046245762
FALSE,Wasatch County,2/1/90,Hide,Hide,2,1990,4308,4308,4573,4573,1,265,265,0.05794883,0.05794883
FALSE,Washington County,2/1/90,Hide,Hide,2,1990,17782,17782,18492,18492,1,710,710,0.038394982,0.038394982
FALSE,Wayne County,2/1/90,Hide,Hide,2,1990,915,915,989,989,1,74,74,0.074823054,0.074823054
FALSE,Weber County,2/1/90,Hide,Hide,2,1990,72869,72869,76727,76727,1,3858,3858,0.050282169,0.050282169
FALSE,Beaver County,3/1/90,Hide,Hide,3,1990,1768,1768,1838,1838,1,70,70,0.038084875,0.038084875
FALSE,Box Elder County,3/1/90,Hide,Hide,3,1990,15444,15444,16214,16214,1,770,770,0.047489824,0.047489824
FALSE,Cache County,3/1/90,Hide,Hide,3,1990,31675,31675,32972,32972,1,1297,1297,0.039336407,0.039336407
FALSE,Carbon County,3/1/90,Hide,Hide,3,1990,7936,7936,8673,8673,1,737,737,0.084976363,0.084976363
FALSE,Daggett County,3/1/90,Hide,Hide,3,1990,347,347,352,352,1,5,5,0.014204545,0.014204545
FALSE,Davis County,3/1/90,Hide,Hide,3,1990,82310,82310,85755,85755,1,3445,3445,0.040172585,0.040172585
FALSE,Duchesne County,3/1/90,Hide,Hide,3,1990,4674,4674,5106,5106,1,432,432,0.084606345,0.084606345
FALSE,Emery County,3/1/90,Hide,Hide,3,1990,3931,3931,4257,4257,1,326,326,0.076579751,0.076579751
FALSE,Garfield County,3/1/90,Hide,Hide,3,1990,1913,1913,2086,2086,1,173,173,0.082933845,0.082933845
FALSE,Grand County,3/1/90,Hide,Hide,3,1990,3062,3062,3294,3294,1,232,232,0.070431087,0.070431087
FALSE,Iron County,3/1/90,Hide,Hide,3,1990,8804,8804,9245,9245,1,441,441,0.04770146,0.04770146
FALSE,Juab County,3/1/90,Hide,Hide,3,1990,2495,2495,2619,2619,1,124,124,0.047346315,0.047346315
FALSE,Kane County,3/1/90,Hide,Hide,3,1990,2428,2428,2586,2586,1,158,158,0.061098221,0.061098221
FALSE,Millard County,3/1/90,Hide,Hide,3,1990,4504,4504,4714,4714,1,210,210,0.044548154,0.044548154
FALSE,Morgan County,3/1/90,Hide,Hide,3,1990,2368,2368,2511,2511,1,143,143,0.056949423,0.056949423
FALSE,Piute County,3/1/90,Hide,Hide,3,1990,440,440,477,477,1,37,37,0.077568134,0.077568134
FALSE,Rich County,3/1/90,Hide,Hide,3,1990,727,727,743,743,1,16,16,0.02153432,0.02153432
FALSE,Salt Lake County,3/1/90,Hide,Hide,3,1990,352000,352000,366387,366387,1,14387,14387,0.039267223,0.039267223
FALSE,San Juan County,3/1/90,Hide,Hide,3,1990,3838,3838,4146,4146,1,308,308,0.074288471,0.074288471
FALSE,Sanpete County,3/1/90,Hide,Hide,3,1990,5698,5698,6400,6400,1,702,702,0.1096875,0.1096875
FALSE,Sevier County,3/1/90,Hide,Hide,3,1990,5962,5962,6326,6326,1,364,364,0.05754031,0.05754031
FALSE,State of Utah,3/1/90,Hide,Hide,3,1990,776622,776622,812954,812954,1,36332,36332,0.044691336,0.044691336
FALSE,Summit County,3/1/90,Hide,Hide,3,1990,7388,7388,7869,7869,1,481,481,0.061125937,0.061125937
FALSE,Tooele County,3/1/90,Hide,Hide,3,1990,11707,11707,12352,12352,1,645,645,0.052218264,0.052218264
FALSE,Uintah County,3/1/90,Hide,Hide,3,1990,8191,8191,8762,8762,1,571,571,0.06516777,0.06516777
FALSE,United States,3/1/90,Hide,Hide,3,1990,119203,119203000,125801,125801000,1,6598,6598000,0.052,0.052
FALSE,Utah County,3/1/90,Hide,Hide,3,1990,109774,109774,115043,115043,1,5269,5269,0.045800266,0.045800266
FALSE,Wasatch County,3/1/90,Hide,Hide,3,1990,4296,4296,4563,4563,1,267,267,0.058514135,0.058514135
FALSE,Washington County,3/1/90,Hide,Hide,3,1990,17986,17986,18691,18691,1,705,705,0.037718688,0.037718688
FALSE,Wayne County,3/1/90,Hide,Hide,3,1990,905,905,980,980,1,75,75,0.076530612,0.076530612
FALSE,Weber County,3/1/90,Hide,Hide,3,1990,72977,72977,76877,76877,1,3900,3900,0.050730388,0.050730388
FALSE,Beaver County,4/1/90,Hide,Hide,4,1990,1797,1797,1867,1867,1,70,70,0.037493305,0.037493305
FALSE,Box Elder County,4/1/90,Hide,Hide,4,1990,15453,15453,16241,16241,1,788,788,0.04851918,0.04851918
FALSE,Cache County,4/1/90,Hide,Hide,4,1990,31651,31651,32973,32973,1,1322,1322,0.04009341,0.04009341
FALSE,Carbon County,4/1/90,Hide,Hide,4,1990,7962,7962,8670,8670,1,708,708,0.0816609,0.0816609
FALSE,Daggett County,4/1/90,Hide,Hide,4,1990,340,340,346,346,1,6,6,0.01734104,0.01734104
FALSE,Davis County,4/1/90,Hide,Hide,4,1990,82539,82539,86037,86037,1,3498,3498,0.040656927,0.040656927
FALSE,Duchesne County,4/1/90,Hide,Hide,4,1990,4694,4694,5125,5125,1,431,431,0.084097561,0.084097561
FALSE,Emery County,4/1/90,Hide,Hide,4,1990,3921,3921,4244,4244,1,323,323,0.076107446,0.076107446
FALSE,Garfield County,4/1/90,Hide,Hide,4,1990,1892,1892,2060,2060,1,168,168,0.081553398,0.081553398
FALSE,Grand County,4/1/90,Hide,Hide,4,1990,3060,3060,3304,3304,1,244,244,0.073849879,0.073849879
FALSE,Iron County,4/1/90,Hide,Hide,4,1990,8804,8804,9232,9232,1,428,428,0.046360485,0.046360485
FALSE,Juab County,4/1/90,Hide,Hide,4,1990,2513,2513,2636,2636,1,123,123,0.046661608,0.046661608
FALSE,Kane County,4/1/90,Hide,Hide,4,1990,2411,2411,2566,2566,1,155,155,0.0604053,0.0604053
FALSE,Millard County,4/1/90,Hide,Hide,4,1990,4504,4504,4714,4714,1,210,210,0.044548154,0.044548154
FALSE,Morgan County,4/1/90,Hide,Hide,4,1990,2378,2378,2519,2519,1,141,141,0.055974593,0.055974593
FALSE,Piute County,4/1/90,Hide,Hide,4,1990,444,444,479,479,1,35,35,0.073068894,0.073068894
FALSE,Rich County,4/1/90,Hide,Hide,4,1990,729,729,744,744,1,15,15,0.02016129,0.02016129
FALSE,Salt Lake County,4/1/90,Hide,Hide,4,1990,352969,352969,367452,367452,1,14483,14483,0.039414672,0.039414672
FALSE,San Juan County,4/1/90,Hide,Hide,4,1990,3834,3834,4155,4155,1,321,321,0.077256318,0.077256318
FALSE,Sanpete County,4/1/90,Hide,Hide,4,1990,5683,5683,6385,6385,1,702,702,0.109945184,0.109945184
FALSE,Sevier County,4/1/90,Hide,Hide,4,1990,5966,5966,6311,6311,1,345,345,0.054666455,0.054666455
FALSE,State of Utah,4/1/90,Hide,Hide,4,1990,779237,779237,815752,815752,1,36515,36515,0.044762379,0.044762379
FALSE,Summit County,4/1/90,Hide,Hide,4,1990,7433,7433,7920,7920,1,487,487,0.061489899,0.061489899
FALSE,Tooele County,4/1/90,Hide,Hide,4,1990,11761,11761,12434,12434,1,673,673,0.054125784,0.054125784
FALSE,Uintah County,4/1/90,Hide,Hide,4,1990,8297,8297,8858,8858,1,561,561,0.063332581,0.063332581
FALSE,United States,4/1/90,Hide,Hide,4,1990,118852,118852000,125649,125649000,1,6797,6797000,0.054,0.054
FALSE,Utah County,4/1/90,Hide,Hide,4,1990,110712,110712,115961,115961,1,5249,5249,0.045265218,0.045265218
FALSE,Wasatch County,4/1/90,Hide,Hide,4,1990,4287,4287,4560,4560,1,273,273,0.059868421,0.059868421
FALSE,Washington County,4/1/90,Hide,Hide,4,1990,18171,18171,18874,18874,1,703,703,0.037247006,0.037247006
FALSE,Wayne County,4/1/90,Hide,Hide,4,1990,892,892,967,967,1,75,75,0.077559462,0.077559462
FALSE,Weber County,4/1/90,Hide,Hide,4,1990,73138,73138,77101,77101,1,3963,3963,0.051400112,0.051400112
FALSE,Beaver County,5/1/90,Hide,Hide,5,1990,1822,1822,1894,1894,1,72,72,0.038014784,0.038014784
FALSE,Box Elder County,5/1/90,Hide,Hide,5,1990,15470,15470,16269,16269,1,799,799,0.049111808,0.049111808
FALSE,Cache County,5/1/90,Hide,Hide,5,1990,31665,31665,33002,33002,1,1337,1337,0.040512696,0.040512696
FALSE,Carbon County,5/1/90,Hide,Hide,5,1990,7988,7988,8671,8671,1,683,683,0.078768308,0.078768308
FALSE,Daggett County,5/1/90,Hide,Hide,5,1990,333,333,340,340,1,7,7,0.020588235,0.020588235
FALSE,Davis County,5/1/90,Hide,Hide,5,1990,82888,82888,86413,86413,1,3525,3525,0.040792473,0.040792473
FALSE,Duchesne County,5/1/90,Hide,Hide,5,1990,4693,4693,5116,5116,1,423,423,0.082681783,0.082681783
FALSE,Emery County,5/1/90,Hide,Hide,5,1990,3902,3902,4226,4226,1,324,324,0.076668244,0.076668244
FALSE,Garfield County,5/1/90,Hide,Hide,5,1990,1865,1865,2031,2031,1,166,166,0.081733136,0.081733136
FALSE,Grand County,5/1/90,Hide,Hide,5,1990,3060,3060,3315,3315,1,255,255,0.076923077,0.076923077
FALSE,Iron County,5/1/90,Hide,Hide,5,1990,8780,8780,9208,9208,1,428,428,0.046481321,0.046481321
FALSE,Juab County,5/1/90,Hide,Hide,5,1990,2529,2529,2652,2652,1,123,123,0.04638009,0.04638009
FALSE,Kane County,5/1/90,Hide,Hide,5,1990,2395,2395,2546,2546,1,151,151,0.05930872,0.05930872
FALSE,Millard County,5/1/90,Hide,Hide,5,1990,4494,4494,4705,4705,1,211,211,0.044845909,0.044845909
FALSE,Morgan County,5/1/90,Hide,Hide,5,1990,2390,2390,2529,2529,1,139,139,0.054962436,0.054962436
FALSE,Piute County,5/1/90,Hide,Hide,5,1990,447,447,480,480,1,33,33,0.06875,0.06875
FALSE,Rich County,5/1/90,Hide,Hide,5,1990,726,726,740,740,1,14,14,0.018918919,0.018918919
FALSE,Salt Lake County,5/1/90,Hide,Hide,5,1990,354451,354451,368842,368842,1,14391,14391,0.039016706,0.039016706
FALSE,San Juan County,5/1/90,Hide,Hide,5,1990,3827,3827,4162,4162,1,335,335,0.080490149,0.080490149
FALSE,Sanpete County,5/1/90,Hide,Hide,5,1990,5661,5661,6360,6360,1,699,699,0.10990566,0.10990566
FALSE,Sevier County,5/1/90,Hide,Hide,5,1990,5973,5973,6301,6301,1,328,328,0.052055229,0.052055229
FALSE,State of Utah,5/1/90,Hide,Hide,5,1990,781977,781977,818538,818538,1,36561,36561,0.044666222,0.044666222
FALSE,Summit County,5/1/90,Hide,Hide,5,1990,7490,7490,7979,7979,1,489,489,0.061285875,0.061285875
FALSE,Tooele County,5/1/90,Hide,Hide,5,1990,11832,11832,12517,12517,1,685,685,0.054725573,0.054725573
FALSE,Uintah County,5/1/90,Hide,Hide,5,1990,8384,8384,8929,8929,1,545,545,0.06103707,0.06103707
FALSE,United States,5/1/90,Hide,Hide,5,1990,119151,119151000,125893,125893000,1,6742,6742000,0.054,0.054
FALSE,Utah County,5/1/90,Hide,Hide,5,1990,111518,111518,116734,116734,1,5216,5216,0.044682783,0.044682783
FALSE,Wasatch County,5/1/90,Hide,Hide,5,1990,4279,4279,4565,4565,1,286,286,0.062650602,0.062650602
FALSE,Washington County,5/1/90,Hide,Hide,5,1990,18327,18327,19032,19032,1,705,705,0.037042875,0.037042875
FALSE,Wayne County,5/1/90,Hide,Hide,5,1990,876,876,953,953,1,77,77,0.080797482,0.080797482
FALSE,Weber County,5/1/90,Hide,Hide,5,1990,73404,73404,77432,77432,1,4028,4028,0.052019837,0.052019837
FALSE,Beaver County,6/1/90,Hide,Hide,6,1990,1837,1837,1912,1912,1,75,75,0.039225941,0.039225941
FALSE,Box Elder County,6/1/90,Hide,Hide,6,1990,15493,15493,16287,16287,1,794,794,0.048750537,0.048750537
FALSE,Cache County,6/1/90,Hide,Hide,6,1990,31751,31751,33099,33099,1,1348,1348,0.040726306,0.040726306
FALSE,Carbon County,6/1/90,Hide,Hide,6,1990,8010,8010,8674,8674,1,664,664,0.076550611,0.076550611
FALSE,Daggett County,6/1/90,Hide,Hide,6,1990,329,329,338,338,1,9,9,0.026627219,0.026627219
FALSE,Davis County,6/1/90,Hide,Hide,6,1990,83368,83368,86879,86879,1,3511,3511,0.040412528,0.040412528
FALSE,Duchesne County,6/1/90,Hide,Hide,6,1990,4664,4664,5072,5072,1,408,408,0.08044164,0.08044164
FALSE,Emery County,6/1/90,Hide,Hide,6,1990,3872,3872,4202,4202,1,330,330,0.078534031,0.078534031
FALSE,Garfield County,6/1/90,Hide,Hide,6,1990,1838,1838,2009,2009,1,171,171,0.085116974,0.085116974
FALSE,Grand County,6/1/90,Hide,Hide,6,1990,3062,3062,3326,3326,1,264,264,0.079374624,0.079374624
FALSE,Iron County,6/1/90,Hide,Hide,6,1990,8739,8739,9179,9179,1,440,440,0.047935505,0.047935505
FALSE,Juab County,6/1/90,Hide,Hide,6,1990,2551,2551,2675,2675,1,124,124,0.04635514,0.04635514
FALSE,Kane County,6/1/90,Hide,Hide,6,1990,2380,2380,2524,2524,1,144,144,0.057052298,0.057052298
FALSE,Millard County,6/1/90,Hide,Hide,6,1990,4473,4473,4685,4685,1,212,212,0.0452508,0.0452508
FALSE,Morgan County,6/1/90,Hide,Hide,6,1990,2402,2402,2537,2537,1,135,135,0.053212456,0.053212456
FALSE,Piute County,6/1/90,Hide,Hide,6,1990,449,449,481,481,1,32,32,0.066528067,0.066528067
FALSE,Rich County,6/1/90,Hide,Hide,6,1990,718,718,730,730,1,12,12,0.016438356,0.016438356
FALSE,Salt Lake County,6/1/90,Hide,Hide,6,1990,356395,356395,370511,370511,1,14116,14116,0.038098734,0.038098734
FALSE,San Juan County,6/1/90,Hide,Hide,6,1990,3813,3813,4162,4162,1,349,349,0.083853916,0.083853916
FALSE,Sanpete County,6/1/90,Hide,Hide,6,1990,5647,5647,6338,6338,1,691,691,0.109024929,0.109024929
FALSE,Sevier County,6/1/90,Hide,Hide,6,1990,5979,5979,6295,6295,1,316,316,0.05019857,0.05019857
FALSE,State of Utah,6/1/90,Hide,Hide,6,1990,784828,784828,821247,821247,1,36419,36419,0.044345976,0.044345976
FALSE,Summit County,6/1/90,Hide,Hide,6,1990,7538,7538,8028,8028,1,490,490,0.061036373,0.061036373
FALSE,Tooele County,6/1/90,Hide,Hide,6,1990,11886,11886,12567,12567,1,681,681,0.054189544,0.054189544
FALSE,Uintah County,6/1/90,Hide,Hide,6,1990,8419,8419,8948,8948,1,529,529,0.059119356,0.059119356
FALSE,United States,6/1/90,Hide,Hide,6,1990,118983,118983000,125573,125573000,1,6590,6590000,0.052,0.052
FALSE,Utah County,6/1/90,Hide,Hide,6,1990,112041,112041,117216,117216,1,5175,5175,0.044149263,0.044149263
FALSE,Wasatch County,6/1/90,Hide,Hide,6,1990,4265,4265,4570,4570,1,305,305,0.066739606,0.066739606
FALSE,Washington County,6/1/90,Hide,Hide,6,1990,18454,18454,19170,19170,1,716,716,0.037350026,0.037350026
FALSE,Wayne County,6/1/90,Hide,Hide,6,1990,858,858,937,937,1,79,79,0.084311633,0.084311633
FALSE,Weber County,6/1/90,Hide,Hide,6,1990,73784,73784,77838,77838,1,4054,4054,0.05208253,0.05208253
FALSE,Beaver County,7/1/90,Hide,Hide,7,1990,1837,1837,1916,1916,1,79,79,0.041231733,0.041231733
FALSE,Box Elder County,7/1/90,Hide,Hide,7,1990,15512,15512,16285,16285,1,773,773,0.047466994,0.047466994
FALSE,Cache County,7/1/90,Hide,Hide,7,1990,31896,31896,33256,33256,1,1360,1360,0.040894876,0.040894876
FALSE,Carbon County,7/1/90,Hide,Hide,7,1990,8025,8025,8678,8678,1,653,653,0.075247753,0.075247753
FALSE,Daggett County,7/1/90,Hide,Hide,7,1990,330,330,340,340,1,10,10,0.029411765,0.029411765
FALSE,Davis County,7/1/90,Hide,Hide,7,1990,83873,83873,87350,87350,1,3477,3477,0.039805381,0.039805381
FALSE,Duchesne County,7/1/90,Hide,Hide,7,1990,4614,4614,5005,5005,1,391,391,0.078121878,0.078121878
FALSE,Emery County,7/1/90,Hide,Hide,7,1990,3834,3834,4174,4174,1,340,340,0.081456636,0.081456636
FALSE,Garfield County,7/1/90,Hide,Hide,7,1990,1817,1817,1999,1999,1,182,182,0.091045523,0.091045523
FALSE,Grand County,7/1/90,Hide,Hide,7,1990,3068,3068,3338,3338,1,270,270,0.080886759,0.080886759
FALSE,Iron County,7/1/90,Hide,Hide,7,1990,8705,8705,9162,9162,1,457,457,0.049879939,0.049879939
FALSE,Juab County,7/1/90,Hide,Hide,7,1990,2581,2581,2706,2706,1,125,125,0.046193644,0.046193644
FALSE,Kane County,7/1/90,Hide,Hide,7,1990,2364,2364,2502,2502,1,138,138,0.055155875,0.055155875
FALSE,Millard County,7/1/90,Hide,Hide,7,1990,4441,4441,4655,4655,1,214,214,0.045972073,0.045972073
FALSE,Morgan County,7/1/90,Hide,Hide,7,1990,2409,2409,2540,2540,1,131,131,0.051574803,0.051574803
FALSE,Piute County,7/1/90,Hide,Hide,7,1990,447,447,478,478,1,31,31,0.064853556,0.064853556
FALSE,Rich County,7/1/90,Hide,Hide,7,1990,708,708,720,720,1,12,12,0.016666667,0.016666667
FALSE,Salt Lake County,7/1/90,Hide,Hide,7,1990,358318,358318,372161,372161,1,13843,13843,0.037196267,0.037196267
FALSE,San Juan County,7/1/90,Hide,Hide,7,1990,3797,3797,4163,4163,1,366,366,0.087917367,0.087917367
FALSE,Sanpete County,7/1/90,Hide,Hide,7,1990,5660,5660,6337,6337,1,677,677,0.106832886,0.106832886
FALSE,Sevier County,7/1/90,Hide,Hide,7,1990,5984,5984,6297,6297,1,313,313,0.049706209,0.049706209
FALSE,State of Utah,7/1/90,Hide,Hide,7,1990,787745,787745,823873,823873,1,36128,36128,0.043851419,0.043851419
FALSE,Summit County,7/1/90,Hide,Hide,7,1990,7562,7562,8051,8051,1,489,489,0.060737797,0.060737797
FALSE,Tooele County,7/1/90,Hide,Hide,7,1990,11886,11886,12562,12562,1,676,676,0.053813087,0.053813087
FALSE,Uintah County,7/1/90,Hide,Hide,7,1990,8409,8409,8932,8932,1,523,523,0.058553515,0.058553515
FALSE,United States,7/1/90,Hide,Hide,7,1990,118810,118810000,125732,125732000,1,6922,6922000,0.055,0.055
FALSE,Utah County,7/1/90,Hide,Hide,7,1990,112400,112400,117533,117533,1,5133,5133,0.043672841,0.043672841
FALSE,Wasatch County,7/1/90,Hide,Hide,7,1990,4241,4241,4561,4561,1,320,320,0.070160053,0.070160053
FALSE,Washington County,7/1/90,Hide,Hide,7,1990,18593,18593,19326,19326,1,733,733,0.03792818,0.03792818
FALSE,Wayne County,7/1/90,Hide,Hide,7,1990,845,845,928,928,1,83,83,0.089439655,0.089439655
FALSE,Weber County,7/1/90,Hide,Hide,7,1990,74188,74188,78226,78226,1,4038,4038,0.051619666,0.051619666
FALSE,Beaver County,8/1/90,Hide,Hide,8,1990,1823,1823,1905,1905,1,82,82,0.043044619,0.043044619
FALSE,Box Elder County,8/1/90,Hide,Hide,8,1990,15515,15515,16256,16256,1,741,741,0.045583169,0.045583169
FALSE,Cache County,8/1/90,Hide,Hide,8,1990,32038,32038,33409,33409,1,1371,1371,0.041036846,0.041036846
FALSE,Carbon County,8/1/90,Hide,Hide,8,1990,8032,8032,8678,8678,1,646,646,0.074441115,0.074441115
FALSE,Daggett County,8/1/90,Hide,Hide,8,1990,336,336,346,346,1,10,10,0.028901734,0.028901734
FALSE,Davis County,8/1/90,Hide,Hide,8,1990,84307,84307,87769,87769,1,3462,3462,0.039444451,0.039444451
FALSE,Duchesne County,8/1/90,Hide,Hide,8,1990,4557,4557,4940,4940,1,383,383,0.077530364,0.077530364
FALSE,Emery County,8/1/90,Hide,Hide,8,1990,3796,3796,4146,4146,1,350,350,0.084418717,0.084418717
FALSE,Garfield County,8/1/90,Hide,Hide,8,1990,1809,1809,2007,2007,1,198,198,0.098654709,0.098654709
FALSE,Grand County,8/1/90,Hide,Hide,8,1990,3080,3080,3350,3350,1,270,270,0.080597015,0.080597015
FALSE,Iron County,8/1/90,Hide,Hide,8,1990,8687,8687,9159,9159,1,472,472,0.05153401,0.05153401
FALSE,Juab County,8/1/90,Hide,Hide,8,1990,2614,2614,2740,2740,1,126,126,0.045985401,0.045985401
FALSE,Kane County,8/1/90,Hide,Hide,8,1990,2352,2352,2488,2488,1,136,136,0.054662379,0.054662379
FALSE,Millard County,8/1/90,Hide,Hide,8,1990,4407,4407,4624,4624,1,217,217,0.046929066,0.046929066
FALSE,Morgan County,8/1/90,Hide,Hide,8,1990,2409,2409,2535,2535,1,126,126,0.049704142,0.049704142
FALSE,Piute County,8/1/90,Hide,Hide,8,1990,442,442,473,473,1,31,31,0.065539112,0.065539112
FALSE,Rich County,8/1/90,Hide,Hide,8,1990,699,699,711,711,1,12,12,0.016877637,0.016877637
FALSE,Salt Lake County,8/1/90,Hide,Hide,8,1990,359879,359879,373578,373578,1,13699,13699,0.036669718,0.036669718
FALSE,San Juan County,8/1/90,Hide,Hide,8,1990,3780,3780,4169,4169,1,389,389,0.093307748,0.093307748
FALSE,Sanpete County,8/1/90,Hide,Hide,8,1990,5709,5709,6368,6368,1,659,659,0.103486181,0.103486181
FALSE,Sevier County,8/1/90,Hide,Hide,8,1990,5986,5986,6307,6307,1,321,321,0.05089583,0.05089583
FALSE,State of Utah,8/1/90,Hide,Hide,8,1990,790606,790606,826442,826442,1,35836,35836,0.043361785,0.043361785
FALSE,Summit County,8/1/90,Hide,Hide,8,1990,7576,7576,8066,8066,1,490,490,0.060748822,0.060748822
FALSE,Tooele County,8/1/90,Hide,Hide,8,1990,11825,11825,12504,12504,1,679,679,0.054302623,0.054302623
FALSE,Uintah County,8/1/90,Hide,Hide,8,1990,8384,8384,8904,8904,1,520,520,0.058400719,0.058400719
FALSE,United States,8/1/90,Hide,Hide,8,1990,118802,118802000,125990,125990000,1,7188,7188000,0.057,0.057
FALSE,Utah County,8/1/90,Hide,Hide,8,1990,112862,112862,117962,117962,1,5100,5100,0.043234262,0.043234262
FALSE,Wasatch County,8/1/90,Hide,Hide,8,1990,4220,4220,4546,4546,1,326,326,0.071711395,0.071711395
FALSE,Washington County,8/1/90,Hide,Hide,8,1990,18762,18762,19517,19517,1,755,755,0.038684224,0.038684224
FALSE,Wayne County,8/1/90,Hide,Hide,8,1990,839,839,926,926,1,87,87,0.093952484,0.093952484
FALSE,Weber County,8/1/90,Hide,Hide,8,1990,74530,74530,78530,78530,1,4000,4000,0.050935948,0.050935948
FALSE,Beaver County,9/1/90,Hide,Hide,9,1990,1803,1803,1887,1887,1,84,84,0.044515103,0.044515103
FALSE,Box Elder County,9/1/90,Hide,Hide,9,1990,15497,15497,16207,16207,1,710,710,0.043808231,0.043808231
FALSE,Cache County,9/1/90,Hide,Hide,9,1990,32122,32122,33495,33495,1,1373,1373,0.040991193,0.040991193
FALSE,Carbon County,9/1/90,Hide,Hide,9,1990,8037,8037,8674,8674,1,637,637,0.07343786,0.07343786
FALSE,Daggett County,9/1/90,Hide,Hide,9,1990,344,344,353,353,1,9,9,0.025495751,0.025495751
FALSE,Davis County,9/1/90,Hide,Hide,9,1990,84625,84625,88108,88108,1,3483,3483,0.03953103,0.03953103
FALSE,Duchesne County,9/1/90,Hide,Hide,9,1990,4511,4511,4895,4895,1,384,384,0.078447395,0.078447395
FALSE,Emery County,9/1/90,Hide,Hide,9,1990,3765,3765,4122,4122,1,357,357,0.086608443,0.086608443
FALSE,Garfield County,9/1/90,Hide,Hide,9,1990,1818,1818,2030,2030,1,212,212,0.104433498,0.104433498
FALSE,Grand County,9/1/90,Hide,Hide,9,1990,3097,3097,3363,3363,1,266,266,0.079096045,0.079096045
FALSE,Iron County,9/1/90,Hide,Hide,9,1990,8686,8686,9166,9166,1,480,480,0.052367445,0.052367445
FALSE,Juab County,9/1/90,Hide,Hide,9,1990,2643,2643,2769,2769,1,126,126,0.045503792,0.045503792
FALSE,Kane County,9/1/90,Hide,Hide,9,1990,2342,2342,2480,2480,1,138,138,0.055645161,0.055645161
FALSE,Millard County,9/1/90,Hide,Hide,9,1990,4379,4379,4600,4600,1,221,221,0.048043478,0.048043478
FALSE,Morgan County,9/1/90,Hide,Hide,9,1990,2404,2404,2526,2526,1,122,122,0.048297704,0.048297704
FALSE,Piute County,9/1/90,Hide,Hide,9,1990,436,436,468,468,1,32,32,0.068376068,0.068376068
FALSE,Rich County,9/1/90,Hide,Hide,9,1990,696,696,709,709,1,13,13,0.018335684,0.018335684
FALSE,Salt Lake County,9/1/90,Hide,Hide,9,1990,361000,361000,374721,374721,1,13721,13721,0.036616576,0.036616576
FALSE,San Juan County,9/1/90,Hide,Hide,9,1990,3769,3769,4184,4184,1,415,415,0.09918738,0.09918738
FALSE,Sanpete County,9/1/90,Hide,Hide,9,1990,5789,5789,6432,6432,1,643,643,0.099968905,0.099968905
FALSE,Sevier County,9/1/90,Hide,Hide,9,1990,5987,5987,6323,6323,1,336,336,0.053139333,0.053139333
FALSE,State of Utah,9/1/90,Hide,Hide,9,1990,793215,793215,828932,828932,1,35717,35717,0.043087973,0.043087973
FALSE,Summit County,9/1/90,Hide,Hide,9,1990,7586,7586,8079,8079,1,493,493,0.061022404,0.061022404
FALSE,Tooele County,9/1/90,Hide,Hide,9,1990,11718,11718,12406,12406,1,688,688,0.055457037,0.055457037
FALSE,Uintah County,9/1/90,Hide,Hide,9,1990,8380,8380,8896,8896,1,516,516,0.058003597,0.058003597
FALSE,United States,9/1/90,Hide,Hide,9,1990,118524,118524000,125892,125892000,1,7368,7368000,0.059,0.059
FALSE,Utah County,9/1/90,Hide,Hide,9,1990,113572,113572,118649,118649,1,5077,5077,0.042790078,0.042790078
FALSE,Wasatch County,9/1/90,Hide,Hide,9,1990,4212,4212,4532,4532,1,320,320,0.070609003,0.070609003
FALSE,Washington County,9/1/90,Hide,Hide,9,1990,18961,18961,19743,19743,1,782,782,0.039608975,0.039608975
FALSE,Wayne County,9/1/90,Hide,Hide,9,1990,843,843,933,933,1,90,90,0.096463023,0.096463023
FALSE,Weber County,9/1/90,Hide,Hide,9,1990,74766,74766,78756,78756,1,3990,3990,0.050662807,0.050662807
FALSE,Beaver County,10/1/90,Hide,Hide,10,1990,1788,1788,1873,1873,1,85,85,0.045381741,0.045381741
FALSE,Box Elder County,10/1/90,Hide,Hide,10,1990,15457,15457,16145,16145,1,688,688,0.042613812,0.042613812
FALSE,Cache County,10/1/90,Hide,Hide,10,1990,32158,32158,33519,33519,1,1361,1361,0.040603837,0.040603837
FALSE,Carbon County,10/1/90,Hide,Hide,10,1990,8045,8045,8669,8669,1,624,624,0.071980621,0.071980621
FALSE,Daggett County,10/1/90,Hide,Hide,10,1990,353,353,361,361,1,8,8,0.022160665,0.022160665
FALSE,Davis County,10/1/90,Hide,Hide,10,1990,84824,84824,88349,88349,1,3525,3525,0.039898584,0.039898584
FALSE,Duchesne County,10/1/90,Hide,Hide,10,1990,4492,4492,4882,4882,1,390,390,0.079885293,0.079885293
FALSE,Emery County,10/1/90,Hide,Hide,10,1990,3748,3748,4110,4110,1,362,362,0.088077859,0.088077859
FALSE,Garfield County,10/1/90,Hide,Hide,10,1990,1840,1840,2061,2061,1,221,221,0.1072295,0.1072295
FALSE,Grand County,10/1/90,Hide,Hide,10,1990,3122,3122,3383,3383,1,261,261,0.077150458,0.077150458
FALSE,Iron County,10/1/90,Hide,Hide,10,1990,8706,8706,9188,9188,1,482,482,0.05245973,0.05245973
FALSE,Juab County,10/1/90,Hide,Hide,10,1990,2668,2668,2795,2795,1,127,127,0.045438283,0.045438283
FALSE,Kane County,10/1/90,Hide,Hide,10,1990,2337,2337,2482,2482,1,145,145,0.058420629,0.058420629
FALSE,Millard County,10/1/90,Hide,Hide,10,1990,4356,4356,4582,4582,1,226,226,0.04932344,0.04932344
FALSE,Morgan County,10/1/90,Hide,Hide,10,1990,2396,2396,2518,2518,1,122,122,0.048451152,0.048451152
FALSE,Piute County,10/1/90,Hide,Hide,10,1990,431,431,465,465,1,34,34,0.07311828,0.07311828
FALSE,Rich County,10/1/90,Hide,Hide,10,1990,699,699,713,713,1,14,14,0.019635344,0.019635344
FALSE,Salt Lake County,10/1/90,Hide,Hide,10,1990,361786,361786,375639,375639,1,13853,13853,0.036878492,0.036878492
FALSE,San Juan County,10/1/90,Hide,Hide,10,1990,3767,3767,4209,4209,1,442,442,0.105013067,0.105013067
FALSE,Sanpete County,10/1/90,Hide,Hide,10,1990,5884,5884,6519,6519,1,635,635,0.097407578,0.097407578
FALSE,Sevier County,10/1/90,Hide,Hide,10,1990,5989,5989,6345,6345,1,356,356,0.056107171,0.056107171
FALSE,State of Utah,10/1/90,Hide,Hide,10,1990,795511,795511,831368,831368,1,35857,35857,0.043130118,0.043130118
FALSE,Summit County,10/1/90,Hide,Hide,10,1990,7593,7593,8090,8090,1,497,497,0.061433869,0.061433869
FALSE,Tooele County,10/1/90,Hide,Hide,10,1990,11605,11605,12297,12297,1,692,692,0.056273888,0.056273888
FALSE,Uintah County,10/1/90,Hide,Hide,10,1990,8417,8417,8927,8927,1,510,510,0.057130055,0.057130055
FALSE,United States,10/1/90,Hide,Hide,10,1990,118536,118536000,125995,125995000,1,7459,7459000,0.059,0.059
FALSE,Utah County,10/1/90,Hide,Hide,10,1990,114437,114437,119507,119507,1,5070,5070,0.042424293,0.042424293
FALSE,Wasatch County,10/1/90,Hide,Hide,10,1990,4217,4217,4524,4524,1,307,307,0.067860301,0.067860301
FALSE,Washington County,10/1/90,Hide,Hide,10,1990,19168,19168,19979,19979,1,811,811,0.040592622,0.040592622
FALSE,Wayne County,10/1/90,Hide,Hide,10,1990,854,854,947,947,1,93,93,0.098204857,0.098204857
FALSE,Weber County,10/1/90,Hide,Hide,10,1990,74902,74902,78929,78929,1,4027,4027,0.051020537,0.051020537
FALSE,Beaver County,11/1/90,Hide,Hide,11,1990,1786,1786,1870,1870,1,84,84,0.044919786,0.044919786
FALSE,Box Elder County,11/1/90,Hide,Hide,11,1990,15410,15410,16088,16088,1,678,678,0.042143212,0.042143212
FALSE,Cache County,11/1/90,Hide,Hide,11,1990,32177,32177,33508,33508,1,1331,1331,0.039721857,0.039721857
FALSE,Carbon County,11/1/90,Hide,Hide,11,1990,8057,8057,8666,8666,1,609,609,0.070274637,0.070274637
FALSE,Daggett County,11/1/90,Hide,Hide,11,1990,361,361,368,368,1,7,7,0.019021739,0.019021739
FALSE,Davis County,11/1/90,Hide,Hide,11,1990,84939,84939,88518,88518,1,3579,3579,0.040432454,0.040432454
FALSE,Duchesne County,11/1/90,Hide,Hide,11,1990,4513,4513,4908,4908,1,395,395,0.080480848,0.080480848
FALSE,Emery County,11/1/90,Hide,Hide,11,1990,3744,3744,4109,4109,1,365,365,0.088829399,0.088829399
FALSE,Garfield County,11/1/90,Hide,Hide,11,1990,1870,1870,2093,2093,1,223,223,0.106545628,0.106545628
FALSE,Grand County,11/1/90,Hide,Hide,11,1990,3154,3154,3410,3410,1,256,256,0.075073314,0.075073314
FALSE,Iron County,11/1/90,Hide,Hide,11,1990,8750,8750,9233,9233,1,483,483,0.052312358,0.052312358
FALSE,Juab County,11/1/90,Hide,Hide,11,1990,2697,2697,2826,2826,1,129,129,0.045647558,0.045647558
FALSE,Kane County,11/1/90,Hide,Hide,11,1990,2336,2336,2493,2493,1,157,157,0.062976334,0.062976334
FALSE,Millard County,11/1/90,Hide,Hide,11,1990,4336,4336,4567,4567,1,231,231,0.05058025,0.05058025
FALSE,Morgan County,11/1/90,Hide,Hide,11,1990,2390,2390,2514,2514,1,124,124,0.049323787,0.049323787
FALSE,Piute County,11/1/90,Hide,Hide,11,1990,428,428,466,466,1,38,38,0.081545064,0.081545064
FALSE,Rich County,11/1/90,Hide,Hide,11,1990,709,709,725,725,1,16,16,0.022068966,0.022068966
FALSE,Salt Lake County,11/1/90,Hide,Hide,11,1990,362324,362324,376358,376358,1,14034,14034,0.037288964,0.037288964
FALSE,San Juan County,11/1/90,Hide,Hide,11,1990,3770,3770,4235,4235,1,465,465,0.109799292,0.109799292
FALSE,Sanpete County,11/1/90,Hide,Hide,11,1990,5971,5971,6609,6609,1,638,638,0.096535028,0.096535028
FALSE,Sevier County,11/1/90,Hide,Hide,11,1990,5994,5994,6369,6369,1,375,375,0.058878945,0.058878945
FALSE,State of Utah,11/1/90,Hide,Hide,11,1990,797545,797545,833788,833788,1,36243,36243,0.043467884,0.043467884
FALSE,Summit County,11/1/90,Hide,Hide,11,1990,7602,7602,8103,8103,1,501,501,0.061828952,0.061828952
FALSE,Tooele County,11/1/90,Hide,Hide,11,1990,11515,11515,12198,12198,1,683,683,0.055992786,0.055992786
FALSE,Uintah County,11/1/90,Hide,Hide,11,1990,8489,8489,8991,8991,1,502,502,0.055833611,0.055833611
FALSE,United States,11/1/90,Hide,Hide,11,1990,118306,118306000,126070,126070000,1,7764,7764000,0.062,0.062
FALSE,Utah County,11/1/90,Hide,Hide,11,1990,115243,115243,120311,120311,1,5068,5068,0.042124162,0.042124162
FALSE,Wasatch County,11/1/90,Hide,Hide,11,1990,4226,4226,4519,4519,1,293,293,0.064837353,0.064837353
FALSE,Washington County,11/1/90,Hide,Hide,11,1990,19348,19348,20187,20187,1,839,839,0.041561401,0.041561401
FALSE,Wayne County,11/1/90,Hide,Hide,11,1990,869,869,962,962,1,93,93,0.096673597,0.096673597
FALSE,Weber County,11/1/90,Hide,Hide,11,1990,74953,74953,79029,79029,1,4076,4076,0.051576004,0.051576004
FALSE,Beaver County,12/1/90,Hide,Hide,12,1990,1800,1800,1883,1883,1,83,83,0.044078598,0.044078598
FALSE,Box Elder County,12/1/90,Hide,Hide,12,1990,15377,15377,16054,16054,1,677,677,0.042170176,0.042170176
FALSE,Cache County,12/1/90,Hide,Hide,12,1990,32240,32240,33533,33533,1,1293,1293,0.038559031,0.038559031
FALSE,Carbon County,12/1/90,Hide,Hide,12,1990,8071,8071,8663,8663,1,592,592,0.068336604,0.068336604
FALSE,Daggett County,12/1/90,Hide,Hide,12,1990,367,367,373,373,1,6,6,0.016085791,0.016085791
FALSE,Davis County,12/1/90,Hide,Hide,12,1990,85017,85017,88666,88666,1,3649,3649,0.041154445,0.041154445
FALSE,Duchesne County,12/1/90,Hide,Hide,12,1990,4570,4570,4966,4966,1,396,396,0.079742247,0.079742247
FALSE,Emery County,12/1/90,Hide,Hide,12,1990,3745,3745,4112,4112,1,367,367,0.089250973,0.089250973
FALSE,Garfield County,12/1/90,Hide,Hide,12,1990,1897,1897,2118,2118,1,221,221,0.10434372,0.10434372
FALSE,Grand County,12/1/90,Hide,Hide,12,1990,3185,3185,3436,3436,1,251,251,0.073050058,0.073050058
FALSE,Iron County,12/1/90,Hide,Hide,12,1990,8819,8819,9301,9301,1,482,482,0.051822385,0.051822385
FALSE,Juab County,12/1/90,Hide,Hide,12,1990,2731,2731,2863,2863,1,132,132,0.046105484,0.046105484
FALSE,Kane County,12/1/90,Hide,Hide,12,1990,2339,2339,2509,2509,1,170,170,0.067756078,0.067756078
FALSE,Millard County,12/1/90,Hide,Hide,12,1990,4319,4319,4556,4556,1,237,237,0.052019315,0.052019315
FALSE,Morgan County,12/1/90,Hide,Hide,12,1990,2389,2389,2517,2517,1,128,128,0.050854191,0.050854191
FALSE,Piute County,12/1/90,Hide,Hide,12,1990,429,429,471,471,1,42,42,0.089171975,0.089171975
FALSE,Rich County,12/1/90,Hide,Hide,12,1990,723,723,740,740,1,17,17,0.022972973,0.022972973
FALSE,Salt Lake County,12/1/90,Hide,Hide,12,1990,362662,362662,376923,376923,1,14261,14261,0.037835314,0.037835314
FALSE,San Juan County,12/1/90,Hide,Hide,12,1990,3773,3773,4253,4253,1,480,480,0.11286151,0.11286151
FALSE,Sanpete County,12/1/90,Hide,Hide,12,1990,6036,6036,6691,6691,1,655,655,0.097892692,0.097892692
FALSE,Sevier County,12/1/90,Hide,Hide,12,1990,6005,6005,6399,6399,1,394,394,0.061572121,0.061572121
FALSE,State of Utah,12/1/90,Hide,Hide,12,1990,799371,799371,836135,836135,1,36764,36764,0.043968976,0.043968976
FALSE,Summit County,12/1/90,Hide,Hide,12,1990,7623,7623,8130,8130,1,507,507,0.062361624,0.062361624
FALSE,Tooele County,12/1/90,Hide,Hide,12,1990,11465,11465,12126,12126,1,661,661,0.054510968,0.054510968
FALSE,Uintah County,12/1/90,Hide,Hide,12,1990,8579,8579,9078,9078,1,499,499,0.054968055,0.054968055
FALSE,United States,12/1/90,Hide,Hide,12,1990,118241,118241000,126142,126142000,1,7901,7901000,0.063,0.063
FALSE,Utah County,12/1/90,Hide,Hide,12,1990,115847,115847,120912,120912,1,5065,5065,0.04188997,0.04188997
FALSE,Wasatch County,12/1/90,Hide,Hide,12,1990,4239,4239,4526,4526,1,287,287,0.063411401,0.063411401
FALSE,Washington County,12/1/90,Hide,Hide,12,1990,19489,19489,20352,20352,1,863,863,0.042403695,0.042403695
FALSE,Wayne County,12/1/90,Hide,Hide,12,1990,881,881,973,973,1,92,92,0.094552929,0.094552929
FALSE,Weber County,12/1/90,Hide,Hide,12,1990,74940,74940,79063,79063,1,4123,4123,0.052148287,0.052148287
FALSE,Beaver County,1/1/91,Hide,Hide,1,1991,1826,1826,1910,1910,1,84,84,0.043979058,0.043979058
FALSE,Box Elder County,1/1/91,Hide,Hide,1,1991,15371,15371,16049,16049,1,678,678,0.042245623,0.042245623
FALSE,Cache County,1/1/91,Hide,Hide,1,1991,32400,32400,33652,33652,1,1252,1252,0.037204327,0.037204327
FALSE,Carbon County,1/1/91,Hide,Hide,1,1991,8084,8084,8665,8665,1,581,581,0.067051356,0.067051356
FALSE,Daggett County,1/1/91,Hide,Hide,1,1991,370,370,377,377,1,7,7,0.018567639,0.018567639
FALSE,Davis County,1/1/91,Hide,Hide,1,1991,85109,85109,88841,88841,1,3732,3732,0.042007632,0.042007632
FALSE,Duchesne County,1/1/91,Hide,Hide,1,1991,4646,4646,5037,5037,1,391,391,0.077625571,0.077625571
FALSE,Emery County,1/1/91,Hide,Hide,1,1991,3744,3744,4112,4112,1,368,368,0.089494163,0.089494163
FALSE,Garfield County,1/1/91,Hide,Hide,1,1991,1914,1914,2134,2134,1,220,220,0.103092784,0.103092784
FALSE,Grand County,1/1/91,Hide,Hide,1,1991,3205,3205,3452,3452,1,247,247,0.071552723,0.071552723
FALSE,Iron County,1/1/91,Hide,Hide,1,1991,8908,8908,9390,9390,1,482,482,0.051331203,0.051331203
FALSE,Juab County,1/1/91,Hide,Hide,1,1991,2774,2774,2911,2911,1,137,137,0.047062865,0.047062865
FALSE,Kane County,1/1/91,Hide,Hide,1,1991,2347,2347,2529,2529,1,182,182,0.071965204,0.071965204
FALSE,Millard County,1/1/91,Hide,Hide,1,1991,4303,4303,4546,4546,1,243,243,0.053453586,0.053453586
FALSE,Morgan County,1/1/91,Hide,Hide,1,1991,2394,2394,2527,2527,1,133,133,0.052631579,0.052631579
FALSE,Piute County,1/1/91,Hide,Hide,1,1991,434,434,482,482,1,48,48,0.099585062,0.099585062
FALSE,Rich County,1/1/91,Hide,Hide,1,1991,737,737,755,755,1,18,18,0.02384106,0.02384106
FALSE,Salt Lake County,1/1/91,Hide,Hide,1,1991,362887,362887,377445,377445,1,14558,14558,0.038569858,0.038569858
FALSE,San Juan County,1/1/91,Hide,Hide,1,1991,3773,3773,4259,4259,1,486,486,0.114111294,0.114111294
FALSE,Sanpete County,1/1/91,Hide,Hide,1,1991,6073,6073,6754,6754,1,681,681,0.100829138,0.100829138
FALSE,Sevier County,1/1/91,Hide,Hide,1,1991,6019,6019,6430,6430,1,411,411,0.063919129,0.063919129
FALSE,State of Utah,1/1/91,Hide,Hide,1,1991,801034,801034,838374,838374,1,37340,37340,0.044538595,0.044538595
FALSE,Summit County,1/1/91,Hide,Hide,1,1991,7652,7652,8170,8170,1,518,518,0.063402693,0.063402693
FALSE,Tooele County,1/1/91,Hide,Hide,1,1991,11434,11434,12067,12067,1,633,633,0.052457114,0.052457114
FALSE,Uintah County,1/1/91,Hide,Hide,1,1991,8665,8665,9168,9168,1,503,503,0.054864747,0.054864747
FALSE,United States,1/1/91,Hide,Hide,1,1991,117940,117940000,125955,125955000,1,8015,8015000,0.064,0.064
FALSE,Utah County,1/1/91,Hide,Hide,1,1991,116293,116293,121378,121378,1,5085,5085,0.041893918,0.041893918
FALSE,Wasatch County,1/1/91,Hide,Hide,1,1991,4249,4249,4540,4540,1,291,291,0.064096916,0.064096916
FALSE,Washington County,1/1/91,Hide,Hide,1,1991,19591,19591,20471,20471,1,880,880,0.042987641,0.042987641
FALSE,Wayne County,1/1/91,Hide,Hide,1,1991,889,889,980,980,1,91,91,0.092857143,0.092857143
FALSE,Weber County,1/1/91,Hide,Hide,1,1991,74911,74911,79090,79090,1,4179,4179,0.052838538,0.052838538
FALSE,Beaver County,2/1/91,Hide,Hide,2,1991,1858,1858,1943,1943,1,85,85,0.043746783,0.043746783
FALSE,Box Elder County,2/1/91,Hide,Hide,2,1991,15392,15392,16068,16068,1,676,676,0.042071197,0.042071197
FALSE,Cache County,2/1/91,Hide,Hide,2,1991,32646,32646,33848,33848,1,1202,1202,0.035511699,0.035511699
FALSE,Carbon County,2/1/91,Hide,Hide,2,1991,8087,8087,8667,8667,1,580,580,0.066920503,0.066920503
FALSE,Daggett County,2/1/91,Hide,Hide,2,1991,371,371,379,379,1,8,8,0.021108179,0.021108179
FALSE,Davis County,2/1/91,Hide,Hide,2,1991,85234,85234,89054,89054,1,3820,3820,0.042895322,0.042895322
FALSE,Duchesne County,2/1/91,Hide,Hide,2,1991,4718,4718,5100,5100,1,382,382,0.074901961,0.074901961
FALSE,Emery County,2/1/91,Hide,Hide,2,1991,3734,3734,4103,4103,1,369,369,0.089934194,0.089934194
FALSE,Garfield County,2/1/91,Hide,Hide,2,1991,1919,1919,2141,2141,1,222,222,0.103689865,0.103689865
FALSE,Grand County,2/1/91,Hide,Hide,2,1991,3211,3211,3455,3455,1,244,244,0.070622287,0.070622287
FALSE,Iron County,2/1/91,Hide,Hide,2,1991,8987,8987,9474,9474,1,487,487,0.051403842,0.051403842
FALSE,Juab County,2/1/91,Hide,Hide,2,1991,2817,2817,2958,2958,1,141,141,0.047667343,0.047667343
FALSE,Kane County,2/1/91,Hide,Hide,2,1991,2359,2359,2550,2550,1,191,191,0.074901961,0.074901961
FALSE,Millard County,2/1/91,Hide,Hide,2,1991,4298,4298,4546,4546,1,248,248,0.054553454,0.054553454
FALSE,Morgan County,2/1/91,Hide,Hide,2,1991,2403,2403,2541,2541,1,138,138,0.054309327,0.054309327
FALSE,Piute County,2/1/91,Hide,Hide,2,1991,441,441,494,494,1,53,53,0.107287449,0.107287449
FALSE,Rich County,2/1/91,Hide,Hide,2,1991,749,749,768,768,1,19,19,0.024739583,0.024739583
FALSE,Salt Lake County,2/1/91,Hide,Hide,2,1991,363133,363133,378041,378041,1,14908,14908,0.039434876,0.039434876
FALSE,San Juan County,2/1/91,Hide,Hide,2,1991,3764,3764,4247,4247,1,483,483,0.113727337,0.113727337
FALSE,Sanpete County,2/1/91,Hide,Hide,2,1991,6088,6088,6796,6796,1,708,708,0.104178929,0.104178929
FALSE,Sevier County,2/1/91,Hide,Hide,2,1991,6035,6035,6463,6463,1,428,428,0.066223116,0.066223116
FALSE,State of Utah,2/1/91,Hide,Hide,2,1991,802677,802677,840623,840623,1,37946,37946,0.04514033,0.04514033
FALSE,Summit County,2/1/91,Hide,Hide,2,1991,7687,7687,8222,8222,1,535,535,0.065069326,0.065069326
FALSE,Tooele County,2/1/91,Hide,Hide,2,1991,11391,11391,12008,12008,1,617,617,0.051382412,0.051382412
FALSE,Uintah County,2/1/91,Hide,Hide,2,1991,8737,8737,9249,9249,1,512,512,0.055357336,0.055357336
FALSE,United States,2/1/91,Hide,Hide,2,1991,117755,117755000,126020,126020000,1,8265,8265000,0.066,0.066
FALSE,Utah County,2/1/91,Hide,Hide,2,1991,116667,116667,121817,121817,1,5150,5150,0.04227653,0.04227653
FALSE,Wasatch County,2/1/91,Hide,Hide,2,1991,4246,4246,4551,4551,1,305,305,0.067018238,0.067018238
FALSE,Washington County,2/1/91,Hide,Hide,2,1991,19692,19692,20588,20588,1,896,896,0.043520497,0.043520497
FALSE,Wayne County,2/1/91,Hide,Hide,2,1991,891,891,980,980,1,89,89,0.090816327,0.090816327
FALSE,Weber County,2/1/91,Hide,Hide,2,1991,74899,74899,79130,79130,1,4231,4231,0.053468975,0.053468975
FALSE,Beaver County,3/1/91,Hide,Hide,3,1991,1889,1889,1976,1976,1,87,87,0.04402834,0.04402834
FALSE,Box Elder County,3/1/91,Hide,Hide,3,1991,15431,15431,16097,16097,1,666,666,0.041374169,0.041374169
FALSE,Cache County,3/1/91,Hide,Hide,3,1991,32904,32904,34050,34050,1,1146,1146,0.033656388,0.033656388
FALSE,Carbon County,3/1/91,Hide,Hide,3,1991,8072,8072,8663,8663,1,591,591,0.06822117,0.06822117
FALSE,Daggett County,3/1/91,Hide,Hide,3,1991,372,372,381,381,1,9,9,0.023622047,0.023622047
FALSE,Davis County,3/1/91,Hide,Hide,3,1991,85405,85405,89303,89303,1,3898,3898,0.04364915,0.04364915
FALSE,Duchesne County,3/1/91,Hide,Hide,3,1991,4770,4770,5144,5144,1,374,374,0.072706065,0.072706065
FALSE,Emery County,3/1/91,Hide,Hide,3,1991,3714,3714,4083,4083,1,369,369,0.090374724,0.090374724
FALSE,Garfield County,3/1/91,Hide,Hide,3,1991,1914,1914,2142,2142,1,228,228,0.106442577,0.106442577
FALSE,Grand County,3/1/91,Hide,Hide,3,1991,3209,3209,3450,3450,1,241,241,0.069855072,0.069855072
FALSE,Iron County,3/1/91,Hide,Hide,3,1991,9034,9034,9529,9529,1,495,495,0.051946689,0.051946689
FALSE,Juab County,3/1/91,Hide,Hide,3,1991,2851,2851,2995,2995,1,144,144,0.048080134,0.048080134
FALSE,Kane County,3/1/91,Hide,Hide,3,1991,2380,2380,2578,2578,1,198,198,0.076803724,0.076803724
FALSE,Millard County,3/1/91,Hide,Hide,3,1991,4311,4311,4560,4560,1,249,249,0.054605263,0.054605263
FALSE,Morgan County,3/1/91,Hide,Hide,3,1991,2413,2413,2555,2555,1,142,142,0.055577299,0.055577299
FALSE,Piute County,3/1/91,Hide,Hide,3,1991,447,447,504,504,1,57,57,0.113095238,0.113095238
FALSE,Rich County,3/1/91,Hide,Hide,3,1991,752,752,771,771,1,19,19,0.02464332,0.02464332
FALSE,Salt Lake County,3/1/91,Hide,Hide,3,1991,363593,363593,378883,378883,1,15290,15290,0.040355466,0.040355466
FALSE,San Juan County,3/1/91,Hide,Hide,3,1991,3745,3745,4217,4217,1,472,472,0.111927911,0.111927911
FALSE,Sanpete County,3/1/91,Hide,Hide,3,1991,6096,6096,6821,6821,1,725,725,0.1062894,0.1062894
FALSE,Sevier County,3/1/91,Hide,Hide,3,1991,6050,6050,6496,6496,1,446,446,0.068657635,0.068657635
FALSE,State of Utah,3/1/91,Hide,Hide,3,1991,804428,804428,842975,842975,1,38547,38547,0.045727335,0.045727335
FALSE,Summit County,3/1/91,Hide,Hide,3,1991,7733,7733,8288,8288,1,555,555,0.066964286,0.066964286
FALSE,Tooele County,3/1/91,Hide,Hide,3,1991,11342,11342,11963,11963,1,621,621,0.051910056,0.051910056
FALSE,Uintah County,3/1/91,Hide,Hide,3,1991,8789,8789,9311,9311,1,522,522,0.056062722,0.056062722
FALSE,United States,3/1/91,Hide,Hide,3,1991,117652,117652000,126238,126238000,1,8586,8586000,0.068,0.068
FALSE,Utah County,3/1/91,Hide,Hide,3,1991,117054,117054,122297,122297,1,5243,5243,0.042871043,0.042871043
FALSE,Wasatch County,3/1/91,Hide,Hide,3,1991,4235,4235,4560,4560,1,325,325,0.07127193,0.07127193
FALSE,Washington County,3/1/91,Hide,Hide,3,1991,19817,19817,20734,20734,1,917,917,0.044226874,0.044226874
FALSE,Wayne County,3/1/91,Hide,Hide,3,1991,888,888,977,977,1,89,89,0.091095189,0.091095189
FALSE,Weber County,3/1/91,Hide,Hide,3,1991,74945,74945,79206,79206,1,4261,4261,0.05379643,0.05379643
FALSE,Beaver County,4/1/91,Hide,Hide,4,1991,1914,1914,2001,2001,1,87,87,0.043478261,0.043478261
FALSE,Box Elder County,4/1/91,Hide,Hide,4,1991,15475,15475,16126,16126,1,651,651,0.040369589,0.040369589
FALSE,Cache County,4/1/91,Hide,Hide,4,1991,33115,33115,34213,34213,1,1098,1098,0.032093064,0.032093064
FALSE,Carbon County,4/1/91,Hide,Hide,4,1991,8039,8039,8652,8652,1,613,613,0.07085067,0.07085067
FALSE,Daggett County,4/1/91,Hide,Hide,4,1991,372,372,382,382,1,10,10,0.02617801,0.02617801
FALSE,Davis County,4/1/91,Hide,Hide,4,1991,85623,85623,89563,89563,1,3940,3940,0.04399138,0.04399138
FALSE,Duchesne County,4/1/91,Hide,Hide,4,1991,4796,4796,5164,5164,1,368,368,0.071262587,0.071262587
FALSE,Emery County,4/1/91,Hide,Hide,4,1991,3685,3685,4051,4051,1,366,366,0.090348062,0.090348062
FALSE,Garfield County,4/1/91,Hide,Hide,4,1991,1907,1907,2145,2145,1,238,238,0.110955711,0.110955711
FALSE,Grand County,4/1/91,Hide,Hide,4,1991,3206,3206,3445,3445,1,239,239,0.069375907,0.069375907
FALSE,Iron County,4/1/91,Hide,Hide,4,1991,9055,9055,9550,9550,1,495,495,0.051832461,0.051832461
FALSE,Juab County,4/1/91,Hide,Hide,4,1991,2868,2868,3016,3016,1,148,148,0.049071618,0.049071618
FALSE,Kane County,4/1/91,Hide,Hide,4,1991,2409,2409,2613,2613,1,204,204,0.078071183,0.078071183
FALSE,Millard County,4/1/91,Hide,Hide,4,1991,4347,4347,4593,4593,1,246,246,0.053559765,0.053559765
FALSE,Morgan County,4/1/91,Hide,Hide,4,1991,2421,2421,2562,2562,1,141,141,0.055035129,0.055035129
FALSE,Piute County,4/1/91,Hide,Hide,4,1991,453,453,511,511,1,58,58,0.113502935,0.113502935
FALSE,Rich County,4/1/91,Hide,Hide,4,1991,748,748,768,768,1,20,20,0.026041667,0.026041667
FALSE,Salt Lake County,4/1/91,Hide,Hide,4,1991,364348,364348,380026,380026,1,15678,15678,0.041255072,0.041255072
FALSE,San Juan County,4/1/91,Hide,Hide,4,1991,3719,3719,4178,4178,1,459,459,0.109861178,0.109861178
FALSE,Sanpete County,4/1/91,Hide,Hide,4,1991,6106,6106,6832,6832,1,726,726,0.106264637,0.106264637
FALSE,Sevier County,4/1/91,Hide,Hide,4,1991,6059,6059,6523,6523,1,464,464,0.071132914,0.071132914
FALSE,State of Utah,4/1/91,Hide,Hide,4,1991,806359,806359,845497,845497,1,39138,39138,0.046289934,0.046289934
FALSE,Summit County,4/1/91,Hide,Hide,4,1991,7778,7778,8353,8353,1,575,575,0.068837543,0.068837543
FALSE,Tooele County,4/1/91,Hide,Hide,4,1991,11305,11305,11948,11948,1,643,643,0.053816538,0.053816538
FALSE,Uintah County,4/1/91,Hide,Hide,4,1991,8821,8821,9353,9353,1,532,532,0.056880145,0.056880145
FALSE,United States,4/1/91,Hide,Hide,4,1991,118109,118109000,126548,126548000,1,8439,8439000,0.067,0.067
FALSE,Utah County,4/1/91,Hide,Hide,4,1991,117464,117464,122786,122786,1,5322,5322,0.043343704,0.043343704
FALSE,Wasatch County,4/1/91,Hide,Hide,4,1991,4223,4223,4567,4567,1,344,344,0.075322969,0.075322969
FALSE,Washington County,4/1/91,Hide,Hide,4,1991,19961,19961,20904,20904,1,943,943,0.045110984,0.045110984
FALSE,Wayne County,4/1/91,Hide,Hide,4,1991,882,882,971,971,1,89,89,0.091658084,0.091658084
FALSE,Weber County,4/1/91,Hide,Hide,4,1991,75063,75063,79323,79323,1,4260,4260,0.053704474,0.053704474
FALSE,Beaver County,5/1/91,Hide,Hide,5,1991,1929,1929,2014,2014,1,85,85,0.042204568,0.042204568
FALSE,Box Elder County,5/1/91,Hide,Hide,5,1991,15513,15513,16149,16149,1,636,636,0.039383244,0.039383244
FALSE,Cache County,5/1/91,Hide,Hide,5,1991,33258,33258,34343,34343,1,1085,1085,0.031593047,0.031593047
FALSE,Carbon County,5/1/91,Hide,Hide,5,1991,8003,8003,8646,8646,1,643,643,0.074369651,0.074369651
FALSE,Daggett County,5/1/91,Hide,Hide,5,1991,374,374,385,385,1,11,11,0.028571429,0.028571429
FALSE,Davis County,5/1/91,Hide,Hide,5,1991,85869,85869,89814,89814,1,3945,3945,0.04392411,0.04392411
FALSE,Duchesne County,5/1/91,Hide,Hide,5,1991,4794,4794,5160,5160,1,366,366,0.070930233,0.070930233
FALSE,Emery County,5/1/91,Hide,Hide,5,1991,3651,3651,4014,4014,1,363,363,0.090433483,0.090433483
FALSE,Garfield County,5/1/91,Hide,Hide,5,1991,1901,1901,2146,2146,1,245,245,0.11416589,0.11416589
FALSE,Grand County,5/1/91,Hide,Hide,5,1991,3211,3211,3449,3449,1,238,238,0.069005509,0.069005509
FALSE,Iron County,5/1/91,Hide,Hide,5,1991,9062,9062,9551,9551,1,489,489,0.051198827,0.051198827
FALSE,Juab County,5/1/91,Hide,Hide,5,1991,2866,2866,3017,3017,1,151,151,0.050049718,0.050049718
FALSE,Kane County,5/1/91,Hide,Hide,5,1991,2448,2448,2658,2658,1,210,210,0.079006772,0.079006772
FALSE,Millard County,5/1/91,Hide,Hide,5,1991,4404,4404,4643,4643,1,239,239,0.051475339,0.051475339
FALSE,Morgan County,5/1/91,Hide,Hide,5,1991,2429,2429,2567,2567,1,138,138,0.053759252,0.053759252
FALSE,Piute County,5/1/91,Hide,Hide,5,1991,457,457,513,513,1,56,56,0.109161793,0.109161793
FALSE,Rich County,5/1/91,Hide,Hide,5,1991,737,737,756,756,1,19,19,0.025132275,0.025132275
FALSE,Salt Lake County,5/1/91,Hide,Hide,5,1991,365313,365313,381387,381387,1,16074,16074,0.042146166,0.042146166
FALSE,San Juan County,5/1/91,Hide,Hide,5,1991,3690,3690,4136,4136,1,446,446,0.107833656,0.107833656
FALSE,Sanpete County,5/1/91,Hide,Hide,5,1991,6117,6117,6826,6826,1,709,709,0.103867565,0.103867565
FALSE,Sevier County,5/1/91,Hide,Hide,5,1991,6062,6062,6544,6544,1,482,482,0.073655257,0.073655257
FALSE,State of Utah,5/1/91,Hide,Hide,5,1991,808466,808466,848146,848146,1,39680,39680,0.046784398,0.046784398
FALSE,Summit County,5/1/91,Hide,Hide,5,1991,7823,7823,8415,8415,1,592,592,0.070350564,0.070350564
FALSE,Tooele County,5/1/91,Hide,Hide,5,1991,11310,11310,11984,11984,1,674,674,0.056241656,0.056241656
FALSE,Uintah County,5/1/91,Hide,Hide,5,1991,8841,8841,9383,9383,1,542,542,0.057764041,0.057764041
FALSE,United States,5/1/91,Hide,Hide,5,1991,117440,117440000,126176,126176000,1,8736,8736000,0.069,0.069
FALSE,Utah County,5/1/91,Hide,Hide,5,1991,117935,117935,123282,123282,1,5347,5347,0.043372106,0.043372106
FALSE,Wasatch County,5/1/91,Hide,Hide,5,1991,4214,4214,4569,4569,1,355,355,0.077697527,0.077697527
FALSE,Washington County,5/1/91,Hide,Hide,5,1991,20109,20109,21075,21075,1,966,966,0.045836299,0.045836299
FALSE,Wayne County,5/1/91,Hide,Hide,5,1991,875,875,965,965,1,90,90,0.093264249,0.093264249
FALSE,Weber County,5/1/91,Hide,Hide,5,1991,75233,75233,79485,79485,1,4252,4252,0.05349437,0.05349437
FALSE,Beaver County,6/1/91,Hide,Hide,6,1991,1934,1934,2017,2017,1,83,83,0.041150223,0.041150223
FALSE,Box Elder County,6/1/91,Hide,Hide,6,1991,15549,15549,16174,16174,1,625,625,0.038642265,0.038642265
FALSE,Cache County,6/1/91,Hide,Hide,6,1991,33328,33328,34446,34446,1,1118,1118,0.032456599,0.032456599
FALSE,Carbon County,6/1/91,Hide,Hide,6,1991,7973,7973,8650,8650,1,677,677,0.078265896,0.078265896
FALSE,Daggett County,6/1/91,Hide,Hide,6,1991,377,377,388,388,1,11,11,0.028350515,0.028350515
FALSE,Davis County,6/1/91,Hide,Hide,6,1991,86117,86117,90054,90054,1,3937,3937,0.043718214,0.043718214
FALSE,Duchesne County,6/1/91,Hide,Hide,6,1991,4777,4777,5146,5146,1,369,369,0.07170618,0.07170618
FALSE,Emery County,6/1/91,Hide,Hide,6,1991,3621,3621,3983,3983,1,362,362,0.090886267,0.090886267
FALSE,Garfield County,6/1/91,Hide,Hide,6,1991,1900,1900,2149,2149,1,249,249,0.115867846,0.115867846
FALSE,Grand County,6/1/91,Hide,Hide,6,1991,3232,3232,3470,3470,1,238,238,0.068587896,0.068587896
FALSE,Iron County,6/1/91,Hide,Hide,6,1991,9064,9064,9544,9544,1,480,480,0.050293378,0.050293378
FALSE,Juab County,6/1/91,Hide,Hide,6,1991,2849,2849,3004,3004,1,155,155,0.05159787,0.05159787
FALSE,Kane County,6/1/91,Hide,Hide,6,1991,2493,2493,2707,2707,1,214,214,0.079054304,0.079054304
FALSE,Millard County,6/1/91,Hide,Hide,6,1991,4470,4470,4701,4701,1,231,231,0.049138481,0.049138481
FALSE,Morgan County,6/1/91,Hide,Hide,6,1991,2437,2437,2570,2570,1,133,133,0.051750973,0.051750973
FALSE,Piute County,6/1/91,Hide,Hide,6,1991,459,459,511,511,1,52,52,0.101761252,0.101761252
FALSE,Rich County,6/1/91,Hide,Hide,6,1991,725,725,744,744,1,19,19,0.025537634,0.025537634
FALSE,Salt Lake County,6/1/91,Hide,Hide,6,1991,366348,366348,382842,382842,1,16494,16494,0.043083047,0.043083047
FALSE,San Juan County,6/1/91,Hide,Hide,6,1991,3665,3665,4101,4101,1,436,436,0.106315533,0.106315533
FALSE,Sanpete County,6/1/91,Hide,Hide,6,1991,6121,6121,6802,6802,1,681,681,0.100117612,0.100117612
FALSE,Sevier County,6/1/91,Hide,Hide,6,1991,6063,6063,6559,6559,1,496,496,0.075621284,0.075621284
FALSE,State of Utah,6/1/91,Hide,Hide,6,1991,810756,810756,850903,850903,1,40147,40147,0.047181641,0.047181641
FALSE,Summit County,6/1/91,Hide,Hide,6,1991,7871,7871,8475,8475,1,604,604,0.071268437,0.071268437
FALSE,Tooele County,6/1/91,Hide,Hide,6,1991,11378,11378,12080,12080,1,702,702,0.058112583,0.058112583
FALSE,Uintah County,6/1/91,Hide,Hide,6,1991,8854,8854,9405,9405,1,551,551,0.058585859,0.058585859
FALSE,United States,6/1/91,Hide,Hide,6,1991,117639,117639000,126331,126331000,1,8692,8692000,0.069,0.069
FALSE,Utah County,6/1/91,Hide,Hide,6,1991,118447,118447,123779,123779,1,5332,5332,0.043076774,0.043076774
FALSE,Wasatch County,6/1/91,Hide,Hide,6,1991,4215,4215,4574,4574,1,359,359,0.078487101,0.078487101
FALSE,Washington County,6/1/91,Hide,Hide,6,1991,20232,20232,21212,21212,1,980,980,0.046200264,0.046200264
FALSE,Wayne County,6/1/91,Hide,Hide,6,1991,868,868,958,958,1,90,90,0.09394572,0.09394572
FALSE,Weber County,6/1/91,Hide,Hide,6,1991,75413,75413,79661,79661,1,4248,4248,0.053325969,0.053325969
FALSE,Beaver County,7/1/91,Hide,Hide,7,1991,1935,1935,2016,2016,1,81,81,0.040178571,0.040178571
FALSE,Box Elder County,7/1/91,Hide,Hide,7,1991,15587,15587,16208,16208,1,621,621,0.038314413,0.038314413
FALSE,Cache County,7/1/91,Hide,Hide,7,1991,33353,33353,34531,34531,1,1178,1178,0.034114274,0.034114274
FALSE,Carbon County,7/1/91,Hide,Hide,7,1991,7957,7957,8670,8670,1,713,713,0.082237601,0.082237601
FALSE,Daggett County,7/1/91,Hide,Hide,7,1991,381,381,392,392,1,11,11,0.028061224,0.028061224
FALSE,Davis County,7/1/91,Hide,Hide,7,1991,86392,86392,90318,90318,1,3926,3926,0.043468633,0.043468633
FALSE,Duchesne County,7/1/91,Hide,Hide,7,1991,4762,4762,5139,5139,1,377,377,0.073360576,0.073360576
FALSE,Emery County,7/1/91,Hide,Hide,7,1991,3600,3600,3967,3967,1,367,367,0.092513234,0.092513234
FALSE,Garfield County,7/1/91,Hide,Hide,7,1991,1905,1905,2155,2155,1,250,250,0.116009281,0.116009281
FALSE,Grand County,7/1/91,Hide,Hide,7,1991,3267,3267,3507,3507,1,240,240,0.068434559,0.068434559
FALSE,Iron County,7/1/91,Hide,Hide,7,1991,9061,9061,9535,9535,1,474,474,0.049711589,0.049711589
FALSE,Juab County,7/1/91,Hide,Hide,7,1991,2831,2831,2990,2990,1,159,159,0.053177258,0.053177258
FALSE,Kane County,7/1/91,Hide,Hide,7,1991,2532,2532,2748,2748,1,216,216,0.07860262,0.07860262
FALSE,Millard County,7/1/91,Hide,Hide,7,1991,4530,4530,4754,4754,1,224,224,0.047118216,0.047118216
FALSE,Morgan County,7/1/91,Hide,Hide,7,1991,2449,2449,2578,2578,1,129,129,0.05003879,0.05003879
FALSE,Piute County,7/1/91,Hide,Hide,7,1991,459,459,507,507,1,48,48,0.094674556,0.094674556
FALSE,Rich County,7/1/91,Hide,Hide,7,1991,716,716,735,735,1,19,19,0.02585034,0.02585034
FALSE,Salt Lake County,7/1/91,Hide,Hide,7,1991,367446,367446,384348,384348,1,16902,16902,0.043975772,0.043975772
FALSE,San Juan County,7/1/91,Hide,Hide,7,1991,3653,3653,4083,4083,1,430,430,0.10531472,0.10531472
FALSE,Sanpete County,7/1/91,Hide,Hide,7,1991,6116,6116,6769,6769,1,653,653,0.096469198,0.096469198
FALSE,Sevier County,7/1/91,Hide,Hide,7,1991,6066,6066,6571,6571,1,505,505,0.076852838,0.076852838
FALSE,State of Utah,7/1/91,Hide,Hide,7,1991,813140,813140,853677,853677,1,40537,40537,0.047485173,0.047485173
FALSE,Summit County,7/1/91,Hide,Hide,7,1991,7930,7930,8540,8540,1,610,610,0.071428571,0.071428571
FALSE,Tooele County,7/1/91,Hide,Hide,7,1991,11477,11477,12188,12188,1,711,711,0.058336068,0.058336068
FALSE,Uintah County,7/1/91,Hide,Hide,7,1991,8867,8867,9426,9426,1,559,559,0.059304053,0.059304053
FALSE,United States,7/1/91,Hide,Hide,7,1991,117568,117568000,126154,126154000,1,8586,8586000,0.068,0.068
FALSE,Utah County,7/1/91,Hide,Hide,7,1991,118885,118885,124214,124214,1,5329,5329,0.042901766,0.042901766
FALSE,Wasatch County,7/1/91,Hide,Hide,7,1991,4228,4228,4590,4590,1,362,362,0.078867102,0.078867102
FALSE,Washington County,7/1/91,Hide,Hide,7,1991,20324,20324,21308,21308,1,984,984,0.046179839,0.046179839
FALSE,Wayne County,7/1/91,Hide,Hide,7,1991,863,863,952,952,1,89,89,0.093487395,0.093487395
FALSE,Weber County,7/1/91,Hide,Hide,7,1991,75610,75610,79865,79865,1,4255,4255,0.053277406,0.053277406
FALSE,Beaver County,8/1/91,Hide,Hide,8,1991,1938,1938,2020,2020,1,82,82,0.040594059,0.040594059
FALSE,Box Elder County,8/1/91,Hide,Hide,8,1991,15633,15633,16255,16255,1,622,622,0.038265149,0.038265149
FALSE,Cache County,8/1/91,Hide,Hide,8,1991,33413,33413,34647,34647,1,1234,1234,0.035616359,0.035616359
FALSE,Carbon County,8/1/91,Hide,Hide,8,1991,7954,7954,8700,8700,1,746,746,0.085747126,0.085747126
FALSE,Daggett County,8/1/91,Hide,Hide,8,1991,384,384,395,395,1,11,11,0.027848101,0.027848101
FALSE,Davis County,8/1/91,Hide,Hide,8,1991,86691,86691,90604,90604,1,3913,3913,0.043187939,0.043187939
FALSE,Duchesne County,8/1/91,Hide,Hide,8,1991,4767,4767,5157,5157,1,390,390,0.075625364,0.075625364
FALSE,Emery County,8/1/91,Hide,Hide,8,1991,3592,3592,3969,3969,1,377,377,0.094986143,0.094986143
FALSE,Garfield County,8/1/91,Hide,Hide,8,1991,1916,1916,2168,2168,1,252,252,0.116236162,0.116236162
FALSE,Grand County,8/1/91,Hide,Hide,8,1991,3313,3313,3557,3557,1,244,244,0.068597132,0.068597132
FALSE,Iron County,8/1/91,Hide,Hide,8,1991,9066,9066,9540,9540,1,474,474,0.049685535,0.049685535
FALSE,Juab County,8/1/91,Hide,Hide,8,1991,2824,2824,2989,2989,1,165,165,0.055202409,0.055202409
FALSE,Kane County,8/1/91,Hide,Hide,8,1991,2556,2556,2770,2770,1,214,214,0.077256318,0.077256318
FALSE,Millard County,8/1/91,Hide,Hide,8,1991,4568,4568,4791,4791,1,223,223,0.046545606,0.046545606
FALSE,Morgan County,8/1/91,Hide,Hide,8,1991,2465,2465,2590,2590,1,125,125,0.048262548,0.048262548
FALSE,Piute County,8/1/91,Hide,Hide,8,1991,457,457,501,501,1,44,44,0.087824351,0.087824351
FALSE,Rich County,8/1/91,Hide,Hide,8,1991,711,711,729,729,1,18,18,0.024691358,0.024691358
FALSE,Salt Lake County,8/1/91,Hide,Hide,8,1991,368612,368612,385834,385834,1,17222,17222,0.044635776,0.044635776
FALSE,San Juan County,8/1/91,Hide,Hide,8,1991,3657,3657,4084,4084,1,427,427,0.104554358,0.104554358
FALSE,Sanpete County,8/1/91,Hide,Hide,8,1991,6102,6102,6736,6736,1,634,634,0.09412114,0.09412114
FALSE,Sevier County,8/1/91,Hide,Hide,8,1991,6071,6071,6578,6578,1,507,507,0.077075099,0.077075099
FALSE,State of Utah,8/1/91,Hide,Hide,8,1991,815515,815515,856381,856381,1,40866,40866,0.047719415,0.047719415
FALSE,Summit County,8/1/91,Hide,Hide,8,1991,7990,7990,8605,8605,1,615,615,0.071470076,0.071470076
FALSE,Tooele County,8/1/91,Hide,Hide,8,1991,11561,11561,12261,12261,1,700,700,0.057091591,0.057091591
FALSE,Uintah County,8/1/91,Hide,Hide,8,1991,8885,8885,9459,9459,1,574,574,0.060682947,0.060682947
FALSE,United States,8/1/91,Hide,Hide,8,1991,117484,117484000,126150,126150000,1,8666,8666000,0.069,0.069
FALSE,Utah County,8/1/91,Hide,Hide,8,1991,119156,119156,124551,124551,1,5395,5395,0.04331559,0.04331559
FALSE,Wasatch County,8/1/91,Hide,Hide,8,1991,4246,4246,4616,4616,1,370,370,0.080155979,0.080155979
FALSE,Washington County,8/1/91,Hide,Hide,8,1991,20401,20401,21383,21383,1,982,982,0.045924332,0.045924332
FALSE,Wayne County,8/1/91,Hide,Hide,8,1991,861,861,949,949,1,88,88,0.092729189,0.092729189
FALSE,Weber County,8/1/91,Hide,Hide,8,1991,75830,75830,80092,80092,1,4262,4262,0.053213804,0.053213804
FALSE,Beaver County,9/1/91,Hide,Hide,9,1991,1945,1945,2029,2029,1,84,84,0.041399704,0.041399704
FALSE,Box Elder County,9/1/91,Hide,Hide,9,1991,15689,15689,16315,16315,1,626,626,0.038369599,0.038369599
FALSE,Cache County,9/1/91,Hide,Hide,9,1991,33556,33556,34805,34805,1,1249,1249,0.035885649,0.035885649
FALSE,Carbon County,9/1/91,Hide,Hide,9,1991,7960,7960,8735,8735,1,775,775,0.088723526,0.088723526
FALSE,Daggett County,9/1/91,Hide,Hide,9,1991,387,387,398,398,1,11,11,0.027638191,0.027638191
FALSE,Davis County,9/1/91,Hide,Hide,9,1991,86983,86983,90885,90885,1,3902,3902,0.042933377,0.042933377
FALSE,Duchesne County,9/1/91,Hide,Hide,9,1991,4791,4791,5201,5201,1,410,410,0.078830994,0.078830994
FALSE,Emery County,9/1/91,Hide,Hide,9,1991,3598,3598,3988,3988,1,390,390,0.09779338,0.09779338
FALSE,Garfield County,9/1/91,Hide,Hide,9,1991,1926,1926,2181,2181,1,255,255,0.116918845,0.116918845
FALSE,Grand County,9/1/91,Hide,Hide,9,1991,3364,3364,3612,3612,1,248,248,0.068660022,0.068660022
FALSE,Iron County,9/1/91,Hide,Hide,9,1991,9087,9087,9566,9566,1,479,479,0.050073176,0.050073176
FALSE,Juab County,9/1/91,Hide,Hide,9,1991,2829,2829,3002,3002,1,173,173,0.057628248,0.057628248
FALSE,Kane County,9/1/91,Hide,Hide,9,1991,2559,2559,2769,2769,1,210,210,0.075839653,0.075839653
FALSE,Millard County,9/1/91,Hide,Hide,9,1991,4577,4577,4805,4805,1,228,228,0.047450572,0.047450572
FALSE,Morgan County,9/1/91,Hide,Hide,9,1991,2488,2488,2612,2612,1,124,124,0.047473201,0.047473201
FALSE,Piute County,9/1/91,Hide,Hide,9,1991,455,455,497,497,1,42,42,0.084507042,0.084507042
FALSE,Rich County,9/1/91,Hide,Hide,9,1991,713,713,731,731,1,18,18,0.024623803,0.024623803
FALSE,Salt Lake County,9/1/91,Hide,Hide,9,1991,369715,369715,387112,387112,1,17397,17397,0.044940482,0.044940482
FALSE,San Juan County,9/1/91,Hide,Hide,9,1991,3677,3677,4101,4101,1,424,424,0.103389417,0.103389417
FALSE,Sanpete County,9/1/91,Hide,Hide,9,1991,6084,6084,6711,6711,1,627,627,0.093428699,0.093428699
FALSE,Sevier County,9/1/91,Hide,Hide,9,1991,6080,6080,6584,6584,1,504,504,0.07654921,0.07654921
FALSE,State of Utah,9/1/91,Hide,Hide,9,1991,817891,817891,859093,859093,1,41202,41202,0.047959883,0.047959883
FALSE,Summit County,9/1/91,Hide,Hide,9,1991,8054,8054,8675,8675,1,621,621,0.071585014,0.071585014
FALSE,Tooele County,9/1/91,Hide,Hide,9,1991,11608,11608,12289,12289,1,681,681,0.055415412,0.055415412
FALSE,Uintah County,9/1/91,Hide,Hide,9,1991,8894,8894,9491,9491,1,597,597,0.062901696,0.062901696
FALSE,United States,9/1/91,Hide,Hide,9,1991,117928,117928000,126650,126650000,1,8722,8722000,0.069,0.069
FALSE,Utah County,9/1/91,Hide,Hide,9,1991,119315,119315,124839,124839,1,5524,5524,0.044248993,0.044248993
FALSE,Wasatch County,9/1/91,Hide,Hide,9,1991,4265,4265,4650,4650,1,385,385,0.082795699,0.082795699
FALSE,Washington County,9/1/91,Hide,Hide,9,1991,20481,20481,21463,21463,1,982,982,0.045753157,0.045753157
FALSE,Wayne County,9/1/91,Hide,Hide,9,1991,863,863,949,949,1,86,86,0.090621707,0.090621707
FALSE,Weber County,9/1/91,Hide,Hide,9,1991,76041,76041,80288,80288,1,4247,4247,0.052897071,0.052897071
FALSE,Beaver County,10/1/91,Hide,Hide,10,1991,1954,1954,2043,2043,1,89,89,0.043563387,0.043563387
FALSE,Box Elder County,10/1/91,Hide,Hide,10,1991,15741,15741,16374,16374,1,633,633,0.038658849,0.038658849
FALSE,Cache County,10/1/91,Hide,Hide,10,1991,33784,33784,35010,35010,1,1226,1226,0.035018566,0.035018566
FALSE,Carbon County,10/1/91,Hide,Hide,10,1991,7971,7971,8770,8770,1,799,799,0.091106043,0.091106043
FALSE,Daggett County,10/1/91,Hide,Hide,10,1991,388,388,400,400,1,12,12,0.03,0.03
FALSE,Davis County,10/1/91,Hide,Hide,10,1991,87249,87249,91155,91155,1,3906,3906,0.042850091,0.042850091
FALSE,Duchesne County,10/1/91,Hide,Hide,10,1991,4824,4824,5255,5255,1,431,431,0.082017127,0.082017127
FALSE,Emery County,10/1/91,Hide,Hide,10,1991,3621,3621,4025,4025,1,404,404,0.100372671,0.100372671
FALSE,Garfield County,10/1/91,Hide,Hide,10,1991,1934,1934,2198,2198,1,264,264,0.12010919,0.12010919
FALSE,Grand County,10/1/91,Hide,Hide,10,1991,3416,3416,3669,3669,1,253,253,0.068956119,0.068956119
FALSE,Iron County,10/1/91,Hide,Hide,10,1991,9126,9126,9606,9606,1,480,480,0.04996877,0.04996877
FALSE,Juab County,10/1/91,Hide,Hide,10,1991,2833,2833,3016,3016,1,183,183,0.060676393,0.060676393
FALSE,Kane County,10/1/91,Hide,Hide,10,1991,2542,2542,2746,2746,1,204,204,0.074289876,0.074289876
FALSE,Millard County,10/1/91,Hide,Hide,10,1991,4558,4558,4797,4797,1,239,239,0.049822806,0.049822806
FALSE,Morgan County,10/1/91,Hide,Hide,10,1991,2520,2520,2644,2644,1,124,124,0.046898638,0.046898638
FALSE,Piute County,10/1/91,Hide,Hide,10,1991,453,453,494,494,1,41,41,0.082995951,0.082995951
FALSE,Rich County,10/1/91,Hide,Hide,10,1991,718,718,737,737,1,19,19,0.02578019,0.02578019
FALSE,Salt Lake County,10/1/91,Hide,Hide,10,1991,370683,370683,388175,388175,1,17492,17492,0.04506215,0.04506215
FALSE,San Juan County,10/1/91,Hide,Hide,10,1991,3706,3706,4128,4128,1,422,422,0.102228682,0.102228682
FALSE,Sanpete County,10/1/91,Hide,Hide,10,1991,6070,6070,6700,6700,1,630,630,0.094029851,0.094029851
FALSE,Sevier County,10/1/91,Hide,Hide,10,1991,6089,6089,6588,6588,1,499,499,0.075743777,0.075743777
FALSE,State of Utah,10/1/91,Hide,Hide,10,1991,820256,820256,861865,861865,1,41609,41609,0.048277863,0.048277863
FALSE,Summit County,10/1/91,Hide,Hide,10,1991,8123,8123,8750,8750,1,627,627,0.071657143,0.071657143
FALSE,Tooele County,10/1/91,Hide,Hide,10,1991,11641,11641,12311,12311,1,670,670,0.054422874,0.054422874
FALSE,Uintah County,10/1/91,Hide,Hide,10,1991,8886,8886,9513,9513,1,627,627,0.065909808,0.065909808
FALSE,United States,10/1/91,Hide,Hide,10,1991,117800,117800000,126642,126642000,1,8842,8842000,0.07,0.07
FALSE,Utah County,10/1/91,Hide,Hide,10,1991,119438,119438,125094,125094,1,5656,5656,0.045213999,0.045213999
FALSE,Wasatch County,10/1/91,Hide,Hide,10,1991,4292,4292,4694,4694,1,402,402,0.085641244,0.085641244
FALSE,Washington County,10/1/91,Hide,Hide,10,1991,20590,20590,21576,21576,1,986,986,0.045698925,0.045698925
FALSE,Wayne County,10/1/91,Hide,Hide,10,1991,871,871,955,955,1,84,84,0.087958115,0.087958115
FALSE,Weber County,10/1/91,Hide,Hide,10,1991,76227,76227,80456,80456,1,4229,4229,0.052562892,0.052562892
FALSE,Beaver County,11/1/91,Hide,Hide,11,1991,1962,1962,2057,2057,1,95,95,0.046183763,0.046183763
FALSE,Box Elder County,11/1/91,Hide,Hide,11,1991,15769,15769,16411,16411,1,642,642,0.039120102,0.039120102
FALSE,Cache County,11/1/91,Hide,Hide,11,1991,34051,34051,35247,35247,1,1196,1196,0.033931966,0.033931966
FALSE,Carbon County,11/1/91,Hide,Hide,11,1991,7984,7984,8805,8805,1,821,821,0.093242476,0.093242476
FALSE,Daggett County,11/1/91,Hide,Hide,11,1991,387,387,401,401,1,14,14,0.034912718,0.034912718
FALSE,Davis County,11/1/91,Hide,Hide,11,1991,87512,87512,91441,91441,1,3929,3929,0.042967597,0.042967597
FALSE,Duchesne County,11/1/91,Hide,Hide,11,1991,4855,4855,5302,5302,1,447,447,0.084307808,0.084307808
FALSE,Emery County,11/1/91,Hide,Hide,11,1991,3659,3659,4074,4074,1,415,415,0.101865488,0.101865488
FALSE,Garfield County,11/1/91,Hide,Hide,11,1991,1938,1938,2212,2212,1,274,274,0.123869801,0.123869801
FALSE,Grand County,11/1/91,Hide,Hide,11,1991,3467,3467,3725,3725,1,258,258,0.069261745,0.069261745
FALSE,Iron County,11/1/91,Hide,Hide,11,1991,9176,9176,9646,9646,1,470,470,0.04872486,0.04872486
FALSE,Juab County,11/1/91,Hide,Hide,11,1991,2836,2836,3030,3030,1,194,194,0.064026403,0.064026403
FALSE,Kane County,11/1/91,Hide,Hide,11,1991,2510,2510,2710,2710,1,200,200,0.073800738,0.073800738
FALSE,Millard County,11/1/91,Hide,Hide,11,1991,4525,4525,4775,4775,1,250,250,0.052356021,0.052356021
FALSE,Morgan County,11/1/91,Hide,Hide,11,1991,2561,2561,2686,2686,1,125,125,0.046537602,0.046537602
FALSE,Piute County,11/1/91,Hide,Hide,11,1991,452,452,492,492,1,40,40,0.081300813,0.081300813
FALSE,Rich County,11/1/91,Hide,Hide,11,1991,725,725,745,745,1,20,20,0.026845638,0.026845638
FALSE,Salt Lake County,11/1/91,Hide,Hide,11,1991,371597,371597,389190,389190,1,17593,17593,0.045204142,0.045204142
FALSE,San Juan County,11/1/91,Hide,Hide,11,1991,3740,3740,4158,4158,1,418,418,0.100529101,0.100529101
FALSE,Sanpete County,11/1/91,Hide,Hide,11,1991,6060,6060,6695,6695,1,635,635,0.094846901,0.094846901
FALSE,Sevier County,11/1/91,Hide,Hide,11,1991,6098,6098,6592,6592,1,494,494,0.07493932,0.07493932
FALSE,State of Utah,11/1/91,Hide,Hide,11,1991,822673,822673,864750,864750,1,42077,42077,0.048657994,0.048657994
FALSE,Summit County,11/1/91,Hide,Hide,11,1991,8184,8184,8815,8815,1,631,631,0.07158253,0.07158253
FALSE,Tooele County,11/1/91,Hide,Hide,11,1991,11693,11693,12368,12368,1,675,675,0.054576326,0.054576326
FALSE,Uintah County,11/1/91,Hide,Hide,11,1991,8877,8877,9530,9530,1,653,653,0.068520462,0.068520462
FALSE,United States,11/1/91,Hide,Hide,11,1991,117770,117770000,126701,126701000,1,8931,8931000,0.07,0.07
FALSE,Utah County,11/1/91,Hide,Hide,11,1991,119602,119602,125344,125344,1,5742,5742,0.045809931,0.045809931
FALSE,Wasatch County,11/1/91,Hide,Hide,11,1991,4326,4326,4741,4741,1,415,415,0.087534275,0.087534275
FALSE,Washington County,11/1/91,Hide,Hide,11,1991,20729,20729,21722,21722,1,993,993,0.045714023,0.045714023
FALSE,Wayne County,11/1/91,Hide,Hide,11,1991,884,884,967,967,1,83,83,0.085832472,0.085832472
FALSE,Weber County,11/1/91,Hide,Hide,11,1991,76408,76408,80667,80667,1,4259,4259,0.052797302,0.052797302
FALSE,Beaver County,12/1/91,Hide,Hide,12,1991,1963,1963,2063,2063,1,100,100,0.048473097,0.048473097
FALSE,Box Elder County,12/1/91,Hide,Hide,12,1991,15752,15752,16408,16408,1,656,656,0.039980497,0.039980497
FALSE,Cache County,12/1/91,Hide,Hide,12,1991,34278,34278,35470,35470,1,1192,1192,0.033605864,0.033605864
FALSE,Carbon County,12/1/91,Hide,Hide,12,1991,8000,8000,8841,8841,1,841,841,0.095124986,0.095124986
FALSE,Daggett County,12/1/91,Hide,Hide,12,1991,387,387,402,402,1,15,15,0.037313433,0.037313433
FALSE,Davis County,12/1/91,Hide,Hide,12,1991,87797,87797,91755,91755,1,3958,3958,0.043136614,0.043136614
FALSE,Duchesne County,12/1/91,Hide,Hide,12,1991,4879,4879,5332,5332,1,453,453,0.08495874,0.08495874
FALSE,Emery County,12/1/91,Hide,Hide,12,1991,3714,3714,4135,4135,1,421,421,0.101813785,0.101813785
FALSE,Garfield County,12/1/91,Hide,Hide,12,1991,1940,1940,2224,2224,1,284,284,0.127697842,0.127697842
FALSE,Grand County,12/1/91,Hide,Hide,12,1991,3519,3519,3782,3782,1,263,263,0.069539926,0.069539926
FALSE,Iron County,12/1/91,Hide,Hide,12,1991,9218,9218,9669,9669,1,451,451,0.046643914,0.046643914
FALSE,Juab County,12/1/91,Hide,Hide,12,1991,2839,2839,3045,3045,1,206,206,0.067651888,0.067651888
FALSE,Kane County,12/1/91,Hide,Hide,12,1991,2479,2479,2677,2677,1,198,198,0.073963392,0.073963392
FALSE,Millard County,12/1/91,Hide,Hide,12,1991,4489,4489,4750,4750,1,261,261,0.054947368,0.054947368
FALSE,Morgan County,12/1/91,Hide,Hide,12,1991,2609,2609,2737,2737,1,128,128,0.046766533,0.046766533
FALSE,Piute County,12/1/91,Hide,Hide,12,1991,452,452,490,490,1,38,38,0.07755102,0.07755102
FALSE,Rich County,12/1/91,Hide,Hide,12,1991,731,731,752,752,1,21,21,0.027925532,0.027925532
FALSE,Salt Lake County,12/1/91,Hide,Hide,12,1991,372584,372584,390323,390323,1,17739,17739,0.045446976,0.045446976
FALSE,San Juan County,12/1/91,Hide,Hide,12,1991,3775,3775,4190,4190,1,415,415,0.099045346,0.099045346
FALSE,Sanpete County,12/1/91,Hide,Hide,12,1991,6059,6059,6695,6695,1,636,636,0.094996266,0.094996266
FALSE,Sevier County,12/1/91,Hide,Hide,12,1991,6105,6105,6597,6597,1,492,492,0.074579354,0.074579354
FALSE,State of Utah,12/1/91,Hide,Hide,12,1991,825270,825270,867831,867831,1,42561,42561,0.049042959,0.049042959
FALSE,Summit County,12/1/91,Hide,Hide,12,1991,8237,8237,8869,8869,1,632,632,0.071259443,0.071259443
FALSE,Tooele County,12/1/91,Hide,Hide,12,1991,11765,11765,12461,12461,1,696,696,0.055854265,0.055854265
FALSE,Uintah County,12/1/91,Hide,Hide,12,1991,8879,8879,9551,9551,1,672,672,0.070359125,0.070359125
FALSE,United States,12/1/91,Hide,Hide,12,1991,117466,117466000,126664,126664000,1,9198,9198000,0.073,0.073
FALSE,Utah County,12/1/91,Hide,Hide,12,1991,119836,119836,125612,125612,1,5776,5776,0.045982868,0.045982868
FALSE,Wasatch County,12/1/91,Hide,Hide,12,1991,4361,4361,4783,4783,1,422,422,0.088229145,0.088229145
FALSE,Washington County,12/1/91,Hide,Hide,12,1991,20881,20881,21882,21882,1,1001,1001,0.045745361,0.045745361
FALSE,Wayne County,12/1/91,Hide,Hide,12,1991,901,901,984,984,1,83,83,0.084349593,0.084349593
FALSE,Weber County,12/1/91,Hide,Hide,12,1991,76610,76610,80943,80943,1,4333,4333,0.053531497,0.053531497
FALSE,Beaver County,1/1/92,Hide,Hide,1,1992,1957,1957,2061,2061,1,104,104,0.050460941,0.050460941
FALSE,Box Elder County,1/1/92,Hide,Hide,1,1992,15689,15689,16366,16366,1,677,677,0.041366247,0.041366247
FALSE,Cache County,1/1/92,Hide,Hide,1,1992,34417,34417,35650,35650,1,1233,1233,0.034586255,0.034586255
FALSE,Carbon County,1/1/92,Hide,Hide,1,1992,8023,8023,8881,8881,1,858,858,0.096610742,0.096610742
FALSE,Daggett County,1/1/92,Hide,Hide,1,1992,387,387,403,403,1,16,16,0.039702233,0.039702233
FALSE,Davis County,1/1/92,Hide,Hide,1,1992,88144,88144,92127,92127,1,3983,3983,0.043233797,0.043233797
FALSE,Duchesne County,1/1/92,Hide,Hide,1,1992,4893,4893,5347,5347,1,454,454,0.084907425,0.084907425
FALSE,Emery County,1/1/92,Hide,Hide,1,1992,3782,3782,4204,4204,1,422,422,0.10038059,0.10038059
FALSE,Garfield County,1/1/92,Hide,Hide,1,1992,1943,1943,2237,2237,1,294,294,0.131426017,0.131426017
FALSE,Grand County,1/1/92,Hide,Hide,1,1992,3570,3570,3841,3841,1,271,271,0.070554543,0.070554543
FALSE,Iron County,1/1/92,Hide,Hide,1,1992,9250,9250,9679,9679,1,429,429,0.044322761,0.044322761
FALSE,Juab County,1/1/92,Hide,Hide,1,1992,2842,2842,3059,3059,1,217,217,0.070938215,0.070938215
FALSE,Kane County,1/1/92,Hide,Hide,1,1992,2466,2466,2667,2667,1,201,201,0.075365579,0.075365579
FALSE,Millard County,1/1/92,Hide,Hide,1,1992,4463,4463,4730,4730,1,267,267,0.056448203,0.056448203
FALSE,Morgan County,1/1/92,Hide,Hide,1,1992,2661,2661,2791,2791,1,130,130,0.046578287,0.046578287
FALSE,Piute County,1/1/92,Hide,Hide,1,1992,453,453,490,490,1,37,37,0.075510204,0.075510204
FALSE,Rich County,1/1/92,Hide,Hide,1,1992,736,736,759,759,1,23,23,0.03030303,0.03030303
FALSE,Salt Lake County,1/1/92,Hide,Hide,1,1992,373823,373823,391709,391709,1,17886,17886,0.045661448,0.045661448
FALSE,San Juan County,1/1/92,Hide,Hide,1,1992,3808,3808,4222,4222,1,414,414,0.098057793,0.098057793
FALSE,Sanpete County,1/1/92,Hide,Hide,1,1992,6067,6067,6697,6697,1,630,630,0.094071973,0.094071973
FALSE,Sevier County,1/1/92,Hide,Hide,1,1992,6113,6113,6602,6602,1,489,489,0.074068464,0.074068464
FALSE,State of Utah,1/1/92,Hide,Hide,1,1992,828107,828107,871120,871120,1,43013,43013,0.049376665,0.049376665
FALSE,Summit County,1/1/92,Hide,Hide,1,1992,8287,8287,8917,8917,1,630,630,0.070651564,0.070651564
FALSE,Tooele County,1/1/92,Hide,Hide,1,1992,11860,11860,12583,12583,1,723,723,0.057458476,0.057458476
FALSE,Uintah County,1/1/92,Hide,Hide,1,1992,8898,8898,9580,9580,1,682,682,0.071189979,0.071189979
FALSE,United States,1/1/92,Hide,Hide,1,1992,117978,117978000,127261,127261000,1,9283,9283000,0.073,0.073
FALSE,Utah County,1/1/92,Hide,Hide,1,1992,120151,120151,125913,125913,1,5762,5762,0.045761756,0.045761756
FALSE,Wasatch County,1/1/92,Hide,Hide,1,1992,4389,4389,4815,4815,1,426,426,0.08847352,0.08847352
FALSE,Washington County,1/1/92,Hide,Hide,1,1992,21036,21036,22040,22040,1,1004,1004,0.045553539,0.045553539
FALSE,Wayne County,1/1/92,Hide,Hide,1,1992,919,919,1003,1003,1,84,84,0.083748754,0.083748754
FALSE,Weber County,1/1/92,Hide,Hide,1,1992,76867,76867,81293,81293,1,4426,4426,0.054445032,0.054445032
FALSE,Beaver County,2/1/92,Hide,Hide,2,1992,1942,1942,2049,2049,1,107,107,0.052220595,0.052220595
FALSE,Box Elder County,2/1/92,Hide,Hide,2,1992,15596,15596,16303,16303,1,707,707,0.043366252,0.043366252
FALSE,Cache County,2/1/92,Hide,Hide,2,1992,34482,34482,35792,35792,1,1310,1310,0.036600358,0.036600358
FALSE,Carbon County,2/1/92,Hide,Hide,2,1992,8057,8057,8924,8924,1,867,867,0.097153743,0.097153743
FALSE,Daggett County,2/1/92,Hide,Hide,2,1992,386,386,403,403,1,17,17,0.042183623,0.042183623
FALSE,Davis County,2/1/92,Hide,Hide,2,1992,88548,88548,92541,92541,1,3993,3993,0.043148442,0.043148442
FALSE,Duchesne County,2/1/92,Hide,Hide,2,1992,4907,4907,5361,5361,1,454,454,0.084685693,0.084685693
FALSE,Emery County,2/1/92,Hide,Hide,2,1992,3861,3861,4279,4279,1,418,418,0.097686375,0.097686375
FALSE,Garfield County,2/1/92,Hide,Hide,2,1992,1949,1949,2251,2251,1,302,302,0.134162594,0.134162594
FALSE,Grand County,2/1/92,Hide,Hide,2,1992,3617,3617,3898,3898,1,281,281,0.07208825,0.07208825
FALSE,Iron County,2/1/92,Hide,Hide,2,1992,9297,9297,9707,9707,1,410,410,0.042237561,0.042237561
FALSE,Juab County,2/1/92,Hide,Hide,2,1992,2846,2846,3071,3071,1,225,225,0.073266037,0.073266037
FALSE,Kane County,2/1/92,Hide,Hide,2,1992,2484,2484,2693,2693,1,209,209,0.077608615,0.077608615
FALSE,Millard County,2/1/92,Hide,Hide,2,1992,4448,4448,4718,4718,1,270,270,0.057227639,0.057227639
FALSE,Morgan County,2/1/92,Hide,Hide,2,1992,2710,2710,2842,2842,1,132,132,0.046446165,0.046446165
FALSE,Piute County,2/1/92,Hide,Hide,2,1992,453,453,488,488,1,35,35,0.071721311,0.071721311
FALSE,Rich County,2/1/92,Hide,Hide,2,1992,740,740,764,764,1,24,24,0.031413613,0.031413613
FALSE,Salt Lake County,2/1/92,Hide,Hide,2,1992,375320,375320,393275,393275,1,17955,17955,0.045655076,0.045655076
FALSE,San Juan County,2/1/92,Hide,Hide,2,1992,3839,3839,4258,4258,1,419,419,0.098403006,0.098403006
FALSE,Sanpete County,2/1/92,Hide,Hide,2,1992,6083,6083,6704,6704,1,621,621,0.092631265,0.092631265
FALSE,Sevier County,2/1/92,Hide,Hide,2,1992,6125,6125,6609,6609,1,484,484,0.07323347,0.07323347
FALSE,State of Utah,2/1/92,Hide,Hide,2,1992,831108,831108,874447,874447,1,43339,43339,0.049561609,0.049561609
FALSE,Summit County,2/1/92,Hide,Hide,2,1992,8341,8341,8968,8968,1,627,627,0.069915254,0.069915254
FALSE,Tooele County,2/1/92,Hide,Hide,2,1992,11957,11957,12702,12702,1,745,745,0.058652181,0.058652181
FALSE,Uintah County,2/1/92,Hide,Hide,2,1992,8926,8926,9612,9612,1,686,686,0.071369122,0.071369122
FALSE,United States,2/1/92,Hide,Hide,2,1992,117753,117753000,127207,127207000,1,9454,9454000,0.074,0.074
FALSE,Utah County,2/1/92,Hide,Hide,2,1992,120503,120503,126204,126204,1,5701,5701,0.045172895,0.045172895
FALSE,Wasatch County,2/1/92,Hide,Hide,2,1992,4406,4406,4831,4831,1,425,425,0.087973504,0.087973504
FALSE,Washington County,2/1/92,Hide,Hide,2,1992,21195,21195,22193,22193,1,998,998,0.044969134,0.044969134
FALSE,Wayne County,2/1/92,Hide,Hide,2,1992,935,935,1020,1020,1,85,85,0.083333333,0.083333333
FALSE,Weber County,2/1/92,Hide,Hide,2,1992,77175,77175,81695,81695,1,4520,4520,0.055327743,0.055327743
FALSE,Beaver County,3/1/92,Hide,Hide,3,1992,1924,1924,2033,2033,1,109,109,0.053615347,0.053615347
FALSE,Box Elder County,3/1/92,Hide,Hide,3,1992,15495,15495,16239,16239,1,744,744,0.045815629,0.045815629
FALSE,Cache County,3/1/92,Hide,Hide,3,1992,34535,34535,35939,35939,1,1404,1404,0.039066195,0.039066195
FALSE,Carbon County,3/1/92,Hide,Hide,3,1992,8098,8098,8967,8967,1,869,869,0.096910896,0.096910896
FALSE,Daggett County,3/1/92,Hide,Hide,3,1992,385,385,402,402,1,17,17,0.042288557,0.042288557
FALSE,Davis County,3/1/92,Hide,Hide,3,1992,88943,88943,92939,92939,1,3996,3996,0.042995944,0.042995944
FALSE,Duchesne County,3/1/92,Hide,Hide,3,1992,4921,4921,5379,5379,1,458,458,0.085145938,0.085145938
FALSE,Emery County,3/1/92,Hide,Hide,3,1992,3945,3945,4356,4356,1,411,411,0.094352617,0.094352617
FALSE,Garfield County,3/1/92,Hide,Hide,3,1992,1957,1957,2268,2268,1,311,311,0.13712522,0.13712522
FALSE,Grand County,3/1/92,Hide,Hide,3,1992,3658,3658,3949,3949,1,291,291,0.073689542,0.073689542
FALSE,Iron County,3/1/92,Hide,Hide,3,1992,9378,9378,9778,9778,1,400,400,0.040908161,0.040908161
FALSE,Juab County,3/1/92,Hide,Hide,3,1992,2855,2855,3084,3084,1,229,229,0.074254215,0.074254215
FALSE,Kane County,3/1/92,Hide,Hide,3,1992,2538,2538,2757,2757,1,219,219,0.079434168,0.079434168
FALSE,Millard County,3/1/92,Hide,Hide,3,1992,4443,4443,4715,4715,1,272,272,0.057688229,0.057688229
FALSE,Morgan County,3/1/92,Hide,Hide,3,1992,2748,2748,2882,2882,1,134,134,0.046495489,0.046495489
FALSE,Piute County,3/1/92,Hide,Hide,3,1992,451,451,484,484,1,33,33,0.068181818,0.068181818
FALSE,Rich County,3/1/92,Hide,Hide,3,1992,745,745,770,770,1,25,25,0.032467532,0.032467532
FALSE,Salt Lake County,3/1/92,Hide,Hide,3,1992,376830,376830,394713,394713,1,17883,17883,0.045306337,0.045306337
FALSE,San Juan County,3/1/92,Hide,Hide,3,1992,3873,3873,4303,4303,1,430,430,0.099930281,0.099930281
FALSE,Sanpete County,3/1/92,Hide,Hide,3,1992,6106,6106,6719,6719,1,613,613,0.091233815,0.091233815
FALSE,Sevier County,3/1/92,Hide,Hide,3,1992,6143,6143,6620,6620,1,477,477,0.072054381,0.072054381
FALSE,State of Utah,3/1/92,Hide,Hide,3,1992,834201,834201,877691,877691,1,43490,43490,0.049550468,0.049550468
FALSE,Summit County,3/1/92,Hide,Hide,3,1992,8403,8403,9028,9028,1,625,625,0.069229065,0.069229065
FALSE,Tooele County,3/1/92,Hide,Hide,3,1992,12036,12036,12794,12794,1,758,758,0.059246522,0.059246522
FALSE,Uintah County,3/1/92,Hide,Hide,3,1992,8946,8946,9638,9638,1,692,692,0.071799128,0.071799128
FALSE,United States,3/1/92,Hide,Hide,3,1992,118144,118144000,127604,127604000,1,9460,9460000,0.074,0.074
FALSE,Utah County,3/1/92,Hide,Hide,3,1992,120903,120903,126502,126502,1,5599,5599,0.04426017,0.04426017
FALSE,Wasatch County,3/1/92,Hide,Hide,3,1992,4411,4411,4830,4830,1,419,419,0.086749482,0.086749482
FALSE,Washington County,3/1/92,Hide,Hide,3,1992,21360,21360,22344,22344,1,984,984,0.044038668,0.044038668
FALSE,Wayne County,3/1/92,Hide,Hide,3,1992,948,948,1035,1035,1,87,87,0.084057971,0.084057971
FALSE,Weber County,3/1/92,Hide,Hide,3,1992,77473,77473,82098,82098,1,4625,4625,0.056335112,0.056335112
FALSE,Beaver County,4/1/92,Hide,Hide,4,1992,1910,1910,2020,2020,1,110,110,0.054455446,0.054455446
FALSE,Box Elder County,4/1/92,Hide,Hide,4,1992,15410,15410,16194,16194,1,784,784,0.048412992,0.048412992
FALSE,Cache County,4/1/92,Hide,Hide,4,1992,34607,34607,36085,36085,1,1478,1478,0.040958847,0.040958847
FALSE,Carbon County,4/1/92,Hide,Hide,4,1992,8140,8140,9005,9005,1,865,865,0.096057746,0.096057746
FALSE,Daggett County,4/1/92,Hide,Hide,4,1992,383,383,400,400,1,17,17,0.0425,0.0425
FALSE,Davis County,4/1/92,Hide,Hide,4,1992,89275,89275,93285,93285,1,4010,4010,0.042986547,0.042986547
FALSE,Duchesne County,4/1/92,Hide,Hide,4,1992,4934,4934,5403,5403,1,469,469,0.086803628,0.086803628
FALSE,Emery County,4/1/92,Hide,Hide,4,1992,4029,4029,4433,4433,1,404,404,0.091134672,0.091134672
FALSE,Garfield County,4/1/92,Hide,Hide,4,1992,1966,1966,2286,2286,1,320,320,0.139982502,0.139982502
FALSE,Grand County,4/1/92,Hide,Hide,4,1992,3691,3691,3992,3992,1,301,301,0.075400802,0.075400802
FALSE,Iron County,4/1/92,Hide,Hide,4,1992,9493,9493,9893,9893,1,400,400,0.040432629,0.040432629
FALSE,Juab County,4/1/92,Hide,Hide,4,1992,2871,2871,3100,3100,1,229,229,0.073870968,0.073870968
FALSE,Kane County,4/1/92,Hide,Hide,4,1992,2621,2621,2850,2850,1,229,229,0.080350877,0.080350877
FALSE,Millard County,4/1/92,Hide,Hide,4,1992,4444,4444,4718,4718,1,274,274,0.058075456,0.058075456
FALSE,Morgan County,4/1/92,Hide,Hide,4,1992,2773,2773,2912,2912,1,139,139,0.047733516,0.047733516
FALSE,Piute County,4/1/92,Hide,Hide,4,1992,447,447,479,479,1,32,32,0.066805846,0.066805846
FALSE,Rich County,4/1/92,Hide,Hide,4,1992,748,748,775,775,1,27,27,0.03483871,0.03483871
FALSE,Salt Lake County,4/1/92,Hide,Hide,4,1992,378133,378133,395842,395842,1,17709,17709,0.044737547,0.044737547
FALSE,San Juan County,4/1/92,Hide,Hide,4,1992,3911,3911,4356,4356,1,445,445,0.102157943,0.102157943
FALSE,Sanpete County,4/1/92,Hide,Hide,4,1992,6137,6137,6751,6751,1,614,614,0.090949489,0.090949489
FALSE,Sevier County,4/1/92,Hide,Hide,4,1992,6167,6167,6635,6635,1,468,468,0.070535041,0.070535041
FALSE,State of Utah,4/1/92,Hide,Hide,4,1992,837278,837278,880748,880748,1,43470,43470,0.049355775,0.049355775
FALSE,Summit County,4/1/92,Hide,Hide,4,1992,8482,8482,9108,9108,1,626,626,0.068730786,0.068730786
FALSE,Tooele County,4/1/92,Hide,Hide,4,1992,12091,12091,12853,12853,1,762,762,0.05928577,0.05928577
FALSE,Uintah County,4/1/92,Hide,Hide,4,1992,8947,8947,9652,9652,1,705,705,0.073041857,0.073041857
FALSE,United States,4/1/92,Hide,Hide,4,1992,118426,118426000,127841,127841000,1,9415,9415000,0.074,0.074
FALSE,Utah County,4/1/92,Hide,Hide,4,1992,121323,121323,126784,126784,1,5461,5461,0.043073258,0.043073258
FALSE,Wasatch County,4/1/92,Hide,Hide,4,1992,4419,4419,4825,4825,1,406,406,0.084145078,0.084145078
FALSE,Washington County,4/1/92,Hide,Hide,4,1992,21530,21530,22499,22499,1,969,969,0.043068581,0.043068581
FALSE,Wayne County,4/1/92,Hide,Hide,4,1992,956,956,1043,1043,1,87,87,0.083413231,0.083413231
FALSE,Weber County,4/1/92,Hide,Hide,4,1992,77716,77716,82472,82472,1,4756,4756,0.057668057,0.057668057
FALSE,Beaver County,5/1/92,Hide,Hide,5,1992,1905,1905,2015,2015,1,110,110,0.054590571,0.054590571
FALSE,Box Elder County,5/1/92,Hide,Hide,5,1992,15349,15349,16170,16170,1,821,821,0.050773036,0.050773036
FALSE,Cache County,5/1/92,Hide,Hide,5,1992,34718,34718,36212,36212,1,1494,1494,0.041257042,0.041257042
FALSE,Carbon County,5/1/92,Hide,Hide,5,1992,8172,8172,9027,9027,1,855,855,0.094715852,0.094715852
FALSE,Daggett County,5/1/92,Hide,Hide,5,1992,381,381,398,398,1,17,17,0.042713568,0.042713568
FALSE,Davis County,5/1/92,Hide,Hide,5,1992,89549,89549,93587,93587,1,4038,4038,0.043147018,0.043147018
FALSE,Duchesne County,5/1/92,Hide,Hide,5,1992,4948,4948,5431,5431,1,483,483,0.088933898,0.088933898
FALSE,Emery County,5/1/92,Hide,Hide,5,1992,4104,4104,4500,4500,1,396,396,0.088,0.088
FALSE,Garfield County,5/1/92,Hide,Hide,5,1992,1974,1974,2307,2307,1,333,333,0.144343303,0.144343303
FALSE,Grand County,5/1/92,Hide,Hide,5,1992,3715,3715,4025,4025,1,310,310,0.077018634,0.077018634
FALSE,Iron County,5/1/92,Hide,Hide,5,1992,9634,9634,10036,10036,1,402,402,0.040055799,0.040055799
FALSE,Juab County,5/1/92,Hide,Hide,5,1992,2893,2893,3120,3120,1,227,227,0.07275641,0.07275641
FALSE,Kane County,5/1/92,Hide,Hide,5,1992,2714,2714,2950,2950,1,236,236,0.08,0.08
FALSE,Millard County,5/1/92,Hide,Hide,5,1992,4442,4442,4721,4721,1,279,279,0.059097649,0.059097649
FALSE,Morgan County,5/1/92,Hide,Hide,5,1992,2784,2784,2929,2929,1,145,145,0.04950495,0.04950495
FALSE,Piute County,5/1/92,Hide,Hide,5,1992,440,440,472,472,1,32,32,0.06779661,0.06779661
FALSE,Rich County,5/1/92,Hide,Hide,5,1992,747,747,775,775,1,28,28,0.036129032,0.036129032
FALSE,Salt Lake County,5/1/92,Hide,Hide,5,1992,379249,379249,396757,396757,1,17508,17508,0.044127766,0.044127766
FALSE,San Juan County,5/1/92,Hide,Hide,5,1992,3951,3951,4410,4410,1,459,459,0.104081633,0.104081633
FALSE,Sanpete County,5/1/92,Hide,Hide,5,1992,6174,6174,6796,6796,1,622,622,0.091524426,0.091524426
FALSE,Sevier County,5/1/92,Hide,Hide,5,1992,6192,6192,6650,6650,1,458,458,0.06887218,0.06887218
FALSE,State of Utah,5/1/92,Hide,Hide,5,1992,840224,840224,883536,883536,1,43312,43312,0.049021206,0.049021206
FALSE,Summit County,5/1/92,Hide,Hide,5,1992,8581,8581,9210,9210,1,629,629,0.068295331,0.068295331
FALSE,Tooele County,5/1/92,Hide,Hide,5,1992,12096,12096,12850,12850,1,754,754,0.058677043,0.058677043
FALSE,Uintah County,5/1/92,Hide,Hide,5,1992,8937,8937,9661,9661,1,724,724,0.074940482,0.074940482
FALSE,United States,5/1/92,Hide,Hide,5,1992,118375,118375000,128119,128119000,1,9744,9744000,0.076,0.076
FALSE,Utah County,5/1/92,Hide,Hide,5,1992,121755,121755,127071,127071,1,5316,5316,0.04183488,0.04183488
FALSE,Wasatch County,5/1/92,Hide,Hide,5,1992,4439,4439,4824,4824,1,385,385,0.079809287,0.079809287
FALSE,Washington County,5/1/92,Hide,Hide,5,1992,21698,21698,22659,22659,1,961,961,0.042411404,0.042411404
FALSE,Wayne County,5/1/92,Hide,Hide,5,1992,960,960,1046,1046,1,86,86,0.082217973,0.082217973
FALSE,Weber County,5/1/92,Hide,Hide,5,1992,77911,77911,82805,82805,1,4894,4894,0.059102711,0.059102711
FALSE,Beaver County,6/1/92,Hide,Hide,6,1992,1910,1910,2018,2018,1,108,108,0.053518335,0.053518335
FALSE,Box Elder County,6/1/92,Hide,Hide,6,1992,15302,15302,16152,16152,1,850,850,0.052625062,0.052625062
FALSE,Cache County,6/1/92,Hide,Hide,6,1992,34878,34878,36322,36322,1,1444,1444,0.03975552,0.03975552
FALSE,Carbon County,6/1/92,Hide,Hide,6,1992,8190,8190,9030,9030,1,840,840,0.093023256,0.093023256
FALSE,Daggett County,6/1/92,Hide,Hide,6,1992,381,381,399,399,1,18,18,0.045112782,0.045112782
FALSE,Davis County,6/1/92,Hide,Hide,6,1992,89817,89817,93890,93890,1,4073,4073,0.043380552,0.043380552
FALSE,Duchesne County,6/1/92,Hide,Hide,6,1992,4969,4969,5464,5464,1,495,495,0.090592972,0.090592972
FALSE,Emery County,6/1/92,Hide,Hide,6,1992,4164,4164,4553,4553,1,389,389,0.085438173,0.085438173
FALSE,Garfield County,6/1/92,Hide,Hide,6,1992,1979,1979,2324,2324,1,345,345,0.148450947,0.148450947
FALSE,Grand County,6/1/92,Hide,Hide,6,1992,3735,3735,4051,4051,1,316,316,0.078005431,0.078005431
FALSE,Iron County,6/1/92,Hide,Hide,6,1992,9778,9778,10180,10180,1,402,402,0.039489194,0.039489194
FALSE,Juab County,6/1/92,Hide,Hide,6,1992,2925,2925,3149,3149,1,224,224,0.071133693,0.071133693
FALSE,Kane County,6/1/92,Hide,Hide,6,1992,2793,2793,3032,3032,1,239,239,0.078825858,0.078825858
FALSE,Millard County,6/1/92,Hide,Hide,6,1992,4430,4430,4716,4716,1,286,286,0.060644614,0.060644614
FALSE,Morgan County,6/1/92,Hide,Hide,6,1992,2786,2786,2937,2937,1,151,151,0.051413006,0.051413006
FALSE,Piute County,6/1/92,Hide,Hide,6,1992,432,432,465,465,1,33,33,0.070967742,0.070967742
FALSE,Rich County,6/1/92,Hide,Hide,6,1992,740,740,768,768,1,28,28,0.036458333,0.036458333
FALSE,Salt Lake County,6/1/92,Hide,Hide,6,1992,380313,380313,397676,397676,1,17363,17363,0.043661171,0.043661171
FALSE,San Juan County,6/1/92,Hide,Hide,6,1992,3990,3990,4461,4461,1,471,471,0.105581708,0.105581708
FALSE,Sanpete County,6/1/92,Hide,Hide,6,1992,6209,6209,6842,6842,1,633,633,0.092516808,0.092516808
FALSE,Sevier County,6/1/92,Hide,Hide,6,1992,6213,6213,6663,6663,1,450,450,0.067537145,0.067537145
FALSE,State of Utah,6/1/92,Hide,Hide,6,1992,843074,843074,886184,886184,1,43110,43110,0.048646782,0.048646782
FALSE,Summit County,6/1/92,Hide,Hide,6,1992,8686,8686,9320,9320,1,634,634,0.068025751,0.068025751
FALSE,Tooele County,6/1/92,Hide,Hide,6,1992,12025,12025,12767,12767,1,742,742,0.058118587,0.058118587
FALSE,Uintah County,6/1/92,Hide,Hide,6,1992,8938,8938,9681,9681,1,743,743,0.07674827,0.07674827
FALSE,United States,6/1/92,Hide,Hide,6,1992,118419,118419000,128459,128459000,1,10040,10040000,0.078,0.078
FALSE,Utah County,6/1/92,Hide,Hide,6,1992,122198,122198,127399,127399,1,5201,5201,0.040824496,0.040824496
FALSE,Wasatch County,6/1/92,Hide,Hide,6,1992,4469,4469,4827,4827,1,358,358,0.074166149,0.074166149
FALSE,Washington County,6/1/92,Hide,Hide,6,1992,21852,21852,22818,22818,1,966,966,0.042334999,0.042334999
FALSE,Wayne County,6/1/92,Hide,Hide,6,1992,963,963,1047,1047,1,84,84,0.080229226,0.080229226
FALSE,Weber County,6/1/92,Hide,Hide,6,1992,78099,78099,83109,83109,1,5010,5010,0.06028228,0.06028228
FALSE,Beaver County,7/1/92,Hide,Hide,7,1992,1922,1922,2027,2027,1,105,105,0.051800691,0.051800691
FALSE,Box Elder County,7/1/92,Hide,Hide,7,1992,15259,15259,16132,16132,1,873,873,0.054116043,0.054116043
FALSE,Cache County,7/1/92,Hide,Hide,7,1992,35062,35062,36413,36413,1,1351,1351,0.037102134,0.037102134
FALSE,Carbon County,7/1/92,Hide,Hide,7,1992,8195,8195,9022,9022,1,827,827,0.091664819,0.091664819
FALSE,Daggett County,7/1/92,Hide,Hide,7,1992,382,382,401,401,1,19,19,0.047381546,0.047381546
FALSE,Davis County,7/1/92,Hide,Hide,7,1992,90118,90118,94224,94224,1,4106,4106,0.043577008,0.043577008
FALSE,Duchesne County,7/1/92,Hide,Hide,7,1992,4991,4991,5491,5491,1,500,500,0.091058095,0.091058095
FALSE,Emery County,7/1/92,Hide,Hide,7,1992,4202,4202,4587,4587,1,385,385,0.083932854,0.083932854
FALSE,Garfield County,7/1/92,Hide,Hide,7,1992,1980,1980,2331,2331,1,351,351,0.150579151,0.150579151
FALSE,Grand County,7/1/92,Hide,Hide,7,1992,3759,3759,4077,4077,1,318,318,0.077998528,0.077998528
FALSE,Iron County,7/1/92,Hide,Hide,7,1992,9908,9908,10303,10303,1,395,395,0.038338348,0.038338348
FALSE,Juab County,7/1/92,Hide,Hide,7,1992,2953,2953,3176,3176,1,223,223,0.070214106,0.070214106
FALSE,Kane County,7/1/92,Hide,Hide,7,1992,2842,2842,3078,3078,1,236,236,0.076673164,0.076673164
FALSE,Millard County,7/1/92,Hide,Hide,7,1992,4406,4406,4700,4700,1,294,294,0.062553191,0.062553191
FALSE,Morgan County,7/1/92,Hide,Hide,7,1992,2784,2784,2942,2942,1,158,158,0.053704963,0.053704963
FALSE,Piute County,7/1/92,Hide,Hide,7,1992,425,425,458,458,1,33,33,0.072052402,0.072052402
FALSE,Rich County,7/1/92,Hide,Hide,7,1992,730,730,760,760,1,30,30,0.039473684,0.039473684
FALSE,Salt Lake County,7/1/92,Hide,Hide,7,1992,381462,381462,398751,398751,1,17289,17289,0.043357885,0.043357885
FALSE,San Juan County,7/1/92,Hide,Hide,7,1992,4024,4024,4499,4499,1,475,475,0.105579018,0.105579018
FALSE,Sanpete County,7/1/92,Hide,Hide,7,1992,6233,6233,6876,6876,1,643,643,0.093513671,0.093513671
FALSE,Sevier County,7/1/92,Hide,Hide,7,1992,6229,6229,6677,6677,1,448,448,0.067096001,0.067096001
FALSE,State of Utah,7/1/92,Hide,Hide,7,1992,846028,846028,888996,888996,1,42968,42968,0.048333176,0.048333176
FALSE,Summit County,7/1/92,Hide,Hide,7,1992,8779,8779,9417,9417,1,638,638,0.067749814,0.067749814
FALSE,Tooele County,7/1/92,Hide,Hide,7,1992,11890,11890,12631,12631,1,741,741,0.058665189,0.058665189
FALSE,Uintah County,7/1/92,Hide,Hide,7,1992,8962,8962,9721,9721,1,759,759,0.078078387,0.078078387
FALSE,United States,7/1/92,Hide,Hide,7,1992,118713,118713000,128563,128563000,1,9850,9850000,0.077,0.077
FALSE,Utah County,7/1/92,Hide,Hide,7,1992,122753,122753,127888,127888,1,5135,5135,0.040152321,0.040152321
FALSE,Wasatch County,7/1/92,Hide,Hide,7,1992,4499,4499,4831,4831,1,332,332,0.068722832,0.068722832
FALSE,Washington County,7/1/92,Hide,Hide,7,1992,21994,21994,22974,22974,1,980,980,0.042656917,0.042656917
FALSE,Wayne County,7/1/92,Hide,Hide,7,1992,966,966,1048,1048,1,82,82,0.078244275,0.078244275
FALSE,Weber County,7/1/92,Hide,Hide,7,1992,78316,78316,83381,83381,1,5065,5065,0.060745254,0.060745254
FALSE,Beaver County,8/1/92,Hide,Hide,8,1992,1934,1934,2035,2035,1,101,101,0.04963145,0.04963145
FALSE,Box Elder County,8/1/92,Hide,Hide,8,1992,15218,15218,16107,16107,1,889,889,0.055193394,0.055193394
FALSE,Cache County,8/1/92,Hide,Hide,8,1992,35231,35231,36489,36489,1,1258,1258,0.034476143,0.034476143
FALSE,Carbon County,8/1/92,Hide,Hide,8,1992,8190,8190,9010,9010,1,820,820,0.091009989,0.091009989
FALSE,Daggett County,8/1/92,Hide,Hide,8,1992,384,384,404,404,1,20,20,0.04950495,0.04950495
FALSE,Davis County,8/1/92,Hide,Hide,8,1992,90480,90480,94606,94606,1,4126,4126,0.043612456,0.043612456
FALSE,Duchesne County,8/1/92,Hide,Hide,8,1992,5005,5005,5503,5503,1,498,498,0.090496093,0.090496093
FALSE,Emery County,8/1/92,Hide,Hide,8,1992,4212,4212,4596,4596,1,384,384,0.083550914,0.083550914
FALSE,Garfield County,8/1/92,Hide,Hide,8,1992,1980,1980,2326,2326,1,346,346,0.148753224,0.148753224
FALSE,Grand County,8/1/92,Hide,Hide,8,1992,3792,3792,4110,4110,1,318,318,0.077372263,0.077372263
FALSE,Iron County,8/1/92,Hide,Hide,8,1992,10019,10019,10396,10396,1,377,377,0.036263948,0.036263948
FALSE,Juab County,8/1/92,Hide,Hide,8,1992,2959,2959,3183,3183,1,224,224,0.070373861,0.070373861
FALSE,Kane County,8/1/92,Hide,Hide,8,1992,2847,2847,3076,3076,1,229,229,0.074447334,0.074447334
FALSE,Millard County,8/1/92,Hide,Hide,8,1992,4379,4379,4678,4678,1,299,299,0.063916204,0.063916204
FALSE,Morgan County,8/1/92,Hide,Hide,8,1992,2784,2784,2949,2949,1,165,165,0.05595117,0.05595117
FALSE,Piute County,8/1/92,Hide,Hide,8,1992,421,421,454,454,1,33,33,0.072687225,0.072687225
FALSE,Rich County,8/1/92,Hide,Hide,8,1992,720,720,751,751,1,31,31,0.041278296,0.041278296
FALSE,Salt Lake County,8/1/92,Hide,Hide,8,1992,382856,382856,400163,400163,1,17307,17307,0.043249876,0.043249876
FALSE,San Juan County,8/1/92,Hide,Hide,8,1992,4055,4055,4527,4527,1,472,472,0.104263309,0.104263309
FALSE,Sanpete County,8/1/92,Hide,Hide,8,1992,6246,6246,6889,6889,1,643,643,0.093337204,0.093337204
FALSE,Sevier County,8/1/92,Hide,Hide,8,1992,6242,6242,6694,6694,1,452,452,0.067523155,0.067523155
FALSE,State of Utah,8/1/92,Hide,Hide,8,1992,849329,849329,892233,892233,1,42904,42904,0.048086094,0.048086094
FALSE,Summit County,8/1/92,Hide,Hide,8,1992,8861,8861,9497,9497,1,636,636,0.066968516,0.066968516
FALSE,Tooele County,8/1/92,Hide,Hide,8,1992,11746,11746,12506,12506,1,760,760,0.06077083,0.06077083
FALSE,Uintah County,8/1/92,Hide,Hide,8,1992,9011,9011,9779,9779,1,768,768,0.078535638,0.078535638
FALSE,United States,8/1/92,Hide,Hide,8,1992,118826,118826000,128613,128613000,1,9787,9787000,0.076,0.076
FALSE,Utah County,8/1/92,Hide,Hide,8,1992,123452,123452,128553,128553,1,5101,5101,0.039680132,0.039680132
FALSE,Wasatch County,8/1/92,Hide,Hide,8,1992,4523,4523,4838,4838,1,315,315,0.065109549,0.065109549
FALSE,Washington County,8/1/92,Hide,Hide,8,1992,22150,22150,23139,23139,1,989,989,0.042741692,0.042741692
FALSE,Wayne County,8/1/92,Hide,Hide,8,1992,973,973,1055,1055,1,82,82,0.077725118,0.077725118
FALSE,Weber County,8/1/92,Hide,Hide,8,1992,78587,78587,83662,83662,1,5075,5075,0.060660754,0.060660754
FALSE,Beaver County,9/1/92,Hide,Hide,9,1992,1945,1945,2042,2042,1,97,97,0.047502449,0.047502449
FALSE,Box Elder County,9/1/92,Hide,Hide,9,1992,15184,15184,16086,16086,1,902,902,0.056073604,0.056073604
FALSE,Cache County,9/1/92,Hide,Hide,9,1992,35359,35359,36575,36575,1,1216,1216,0.033246753,0.033246753
FALSE,Carbon County,9/1/92,Hide,Hide,9,1992,8180,8180,8998,8998,1,818,818,0.090909091,0.090909091
FALSE,Daggett County,9/1/92,Hide,Hide,9,1992,387,387,407,407,1,20,20,0.049140049,0.049140049
FALSE,Davis County,9/1/92,Hide,Hide,9,1992,90927,90927,95063,95063,1,4136,4136,0.043507989,0.043507989
FALSE,Duchesne County,9/1/92,Hide,Hide,9,1992,5010,5010,5498,5498,1,488,488,0.088759549,0.088759549
FALSE,Emery County,9/1/92,Hide,Hide,9,1992,4192,4192,4577,4577,1,385,385,0.084116233,0.084116233
FALSE,Beaver County,1/1/93,Hide,Hide,1,1993,1975,1975,2068,2068,1,93,93,0.044970986,0.044970986
FALSE,Beaver County,1/1/94,Hide,Hide,1,1994,2048,2048,2140,2140,1,92,92,0.042990654,0.042990654
FALSE,Beaver County,1/1/95,Hide,Hide,1,1995,2196,2196,2272,2272,1,76,76,0.033450704,0.033450704
FALSE,Beaver County,1/1/96,Hide,Hide,1,1996,2343,2343,2471,2471,1,128,128,0.05180089,0.05180089
FALSE,Beaver County,1/1/97,Hide,Hide,1,1997,2441,2441,2587,2587,1,146,146,0.056436026,0.056436026
FALSE,Beaver County,1/1/98,Hide,Hide,1,1998,2413,2413,2518,2518,1,105,105,0.041699762,0.041699762
FALSE,Beaver County,1/1/99,Hide,Hide,1,1999,2373,2373,2466,2466,1,93,93,0.037712895,0.037712895
FALSE,Beaver County,1/1/00,Hide,Hide,1,2000,2520,2520,2609,2609,1,89,89,0.034112687,0.034112687
FALSE,Beaver County,1/1/01,Hide,Hide,1,2001,2585,2585,2687,2687,1,102,102,0.037960551,0.037960551
FALSE,Beaver County,1/1/02,Hide,Hide,1,2002,3085,3085,3213,3213,1,128,128,0.039838157,0.039838157
FALSE,Beaver County,1/1/03,Hide,Hide,1,2003,2902,2902,3061,3061,1,159,159,0.051943809,0.051943809
FALSE,Beaver County,1/1/04,Hide,Hide,1,2004,2862,2862,3006,3006,1,144,144,0.047904192,0.047904192
FALSE,Beaver County,1/1/05,Hide,Hide,1,2005,2816,2816,2946,2946,1,130,130,0.044127631,0.044127631
FALSE,Beaver County,1/1/06,Hide,Hide,1,2006,2955,2955,3071,3071,1,116,116,0.037772712,0.037772712
FALSE,Beaver County,1/1/07,Hide,Hide,1,2007,3130,3130,3204,3204,1,74,74,0.02309613,0.02309613
FALSE,Beaver County,1/1/08,Hide,Hide,1,2008,3031,3031,3114,3114,1,83,83,0.026653821,0.026653821
FALSE,Beaver County,1/1/09,Hide,Hide,1,2009,3201,3201,3389,3389,1,188,188,0.055473591,0.055473591
FALSE,Beaver County,1/1/10,Hide,Hide,1,2010,2990,2990,3275,3275,1,285,285,0.087022901,0.087022901
FALSE,Beaver County,1/1/11,Hide,Hide,1,2011,2820,2820,3099,3099,1,279,279,0.090029042,0.090029042
FALSE,Beaver County,1/1/12,Hide,Hide,1,2012,2729,2729,2935,2935,1,206,206,0.070187394,0.070187394
FALSE,Beaver County,1/1/13,Hide,Hide,1,2013,2868,2868,3022,3022,1,154,154,0.050959629,0.050959629
FALSE,Beaver County,1/1/14,Hide,Hide,1,2014,2908,2908,3038,3038,1,130,130,0.04279131,0.04279131
FALSE,Beaver County,1/1/15,Hide,Hide,1,2015,3007,3007,3121,3121,1,114,114,0.036526754,0.036526754
FALSE,Beaver County,1/1/16,Hide,Hide,1,2016,2979,2979,3097,3097,1,118,118,0.038101388,0.038101388
FALSE,Beaver County,1/1/17,Hide,Hide,1,2017,2894,2894,3046,3046,1,152,152,0.04990151,0.04990151
FALSE,Beaver County,1/1/18,Hide,Hide,1,2018,2925,2925,3039,3039,1,114,114,0.03751234,0.03751234
FALSE,Beaver County,1/1/19,Hide,Hide,1,2019,2836,2836,2927,2927,1,91,91,0.031089853,0.031089853
FALSE,Beaver County,1/1/20,Hide,Hide,1,2020,2726,2726,2802,2802,1,76,76,0.027123483,0.027123483
FALSE,Box Elder County,1/1/93,Hide,Hide,1,1993,15602,15602,16530,16530,1,928,928,0.056140351,0.056140351
FALSE,Box Elder County,1/1/94,Hide,Hide,1,1994,16928,16928,17829,17829,1,901,901,0.050535644,0.050535644
FALSE,Box Elder County,1/1/95,Hide,Hide,1,1995,17326,17326,18184,18184,1,858,858,0.047184338,0.047184338
FALSE,Box Elder County,1/1/96,Hide,Hide,1,1996,17004,17004,17814,17814,1,810,810,0.045469855,0.045469855
FALSE,Box Elder County,1/1/97,Hide,Hide,1,1997,17620,17620,18333,18333,1,713,713,0.038891616,0.038891616
FALSE,Box Elder County,1/1/98,Hide,Hide,1,1998,18294,18294,19102,19102,1,808,808,0.042299236,0.042299236
FALSE,Box Elder County,1/1/99,Hide,Hide,1,1999,17964,17964,18808,18808,1,844,844,0.044874521,0.044874521
FALSE,Box Elder County,1/1/00,Hide,Hide,1,2000,18381,18381,19110,19110,1,729,729,0.038147567,0.038147567
FALSE,Box Elder County,1/1/01,Hide,Hide,1,2001,19266,19266,20135,20135,1,869,869,0.043158679,0.043158679
FALSE,Box Elder County,1/1/02,Hide,Hide,1,2002,19967,19967,21078,21078,1,1111,1111,0.052708986,0.052708986
FALSE,Box Elder County,1/1/03,Hide,Hide,1,2003,19928,19928,21143,21143,1,1215,1215,0.057465828,0.057465828
FALSE,Box Elder County,1/1/04,Hide,Hide,1,2004,20784,20784,21923,21923,1,1139,1139,0.051954568,0.051954568
FALSE,Box Elder County,1/1/05,Hide,Hide,1,2005,20841,20841,21879,21879,1,1038,1038,0.047442753,0.047442753
FALSE,Box Elder County,1/1/06,Hide,Hide,1,2006,21851,21851,22704,22704,1,853,853,0.037570472,0.037570472
FALSE,Box Elder County,1/1/07,Hide,Hide,1,2007,22631,22631,23229,23229,1,598,598,0.025743682,0.025743682
FALSE,Box Elder County,1/1/08,Hide,Hide,1,2008,23032,23032,23717,23717,1,685,685,0.028882236,0.028882236
FALSE,Box Elder County,1/1/09,Hide,Hide,1,2009,21860,21860,23548,23548,1,1688,1688,0.07168337,0.07168337
FALSE,Box Elder County,1/1/10,Hide,Hide,1,2010,21425,21425,23362,23362,1,1937,1937,0.082912422,0.082912422
FALSE,Box Elder County,1/1/11,Hide,Hide,1,2011,21361,21361,23337,23337,1,1976,1976,0.084672409,0.084672409
FALSE,Box Elder County,1/1/12,Hide,Hide,1,2012,21548,21548,22979,22979,1,1431,1431,0.06227425,0.06227425
FALSE,Box Elder County,1/1/13,Hide,Hide,1,2013,21946,21946,23141,23141,1,1195,1195,0.051639946,0.051639946
FALSE,Box Elder County,1/1/14,Hide,Hide,1,2014,22405,22405,23362,23362,1,957,957,0.040963959,0.040963959
FALSE,Box Elder County,1/1/15,Hide,Hide,1,2015,22908,22908,23806,23806,1,898,898,0.037721583,0.037721583
FALSE,Box Elder County,1/1/16,Hide,Hide,1,2016,23378,23378,24263,24263,1,885,885,0.036475292,0.036475292
FALSE,Box Elder County,1/1/17,Hide,Hide,1,2017,24232,24232,25086,25086,1,854,854,0.034042892,0.034042892
FALSE,Box Elder County,1/1/18,Hide,Hide,1,2018,24682,24682,25445,25445,1,763,763,0.029986245,0.029986245
FALSE,Box Elder County,1/1/19,Hide,Hide,1,2019,24872,24872,25608,25608,1,736,736,0.028741018,0.028741018
FALSE,Box Elder County,1/1/20,Hide,Hide,1,2020,25574,25574,26220,26220,1,646,646,0.024637681,0.024637681
FALSE,Cache County,1/1/93,Hide,Hide,1,1993,36085,36085,37371,37371,1,1286,1286,0.03441171,0.03441171
FALSE,Cache County,1/1/94,Hide,Hide,1,1994,38754,38754,39917,39917,1,1163,1163,0.029135456,0.029135456
FALSE,Cache County,1/1/95,Hide,Hide,1,1995,40004,40004,41314,41314,1,1310,1310,0.03170838,0.03170838
FALSE,Cache County,1/1/96,Hide,Hide,1,1996,40827,40827,42072,42072,1,1245,1245,0.029592128,0.029592128
FALSE,Cache County,1/1/97,Hide,Hide,1,1997,41365,41365,42560,42560,1,1195,1195,0.028078008,0.028078008
FALSE,Cache County,1/1/98,Hide,Hide,1,1998,42900,42900,44115,44115,1,1215,1215,0.027541652,0.027541652
FALSE,Cache County,1/1/99,Hide,Hide,1,1999,43514,43514,44722,44722,1,1208,1208,0.027011314,0.027011314
FALSE,Cache County,1/1/00,Hide,Hide,1,2000,45610,45610,46836,46836,1,1226,1226,0.026176445,0.026176445
FALSE,Cache County,1/1/01,Hide,Hide,1,2001,47242,47242,48772,48772,1,1530,1530,0.031370458,0.031370458
FALSE,Cache County,1/1/02,Hide,Hide,1,2002,49483,49483,51498,51498,1,2015,2015,0.039127733,0.039127733
FALSE,Cache County,1/1/03,Hide,Hide,1,2003,51179,51179,53415,53415,1,2236,2236,0.0418609,0.0418609
FALSE,Cache County,1/1/04,Hide,Hide,1,2004,53212,53212,55269,55269,1,2057,2057,0.03721797,0.03721797
FALSE,Cache County,1/1/05,Hide,Hide,1,2005,54877,54877,56784,56784,1,1907,1907,0.033583404,0.033583404
FALSE,Cache County,1/1/06,Hide,Hide,1,2006,55734,55734,57368,57368,1,1634,1634,0.028482778,0.028482778
FALSE,Cache County,1/1/07,Hide,Hide,1,2007,58299,58299,59436,59436,1,1137,1137,0.01912982,0.01912982
FALSE,Cache County,1/1/08,Hide,Hide,1,2008,60406,60406,61842,61842,1,1436,1436,0.023220465,0.023220465
FALSE,Cache County,1/1/09,Hide,Hide,1,2009,59006,59006,61857,61857,1,2851,2851,0.046090176,0.046090176
FALSE,Cache County,1/1/10,Hide,Hide,1,2010,55537,55537,58971,58971,1,3434,3434,0.058232012,0.058232012
FALSE,Cache County,1/1/11,Hide,Hide,1,2011,54004,54004,57304,57304,1,3300,3300,0.057587603,0.057587603
FALSE,Cache County,1/1/12,Hide,Hide,1,2012,54104,54104,56769,56769,1,2665,2665,0.046944635,0.046944635
FALSE,Cache County,1/1/13,Hide,Hide,1,2013,55097,55097,57546,57546,1,2449,2449,0.042557259,0.042557259
FALSE,Cache County,1/1/14,Hide,Hide,1,2014,56422,56422,58425,58425,1,2003,2003,0.034283269,0.034283269
FALSE,Cache County,1/1/15,Hide,Hide,1,2015,57631,57631,59420,59420,1,1789,1789,0.030107708,0.030107708
FALSE,Cache County,1/1/16,Hide,Hide,1,2016,58666,58666,60588,60588,1,1922,1922,0.031722453,0.031722453
FALSE,Cache County,1/1/17,Hide,Hide,1,2017,60252,60252,62059,62059,1,1807,1807,0.029117453,0.029117453
FALSE,Cache County,1/1/18,Hide,Hide,1,2018,61312,61312,62974,62974,1,1662,1662,0.026391844,0.026391844
FALSE,Cache County,1/1/19,Hide,Hide,1,2019,62350,62350,63908,63908,1,1558,1558,0.024378795,0.024378795
FALSE,Cache County,1/1/20,Hide,Hide,1,2020,63454,63454,64753,64753,1,1299,1299,0.020060847,0.020060847
FALSE,Carbon County,1/1/93,Hide,Hide,1,1993,8152,8152,8927,8927,1,775,775,0.086815279,0.086815279
FALSE,Carbon County,1/1/94,Hide,Hide,1,1994,8663,8663,9318,9318,1,655,655,0.070294055,0.070294055
FALSE,Carbon County,1/1/95,Hide,Hide,1,1995,8607,8607,9234,9234,1,627,627,0.067901235,0.067901235
FALSE,Carbon County,1/1/96,Hide,Hide,1,1996,8636,8636,9201,9201,1,565,565,0.061406369,0.061406369
FALSE,Carbon County,1/1/97,Hide,Hide,1,1997,9078,9078,9607,9607,1,529,529,0.055064016,0.055064016
FALSE,Carbon County,1/1/98,Hide,Hide,1,1998,9224,9224,9734,9734,1,510,510,0.052393672,0.052393672
FALSE,Carbon County,1/1/99,Hide,Hide,1,1999,9262,9262,10000,10000,1,738,738,0.0738,0.0738
FALSE,Carbon County,1/1/00,Hide,Hide,1,2000,9112,9112,9590,9590,1,478,478,0.049843587,0.049843587
FALSE,Carbon County,1/1/01,Hide,Hide,1,2001,8392,8392,8979,8979,1,587,587,0.065374763,0.065374763
FALSE,Carbon County,1/1/02,Hide,Hide,1,2002,8723,8723,9308,9308,1,585,585,0.062849162,0.062849162
FALSE,Carbon County,1/1/03,Hide,Hide,1,2003,8731,8731,9470,9470,1,739,739,0.078035903,0.078035903
FALSE,Carbon County,1/1/04,Hide,Hide,1,2004,8599,8599,9288,9288,1,689,689,0.07418174,0.07418174
FALSE,Carbon County,1/1/05,Hide,Hide,1,2005,8800,8800,9322,9322,1,522,522,0.055996567,0.055996567
FALSE,Carbon County,1/1/06,Hide,Hide,1,2006,9332,9332,9738,9738,1,406,406,0.041692339,0.041692339
FALSE,Carbon County,1/1/07,Hide,Hide,1,2007,9514,9514,9812,9812,1,298,298,0.030370974,0.030370974
FALSE,Carbon County,1/1/08,Hide,Hide,1,2008,9311,9311,9704,9704,1,393,393,0.040498763,0.040498763
FALSE,Carbon County,1/1/09,Hide,Hide,1,2009,9987,9987,10598,10598,1,611,611,0.057652387,0.057652387
FALSE,Carbon County,1/1/10,Hide,Hide,1,2010,9151,9151,10059,10059,1,908,908,0.090267422,0.090267422
FALSE,Carbon County,1/1/11,Hide,Hide,1,2011,8982,8982,9782,9782,1,800,800,0.081782866,0.081782866
FALSE,Carbon County,1/1/12,Hide,Hide,1,2012,8775,8775,9440,9440,1,665,665,0.070444915,0.070444915
FALSE,Carbon County,1/1/13,Hide,Hide,1,2013,8415,8415,9037,9037,1,622,622,0.068828151,0.068828151
FALSE,Carbon County,1/1/14,Hide,Hide,1,2014,8294,8294,8772,8772,1,478,478,0.054491564,0.054491564
FALSE,Carbon County,1/1/15,Hide,Hide,1,2015,8319,8319,8757,8757,1,438,438,0.050017129,0.050017129
FALSE,Carbon County,1/1/16,Hide,Hide,1,2016,8000,8000,8536,8536,1,536,536,0.062792877,0.062792877
FALSE,Carbon County,1/1/17,Hide,Hide,1,2017,7791,7791,8247,8247,1,456,456,0.055292834,0.055292834
FALSE,Carbon County,1/1/18,Hide,Hide,1,2018,8000,8000,8394,8394,1,394,394,0.046938289,0.046938289
FALSE,Carbon County,1/1/19,Hide,Hide,1,2019,8091,8091,8430,8430,1,339,339,0.040213523,0.040213523
FALSE,Carbon County,1/1/20,Hide,Hide,1,2020,8268,8268,8579,8579,1,311,311,0.036251311,0.036251311
FALSE,Daggett County,1/1/93,Hide,Hide,1,1993,384,384,403,403,1,19,19,0.047146402,0.047146402
FALSE,Daggett County,1/1/94,Hide,Hide,1,1994,416,416,429,429,1,13,13,0.03030303,0.03030303
FALSE,Daggett County,1/1/95,Hide,Hide,1,1995,425,425,465,465,1,40,40,0.086021505,0.086021505
FALSE,Daggett County,1/1/96,Hide,Hide,1,1996,405,405,420,420,1,15,15,0.035714286,0.035714286
FALSE,Daggett County,1/1/97,Hide,Hide,1,1997,393,393,408,408,1,15,15,0.036764706,0.036764706
FALSE,Daggett County,1/1/98,Hide,Hide,1,1998,401,401,419,419,1,18,18,0.042959427,0.042959427
FALSE,Daggett County,1/1/99,Hide,Hide,1,1999,409,409,424,424,1,15,15,0.035377358,0.035377358
FALSE,Daggett County,1/1/00,Hide,Hide,1,2000,443,443,458,458,1,15,15,0.032751092,0.032751092
FALSE,Daggett County,1/1/01,Hide,Hide,1,2001,418,418,441,441,1,23,23,0.052154195,0.052154195
FALSE,Daggett County,1/1/02,Hide,Hide,1,2002,501,501,524,524,1,23,23,0.04389313,0.04389313
FALSE,Daggett County,1/1/03,Hide,Hide,1,2003,478,478,504,504,1,26,26,0.051587302,0.051587302
FALSE,Daggett County,1/1/04,Hide,Hide,1,2004,474,474,500,500,1,26,26,0.052,0.052
FALSE,Daggett County,1/1/05,Hide,Hide,1,2005,445,445,470,470,1,25,25,0.053191489,0.053191489
FALSE,Daggett County,1/1/06,Hide,Hide,1,2006,492,492,522,522,1,30,30,0.057471264,0.057471264
FALSE,Daggett County,1/1/07,Hide,Hide,1,2007,476,476,494,494,1,18,18,0.036437247,0.036437247
FALSE,Daggett County,1/1/08,Hide,Hide,1,2008,490,490,508,508,1,18,18,0.035433071,0.035433071
FALSE,Daggett County,1/1/09,Hide,Hide,1,2009,434,434,457,457,1,23,23,0.050328228,0.050328228
FALSE,Daggett County,1/1/10,Hide,Hide,1,2010,463,463,497,497,1,34,34,0.068410463,0.068410463
FALSE,Daggett County,1/1/11,Hide,Hide,1,2011,444,444,476,476,1,32,32,0.067226891,0.067226891
FALSE,Daggett County,1/1/12,Hide,Hide,1,2012,425,425,447,447,1,22,22,0.049217002,0.049217002
FALSE,Daggett County,1/1/13,Hide,Hide,1,2013,415,415,436,436,1,21,21,0.048165138,0.048165138
FALSE,Daggett County,1/1/14,Hide,Hide,1,2014,416,416,434,434,1,18,18,0.041474654,0.041474654
FALSE,Daggett County,1/1/15,Hide,Hide,1,2015,446,446,467,467,1,21,21,0.04496788,0.04496788
FALSE,Daggett County,1/1/16,Hide,Hide,1,2016,451,451,476,476,1,25,25,0.052521008,0.052521008
FALSE,Daggett County,1/1/17,Hide,Hide,1,2017,413,413,432,432,1,19,19,0.043981481,0.043981481
FALSE,Daggett County,1/1/18,Hide,Hide,1,2018,393,393,410,410,1,17,17,0.041463415,0.041463415
FALSE,Daggett County,1/1/19,Hide,Hide,1,2019,372,372,390,390,1,18,18,0.046153846,0.046153846
FALSE,Daggett County,1/1/20,Hide,Hide,1,2020,376,376,388,388,1,12,12,0.030927835,0.030927835
FALSE,Davis County,1/1/93,Hide,Hide,1,1993,93306,93306,97285,97285,1,3979,3979,0.040900447,0.040900447
FALSE,Davis County,1/1/94,Hide,Hide,1,1994,100407,100407,103848,103848,1,3441,3441,0.033134966,0.033134966
FALSE,Davis County,1/1/95,Hide,Hide,1,1995,102134,102134,106024,106024,1,3890,3890,0.036689806,0.036689806
FALSE,Davis County,1/1/96,Hide,Hide,1,1996,105176,105176,108584,108584,1,3408,3408,0.03138584,0.03138584
FALSE,Davis County,1/1/97,Hide,Hide,1,1997,110306,110306,113823,113823,1,3517,3517,0.030898852,0.030898852
FALSE,Davis County,1/1/98,Hide,Hide,1,1998,114891,114891,118680,118680,1,3789,3789,0.031926188,0.031926188
FALSE,Davis County,1/1/99,Hide,Hide,1,1999,119115,119115,123111,123111,1,3996,3996,0.032458513,0.032458513
FALSE,Davis County,1/1/00,Hide,Hide,1,2000,118446,118446,122058,122058,1,3612,3612,0.029592489,0.029592489
FALSE,Davis County,1/1/01,Hide,Hide,1,2001,116716,116716,121216,121216,1,4500,4500,0.037123812,0.037123812
FALSE,Davis County,1/1/02,Hide,Hide,1,2002,117495,117495,123238,123238,1,5743,5743,0.046600886,0.046600886
FALSE,Davis County,1/1/03,Hide,Hide,1,2003,120266,120266,126890,126890,1,6624,6624,0.052202695,0.052202695
FALSE,Davis County,1/1/04,Hide,Hide,1,2004,124097,124097,130671,130671,1,6574,6574,0.050309556,0.050309556
FALSE,Davis County,1/1/05,Hide,Hide,1,2005,128321,128321,133889,133889,1,5568,5568,0.041586687,0.041586687
FALSE,Davis County,1/1/06,Hide,Hide,1,2006,133786,133786,138581,138581,1,4795,4795,0.034600703,0.034600703
FALSE,Davis County,1/1/07,Hide,Hide,1,2007,139456,139456,142794,142794,1,3338,3338,0.023376332,0.023376332
FALSE,Davis County,1/1/08,Hide,Hide,1,2008,141568,141568,145739,145739,1,4171,4171,0.028619656,0.028619656
FALSE,Davis County,1/1/09,Hide,Hide,1,2009,137890,137890,145603,145603,1,7713,7713,0.05297281,0.05297281
FALSE,Davis County,1/1/10,Hide,Hide,1,2010,135432,135432,145711,145711,1,10279,10279,0.070543748,0.070543748
FALSE,Davis County,1/1/11,Hide,Hide,1,2011,136694,136694,146431,146431,1,9737,9737,0.066495483,0.066495483
FALSE,Davis County,1/1/12,Hide,Hide,1,2012,139480,139480,147261,147261,1,7781,7781,0.052838158,0.052838158
FALSE,Davis County,1/1/13,Hide,Hide,1,2013,143971,143971,150834,150834,1,6863,6863,0.045500351,0.045500351
FALSE,Davis County,1/1/14,Hide,Hide,1,2014,148562,148562,154439,154439,1,5877,5877,0.038053859,0.038053859
FALSE,Davis County,1/1/15,Hide,Hide,1,2015,152437,152437,157794,157794,1,5357,5357,0.033949326,0.033949326
FALSE,Davis County,1/1/16,Hide,Hide,1,2016,156483,156483,161892,161892,1,5409,5409,0.033411163,0.033411163
FALSE,Davis County,1/1/17,Hide,Hide,1,2017,162077,162077,167169,167169,1,5092,5092,0.030460193,0.030460193
FALSE,Davis County,1/1/18,Hide,Hide,1,2018,164365,164365,169417,169417,1,5052,5052,0.029819912,0.029819912
FALSE,Davis County,1/1/19,Hide,Hide,1,2019,167066,167066,171670,171670,1,4604,4604,0.026818897,0.026818897
FALSE,Davis County,1/1/20,Hide,Hide,1,2020,172382,172382,176455,176455,1,4073,4073,0.023082372,0.023082372
FALSE,Duchesne County,1/1/93,Hide,Hide,1,1993,5046,5046,5531,5531,1,485,485,0.087687579,0.087687579
FALSE,Duchesne County,1/1/94,Hide,Hide,1,1994,5235,5235,5775,5775,1,540,540,0.093506494,0.093506494
FALSE,Duchesne County,1/1/95,Hide,Hide,1,1995,5398,5398,5936,5936,1,538,538,0.090633423,0.090633423
FALSE,Duchesne County,1/1/96,Hide,Hide,1,1996,5236,5236,5733,5733,1,497,497,0.086691087,0.086691087
FALSE,Duchesne County,1/1/97,Hide,Hide,1,1997,5410,5410,5854,5854,1,444,444,0.075845576,0.075845576
FALSE,Duchesne County,1/1/98,Hide,Hide,1,1998,5763,5763,6127,6127,1,364,364,0.059409173,0.059409173
FALSE,Duchesne County,1/1/99,Hide,Hide,1,1999,5504,5504,6108,6108,1,604,604,0.098886706,0.098886706
FALSE,Duchesne County,1/1/00,Hide,Hide,1,2000,5535,5535,5855,5855,1,320,320,0.054654142,0.054654142
FALSE,Duchesne County,1/1/01,Hide,Hide,1,2001,6047,6047,6368,6368,1,321,321,0.050408291,0.050408291
FALSE,Duchesne County,1/1/02,Hide,Hide,1,2002,6627,6627,7065,7065,1,438,438,0.061995754,0.061995754
FALSE,Duchesne County,1/1/03,Hide,Hide,1,2003,6541,6541,7032,7032,1,491,491,0.069823663,0.069823663
FALSE,Duchesne County,1/1/04,Hide,Hide,1,2004,6578,6578,7021,7021,1,443,443,0.063096425,0.063096425
FALSE,Duchesne County,1/1/05,Hide,Hide,1,2005,7006,7006,7357,7357,1,351,351,0.047709664,0.047709664
FALSE,Duchesne County,1/1/06,Hide,Hide,1,2006,7688,7688,7978,7978,1,290,290,0.036349962,0.036349962
FALSE,Duchesne County,1/1/07,Hide,Hide,1,2007,8835,8835,9030,9030,1,195,195,0.021594684,0.021594684
FALSE,Duchesne County,1/1/08,Hide,Hide,1,2008,9368,9368,9613,9613,1,245,245,0.025486321,0.025486321
FALSE,Duchesne County,1/1/09,Hide,Hide,1,2009,10413,10413,10961,10961,1,548,548,0.049995438,0.049995438
FALSE,Duchesne County,1/1/10,Hide,Hide,1,2010,7916,7916,8812,8812,1,896,896,0.101679528,0.101679528
FALSE,Duchesne County,1/1/11,Hide,Hide,1,2011,7536,7536,8191,8191,1,655,655,0.079965816,0.079965816
FALSE,Duchesne County,1/1/12,Hide,Hide,1,2012,8424,8424,8891,8891,1,467,467,0.052525025,0.052525025
FALSE,Duchesne County,1/1/13,Hide,Hide,1,2013,8807,8807,9237,9237,1,430,430,0.046551911,0.046551911
FALSE,Duchesne County,1/1/14,Hide,Hide,1,2014,9157,9157,9519,9519,1,362,362,0.038029205,0.038029205
FALSE,Duchesne County,1/1/15,Hide,Hide,1,2015,8966,8966,9429,9429,1,463,463,0.049103829,0.049103829
FALSE,Duchesne County,1/1/16,Hide,Hide,1,2016,7527,7527,8316,8316,1,789,789,0.094877345,0.094877345
FALSE,Duchesne County,1/1/17,Hide,Hide,1,2017,7412,7412,7990,7990,1,578,578,0.072340426,0.072340426
FALSE,Duchesne County,1/1/18,Hide,Hide,1,2018,7457,7457,7828,7828,1,371,371,0.04739397,0.04739397
FALSE,Duchesne County,1/1/19,Hide,Hide,1,2019,7395,7395,7708,7708,1,313,313,0.040607161,0.040607161
FALSE,Duchesne County,1/1/20,Hide,Hide,1,2020,7569,7569,7881,7881,1,312,312,0.039588885,0.039588885
FALSE,Emery County,1/1/93,Hide,Hide,1,1993,3898,3898,4260,4260,1,362,362,0.084976526,0.084976526
FALSE,Emery County,1/1/94,Hide,Hide,1,1994,3896,3896,4222,4222,1,326,326,0.07721459,0.07721459
FALSE,Emery County,1/1/95,Hide,Hide,1,1995,3907,3907,4256,4256,1,349,349,0.08200188,0.08200188
FALSE,Emery County,1/1/96,Hide,Hide,1,1996,3931,3931,4242,4242,1,311,311,0.073314474,0.073314474
FALSE,Emery County,1/1/97,Hide,Hide,1,1997,3886,3886,4188,4188,1,302,302,0.072110793,0.072110793
FALSE,Emery County,1/1/98,Hide,Hide,1,1998,3890,3890,4172,4172,1,282,282,0.06759348,0.06759348
FALSE,Emery County,1/1/99,Hide,Hide,1,1999,3819,3819,4124,4124,1,305,305,0.073957323,0.073957323
FALSE,Emery County,1/1/00,Hide,Hide,1,2000,4216,4216,4431,4431,1,215,215,0.048521778,0.048521778
FALSE,Emery County,1/1/01,Hide,Hide,1,2001,4377,4377,4657,4657,1,280,280,0.060124544,0.060124544
FALSE,Emery County,1/1/02,Hide,Hide,1,2002,4455,4455,4792,4792,1,337,337,0.070325543,0.070325543
FALSE,Emery County,1/1/03,Hide,Hide,1,2003,4524,4524,4904,4904,1,380,380,0.077487765,0.077487765
FALSE,Emery County,1/1/04,Hide,Hide,1,2004,4652,4652,5046,5046,1,394,394,0.078081649,0.078081649
FALSE,Emery County,1/1/05,Hide,Hide,1,2005,4717,4717,5010,5010,1,293,293,0.058483034,0.058483034
FALSE,Emery County,1/1/06,Hide,Hide,1,2006,4984,4984,5194,5194,1,210,210,0.040431267,0.040431267
FALSE,Emery County,1/1/07,Hide,Hide,1,2007,5062,5062,5225,5225,1,163,163,0.031196172,0.031196172
FALSE,Emery County,1/1/08,Hide,Hide,1,2008,4954,4954,5134,5134,1,180,180,0.035060382,0.035060382
FALSE,Emery County,1/1/09,Hide,Hide,1,2009,4810,4810,5076,5076,1,266,266,0.052403467,0.052403467
FALSE,Emery County,1/1/10,Hide,Hide,1,2010,4841,4841,5256,5256,1,415,415,0.078957382,0.078957382
FALSE,Emery County,1/1/11,Hide,Hide,1,2011,4803,4803,5181,5181,1,378,378,0.072958888,0.072958888
FALSE,Emery County,1/1/12,Hide,Hide,1,2012,4512,4512,4860,4860,1,348,348,0.071604938,0.071604938
FALSE,Emery County,1/1/13,Hide,Hide,1,2013,4442,4442,4766,4766,1,324,324,0.067981536,0.067981536
FALSE,Emery County,1/1/14,Hide,Hide,1,2014,4389,4389,4654,4654,1,265,265,0.056940266,0.056940266
FALSE,Emery County,1/1/15,Hide,Hide,1,2015,4229,4229,4456,4456,1,227,227,0.050942549,0.050942549
FALSE,Emery County,1/1/16,Hide,Hide,1,2016,4030,4030,4335,4335,1,305,305,0.070357555,0.070357555
FALSE,Emery County,1/1/17,Hide,Hide,1,2017,3945,3945,4177,4177,1,232,232,0.055542255,0.055542255
FALSE,Emery County,1/1/18,Hide,Hide,1,2018,4061,4061,4265,4265,1,204,204,0.047831184,0.047831184
FALSE,Emery County,1/1/19,Hide,Hide,1,2019,4143,4143,4331,4331,1,188,188,0.043407989,0.043407989
FALSE,Emery County,1/1/20,Hide,Hide,1,2020,4165,4165,4338,4338,1,173,173,0.039880129,0.039880129
FALSE,Garfield County,1/1/93,Hide,Hide,1,1993,2046,2046,2306,2306,1,260,260,0.11274935,0.11274935
FALSE,Garfield County,1/1/94,Hide,Hide,1,1994,2195,2195,2434,2434,1,239,239,0.098192276,0.098192276
FALSE,Garfield County,1/1/95,Hide,Hide,1,1995,2250,2250,2584,2584,1,334,334,0.129256966,0.129256966
FALSE,Garfield County,1/1/96,Hide,Hide,1,1996,2394,2394,2657,2657,1,263,263,0.098983816,0.098983816
FALSE,Garfield County,1/1/97,Hide,Hide,1,1997,2461,2461,2719,2719,1,258,258,0.094887826,0.094887826
FALSE,Garfield County,1/1/98,Hide,Hide,1,1998,2547,2547,2765,2765,1,218,218,0.078842676,0.078842676
FALSE,Garfield County,1/1/99,Hide,Hide,1,1999,2534,2534,2776,2776,1,242,242,0.087175793,0.087175793
FALSE,Garfield County,1/1/00,Hide,Hide,1,2000,2502,2502,2680,2680,1,178,178,0.06641791,0.06641791
FALSE,Garfield County,1/1/01,Hide,Hide,1,2001,2336,2336,2526,2526,1,190,190,0.075217736,0.075217736
FALSE,Garfield County,1/1/02,Hide,Hide,1,2002,2392,2392,2624,2624,1,232,232,0.088414634,0.088414634
FALSE,Garfield County,1/1/03,Hide,Hide,1,2003,2343,2343,2571,2571,1,228,228,0.088681447,0.088681447
FALSE,Garfield County,1/1/04,Hide,Hide,1,2004,2401,2401,2606,2606,1,205,205,0.07866462,0.07866462
FALSE,Garfield County,1/1/05,Hide,Hide,1,2005,2464,2464,2664,2664,1,200,200,0.075075075,0.075075075
FALSE,Garfield County,1/1/06,Hide,Hide,1,2006,2512,2512,2674,2674,1,162,162,0.060583396,0.060583396
FALSE,Garfield County,1/1/07,Hide,Hide,1,2007,2603,2603,2714,2714,1,111,111,0.040899042,0.040899042
FALSE,Garfield County,1/1/08,Hide,Hide,1,2008,2597,2597,2758,2758,1,161,161,0.058375635,0.058375635
FALSE,Garfield County,1/1/09,Hide,Hide,1,2009,2649,2649,2902,2902,1,253,253,0.087181254,0.087181254
FALSE,Garfield County,1/1/10,Hide,Hide,1,2010,2655,2655,2972,2972,1,317,317,0.10666218,0.10666218
FALSE,Garfield County,1/1/11,Hide,Hide,1,2011,2713,2713,3017,3017,1,304,304,0.100762347,0.100762347
FALSE,Garfield County,1/1/12,Hide,Hide,1,2012,2581,2581,2859,2859,1,278,278,0.097236796,0.097236796
FALSE,Garfield County,1/1/13,Hide,Hide,1,2013,2579,2579,2834,2834,1,255,255,0.089978829,0.089978829
FALSE,Garfield County,1/1/14,Hide,Hide,1,2014,2498,2498,2746,2746,1,248,248,0.090313183,0.090313183
FALSE,Garfield County,1/1/15,Hide,Hide,1,2015,2545,2545,2786,2786,1,241,241,0.086503948,0.086503948
FALSE,Garfield County,1/1/16,Hide,Hide,1,2016,2493,2493,2743,2743,1,250,250,0.091141086,0.091141086
FALSE,Garfield County,1/1/17,Hide,Hide,1,2017,2632,2632,2848,2848,1,216,216,0.075842697,0.075842697
FALSE,Garfield County,1/1/18,Hide,Hide,1,2018,2618,2618,2847,2847,1,229,229,0.080435546,0.080435546
FALSE,Garfield County,1/1/19,Hide,Hide,1,2019,2570,2570,2758,2758,1,188,188,0.068165337,0.068165337
FALSE,Garfield County,1/1/20,Hide,Hide,1,2020,2616,2616,2782,2782,1,166,166,0.059669303,0.059669303
FALSE,Grand County,1/1/93,Hide,Hide,1,1993,4065,4065,4358,4358,1,293,293,0.067232676,0.067232676
FALSE,Grand County,1/1/94,Hide,Hide,1,1994,4511,4511,4830,4830,1,319,319,0.066045549,0.066045549
FALSE,Grand County,1/1/95,Hide,Hide,1,1995,4501,4501,4839,4839,1,338,338,0.069849142,0.069849142
FALSE,Grand County,1/1/96,Hide,Hide,1,1996,4760,4760,5091,5091,1,331,331,0.065016696,0.065016696
FALSE,Grand County,1/1/97,Hide,Hide,1,1997,4744,4744,5084,5084,1,340,340,0.066876475,0.066876475
FALSE,Grand County,1/1/98,Hide,Hide,1,1998,4861,4861,5222,5222,1,361,361,0.069130601,0.069130601
FALSE,Grand County,1/1/99,Hide,Hide,1,1999,5188,5188,5569,5569,1,381,381,0.068414437,0.068414437
FALSE,Grand County,1/1/00,Hide,Hide,1,2000,4676,4676,4979,4979,1,303,303,0.060855593,0.060855593
FALSE,Grand County,1/1/01,Hide,Hide,1,2001,4346,4346,4656,4656,1,310,310,0.066580756,0.066580756
FALSE,Grand County,1/1/02,Hide,Hide,1,2002,4485,4485,4837,4837,1,352,352,0.07277238,0.07277238
FALSE,Grand County,1/1/03,Hide,Hide,1,2003,4531,4531,4886,4886,1,355,355,0.07265657,0.07265657
FALSE,Grand County,1/1/04,Hide,Hide,1,2004,4443,4443,4798,4798,1,355,355,0.073989162,0.073989162
FALSE,Grand County,1/1/05,Hide,Hide,1,2005,4543,4543,4869,4869,1,326,326,0.0669542,0.0669542
FALSE,Grand County,1/1/06,Hide,Hide,1,2006,4753,4753,5040,5040,1,287,287,0.056944444,0.056944444
FALSE,Grand County,1/1/07,Hide,Hide,1,2007,4947,4947,5161,5161,1,214,214,0.041464832,0.041464832
FALSE,Grand County,1/1/08,Hide,Hide,1,2008,4947,4947,5219,5219,1,272,272,0.052117264,0.052117264
FALSE,Grand County,1/1/09,Hide,Hide,1,2009,4884,4884,5347,5347,1,463,463,0.086590612,0.086590612
FALSE,Grand County,1/1/10,Hide,Hide,1,2010,4826,4826,5370,5370,1,544,544,0.101303538,0.101303538
FALSE,Grand County,1/1/11,Hide,Hide,1,2011,4771,4771,5308,5308,1,537,537,0.101168048,0.101168048
FALSE,Grand County,1/1/12,Hide,Hide,1,2012,4895,4895,5357,5357,1,462,462,0.0862423,0.0862423
FALSE,Grand County,1/1/13,Hide,Hide,1,2013,4989,4989,5426,5426,1,437,437,0.08053815,0.08053815
FALSE,Grand County,1/1/14,Hide,Hide,1,2014,5105,5105,5494,5494,1,389,389,0.070804514,0.070804514
FALSE,Grand County,1/1/15,Hide,Hide,1,2015,5250,5250,5594,5594,1,344,344,0.061494458,0.061494458
FALSE,Grand County,1/1/16,Hide,Hide,1,2016,5333,5333,5669,5669,1,336,336,0.059269712,0.059269712
FALSE,Grand County,1/1/17,Hide,Hide,1,2017,5483,5483,5814,5814,1,331,331,0.056931545,0.056931545
FALSE,Grand County,1/1/18,Hide,Hide,1,2018,5735,5735,6036,6036,1,301,301,0.049867462,0.049867462
FALSE,Grand County,1/1/19,Hide,Hide,1,2019,5816,5816,6074,6074,1,258,258,0.042476128,0.042476128
FALSE,Grand County,1/1/20,Hide,Hide,1,2020,6116,6116,6367,6367,1,251,251,0.03942202,0.03942202
FALSE,Iron County,1/1/93,Hide,Hide,1,1993,10372,10372,10777,10777,1,405,405,0.037580032,0.037580032
FALSE,Iron County,1/1/94,Hide,Hide,1,1994,11270,11270,11700,11700,1,430,430,0.036752137,0.036752137
FALSE,Iron County,1/1/95,Hide,Hide,1,1995,12391,12391,12815,12815,1,424,424,0.033086227,0.033086227
FALSE,Iron County,1/1/96,Hide,Hide,1,1996,12518,12518,13028,13028,1,510,510,0.039146454,0.039146454
FALSE,Iron County,1/1/97,Hide,Hide,1,1997,13523,13523,13994,13994,1,471,471,0.033657282,0.033657282
FALSE,Iron County,1/1/98,Hide,Hide,1,1998,14066,14066,14602,14602,1,536,536,0.0367073,0.0367073
FALSE,Iron County,1/1/99,Hide,Hide,1,1999,14435,14435,14992,14992,1,557,557,0.037153148,0.037153148
FALSE,Iron County,1/1/00,Hide,Hide,1,2000,15527,15527,16030,16030,1,503,503,0.031378665,0.031378665
FALSE,Iron County,1/1/01,Hide,Hide,1,2001,16266,16266,16928,16928,1,662,662,0.039106805,0.039106805
FALSE,Iron County,1/1/02,Hide,Hide,1,2002,16825,16825,17696,17696,1,871,871,0.049220163,0.049220163
FALSE,Iron County,1/1/03,Hide,Hide,1,2003,16818,16818,17788,17788,1,970,970,0.054531145,0.054531145
FALSE,Iron County,1/1/04,Hide,Hide,1,2004,17466,17466,18364,18364,1,898,898,0.048900022,0.048900022
FALSE,Iron County,1/1/05,Hide,Hide,1,2005,18577,18577,19392,19392,1,815,815,0.04202764,0.04202764
FALSE,Iron County,1/1/06,Hide,Hide,1,2006,19659,19659,20339,20339,1,680,680,0.033433305,0.033433305
FALSE,Iron County,1/1/07,Hide,Hide,1,2007,20688,20688,21232,21232,1,544,544,0.025621703,0.025621703
FALSE,Iron County,1/1/08,Hide,Hide,1,2008,20088,20088,20804,20804,1,716,716,0.034416458,0.034416458
FALSE,Iron County,1/1/09,Hide,Hide,1,2009,19489,19489,21039,21039,1,1550,1550,0.073672703,0.073672703
FALSE,Iron County,1/1/10,Hide,Hide,1,2010,18781,18781,20730,20730,1,1949,1949,0.094018331,0.094018331
FALSE,Iron County,1/1/11,Hide,Hide,1,2011,18252,18252,20083,20083,1,1831,1831,0.091171638,0.091171638
FALSE,Iron County,1/1/12,Hide,Hide,1,2012,18173,18173,19590,19590,1,1417,1417,0.072332823,0.072332823
FALSE,Iron County,1/1/13,Hide,Hide,1,2013,18152,18152,19354,19354,1,1202,1202,0.062106025,0.062106025
FALSE,Iron County,1/1/14,Hide,Hide,1,2014,18904,18904,19829,19829,1,925,925,0.046648848,0.046648848
FALSE,Iron County,1/1/15,Hide,Hide,1,2015,19187,19187,20115,20115,1,928,928,0.046134725,0.046134725
FALSE,Iron County,1/1/16,Hide,Hide,1,2016,19907,19907,20803,20803,1,896,896,0.043070711,0.043070711
FALSE,Iron County,1/1/17,Hide,Hide,1,2017,21025,21025,22001,22001,1,976,976,0.04436162,0.04436162
FALSE,Iron County,1/1/18,Hide,Hide,1,2018,21659,21659,22471,22471,1,812,812,0.036135463,0.036135463
FALSE,Iron County,1/1/19,Hide,Hide,1,2019,22698,22698,23467,23467,1,769,769,0.032769421,0.032769421
FALSE,Iron County,1/1/20,Hide,Hide,1,2020,24009,24009,24693,24693,1,684,684,0.027700158,0.027700158
FALSE,Juab County,1/1/93,Hide,Hide,1,1993,2947,2947,3161,3161,1,214,214,0.067700095,0.067700095
FALSE,Juab County,1/1/94,Hide,Hide,1,1994,3163,3163,3316,3316,1,153,153,0.046139928,0.046139928
FALSE,Juab County,1/1/95,Hide,Hide,1,1995,3250,3250,3418,3418,1,168,168,0.049151551,0.049151551
FALSE,Juab County,1/1/96,Hide,Hide,1,1996,3168,3168,3312,3312,1,144,144,0.043478261,0.043478261
FALSE,Juab County,1/1/97,Hide,Hide,1,1997,3313,3313,3455,3455,1,142,142,0.041099855,0.041099855
FALSE,Juab County,1/1/98,Hide,Hide,1,1998,3355,3355,3502,3502,1,147,147,0.041976014,0.041976014
FALSE,Juab County,1/1/99,Hide,Hide,1,1999,3466,3466,3653,3653,1,187,187,0.051190802,0.051190802
FALSE,Juab County,1/1/00,Hide,Hide,1,2000,3486,3486,3617,3617,1,131,131,0.03621786,0.03621786
FALSE,Juab County,1/1/01,Hide,Hide,1,2001,3663,3663,3809,3809,1,146,146,0.03833027,0.03833027
FALSE,Juab County,1/1/02,Hide,Hide,1,2002,3458,3458,3710,3710,1,252,252,0.067924528,0.067924528
FALSE,Juab County,1/1/03,Hide,Hide,1,2003,3414,3414,3688,3688,1,274,274,0.074295011,0.074295011
FALSE,Juab County,1/1/04,Hide,Hide,1,2004,3508,3508,3769,3769,1,261,261,0.069249138,0.069249138
FALSE,Juab County,1/1/05,Hide,Hide,1,2005,3661,3661,3861,3861,1,200,200,0.051800052,0.051800052
FALSE,Juab County,1/1/06,Hide,Hide,1,2006,3815,3815,3981,3981,1,166,166,0.041698066,0.041698066
FALSE,Juab County,1/1/07,Hide,Hide,1,2007,3969,3969,4089,4089,1,120,120,0.029347029,0.029347029
FALSE,Juab County,1/1/08,Hide,Hide,1,2008,3848,3848,4010,4010,1,162,162,0.040399002,0.040399002
FALSE,Juab County,1/1/09,Hide,Hide,1,2009,3650,3650,4009,4009,1,359,359,0.089548516,0.089548516
FALSE,Juab County,1/1/10,Hide,Hide,1,2010,3919,3919,4335,4335,1,416,416,0.095963091,0.095963091
FALSE,Juab County,1/1/11,Hide,Hide,1,2011,4173,4173,4577,4577,1,404,404,0.088267424,0.088267424
FALSE,Juab County,1/1/12,Hide,Hide,1,2012,4251,4251,4554,4554,1,303,303,0.066534914,0.066534914
FALSE,Juab County,1/1/13,Hide,Hide,1,2013,4419,4419,4674,4674,1,255,255,0.054557125,0.054557125
FALSE,Juab County,1/1/14,Hide,Hide,1,2014,4536,4536,4748,4748,1,212,212,0.044650379,0.044650379
FALSE,Juab County,1/1/15,Hide,Hide,1,2015,4670,4670,4862,4862,1,192,192,0.039489922,0.039489922
FALSE,Juab County,1/1/16,Hide,Hide,1,2016,4896,4896,5094,5094,1,198,198,0.038869258,0.038869258
FALSE,Juab County,1/1/17,Hide,Hide,1,2017,5143,5143,5323,5323,1,180,180,0.033815518,0.033815518
FALSE,Juab County,1/1/18,Hide,Hide,1,2018,5353,5353,5527,5527,1,174,174,0.031481817,0.031481817
FALSE,Juab County,1/1/19,Hide,Hide,1,2019,5483,5483,5639,5639,1,156,156,0.02766448,0.02766448
FALSE,Juab County,1/1/20,Hide,Hide,1,2020,5683,5683,5814,5814,1,131,131,0.02253182,0.02253182
FALSE,Kane County,1/1/93,Hide,Hide,1,1993,2530,2530,2719,2719,1,189,189,0.06951085,0.06951085
FALSE,Kane County,1/1/94,Hide,Hide,1,1994,2535,2535,2726,2726,1,191,191,0.070066031,0.070066031
FALSE,Kane County,1/1/95,Hide,Hide,1,1995,2519,2519,2783,2783,1,264,264,0.09486166,0.09486166
FALSE,Kane County,1/1/96,Hide,Hide,1,1996,2429,2429,2596,2596,1,167,167,0.064329738,0.064329738
FALSE,Kane County,1/1/97,Hide,Hide,1,1997,2437,2437,2595,2595,1,158,158,0.06088632,0.06088632
FALSE,Kane County,1/1/98,Hide,Hide,1,1998,2603,2603,2709,2709,1,106,106,0.03912883,0.03912883
FALSE,Kane County,1/1/99,Hide,Hide,1,1999,2677,2677,2796,2796,1,119,119,0.042560801,0.042560801
FALSE,Kane County,1/1/00,Hide,Hide,1,2000,2798,2798,2897,2897,1,99,99,0.034173283,0.034173283
FALSE,Kane County,1/1/01,Hide,Hide,1,2001,2898,2898,3025,3025,1,127,127,0.041983471,0.041983471
FALSE,Kane County,1/1/02,Hide,Hide,1,2002,2959,2959,3098,3098,1,139,139,0.044867657,0.044867657
FALSE,Kane County,1/1/03,Hide,Hide,1,2003,2866,2866,3029,3029,1,163,163,0.05381314,0.05381314
FALSE,Kane County,1/1/04,Hide,Hide,1,2004,2994,2994,3175,3175,1,181,181,0.057007874,0.057007874
FALSE,Kane County,1/1/05,Hide,Hide,1,2005,3022,3022,3192,3192,1,170,170,0.053258145,0.053258145
FALSE,Kane County,1/1/06,Hide,Hide,1,2006,3216,3216,3353,3353,1,137,137,0.040858932,0.040858932
FALSE,Kane County,1/1/07,Hide,Hide,1,2007,3416,3416,3520,3520,1,104,104,0.029545455,0.029545455
FALSE,Kane County,1/1/08,Hide,Hide,1,2008,3322,3322,3438,3438,1,116,116,0.033740547,0.033740547
FALSE,Kane County,1/1/09,Hide,Hide,1,2009,3280,3280,3511,3511,1,231,231,0.065793221,0.065793221
FALSE,Kane County,1/1/10,Hide,Hide,1,2010,3307,3307,3600,3600,1,293,293,0.081388889,0.081388889
FALSE,Kane County,1/1/11,Hide,Hide,1,2011,3239,3239,3512,3512,1,273,273,0.077733485,0.077733485
FALSE,Kane County,1/1/12,Hide,Hide,1,2012,3223,3223,3459,3459,1,236,236,0.068227812,0.068227812
FALSE,Kane County,1/1/13,Hide,Hide,1,2013,3270,3270,3471,3471,1,201,201,0.057908384,0.057908384
FALSE,Kane County,1/1/14,Hide,Hide,1,2014,3339,3339,3515,3515,1,176,176,0.050071124,0.050071124
FALSE,Kane County,1/1/15,Hide,Hide,1,2015,3403,3403,3567,3567,1,164,164,0.045977011,0.045977011
FALSE,Kane County,1/1/16,Hide,Hide,1,2016,3529,3529,3685,3685,1,156,156,0.042333786,0.042333786
FALSE,Kane County,1/1/17,Hide,Hide,1,2017,3594,3594,3722,3722,1,128,128,0.034390113,0.034390113
FALSE,Kane County,1/1/18,Hide,Hide,1,2018,3671,3671,3795,3795,1,124,124,0.032674572,0.032674572
FALSE,Kane County,1/1/19,Hide,Hide,1,2019,3671,3671,3789,3789,1,118,118,0.031142782,0.031142782
FALSE,Kane County,1/1/20,Hide,Hide,1,2020,3747,3747,3845,3845,1,98,98,0.025487646,0.025487646
FALSE,Millard County,1/1/93,Hide,Hide,1,1993,4410,4410,4689,4689,1,279,279,0.05950096,0.05950096
FALSE,Millard County,1/1/94,Hide,Hide,1,1994,4512,4512,4724,4724,1,212,212,0.044877223,0.044877223
FALSE,Millard County,1/1/95,Hide,Hide,1,1995,4607,4607,4849,4849,1,242,242,0.049907197,0.049907197
FALSE,Millard County,1/1/96,Hide,Hide,1,1996,4474,4474,4680,4680,1,206,206,0.044017094,0.044017094
FALSE,Millard County,1/1/97,Hide,Hide,1,1997,4585,4585,4766,4766,1,181,181,0.037977339,0.037977339
FALSE,Millard County,1/1/98,Hide,Hide,1,1998,4607,4607,4822,4822,1,215,215,0.044587308,0.044587308
FALSE,Millard County,1/1/99,Hide,Hide,1,1999,4476,4476,4675,4675,1,199,199,0.042566845,0.042566845
FALSE,Millard County,1/1/00,Hide,Hide,1,2000,4786,4786,4954,4954,1,168,168,0.03391199,0.03391199
FALSE,Millard County,1/1/01,Hide,Hide,1,2001,4971,4971,5167,5167,1,196,196,0.037933037,0.037933037
FALSE,Millard County,1/1/02,Hide,Hide,1,2002,5810,5810,6086,6086,1,276,276,0.045349984,0.045349984
FALSE,Millard County,1/1/03,Hide,Hide,1,2003,5930,5930,6220,6220,1,290,290,0.046623794,0.046623794
FALSE,Millard County,1/1/04,Hide,Hide,1,2004,5750,5750,6070,6070,1,320,320,0.052718287,0.052718287
FALSE,Millard County,1/1/05,Hide,Hide,1,2005,5633,5633,5884,5884,1,251,251,0.042658056,0.042658056
FALSE,Millard County,1/1/06,Hide,Hide,1,2006,5881,5881,6099,6099,1,218,218,0.035743565,0.035743565
FALSE,Millard County,1/1/07,Hide,Hide,1,2007,6150,6150,6297,6297,1,147,147,0.02334445,0.02334445
FALSE,Millard County,1/1/08,Hide,Hide,1,2008,5875,5875,6051,6051,1,176,176,0.029086101,0.029086101
FALSE,Millard County,1/1/09,Hide,Hide,1,2009,6039,6039,6332,6332,1,293,293,0.0462729,0.0462729
FALSE,Millard County,1/1/10,Hide,Hide,1,2010,5996,5996,6405,6405,1,409,409,0.063856362,0.063856362
FALSE,Millard County,1/1/11,Hide,Hide,1,2011,5943,5943,6302,6302,1,359,359,0.056966043,0.056966043
FALSE,Millard County,1/1/12,Hide,Hide,1,2012,5696,5696,5990,5990,1,294,294,0.049081803,0.049081803
FALSE,Millard County,1/1/13,Hide,Hide,1,2013,5743,5743,6003,6003,1,260,260,0.043311677,0.043311677
FALSE,Millard County,1/1/14,Hide,Hide,1,2014,5791,5791,6003,6003,1,212,212,0.035315675,0.035315675
FALSE,Millard County,1/1/15,Hide,Hide,1,2015,5950,5950,6167,6167,1,217,217,0.035187287,0.035187287
FALSE,Millard County,1/1/16,Hide,Hide,1,2016,5884,5884,6094,6094,1,210,210,0.034460125,0.034460125
FALSE,Millard County,1/1/17,Hide,Hide,1,2017,6097,6097,6314,6314,1,217,217,0.034368071,0.034368071
FALSE,Millard County,1/1/18,Hide,Hide,1,2018,6218,6218,6417,6417,1,199,199,0.031011376,0.031011376
FALSE,Millard County,1/1/19,Hide,Hide,1,2019,5821,5821,6005,6005,1,184,184,0.030641132,0.030641132
FALSE,Millard County,1/1/20,Hide,Hide,1,2020,5779,5779,5929,5929,1,150,150,0.025299376,0.025299376
FALSE,Morgan County,1/1/93,Hide,Hide,1,1993,2789,2789,2962,2962,1,173,173,0.058406482,0.058406482
FALSE,Morgan County,1/1/94,Hide,Hide,1,1994,2823,2823,2960,2960,1,137,137,0.046283784,0.046283784
FALSE,Morgan County,1/1/95,Hide,Hide,1,1995,3122,3122,3292,3292,1,170,170,0.05164034,0.05164034
FALSE,Morgan County,1/1/96,Hide,Hide,1,1996,3224,3224,3379,3379,1,155,155,0.04587156,0.04587156
FALSE,Morgan County,1/1/97,Hide,Hide,1,1997,3416,3416,3553,3553,1,137,137,0.038558964,0.038558964
FALSE,Morgan County,1/1/98,Hide,Hide,1,1998,3577,3577,3716,3716,1,139,139,0.037405813,0.037405813
FALSE,Morgan County,1/1/99,Hide,Hide,1,1999,3458,3458,3598,3598,1,140,140,0.038910506,0.038910506
FALSE,Morgan County,1/1/00,Hide,Hide,1,2000,3373,3373,3488,3488,1,115,115,0.032970183,0.032970183
FALSE,Morgan County,1/1/01,Hide,Hide,1,2001,3337,3337,3460,3460,1,123,123,0.035549133,0.035549133
FALSE,Morgan County,1/1/02,Hide,Hide,1,2002,3343,3343,3517,3517,1,174,174,0.049473984,0.049473984
FALSE,Morgan County,1/1/03,Hide,Hide,1,2003,3382,3382,3579,3579,1,197,197,0.055043308,0.055043308
FALSE,Morgan County,1/1/04,Hide,Hide,1,2004,3454,3454,3640,3640,1,186,186,0.051098901,0.051098901
FALSE,Morgan County,1/1/05,Hide,Hide,1,2005,3587,3587,3753,3753,1,166,166,0.044231282,0.044231282
FALSE,Morgan County,1/1/06,Hide,Hide,1,2006,3749,3749,3888,3888,1,139,139,0.035751029,0.035751029
FALSE,Morgan County,1/1/07,Hide,Hide,1,2007,3867,3867,3960,3960,1,93,93,0.023484848,0.023484848
FALSE,Morgan County,1/1/08,Hide,Hide,1,2008,3927,3927,4048,4048,1,121,121,0.029891304,0.029891304
FALSE,Morgan County,1/1/09,Hide,Hide,1,2009,3872,3872,4083,4083,1,211,211,0.051677688,0.051677688
FALSE,Morgan County,1/1/10,Hide,Hide,1,2010,3885,3885,4170,4170,1,285,285,0.068345324,0.068345324
FALSE,Morgan County,1/1/11,Hide,Hide,1,2011,3969,3969,4240,4240,1,271,271,0.063915094,0.063915094
FALSE,Morgan County,1/1/12,Hide,Hide,1,2012,4064,4064,4285,4285,1,221,221,0.051575263,0.051575263
FALSE,Morgan County,1/1/13,Hide,Hide,1,2013,4236,4236,4433,4433,1,197,197,0.044439432,0.044439432
FALSE,Morgan County,1/1/14,Hide,Hide,1,2014,4443,4443,4612,4612,1,169,169,0.036643539,0.036643539
FALSE,Morgan County,1/1/15,Hide,Hide,1,2015,4661,4661,4810,4810,1,149,149,0.030977131,0.030977131
FALSE,Morgan County,1/1/16,Hide,Hide,1,2016,4871,4871,5030,5030,1,159,159,0.031610338,0.031610338
FALSE,Morgan County,1/1/17,Hide,Hide,1,2017,5144,5144,5298,5298,1,154,154,0.029067573,0.029067573
FALSE,Morgan County,1/1/18,Hide,Hide,1,2018,5269,5269,5416,5416,1,147,147,0.027141802,0.027141802
FALSE,Morgan County,1/1/19,Hide,Hide,1,2019,5341,5341,5484,5484,1,143,143,0.026075857,0.026075857
FALSE,Morgan County,1/1/20,Hide,Hide,1,2020,5507,5507,5634,5634,1,127,127,0.022541711,0.022541711
FALSE,Piute County,1/1/93,Hide,Hide,1,1993,417,417,445,445,1,28,28,0.062921348,0.062921348
FALSE,Piute County,1/1/94,Hide,Hide,1,1994,449,449,484,484,1,35,35,0.07231405,0.07231405
FALSE,Piute County,1/1/95,Hide,Hide,1,1995,459,459,492,492,1,33,33,0.067073171,0.067073171
FALSE,Piute County,1/1/96,Hide,Hide,1,1996,479,479,501,501,1,22,22,0.043912176,0.043912176
FALSE,Piute County,1/1/97,Hide,Hide,1,1997,505,505,533,533,1,28,28,0.052532833,0.052532833
FALSE,Piute County,1/1/98,Hide,Hide,1,1998,518,518,545,545,1,27,27,0.049541284,0.049541284
FALSE,Piute County,1/1/99,Hide,Hide,1,1999,504,504,537,537,1,33,33,0.061452514,0.061452514
FALSE,Piute County,1/1/00,Hide,Hide,1,2000,541,541,562,562,1,21,21,0.037366548,0.037366548
FALSE,Piute County,1/1/01,Hide,Hide,1,2001,657,657,697,697,1,40,40,0.057388809,0.057388809
FALSE,Piute County,1/1/02,Hide,Hide,1,2002,710,710,755,755,1,45,45,0.059602649,0.059602649
FALSE,Piute County,1/1/03,Hide,Hide,1,2003,742,742,788,788,1,46,46,0.058375635,0.058375635
FALSE,Piute County,1/1/04,Hide,Hide,1,2004,796,796,835,835,1,39,39,0.046706587,0.046706587
FALSE,Piute County,1/1/05,Hide,Hide,1,2005,841,841,879,879,1,38,38,0.043230944,0.043230944
FALSE,Piute County,1/1/06,Hide,Hide,1,2006,813,813,843,843,1,30,30,0.035587189,0.035587189
FALSE,Piute County,1/1/07,Hide,Hide,1,2007,877,877,896,896,1,19,19,0.021205357,0.021205357
FALSE,Piute County,1/1/08,Hide,Hide,1,2008,880,880,904,904,1,24,24,0.026548673,0.026548673
FALSE,Piute County,1/1/09,Hide,Hide,1,2009,866,866,911,911,1,45,45,0.049396268,0.049396268
FALSE,Piute County,1/1/10,Hide,Hide,1,2010,649,649,709,709,1,60,60,0.084626234,0.084626234
FALSE,Piute County,1/1/11,Hide,Hide,1,2011,506,506,563,563,1,57,57,0.101243339,0.101243339
FALSE,Piute County,1/1/12,Hide,Hide,1,2012,462,462,508,508,1,46,46,0.090551181,0.090551181
FALSE,Piute County,1/1/13,Hide,Hide,1,2013,453,453,490,490,1,37,37,0.075510204,0.075510204
FALSE,Piute County,1/1/14,Hide,Hide,1,2014,432,432,466,466,1,34,34,0.072961373,0.072961373
FALSE,Piute County,1/1/15,Hide,Hide,1,2015,443,443,476,476,1,33,33,0.069327731,0.069327731
FALSE,Piute County,1/1/16,Hide,Hide,1,2016,418,418,447,447,1,29,29,0.064876957,0.064876957
FALSE,Piute County,1/1/17,Hide,Hide,1,2017,444,444,469,469,1,25,25,0.053304904,0.053304904
FALSE,Piute County,1/1/18,Hide,Hide,1,2018,466,466,488,488,1,22,22,0.045081967,0.045081967
FALSE,Piute County,1/1/19,Hide,Hide,1,2019,458,458,482,482,1,24,24,0.049792531,0.049792531
FALSE,Piute County,1/1/20,Hide,Hide,1,2020,463,463,485,485,1,22,22,0.045360825,0.045360825
FALSE,Rich County,1/1/93,Hide,Hide,1,1993,733,733,762,762,1,29,29,0.038057743,0.038057743
FALSE,Rich County,1/1/94,Hide,Hide,1,1994,762,762,791,791,1,29,29,0.036662453,0.036662453
FALSE,Rich County,1/1/95,Hide,Hide,1,1995,811,811,843,843,1,32,32,0.037959668,0.037959668
FALSE,Rich County,1/1/96,Hide,Hide,1,1996,914,914,947,947,1,33,33,0.034846885,0.034846885
FALSE,Rich County,1/1/97,Hide,Hide,1,1997,906,906,933,933,1,27,27,0.028938907,0.028938907
FALSE,Rich County,1/1/98,Hide,Hide,1,1998,971,971,1006,1006,1,35,35,0.034791252,0.034791252
FALSE,Rich County,1/1/99,Hide,Hide,1,1999,951,951,983,983,1,32,32,0.032553408,0.032553408
FALSE,Rich County,1/1/00,Hide,Hide,1,2000,930,930,962,962,1,32,32,0.033264033,0.033264033
FALSE,Rich County,1/1/01,Hide,Hide,1,2001,1020,1020,1060,1060,1,40,40,0.037735849,0.037735849
FALSE,Rich County,1/1/02,Hide,Hide,1,2002,1245,1245,1288,1288,1,43,43,0.033385093,0.033385093
FALSE,Rich County,1/1/03,Hide,Hide,1,2003,1226,1226,1279,1279,1,53,53,0.041438624,0.041438624
FALSE,Rich County,1/1/04,Hide,Hide,1,2004,1278,1278,1323,1323,1,45,45,0.034013605,0.034013605
FALSE,Rich County,1/1/05,Hide,Hide,1,2005,1245,1245,1290,1290,1,45,45,0.034883721,0.034883721
FALSE,Rich County,1/1/06,Hide,Hide,1,2006,1292,1292,1329,1329,1,37,37,0.027840482,0.027840482
FALSE,Rich County,1/1/07,Hide,Hide,1,2007,1426,1426,1450,1450,1,24,24,0.016551724,0.016551724
FALSE,Rich County,1/1/08,Hide,Hide,1,2008,1412,1412,1443,1443,1,31,31,0.021483021,0.021483021
FALSE,Rich County,1/1/09,Hide,Hide,1,2009,1435,1435,1498,1498,1,63,63,0.042056075,0.042056075
FALSE,Rich County,1/1/10,Hide,Hide,1,2010,1133,1133,1210,1210,1,77,77,0.063636364,0.063636364
FALSE,Rich County,1/1/11,Hide,Hide,1,2011,924,924,1000,1000,1,76,76,0.076,0.076
FALSE,Rich County,1/1/12,Hide,Hide,1,2012,893,893,948,948,1,55,55,0.058016878,0.058016878
FALSE,Rich County,1/1/13,Hide,Hide,1,2013,911,911,961,961,1,50,50,0.052029136,0.052029136
FALSE,Rich County,1/1/14,Hide,Hide,1,2014,1006,1006,1045,1045,1,39,39,0.037320574,0.037320574
FALSE,Rich County,1/1/15,Hide,Hide,1,2015,1008,1008,1045,1045,1,37,37,0.035406699,0.035406699
FALSE,Rich County,1/1/16,Hide,Hide,1,2016,1015,1015,1048,1048,1,33,33,0.03148855,0.03148855
FALSE,Rich County,1/1/17,Hide,Hide,1,2017,1074,1074,1112,1112,1,38,38,0.034172662,0.034172662
FALSE,Rich County,1/1/18,Hide,Hide,1,2018,1127,1127,1165,1165,1,38,38,0.032618026,0.032618026
FALSE,Rich County,1/1/19,Hide,Hide,1,2019,1132,1132,1170,1170,1,38,38,0.032478632,0.032478632
FALSE,Rich County,1/1/20,Hide,Hide,1,2020,1131,1131,1167,1167,1,36,36,0.030848329,0.030848329
FALSE,Salt Lake County,1/1/93,Hide,Hide,1,1993,393388,393388,410236,410236,1,16848,16848,0.041069043,0.041069043
FALSE,Salt Lake County,1/1/94,Hide,Hide,1,1994,420611,420611,434581,434581,1,13970,13970,0.032145906,0.032145906
FALSE,Salt Lake County,1/1/95,Hide,Hide,1,1995,435176,435176,449946,449946,1,14770,14770,0.032826161,0.032826161
FALSE,Salt Lake County,1/1/96,Hide,Hide,1,1996,442724,442724,455716,455716,1,12992,12992,0.028508984,0.028508984
FALSE,Salt Lake County,1/1/97,Hide,Hide,1,1997,454875,454875,468005,468005,1,13130,13130,0.028055256,0.028055256
FALSE,Salt Lake County,1/1/98,Hide,Hide,1,1998,465076,465076,480131,480131,1,15055,15055,0.031356026,0.031356026
FALSE,Salt Lake County,1/1/99,Hide,Hide,1,1999,471496,471496,487523,487523,1,16027,16027,0.032874346,0.032874346
FALSE,Salt Lake County,1/1/00,Hide,Hide,1,2000,470532,470532,484817,484817,1,14285,14285,0.029464726,0.029464726
FALSE,Salt Lake County,1/1/01,Hide,Hide,1,2001,476708,476708,494832,494832,1,18124,18124,0.036626572,0.036626572
FALSE,Salt Lake County,1/1/02,Hide,Hide,1,2002,467443,467443,494113,494113,1,26670,26670,0.053975508,0.053975508
FALSE,Salt Lake County,1/1/03,Hide,Hide,1,2003,463485,463485,493447,493447,1,29962,29962,0.060719794,0.060719794
FALSE,Salt Lake County,1/1/04,Hide,Hide,1,2004,471126,471126,498055,498055,1,26929,26929,0.054068326,0.054068326
FALSE,Salt Lake County,1/1/05,Hide,Hide,1,2005,486329,486329,508840,508840,1,22511,22511,0.04423984,0.04423984
FALSE,Salt Lake County,1/1/06,Hide,Hide,1,2006,508959,508959,527316,527316,1,18357,18357,0.034812143,0.034812143
FALSE,Salt Lake County,1/1/07,Hide,Hide,1,2007,531375,531375,544100,544100,1,12725,12725,0.023387245,0.023387245
FALSE,Salt Lake County,1/1/08,Hide,Hide,1,2008,541904,541904,557542,557542,1,15638,15638,0.028048111,0.028048111
FALSE,Salt Lake County,1/1/09,Hide,Hide,1,2009,527112,527112,558437,558437,1,31325,31325,0.056094063,0.056094063
FALSE,Salt Lake County,1/1/10,Hide,Hide,1,2010,505902,505902,547499,547499,1,41597,41597,0.075976394,0.075976394
FALSE,Salt Lake County,1/1/11,Hide,Hide,1,2011,507200,507200,547212,547212,1,40012,40012,0.073119742,0.073119742
FALSE,Salt Lake County,1/1/12,Hide,Hide,1,2012,517520,517520,549241,549241,1,31721,31721,0.057754246,0.057754246
FALSE,Salt Lake County,1/1/13,Hide,Hide,1,2013,536731,536731,563579,563579,1,26848,26848,0.047638397,0.047638397
FALSE,Salt Lake County,1/1/14,Hide,Hide,1,2014,551610,551610,574250,574250,1,22640,22640,0.039425337,0.039425337
FALSE,Salt Lake County,1/1/15,Hide,Hide,1,2015,558947,558947,579013,579013,1,20066,20066,0.034655526,0.034655526
FALSE,Salt Lake County,1/1/16,Hide,Hide,1,2016,573541,573541,593205,593205,1,19664,19664,0.033148743,0.033148743
FALSE,Salt Lake County,1/1/17,Hide,Hide,1,2017,591436,591436,610420,610420,1,18984,18984,0.031099898,0.031099898
FALSE,Salt Lake County,1/1/18,Hide,Hide,1,2018,598444,598444,616956,616956,1,18512,18512,0.030005381,0.030005381
FALSE,Salt Lake County,1/1/19,Hide,Hide,1,2019,607775,607775,625207,625207,1,17432,17432,0.027881965,0.027881965
FALSE,Salt Lake County,1/1/20,Hide,Hide,1,2020,630451,630451,646071,646071,1,15620,15620,0.024176909,0.024176909
FALSE,San Juan County,1/1/93,Hide,Hide,1,1993,4450,4450,4839,4839,1,389,389,0.08038851,0.08038851
FALSE,San Juan County,1/1/94,Hide,Hide,1,1994,4643,4643,5052,5052,1,409,409,0.080958036,0.080958036
FALSE,San Juan County,1/1/95,Hide,Hide,1,1995,4712,4712,5150,5150,1,438,438,0.085048544,0.085048544
FALSE,San Juan County,1/1/96,Hide,Hide,1,1996,4768,4768,5230,5230,1,462,462,0.08833652,0.08833652
FALSE,San Juan County,1/1/97,Hide,Hide,1,1997,4485,4485,4981,4981,1,496,496,0.099578398,0.099578398
FALSE,San Juan County,1/1/98,Hide,Hide,1,1998,4509,4509,4890,4890,1,381,381,0.07791411,0.07791411
FALSE,San Juan County,1/1/99,Hide,Hide,1,1999,4707,4707,5110,5110,1,403,403,0.078864971,0.078864971
FALSE,San Juan County,1/1/00,Hide,Hide,1,2000,4516,4516,4851,4851,1,335,335,0.069057926,0.069057926
FALSE,San Juan County,1/1/01,Hide,Hide,1,2001,4190,4190,4580,4580,1,390,390,0.085152838,0.085152838
FALSE,San Juan County,1/1/02,Hide,Hide,1,2002,4321,4321,4716,4716,1,395,395,0.083757422,0.083757422
FALSE,San Juan County,1/1/03,Hide,Hide,1,2003,4377,4377,4809,4809,1,432,432,0.089831566,0.089831566
FALSE,San Juan County,1/1/04,Hide,Hide,1,2004,4361,4361,4802,4802,1,441,441,0.091836735,0.091836735
FALSE,San Juan County,1/1/05,Hide,Hide,1,2005,4345,4345,4749,4749,1,404,404,0.085070541,0.085070541
FALSE,San Juan County,1/1/06,Hide,Hide,1,2006,4514,4514,4849,4849,1,335,335,0.06908641,0.06908641
FALSE,San Juan County,1/1/07,Hide,Hide,1,2007,4679,4679,4918,4918,1,239,239,0.048596991,0.048596991
FALSE,San Juan County,1/1/08,Hide,Hide,1,2008,4678,4678,4956,4956,1,278,278,0.056093624,0.056093624
FALSE,San Juan County,1/1/09,Hide,Hide,1,2009,4692,4692,5170,5170,1,478,478,0.09245648,0.09245648
FALSE,San Juan County,1/1/10,Hide,Hide,1,2010,5095,5095,5780,5780,1,685,685,0.118512111,0.118512111
FALSE,San Juan County,1/1/11,Hide,Hide,1,2011,5403,5403,6053,6053,1,650,650,0.107384768,0.107384768
FALSE,San Juan County,1/1/12,Hide,Hide,1,2012,5263,5263,5797,5797,1,534,534,0.092116612,0.092116612
FALSE,San Juan County,1/1/13,Hide,Hide,1,2013,5170,5170,5628,5628,1,458,458,0.08137882,0.08137882
FALSE,San Juan County,1/1/14,Hide,Hide,1,2014,5277,5277,5711,5711,1,434,434,0.075993696,0.075993696
FALSE,San Juan County,1/1/15,Hide,Hide,1,2015,5213,5213,5657,5657,1,444,444,0.07848683,0.07848683
FALSE,San Juan County,1/1/16,Hide,Hide,1,2016,5235,5235,5718,5718,1,483,483,0.084470094,0.084470094
FALSE,San Juan County,1/1/17,Hide,Hide,1,2017,5301,5301,5729,5729,1,428,428,0.074707628,0.074707628
FALSE,San Juan County,1/1/18,Hide,Hide,1,2018,5324,5324,5689,5689,1,365,365,0.064158903,0.064158903
FALSE,San Juan County,1/1/19,Hide,Hide,1,2019,5393,5393,5707,5707,1,314,314,0.055020151,0.055020151
FALSE,San Juan County,1/1/20,Hide,Hide,1,2020,5439,5439,5746,5746,1,307,307,0.053428472,0.053428472
FALSE,Sanpete County,1/1/93,Hide,Hide,1,1993,6394,6394,6924,6924,1,530,530,0.07654535,0.07654535
FALSE,Sanpete County,1/1/94,Hide,Hide,1,1994,6849,6849,7317,7317,1,468,468,0.06396064,0.06396064
FALSE,Sanpete County,1/1/95,Hide,Hide,1,1995,7192,7192,7696,7696,1,504,504,0.065488565,0.065488565
FALSE,Sanpete County,1/1/96,Hide,Hide,1,1996,7551,7551,8041,8041,1,490,490,0.060937694,0.060937694
FALSE,Sanpete County,1/1/97,Hide,Hide,1,1997,8013,8013,8486,8486,1,473,473,0.055738864,0.055738864
FALSE,Sanpete County,1/1/98,Hide,Hide,1,1998,8351,8351,8843,8843,1,492,492,0.055637227,0.055637227
FALSE,Sanpete County,1/1/99,Hide,Hide,1,1999,8462,8462,8945,8945,1,483,483,0.053996646,0.053996646
FALSE,Sanpete County,1/1/00,Hide,Hide,1,2000,8870,8870,9253,9253,1,383,383,0.041391981,0.041391981
FALSE,Sanpete County,1/1/01,Hide,Hide,1,2001,9282,9282,9782,9782,1,500,500,0.051114292,0.051114292
FALSE,Sanpete County,1/1/02,Hide,Hide,1,2002,9632,9632,10252,10252,1,620,620,0.060476005,0.060476005
FALSE,Sanpete County,1/1/03,Hide,Hide,1,2003,9687,9687,10386,10386,1,699,699,0.067302137,0.067302137
FALSE,Sanpete County,1/1/04,Hide,Hide,1,2004,9772,9772,10443,10443,1,671,671,0.064253567,0.064253567
FALSE,Sanpete County,1/1/05,Hide,Hide,1,2005,9775,9775,10373,10373,1,598,598,0.057649667,0.057649667
FALSE,Sanpete County,1/1/06,Hide,Hide,1,2006,10127,10127,10599,10599,1,472,472,0.044532503,0.044532503
FALSE,Sanpete County,1/1/07,Hide,Hide,1,2007,10585,10585,10897,10897,1,312,312,0.028631734,0.028631734
FALSE,Sanpete County,1/1/08,Hide,Hide,1,2008,10521,10521,10910,10910,1,389,389,0.035655362,0.035655362
FALSE,Sanpete County,1/1/09,Hide,Hide,1,2009,10548,10548,11359,11359,1,811,811,0.07139713,0.07139713
FALSE,Sanpete County,1/1/10,Hide,Hide,1,2010,10481,10481,11458,11458,1,977,977,0.085267935,0.085267935
FALSE,Sanpete County,1/1/11,Hide,Hide,1,2011,10171,10171,11154,11154,1,983,983,0.088129819,0.088129819
FALSE,Sanpete County,1/1/12,Hide,Hide,1,2012,10459,10459,11226,11226,1,767,767,0.068323535,0.068323535
FALSE,Sanpete County,1/1/13,Hide,Hide,1,2013,10587,10587,11274,11274,1,687,687,0.060936668,0.060936668
FALSE,Sanpete County,1/1/14,Hide,Hide,1,2014,10458,10458,10994,10994,1,536,536,0.048753866,0.048753866
FALSE,Sanpete County,1/1/15,Hide,Hide,1,2015,10847,10847,11326,11326,1,479,479,0.042292071,0.042292071
FALSE,Sanpete County,1/1/16,Hide,Hide,1,2016,11089,11089,11567,11567,1,478,478,0.041324458,0.041324458
FALSE,Sanpete County,1/1/17,Hide,Hide,1,2017,11399,11399,11871,11871,1,472,472,0.039760762,0.039760762
FALSE,Sanpete County,1/1/18,Hide,Hide,1,2018,11839,11839,12298,12298,1,459,459,0.037323142,0.037323142
FALSE,Sanpete County,1/1/19,Hide,Hide,1,2019,12031,12031,12464,12464,1,433,433,0.034740051,0.034740051
FALSE,Sanpete County,1/1/20,Hide,Hide,1,2020,12138,12138,12526,12526,1,388,388,0.030975571,0.030975571
FALSE,Sevier County,1/1/93,Hide,Hide,1,1993,6443,6443,6896,6896,1,453,453,0.065690255,0.065690255
FALSE,Sevier County,1/1/94,Hide,Hide,1,1994,6944,6944,7277,7277,1,333,333,0.045760616,0.045760616
FALSE,Sevier County,1/1/95,Hide,Hide,1,1995,7241,7241,7631,7631,1,390,390,0.051107325,0.051107325
FALSE,Sevier County,1/1/96,Hide,Hide,1,1996,7405,7405,7760,7760,1,355,355,0.045747423,0.045747423
FALSE,Sevier County,1/1/97,Hide,Hide,1,1997,7652,7652,8014,8014,1,362,362,0.045170951,0.045170951
FALSE,Sevier County,1/1/98,Hide,Hide,1,1998,7918,7918,8263,8263,1,345,345,0.04175239,0.04175239
FALSE,Sevier County,1/1/99,Hide,Hide,1,1999,7974,7974,8337,8337,1,363,363,0.043540842,0.043540842
FALSE,Sevier County,1/1/00,Hide,Hide,1,2000,8066,8066,8354,8354,1,288,288,0.034474503,0.034474503
FALSE,Sevier County,1/1/01,Hide,Hide,1,2001,7960,7960,8338,8338,1,378,378,0.045334613,0.045334613
FALSE,Sevier County,1/1/02,Hide,Hide,1,2002,8383,8383,8859,8859,1,476,476,0.053730669,0.053730669
FALSE,Sevier County,1/1/03,Hide,Hide,1,2003,8314,8314,8825,8825,1,511,511,0.057903683,0.057903683
FALSE,Sevier County,1/1/04,Hide,Hide,1,2004,8559,8559,9050,9050,1,491,491,0.054254144,0.054254144
FALSE,Sevier County,1/1/05,Hide,Hide,1,2005,8619,8619,9055,9055,1,436,436,0.048150193,0.048150193
FALSE,Sevier County,1/1/06,Hide,Hide,1,2006,8915,8915,9267,9267,1,352,352,0.037984245,0.037984245
FALSE,Sevier County,1/1/07,Hide,Hide,1,2007,9287,9287,9518,9518,1,231,231,0.024269805,0.024269805
FALSE,Sevier County,1/1/08,Hide,Hide,1,2008,9255,9255,9545,9545,1,290,290,0.030382399,0.030382399
FALSE,Sevier County,1/1/09,Hide,Hide,1,2009,9119,9119,9776,9776,1,657,657,0.067205401,0.067205401
FALSE,Sevier County,1/1/10,Hide,Hide,1,2010,8943,8943,9784,9784,1,841,841,0.085956664,0.085956664
FALSE,Sevier County,1/1/11,Hide,Hide,1,2011,8787,8787,9568,9568,1,781,781,0.081626254,0.081626254
FALSE,Sevier County,1/1/12,Hide,Hide,1,2012,8870,8870,9479,9479,1,609,609,0.064247283,0.064247283
FALSE,Sevier County,1/1/13,Hide,Hide,1,2013,8816,8816,9363,9363,1,547,547,0.058421446,0.058421446
FALSE,Sevier County,1/1/14,Hide,Hide,1,2014,8837,8837,9271,9271,1,434,434,0.046812642,0.046812642
FALSE,Sevier County,1/1/15,Hide,Hide,1,2015,9047,9047,9461,9461,1,414,414,0.043758588,0.043758588
FALSE,Sevier County,1/1/16,Hide,Hide,1,2016,9058,9058,9488,9488,1,430,430,0.045320405,0.045320405
FALSE,Sevier County,1/1/17,Hide,Hide,1,2017,9274,9274,9670,9670,1,396,396,0.040951396,0.040951396
FALSE,Sevier County,1/1/18,Hide,Hide,1,2018,9485,9485,9847,9847,1,362,362,0.036762466,0.036762466
FALSE,Sevier County,1/1/19,Hide,Hide,1,2019,9464,9464,9793,9793,1,329,329,0.033595425,0.033595425
FALSE,Sevier County,1/1/20,Hide,Hide,1,2020,9473,9473,9757,9757,1,284,284,0.029107308,0.029107308
FALSE,State of Utah,1/1/93,Hide,Hide,1,1993,872309,872309,913903,913903,1,41594,41594,0.045512489,0.045512489
FALSE,State of Utah,1/1/94,Hide,Hide,1,1994,936406,936406,971968,971968,1,35562,35562,0.036587624,0.036587624
FALSE,State of Utah,1/1/95,Hide,Hide,1,1995,966947,966947,1004691,1004691,1,37744,37744,0.03756777,0.03756777
FALSE,State of Utah,1/1/96,Hide,Hide,1,1996,990481,990481,1025002,1025002,1,34521,34521,0.033678959,0.033678959
FALSE,State of Utah,1/1/97,Hide,Hide,1,1997,1021888,1021888,1056500,1056500,1,34612,34612,0.032761003,0.032761003
FALSE,State of Utah,1/1/98,Hide,Hide,1,1998,1049289,1049289,1086799,1086799,1,37510,37510,0.034514202,0.034514202
FALSE,State of Utah,1/1/99,Hide,Hide,1,1999,1073508,1073508,1114321,1114321,1,40813,40813,0.036625891,0.036625891
FALSE,State of Utah,1/1/00,Hide,Hide,1,2000,1093326,1093326,1128581,1128581,1,35255,35255,0.031238343,0.031238343
FALSE,State of Utah,1/1/01,Hide,Hide,1,2001,1113703,1113703,1158246,1158246,1,44543,44543,0.038457288,0.038457288
FALSE,State of Utah,1/1/02,Hide,Hide,1,2002,1113397,1113397,1176650,1176650,1,63253,63253,0.053756852,0.053756852
FALSE,State of Utah,1/1/03,Hide,Hide,1,2003,1121384,1121384,1191676,1191676,1,70292,70292,0.058985832,0.058985832
FALSE,State of Utah,1/1/04,Hide,Hide,1,2004,1150676,1150676,1215641,1215641,1,64965,64965,0.053440942,0.053440942
FALSE,State of Utah,1/1/05,Hide,Hide,1,2005,1194307,1194307,1249758,1249758,1,55451,55451,0.04436939,0.04436939
FALSE,State of Utah,1/1/06,Hide,Hide,1,2006,1251363,1251363,1297394,1297394,1,46031,46031,0.035479584,0.035479584
FALSE,State of Utah,1/1/07,Hide,Hide,1,2007,1310570,1310570,1342842,1342842,1,32272,32272,0.024032611,0.024032611
FALSE,State of Utah,1/1/08,Hide,Hide,1,2008,1331021,1331021,1371668,1371668,1,40647,40647,0.029633264,0.029633264
FALSE,State of Utah,1/1/09,Hide,Hide,1,2009,1294880,1294880,1380586,1380586,1,85706,85706,0.062079436,0.062079436
FALSE,State of Utah,1/1/10,Hide,Hide,1,2010,1247979,1247979,1355042,1355042,1,107063,107063,0.079010835,0.079010835
FALSE,State of Utah,1/1/11,Hide,Hide,1,2011,1251698,1251698,1352758,1352758,1,101060,101060,0.074706636,0.074706636
FALSE,State of Utah,1/1/12,Hide,Hide,1,2012,1277412,1277412,1357156,1357156,1,79744,79744,0.058758168,0.058758168
FALSE,State of Utah,1/1/13,Hide,Hide,1,2013,1322501,1322501,1391627,1391627,1,69126,69126,0.049672793,0.049672793
FALSE,State of Utah,1/1/14,Hide,Hide,1,2014,1361596,1361596,1419160,1419160,1,57564,57564,0.040562023,0.040562023
FALSE,State of Utah,1/1/15,Hide,Hide,1,2015,1391544,1391544,1443741,1443741,1,52197,52197,0.036153992,0.036153992
FALSE,State of Utah,1/1/16,Hide,Hide,1,2016,1428964,1428964,1482367,1482367,1,53403,53403,0.036025492,0.036025492
FALSE,State of Utah,1/1/17,Hide,Hide,1,2017,1481112,1481112,1531884,1531884,1,50772,50772,0.033143502,0.033143502
FALSE,State of Utah,1/1/18,Hide,Hide,1,2018,1514390,1514390,1562805,1562805,1,48415,48415,0.030979553,0.030979553
FALSE,State of Utah,1/1/19,Hide,Hide,1,2019,1532394,1532394,1581779,1581779,1,49385,49385,0.031221176,0.031221176
FALSE,State of Utah,1/1/20,Hide,Hide,1,2020,1586763,1586763,1626802,1626802,1,40039,40039,0.024612092,0.024612092
FALSE,Summit County,1/1/93,Hide,Hide,1,1993,9332,9332,9926,9926,1,594,594,0.059842837,0.059842837
FALSE,Summit County,1/1/94,Hide,Hide,1,1994,10424,10424,10913,10913,1,489,489,0.044808943,0.044808943
FALSE,Summit County,1/1/95,Hide,Hide,1,1995,11344,11344,11837,11837,1,493,493,0.041649066,0.041649066
FALSE,Summit County,1/1/96,Hide,Hide,1,1996,11871,11871,12342,12342,1,471,471,0.038162372,0.038162372
FALSE,Summit County,1/1/97,Hide,Hide,1,1997,12727,12727,13155,13155,1,428,428,0.032535158,0.032535158
FALSE,Summit County,1/1/98,Hide,Hide,1,1998,13458,13458,14045,14045,1,587,587,0.041794233,0.041794233
FALSE,Summit County,1/1/99,Hide,Hide,1,1999,14031,14031,14675,14675,1,644,644,0.043884157,0.043884157
FALSE,Summit County,1/1/00,Hide,Hide,1,2000,15729,15729,16336,16336,1,607,607,0.037157199,0.037157199
FALSE,Summit County,1/1/01,Hide,Hide,1,2001,17691,17691,18388,18388,1,697,697,0.037905156,0.037905156
FALSE,Summit County,1/1/02,Hide,Hide,1,2002,18023,18023,19262,19262,1,1239,1239,0.064323539,0.064323539
FALSE,Summit County,1/1/03,Hide,Hide,1,2003,18281,18281,19549,19549,1,1268,1268,0.064862653,0.064862653
FALSE,Summit County,1/1/04,Hide,Hide,1,2004,18992,18992,20145,20145,1,1153,1153,0.057235046,0.057235046
FALSE,Summit County,1/1/05,Hide,Hide,1,2005,20014,20014,20945,20945,1,931,931,0.044449749,0.044449749
FALSE,Summit County,1/1/06,Hide,Hide,1,2006,20823,20823,21561,21561,1,738,738,0.034228468,0.034228468
FALSE,Summit County,1/1/07,Hide,Hide,1,2007,21327,21327,21841,21841,1,514,514,0.023533721,0.023533721
FALSE,Summit County,1/1/08,Hide,Hide,1,2008,21207,21207,21817,21817,1,610,610,0.027959848,0.027959848
FALSE,Summit County,1/1/09,Hide,Hide,1,2009,20482,20482,21661,21661,1,1179,1179,0.05442962,0.05442962
FALSE,Summit County,1/1/10,Hide,Hide,1,2010,20439,20439,22010,22010,1,1571,1571,0.071376647,0.071376647
FALSE,Summit County,1/1/11,Hide,Hide,1,2011,20124,20124,21583,21583,1,1459,1459,0.0675995,0.0675995
FALSE,Summit County,1/1/12,Hide,Hide,1,2012,20317,20317,21439,21439,1,1122,1122,0.052334531,0.052334531
FALSE,Summit County,1/1/13,Hide,Hide,1,2013,20939,20939,21958,21958,1,1019,1019,0.046406777,0.046406777
FALSE,Summit County,1/1/14,Hide,Hide,1,2014,21515,21515,22350,22350,1,835,835,0.037360179,0.037360179
FALSE,Summit County,1/1/15,Hide,Hide,1,2015,21917,21917,22667,22667,1,750,750,0.033087749,0.033087749
FALSE,Summit County,1/1/16,Hide,Hide,1,2016,22724,22724,23490,23490,1,766,766,0.032609621,0.032609621
FALSE,Summit County,1/1/17,Hide,Hide,1,2017,23524,23524,24283,24283,1,759,759,0.031256435,0.031256435
FALSE,Summit County,1/1/18,Hide,Hide,1,2018,23523,23523,24255,24255,1,732,732,0.030179344,0.030179344
FALSE,Summit County,1/1/19,Hide,Hide,1,2019,24078,24078,24753,24753,1,675,675,0.027269422,0.027269422
FALSE,Summit County,1/1/20,Hide,Hide,1,2020,25006,25006,25603,25603,1,597,597,0.02331758,0.02331758
FALSE,Tooele County,1/1/93,Hide,Hide,1,1993,11601,11601,12436,12436,1,835,835,0.067143776,0.067143776
FALSE,Tooele County,1/1/94,Hide,Hide,1,1994,11160,11160,11778,11778,1,618,618,0.052470708,0.052470708
FALSE,Tooele County,1/1/95,Hide,Hide,1,1995,10896,10896,11562,11562,1,666,666,0.057602491,0.057602491
FALSE,Tooele County,1/1/96,Hide,Hide,1,1996,10910,10910,11510,11510,1,600,600,0.052128584,0.052128584
FALSE,Tooele County,1/1/97,Hide,Hide,1,1997,11183,11183,11752,11752,1,569,569,0.048417291,0.048417291
FALSE,Tooele County,1/1/98,Hide,Hide,1,1998,11238,11238,11780,11780,1,542,542,0.046010187,0.046010187
FALSE,Tooele County,1/1/99,Hide,Hide,1,1999,11394,11394,12035,12035,1,641,641,0.053261321,0.053261321
FALSE,Tooele County,1/1/00,Hide,Hide,1,2000,16131,16131,16793,16793,1,662,662,0.039421187,0.039421187
FALSE,Tooele County,1/1/01,Hide,Hide,1,2001,20199,20199,21073,21073,1,874,874,0.041474873,0.041474873
FALSE,Tooele County,1/1/02,Hide,Hide,1,2002,20651,20651,21917,21917,1,1266,1266,0.05776338,0.05776338
FALSE,Tooele County,1/1/03,Hide,Hide,1,2003,21201,21201,22707,22707,1,1506,1506,0.06632316,0.06632316
FALSE,Tooele County,1/1/04,Hide,Hide,1,2004,22191,22191,23549,23549,1,1358,1358,0.057666992,0.057666992
FALSE,Tooele County,1/1/05,Hide,Hide,1,2005,23379,23379,24550,24550,1,1171,1171,0.047698574,0.047698574
FALSE,Tooele County,1/1/06,Hide,Hide,1,2006,24812,24812,25818,25818,1,1006,1006,0.038965063,0.038965063
FALSE,Tooele County,1/1/07,Hide,Hide,1,2007,25890,25890,26582,26582,1,692,692,0.026032654,0.026032654
FALSE,Tooele County,1/1/08,Hide,Hide,1,2008,26776,26776,27649,27649,1,873,873,0.031574379,0.031574379
FALSE,Tooele County,1/1/09,Hide,Hide,1,2009,26488,26488,28269,28269,1,1781,1781,0.063001875,0.063001875
FALSE,Tooele County,1/1/10,Hide,Hide,1,2010,25264,25264,27640,27640,1,2376,2376,0.085962373,0.085962373
FALSE,Tooele County,1/1/11,Hide,Hide,1,2011,25184,25184,27333,27333,1,2149,2149,0.07862291,0.07862291
FALSE,Tooele County,1/1/12,Hide,Hide,1,2012,25616,25616,27337,27337,1,1721,1721,0.062954969,0.062954969
FALSE,Tooele County,1/1/13,Hide,Hide,1,2013,26553,26553,28142,28142,1,1589,1589,0.056463649,0.056463649
FALSE,Tooele County,1/1/14,Hide,Hide,1,2014,27319,27319,28799,28799,1,1480,1480,0.051390673,0.051390673
FALSE,Tooele County,1/1/15,Hide,Hide,1,2015,27883,27883,29148,29148,1,1265,1265,0.043399204,0.043399204
FALSE,Tooele County,1/1/16,Hide,Hide,1,2016,28878,28878,30094,30094,1,1216,1216,0.040406726,0.040406726
FALSE,Tooele County,1/1/17,Hide,Hide,1,2017,30435,30435,31584,31584,1,1149,1149,0.036379179,0.036379179
FALSE,Tooele County,1/1/18,Hide,Hide,1,2018,31527,31527,32634,32634,1,1107,1107,0.033921677,0.033921677
FALSE,Tooele County,1/1/19,Hide,Hide,1,2019,32371,32371,33463,33463,1,1092,1092,0.032633057,0.032633057
FALSE,Tooele County,1/1/20,Hide,Hide,1,2020,33593,33593,34512,34512,1,919,919,0.026628419,0.026628419
FALSE,Uintah County,1/1/93,Hide,Hide,1,1993,9120,9120,9872,9872,1,752,752,0.076175041,0.076175041
FALSE,Uintah County,1/1/94,Hide,Hide,1,1994,9426,9426,10156,10156,1,730,730,0.071878692,0.071878692
FALSE,Uintah County,1/1/95,Hide,Hide,1,1995,9671,9671,10390,10390,1,719,719,0.069201155,0.069201155
FALSE,Uintah County,1/1/96,Hide,Hide,1,1996,9422,9422,10168,10168,1,746,746,0.073367427,0.073367427
FALSE,Uintah County,1/1/97,Hide,Hide,1,1997,9756,9756,10416,10416,1,660,660,0.063364055,0.063364055
FALSE,Uintah County,1/1/98,Hide,Hide,1,1998,10241,10241,10782,10782,1,541,541,0.05017622,0.05017622
FALSE,Uintah County,1/1/99,Hide,Hide,1,1999,10218,10218,11074,11074,1,856,856,0.077298176,0.077298176
FALSE,Uintah County,1/1/00,Hide,Hide,1,2000,10707,10707,11204,11204,1,497,497,0.044359157,0.044359157
FALSE,Uintah County,1/1/01,Hide,Hide,1,2001,11362,11362,11869,11869,1,507,507,0.04271632,0.04271632
FALSE,Uintah County,1/1/02,Hide,Hide,1,2002,11839,11839,12516,12516,1,677,677,0.054090764,0.054090764
FALSE,Uintah County,1/1/03,Hide,Hide,1,2003,12138,12138,12941,12941,1,803,803,0.062050846,0.062050846
FALSE,Uintah County,1/1/04,Hide,Hide,1,2004,12665,12665,13402,13402,1,737,737,0.054991792,0.054991792
FALSE,Uintah County,1/1/05,Hide,Hide,1,2005,13501,13501,14108,14108,1,607,607,0.043025234,0.043025234
FALSE,Uintah County,1/1/06,Hide,Hide,1,2006,15108,15108,15578,15578,1,470,470,0.030170754,0.030170754
FALSE,Uintah County,1/1/07,Hide,Hide,1,2007,16707,16707,17033,17033,1,326,326,0.019139318,0.019139318
FALSE,Uintah County,1/1/08,Hide,Hide,1,2008,17080,17080,17485,17485,1,405,405,0.023162711,0.023162711
FALSE,Uintah County,1/1/09,Hide,Hide,1,2009,18121,18121,18945,18945,1,824,824,0.043494326,0.043494326
FALSE,Uintah County,1/1/10,Hide,Hide,1,2010,14277,14277,15797,15797,1,1520,1520,0.096220801,0.096220801
FALSE,Uintah County,1/1/11,Hide,Hide,1,2011,14296,14296,15406,15406,1,1110,1110,0.072049851,0.072049851
FALSE,Uintah County,1/1/12,Hide,Hide,1,2012,15138,15138,15900,15900,1,762,762,0.047924528,0.047924528
FALSE,Uintah County,1/1/13,Hide,Hide,1,2013,15097,15097,15832,15832,1,735,735,0.046424962,0.046424962
FALSE,Uintah County,1/1/14,Hide,Hide,1,2014,15141,15141,15743,15743,1,602,602,0.038239217,0.038239217
FALSE,Uintah County,1/1/15,Hide,Hide,1,2015,15364,15364,16092,16092,1,728,728,0.045239871,0.045239871
FALSE,Uintah County,1/1/16,Hide,Hide,1,2016,13181,13181,14525,14525,1,1344,1344,0.09253012,0.09253012
FALSE,Uintah County,1/1/17,Hide,Hide,1,2017,12618,12618,13647,13647,1,1029,1029,0.075401187,0.075401187
FALSE,Uintah County,1/1/18,Hide,Hide,1,2018,12997,12997,13673,13673,1,676,676,0.049440503,0.049440503
FALSE,Uintah County,1/1/19,Hide,Hide,1,2019,13017,13017,13596,13596,1,579,579,0.042586055,0.042586055
FALSE,Uintah County,1/1/20,Hide,Hide,1,2020,13160,13160,13815,13815,1,655,655,0.047412233,0.047412233
FALSE,United States,1/1/93,Hide,Hide,1,1993,119075,119075000,128400,128400000,1,9325,9325000,0.073,0.073
FALSE,United States,1/1/94,Hide,Hide,1,1994,121966,121966000,130596,130596000,1,8630,8630000,0.066,0.066
FALSE,United States,1/1/95,Hide,Hide,1,1995,124663,124663000,132038,132038000,1,7375,7375000,0.056,0.056
FALSE,United States,1/1/96,Hide,Hide,1,1996,125125,125125000,132616,132616000,1,7491,7491000,0.056,0.056
FALSE,United States,1/1/97,Hide,Hide,1,1997,128298,128298000,135456,135456000,1,7158,7158000,0.053,0.053
FALSE,United States,1/1/98,Hide,Hide,1,1998,130726,130726000,137095,137095000,1,6368,6368000,0.046,0.046
FALSE,United States,1/1/99,Hide,Hide,1,1999,133027,133027000,139003,139003000,1,5976,5976000,0.043,0.043
FALSE,United States,1/1/00,Hide,Hide,1,2000,136559,136559000,142267,142267000,1,5708,5708000,0.04,0.04
FALSE,United States,1/1/01,Hide,Hide,1,2001,137778,137778000,143800,143800000,1,6023,6023000,0.042,0.042
FALSE,United States,1/1/02,Hide,Hide,1,2002,135701,135701000,143883,143883000,1,8182,8182000,0.057,0.057
FALSE,United States,1/1/03,Hide,Hide,1,2003,137417,137417000,145937,145937000,1,8520,8520000,0.058,0.058
FALSE,United States,1/1/04,Hide,Hide,1,2004,138472,138472000,146842,146842000,1,8370,8370000,0.057,0.057
FALSE,United States,1/1/05,Hide,Hide,1,2005,140245,140245000,148029,148029000,1,7784,7784000,0.053,0.053
FALSE,United States,1/1/06,Hide,Hide,1,2006,143150,143150000,150214,150214000,1,7064,7064000,0.047,0.047
FALSE,United States,1/1/07,Hide,Hide,1,2007,146028,146028000,153144,153144000,1,7116,7116000,0.046,0.046
FALSE,United States,1/1/08,Hide,Hide,1,2008,146378,146378000,154063,154063000,1,7685,7685000,0.05,0.05
FALSE,United States,1/1/09,Hide,Hide,1,2009,142152,142152000,154210,154210000,1,12058,12058000,0.078,0.078
FALSE,United States,1/1/10,Hide,Hide,1,2010,138438,138438000,153484,153484000,1,15046,15046000,0.098,0.098
FALSE,United States,1/1/11,Hide,Hide,1,2011,139250,139250000,153263,153263000,1,14013,14013000,0.091,0.091
FALSE,United States,1/1/12,Hide,Hide,1,2012,141584,141584000,154381,154381000,1,12797,12797000,0.083,0.083
FALSE,United States,1/1/13,Hide,Hide,1,2013,143292,143292000,155763,155763000,1,12471,12471000,0.08,0.08
FALSE,United States,1/1/14,Hide,Hide,1,2014,145150,145150000,155352,155352000,1,10202,10202000,0.066,0.066
FALSE,United States,1/1/15,Hide,Hide,1,2015,148145,148145000,157030,157030000,1,8885,8885000,0.057,0.057
FALSE,United States,1/1/16,Hide,Hide,1,2016,150621,150621000,158342,158342000,1,7721,7721000,0.049,0.049
FALSE,United States,1/1/17,Hide,Hide,1,2017,152129,152129000,159647,159647000,1,7518,7518000,0.047,0.047
FALSE,United States,1/1/18,Hide,Hide,1,2018,154486,154486000,161068,161068000,1,6582,6582000,0.041,0.041
FALSE,United States,1/1/19,Hide,Hide,1,2019,156627,156627000,163142,163142000,1,6516,6516000,0.04,0.04
FALSE,United States,1/1/20,Hide,Hide,1,2020,158714,158714000,164606,164606000,1,5892,5892000,0.035794564,0.035794564
FALSE,Utah County,1/1/93,Hide,Hide,1,1993,127306,127306,132523,132523,1,5217,5217,0.039366751,0.039366751
FALSE,Utah County,1/1/94,Hide,Hide,1,1994,137716,137716,142122,142122,1,4406,4406,0.031001534,0.031001534
FALSE,Utah County,1/1/95,Hide,Hide,1,1995,141623,141623,146136,146136,1,4513,4513,0.030882192,0.030882192
FALSE,Utah County,1/1/96,Hide,Hide,1,1996,148507,148507,152633,152633,1,4126,4126,0.027032162,0.027032162
FALSE,Utah County,1/1/97,Hide,Hide,1,1997,152389,152389,156748,156748,1,4359,4359,0.027808967,0.027808967
FALSE,Utah County,1/1/98,Hide,Hide,1,1998,156394,156394,160981,160981,1,4587,4587,0.028494046,0.028494046
FALSE,Utah County,1/1/99,Hide,Hide,1,1999,163109,163109,168621,168621,1,5512,5512,0.032688692,0.032688692
FALSE,Utah County,1/1/00,Hide,Hide,1,2000,171697,171697,176302,176302,1,4605,4605,0.026119953,0.026119953
FALSE,Utah County,1/1/01,Hide,Hide,1,2001,177407,177407,183478,183478,1,6071,6071,0.033088436,0.033088436
FALSE,Utah County,1/1/02,Hide,Hide,1,2002,173899,173899,184084,184084,1,10185,10185,0.055328002,0.055328002
FALSE,Utah County,1/1/03,Hide,Hide,1,2003,176747,176747,187441,187441,1,10694,10694,0.057052619,0.057052619
FALSE,Utah County,1/1/04,Hide,Hide,1,2004,183180,183180,192900,192900,1,9720,9720,0.050388802,0.050388802
FALSE,Utah County,1/1/05,Hide,Hide,1,2005,192511,192511,200904,200904,1,8393,8393,0.041776172,0.041776172
FALSE,Utah County,1/1/06,Hide,Hide,1,2006,202952,202952,210048,210048,1,7096,7096,0.033782754,0.033782754
FALSE,Utah County,1/1/07,Hide,Hide,1,2007,215207,215207,220207,220207,1,5000,5000,0.022705909,0.022705909
FALSE,Utah County,1/1/08,Hide,Hide,1,2008,217735,217735,224261,224261,1,6526,6526,0.029100022,0.029100022
FALSE,Utah County,1/1/09,Hide,Hide,1,2009,210493,210493,223262,223262,1,12769,12769,0.057192894,0.057192894
FALSE,Utah County,1/1/10,Hide,Hide,1,2010,208964,208964,225935,225935,1,16971,16971,0.075114524,0.075114524
FALSE,Utah County,1/1/11,Hide,Hide,1,2011,213611,213611,229891,229891,1,16280,16280,0.070816169,0.070816169
FALSE,Utah County,1/1/12,Hide,Hide,1,2012,220901,220901,233464,233464,1,12563,12563,0.053811294,0.053811294
FALSE,Utah County,1/1/13,Hide,Hide,1,2013,233113,233113,244334,244334,1,11221,11221,0.045924841,0.045924841
FALSE,Utah County,1/1/14,Hide,Hide,1,2014,242489,242489,252072,252072,1,9583,9583,0.038016916,0.038016916
FALSE,Utah County,1/1/15,Hide,Hide,1,2015,251671,251671,260189,260189,1,8518,8518,0.032737741,0.032737741
FALSE,Utah County,1/1/16,Hide,Hide,1,2016,263840,263840,272518,272518,1,8678,8678,0.031843768,0.031843768
FALSE,Utah County,1/1/17,Hide,Hide,1,2017,276947,276947,285550,285550,1,8603,8603,0.030127823,0.030127823
FALSE,Utah County,1/1/18,Hide,Hide,1,2018,288079,288079,296407,296407,1,8328,8328,0.028096502,0.028096502
FALSE,Utah County,1/1/19,Hide,Hide,1,2019,295088,295088,303050,303050,1,7962,7962,0.026272892,0.026272892
FALSE,Utah County,1/1/20,Hide,Hide,1,2020,306051,306051,313186,313186,1,7135,7135,0.022781989,0.022781989
FALSE,Wasatch County,1/1/93,Hide,Hide,1,1993,4620,4620,4949,4949,1,329,329,0.066478076,0.066478076
FALSE,Wasatch County,1/1/94,Hide,Hide,1,1994,4933,4933,5219,5219,1,286,286,0.05479977,0.05479977
FALSE,Wasatch County,1/1/95,Hide,Hide,1,1995,5146,5146,5458,5458,1,312,312,0.057163796,0.057163796
FALSE,Wasatch County,1/1/96,Hide,Hide,1,1996,5240,5240,5483,5483,1,243,243,0.044318804,0.044318804
FALSE,Wasatch County,1/1/97,Hide,Hide,1,1997,5576,5576,5809,5809,1,233,233,0.040110174,0.040110174
FALSE,Wasatch County,1/1/98,Hide,Hide,1,1998,5863,5863,6153,6153,1,290,290,0.047131481,0.047131481
FALSE,Wasatch County,1/1/99,Hide,Hide,1,1999,6147,6147,6431,6431,1,284,284,0.044161095,0.044161095
FALSE,Wasatch County,1/1/00,Hide,Hide,1,2000,6724,6724,6971,6971,1,247,247,0.035432506,0.035432506
FALSE,Wasatch County,1/1/01,Hide,Hide,1,2001,7307,7307,7632,7632,1,325,325,0.042583857,0.042583857
FALSE,Wasatch County,1/1/02,Hide,Hide,1,2002,7635,7635,8118,8118,1,483,483,0.059497413,0.059497413
FALSE,Wasatch County,1/1/03,Hide,Hide,1,2003,7714,7714,8235,8235,1,521,521,0.063266545,0.063266545
FALSE,Wasatch County,1/1/04,Hide,Hide,1,2004,8070,8070,8584,8584,1,514,514,0.059878844,0.059878844
FALSE,Wasatch County,1/1/05,Hide,Hide,1,2005,8666,8666,9075,9075,1,409,409,0.045068871,0.045068871
FALSE,Wasatch County,1/1/06,Hide,Hide,1,2006,9344,9344,9691,9691,1,347,347,0.035806418,0.035806418
FALSE,Wasatch County,1/1/07,Hide,Hide,1,2007,10244,10244,10501,10501,1,257,257,0.02447386,0.02447386
FALSE,Wasatch County,1/1/08,Hide,Hide,1,2008,10315,10315,10633,10633,1,318,318,0.029906894,0.029906894
FALSE,Wasatch County,1/1/09,Hide,Hide,1,2009,9358,9358,10018,10018,1,660,660,0.065881413,0.065881413
FALSE,Wasatch County,1/1/10,Hide,Hide,1,2010,9902,9902,10836,10836,1,934,934,0.086194168,0.086194168
FALSE,Wasatch County,1/1/11,Hide,Hide,1,2011,10611,10611,11498,11498,1,887,887,0.077143851,0.077143851
FALSE,Wasatch County,1/1/12,Hide,Hide,1,2012,10787,10787,11498,11498,1,711,711,0.061836841,0.061836841
FALSE,Wasatch County,1/1/13,Hide,Hide,1,2013,11391,11391,12008,12008,1,617,617,0.051382412,0.051382412
FALSE,Wasatch County,1/1/14,Hide,Hide,1,2014,12053,12053,12577,12577,1,524,524,0.041663354,0.041663354
FALSE,Wasatch County,1/1/15,Hide,Hide,1,2015,12448,12448,12897,12897,1,449,449,0.034814298,0.034814298
FALSE,Wasatch County,1/1/16,Hide,Hide,1,2016,13095,13095,13585,13585,1,490,490,0.036069194,0.036069194
FALSE,Wasatch County,1/1/17,Hide,Hide,1,2017,13788,13788,14263,14263,1,475,475,0.033302952,0.033302952
FALSE,Wasatch County,1/1/18,Hide,Hide,1,2018,14363,14363,14825,14825,1,462,462,0.031163575,0.031163575
FALSE,Wasatch County,1/1/19,Hide,Hide,1,2019,15173,15173,15634,15634,1,461,461,0.029487015,0.029487015
FALSE,Wasatch County,1/1/20,Hide,Hide,1,2020,16298,16298,16729,16729,1,431,431,0.025763644,0.025763644
FALSE,Washington County,1/1/93,Hide,Hide,1,1993,23184,23184,24187,24187,1,1003,1003,0.041468557,0.041468557
FALSE,Washington County,1/1/94,Hide,Hide,1,1994,27925,27925,28766,28766,1,841,841,0.029235903,0.029235903
FALSE,Washington County,1/1/95,Hide,Hide,1,1995,30774,30774,31802,31802,1,1028,1028,0.032325011,0.032325011
FALSE,Washington County,1/1/96,Hide,Hide,1,1996,32936,32936,34077,34077,1,1141,1141,0.033482994,0.033482994
FALSE,Washington County,1/1/97,Hide,Hide,1,1997,33675,33675,34931,34931,1,1256,1256,0.0359566,0.0359566
FALSE,Washington County,1/1/98,Hide,Hide,1,1998,35078,35078,36279,36279,1,1201,1201,0.033104551,0.033104551
FALSE,Washington County,1/1/99,Hide,Hide,1,1999,37038,37038,38430,38430,1,1392,1392,0.036221702,0.036221702
FALSE,Washington County,1/1/00,Hide,Hide,1,2000,37586,37586,38886,38886,1,1300,1300,0.033431055,0.033431055
FALSE,Washington County,1/1/01,Hide,Hide,1,2001,39229,39229,40833,40833,1,1604,1604,0.039281953,0.039281953
FALSE,Washington County,1/1/02,Hide,Hide,1,2002,41086,41086,43144,43144,1,2058,2058,0.047700723,0.047700723
FALSE,Washington County,1/1/03,Hide,Hide,1,2003,43663,43663,46233,46233,1,2570,2570,0.055588,0.055588
FALSE,Washington County,1/1/04,Hide,Hide,1,2004,47367,47367,49919,49919,1,2552,2552,0.051122819,0.051122819
FALSE,Washington County,1/1/05,Hide,Hide,1,2005,52227,52227,54579,54579,1,2352,2352,0.043093497,0.043093497
FALSE,Washington County,1/1/06,Hide,Hide,1,2006,57739,57739,59784,59784,1,2045,2045,0.034206477,0.034206477
FALSE,Washington County,1/1/07,Hide,Hide,1,2007,60777,60777,62411,62411,1,1634,1634,0.026181282,0.026181282
FALSE,Washington County,1/1/08,Hide,Hide,1,2008,61703,61703,63826,63826,1,2123,2123,0.033262307,0.033262307
FALSE,Washington County,1/1/09,Hide,Hide,1,2009,55921,55921,60857,60857,1,4936,4936,0.081108172,0.081108172
FALSE,Washington County,1/1/10,Hide,Hide,1,2010,51647,51647,57677,57677,1,6030,6030,0.10454774,0.10454774
FALSE,Washington County,1/1/11,Hide,Hide,1,2011,50496,50496,56051,56051,1,5555,5555,0.099106171,0.099106171
FALSE,Washington County,1/1/12,Hide,Hide,1,2012,52137,52137,56461,56461,1,4324,4324,0.076583837,0.076583837
FALSE,Washington County,1/1/13,Hide,Hide,1,2013,54542,54542,58141,58141,1,3599,3599,0.06190124,0.06190124
FALSE,Washington County,1/1/14,Hide,Hide,1,2014,57940,57940,60777,60777,1,2837,2837,0.046678842,0.046678842
FALSE,Washington County,1/1/15,Hide,Hide,1,2015,59954,59954,62602,62602,1,2648,2648,0.042298968,0.042298968
FALSE,Washington County,1/1/16,Hide,Hide,1,2016,62747,62747,65355,65355,1,2608,2608,0.039905134,0.039905134
FALSE,Washington County,1/1/17,Hide,Hide,1,2017,66757,66757,69205,69205,1,2448,2448,0.035373167,0.035373167
FALSE,Washington County,1/1/18,Hide,Hide,1,2018,70306,70306,72760,72760,1,2454,2454,0.033727323,0.033727323
FALSE,Washington County,1/1/19,Hide,Hide,1,2019,72709,72709,75134,75134,1,2425,2425,0.032275667,0.032275667
FALSE,Washington County,1/1/20,Hide,Hide,1,2020,75365,75365,77613,77613,1,2248,2248,0.02896422,0.02896422
FALSE,Wayne County,1/1/93,Hide,Hide,1,1993,972,972,1059,1059,1,87,87,0.082152975,0.082152975
FALSE,Wayne County,1/1/94,Hide,Hide,1,1994,1047,1047,1134,1134,1,87,87,0.076719577,0.076719577
FALSE,Wayne County,1/1/95,Hide,Hide,1,1995,1145,1145,1224,1224,1,79,79,0.064542484,0.064542484
FALSE,Wayne County,1/1/96,Hide,Hide,1,1996,1255,1255,1330,1330,1,75,75,0.056390977,0.056390977
FALSE,Wayne County,1/1/97,Hide,Hide,1,1997,1283,1283,1357,1357,1,74,74,0.054532056,0.054532056
FALSE,Wayne County,1/1/98,Hide,Hide,1,1998,1429,1429,1507,1507,1,78,78,0.051758461,0.051758461
FALSE,Wayne County,1/1/99,Hide,Hide,1,1999,1351,1351,1444,1444,1,93,93,0.064404432,0.064404432
FALSE,Wayne County,1/1/00,Hide,Hide,1,2000,1338,1338,1398,1398,1,60,60,0.042918455,0.042918455
FALSE,Wayne County,1/1/01,Hide,Hide,1,2001,1274,1274,1346,1346,1,72,72,0.053491828,0.053491828
FALSE,Wayne County,1/1/02,Hide,Hide,1,2002,1437,1437,1515,1515,1,78,78,0.051485149,0.051485149
FALSE,Wayne County,1/1/03,Hide,Hide,1,2003,1292,1292,1380,1380,1,88,88,0.063768116,0.063768116
FALSE,Wayne County,1/1/04,Hide,Hide,1,2004,1244,1244,1334,1334,1,90,90,0.067466267,0.067466267
FALSE,Wayne County,1/1/05,Hide,Hide,1,2005,1221,1221,1297,1297,1,76,76,0.058596762,0.058596762
FALSE,Wayne County,1/1/06,Hide,Hide,1,2006,1303,1303,1370,1370,1,67,67,0.048905109,0.048905109
FALSE,Wayne County,1/1/07,Hide,Hide,1,2007,1345,1345,1399,1399,1,54,54,0.038598999,0.038598999
FALSE,Wayne County,1/1/08,Hide,Hide,1,2008,1320,1320,1383,1383,1,63,63,0.045553145,0.045553145
FALSE,Wayne County,1/1/09,Hide,Hide,1,2009,1357,1357,1467,1467,1,110,110,0.074982958,0.074982958
FALSE,Wayne County,1/1/10,Hide,Hide,1,2010,1414,1414,1547,1547,1,133,133,0.085972851,0.085972851
FALSE,Wayne County,1/1/11,Hide,Hide,1,2011,1382,1382,1514,1514,1,132,132,0.087186262,0.087186262
FALSE,Wayne County,1/1/12,Hide,Hide,1,2012,1189,1189,1334,1334,1,145,145,0.108695652,0.108695652
FALSE,Wayne County,1/1/13,Hide,Hide,1,2013,1188,1188,1340,1340,1,152,152,0.113432836,0.113432836
FALSE,Wayne County,1/1/14,Hide,Hide,1,2014,1267,1267,1404,1404,1,137,137,0.097578348,0.097578348
FALSE,Wayne County,1/1/15,Hide,Hide,1,2015,1274,1274,1403,1403,1,129,129,0.09194583,0.09194583
FALSE,Wayne County,1/1/16,Hide,Hide,1,2016,1322,1322,1442,1442,1,120,120,0.083217753,0.083217753
FALSE,Wayne County,1/1/17,Hide,Hide,1,2017,1321,1321,1434,1434,1,113,113,0.078800558,0.078800558
FALSE,Wayne County,1/1/18,Hide,Hide,1,2018,1356,1356,1448,1448,1,92,92,0.063535912,0.063535912
FALSE,Wayne County,1/1/19,Hide,Hide,1,2019,1336,1336,1416,1416,1,80,80,0.056497175,0.056497175
FALSE,Wayne County,1/1/20,Hide,Hide,1,2020,1346,1346,1427,1427,1,81,81,0.056762439,0.056762439
FALSE,Weber County,1/1/93,Hide,Hide,1,1993,80773,80773,85662,85662,1,4889,4889,0.057073148,0.057073148
FALSE,Weber County,1/1/94,Hide,Hide,1,1994,86413,86413,90481,90481,1,4068,4068,0.044959715,0.044959715
FALSE,Weber County,1/1/95,Hide,Hide,1,1995,88088,88088,92261,92261,1,4173,4173,0.045230379,0.045230379
FALSE,Weber County,1/1/96,Hide,Hide,1,1996,90213,90213,94094,94094,1,3881,3881,0.041245988,0.041245988
FALSE,Weber County,1/1/97,Hide,Hide,1,1997,93713,93713,97601,97601,1,3888,3888,0.039835657,0.039835657
FALSE,Weber County,1/1/98,Hide,Hide,1,1998,95995,95995,100394,100394,1,4399,4399,0.04381736,0.04381736
FALSE,Weber County,1/1/99,Hide,Hide,1,1999,97958,97958,102521,102521,1,4563,4563,0.044507954,0.044507954
FALSE,Weber County,1/1/00,Hide,Hide,1,2000,97430,97430,101399,101399,1,3969,3969,0.039142398,0.039142398
FALSE,Weber County,1/1/01,Hide,Hide,1,2001,96460,96460,101464,101464,1,5004,5004,0.049317985,0.049317985
FALSE,Weber County,1/1/02,Hide,Hide,1,2002,96727,96727,102941,102941,1,6214,6214,0.060364675,0.060364675
FALSE,Weber County,1/1/03,Hide,Hide,1,2003,98061,98061,104909,104909,1,6848,6848,0.06527562,0.06527562
FALSE,Weber County,1/1/04,Hide,Hide,1,2004,100081,100081,106437,106437,1,6356,6356,0.059716076,0.059716076
FALSE,Weber County,1/1/05,Hide,Hide,1,2005,102143,102143,107497,107497,1,5354,5354,0.049806041,0.049806041
FALSE,Weber County,1/1/06,Hide,Hide,1,2006,104696,104696,109144,109144,1,4448,4448,0.0407535,0.0407535
FALSE,Weber County,1/1/07,Hide,Hide,1,2007,108361,108361,111424,111424,1,3063,3063,0.027489589,0.027489589
FALSE,Weber County,1/1/08,Hide,Hide,1,2008,109672,109672,113645,113645,1,3973,3973,0.034959743,0.034959743
FALSE,Weber County,1/1/09,Hide,Hide,1,2009,107209,107209,115253,115253,1,8044,8044,0.069794279,0.069794279
FALSE,Weber County,1/1/10,Hide,Hide,1,2010,103303,103303,113174,113174,1,9871,9871,0.087219679,0.087219679
FALSE,Weber County,1/1/11,Hide,Hide,1,2011,102928,102928,112360,112360,1,9432,9432,0.083944464,0.083944464
FALSE,Weber County,1/1/12,Hide,Hide,1,2012,104949,104949,112717,112717,1,7768,7768,0.068915958,0.068915958
FALSE,Weber County,1/1/13,Hide,Hide,1,2013,107371,107371,114010,114010,1,6639,6639,0.058231734,0.058231734
FALSE,Weber County,1/1/14,Hide,Hide,1,2014,109182,109182,114635,114635,1,5453,5453,0.047568369,0.047568369
FALSE,Weber County,1/1/15,Hide,Hide,1,2015,111235,111235,116045,116045,1,4810,4810,0.041449438,0.041449438
FALSE,Weber County,1/1/16,Hide,Hide,1,2016,113758,113758,118582,118582,1,4824,4824,0.04068071,0.04068071
FALSE,Weber County,1/1/17,Hide,Hide,1,2017,117603,117603,122107,122107,1,4504,4504,0.036885682,0.036885682
FALSE,Weber County,1/1/18,Hide,Hide,1,2018,119907,119907,124283,124283,1,4376,4376,0.035209964,0.035209964
FALSE,Weber County,1/1/19,Hide,Hide,1,2019,121934,121934,126202,126202,1,4268,4268,0.033818798,0.033818798
FALSE,Weber County,1/1/20,Hide,Hide,1,2020,125865,125865,129272,129272,1,3407,3407,0.026355282,0.026355282
FALSE,Beaver County,10/1/92,Hide,Hide,10,1992,1953,1953,2047,2047,1,94,94,0.04592086,0.04592086
FALSE,Beaver County,10/1/93,Hide,Hide,10,1993,2059,2059,2159,2159,1,100,100,0.04631774,0.04631774
FALSE,Beaver County,10/1/94,Hide,Hide,10,1994,2190,2190,2273,2273,1,83,83,0.036515618,0.036515618
FALSE,Beaver County,10/1/95,Hide,Hide,10,1995,2288,2288,2401,2401,1,113,113,0.047063723,0.047063723
FALSE,Beaver County,10/1/96,Hide,Hide,10,1996,2398,2398,2539,2539,1,141,141,0.055533675,0.055533675
FALSE,Beaver County,10/1/97,Hide,Hide,10,1997,2435,2435,2541,2541,1,106,106,0.04171586,0.04171586
FALSE,Beaver County,10/1/98,Hide,Hide,10,1998,2360,2360,2466,2466,1,106,106,0.04298459,0.04298459
FALSE,Beaver County,10/1/99,Hide,Hide,10,1999,2374,2374,2468,2468,1,94,94,0.03808752,0.03808752
FALSE,Beaver County,10/1/00,Hide,Hide,10,2000,2601,2601,2697,2697,1,96,96,0.035595106,0.035595106
FALSE,Beaver County,10/1/01,Hide,Hide,10,2001,3116,3116,3239,3239,1,123,123,0.037974684,0.037974684
FALSE,Beaver County,10/1/02,Hide,Hide,10,2002,2927,2927,3081,3081,1,154,154,0.049983772,0.049983772
FALSE,Beaver County,10/1/03,Hide,Hide,10,2003,2771,2771,2923,2923,1,152,152,0.052001368,0.052001368
FALSE,Beaver County,10/1/04,Hide,Hide,10,2004,2752,2752,2883,2883,1,131,131,0.045438779,0.045438779
FALSE,Beaver County,10/1/05,Hide,Hide,10,2005,2983,2983,3109,3109,1,126,126,0.040527501,0.040527501
FALSE,Beaver County,10/1/06,Hide,Hide,10,2006,3079,3079,3164,3164,1,85,85,0.026864728,0.026864728
FALSE,Beaver County,10/1/07,Hide,Hide,10,2007,3049,3049,3134,3134,1,85,85,0.027121889,0.027121889
FALSE,Beaver County,10/1/08,Hide,Hide,10,2008,3107,3107,3247,3247,1,140,140,0.043116723,0.043116723
FALSE,Beaver County,10/1/09,Hide,Hide,10,2009,3378,3378,3621,3621,1,243,243,0.067108534,0.067108534
FALSE,Beaver County,10/1/10,Hide,Hide,10,2010,2872,2872,3175,3175,1,303,303,0.095433071,0.095433071
FALSE,Beaver County,10/1/11,Hide,Hide,10,2011,2774,2774,2998,2998,1,224,224,0.074716478,0.074716478
FALSE,Beaver County,10/1/12,Hide,Hide,10,2012,2779,2779,2944,2944,1,165,165,0.056046196,0.056046196
FALSE,Beaver County,10/1/13,Hide,Hide,10,2013,2885,2885,3016,3016,1,131,131,0.043435013,0.043435013
FALSE,Beaver County,10/1/14,Hide,Hide,10,2014,2828,2828,2944,2944,1,116,116,0.039402174,0.039402174
FALSE,Beaver County,10/1/15,Hide,Hide,10,2015,2972,2972,3090,3090,1,118,118,0.038187702,0.038187702
FALSE,Beaver County,10/1/16,Hide,Hide,10,2016,2877,2877,3040,3040,1,163,163,0.053618421,0.053618421
FALSE,Beaver County,10/1/17,Hide,Hide,10,2017,2946,2946,3060,3060,1,114,114,0.037254902,0.037254902
FALSE,Beaver County,10/1/18,Hide,Hide,10,2018,2899,2899,2995,2995,1,96,96,0.032053422,0.032053422
FALSE,Beaver County,10/1/19,Hide,Hide,10,2019,2751,2751,2829,2829,1,78,78,0.02757158,0.02757158
FALSE,Box Elder County,10/1/92,Hide,Hide,10,1992,15191,15191,16104,16104,1,913,913,0.056693989,0.056693989
FALSE,Box Elder County,10/1/93,Hide,Hide,10,1993,16964,16964,17880,17880,1,916,916,0.051230425,0.051230425
FALSE,Box Elder County,10/1/94,Hide,Hide,10,1994,17372,17372,18252,18252,1,880,880,0.048213894,0.048213894
FALSE,Box Elder County,10/1/95,Hide,Hide,10,1995,16795,16795,17600,17600,1,805,805,0.045738636,0.045738636
FALSE,Box Elder County,10/1/96,Hide,Hide,10,1996,17460,17460,18199,18199,1,739,739,0.040606627,0.040606627
FALSE,Box Elder County,10/1/97,Hide,Hide,10,1997,18175,18175,18935,18935,1,760,760,0.040137312,0.040137312
FALSE,Box Elder County,10/1/98,Hide,Hide,10,1998,18417,18417,19315,19315,1,898,898,0.046492363,0.046492363
FALSE,Box Elder County,10/1/99,Hide,Hide,10,1999,17448,17448,18220,18220,1,772,772,0.042371021,0.042371021
FALSE,Box Elder County,10/1/00,Hide,Hide,10,2000,19406,19406,20187,20187,1,781,781,0.038688265,0.038688265
FALSE,Box Elder County,10/1/01,Hide,Hide,10,2001,20035,20035,21049,21049,1,1014,1014,0.04817331,0.04817331
FALSE,Box Elder County,10/1/02,Hide,Hide,10,2002,19850,19850,21076,21076,1,1226,1226,0.058170431,0.058170431
FALSE,Box Elder County,10/1/03,Hide,Hide,10,2003,20423,20423,21590,21590,1,1167,1167,0.054052802,0.054052802
FALSE,Box Elder County,10/1/04,Hide,Hide,10,2004,20704,20704,21777,21777,1,1073,1073,0.049272168,0.049272168
FALSE,Box Elder County,10/1/05,Hide,Hide,10,2005,21802,21802,22731,22731,1,929,929,0.040869297,0.040869297
FALSE,Box Elder County,10/1/06,Hide,Hide,10,2006,22308,22308,22956,22956,1,648,648,0.028227914,0.028227914
FALSE,Box Elder County,10/1/07,Hide,Hide,10,2007,22894,22894,23543,23543,1,649,649,0.02756658,0.02756658
FALSE,Box Elder County,10/1/08,Hide,Hide,10,2008,22541,22541,23813,23813,1,1272,1272,0.053416201,0.053416201
FALSE,Box Elder County,10/1/09,Hide,Hide,10,2009,21322,21322,23217,23217,1,1895,1895,0.081621226,0.081621226
FALSE,Box Elder County,10/1/10,Hide,Hide,10,2010,21649,21649,23701,23701,1,2052,2052,0.086578625,0.086578625
FALSE,Box Elder County,10/1/11,Hide,Hide,10,2011,21570,21570,23150,23150,1,1580,1580,0.06825054,0.06825054
FALSE,Box Elder County,10/1/12,Hide,Hide,10,2012,21760,21760,23016,23016,1,1256,1256,0.054570733,0.054570733
FALSE,Box Elder County,10/1/13,Hide,Hide,10,2013,22178,22178,23201,23201,1,1023,1023,0.044092927,0.044092927
FALSE,Box Elder County,10/1/14,Hide,Hide,10,2014,22620,22620,23534,23534,1,914,914,0.038837427,0.038837427
FALSE,Box Elder County,10/1/15,Hide,Hide,10,2015,23165,23165,24036,24036,1,871,871,0.036237311,0.036237311
FALSE,Box Elder County,10/1/16,Hide,Hide,10,2016,24079,24079,24930,24930,1,851,851,0.03413558,0.03413558
FALSE,Box Elder County,10/1/17,Hide,Hide,10,2017,24629,24629,25432,25432,1,803,803,0.031574394,0.031574394
FALSE,Box Elder County,10/1/18,Hide,Hide,10,2018,24712,24712,25459,25459,1,747,747,0.029341294,0.029341294
FALSE,Box Elder County,10/1/19,Hide,Hide,10,2019,25394,25394,26021,26021,1,627,627,0.024095923,0.024095923
FALSE,Cache County,10/1/92,Hide,Hide,10,1992,35458,35458,36684,36684,1,1226,1226,0.033420565,0.033420565
FALSE,Cache County,10/1/93,Hide,Hide,10,1993,38574,38574,39789,39789,1,1215,1215,0.030536078,0.030536078
FALSE,Cache County,10/1/94,Hide,Hide,10,1994,39937,39937,41241,41241,1,1304,1304,0.03161902,0.03161902
FALSE,Cache County,10/1/95,Hide,Hide,10,1995,40510,40510,41750,41750,1,1240,1240,0.029700599,0.029700599
FALSE,Cache County,10/1/96,Hide,Hide,10,1996,40891,40891,42082,42082,1,1191,1191,0.028301887,0.028301887
FALSE,Cache County,10/1/97,Hide,Hide,10,1997,42226,42226,43324,43324,1,1098,1098,0.02534392,0.02534392
FALSE,Cache County,10/1/98,Hide,Hide,10,1998,43742,43742,45100,45100,1,1358,1358,0.030110865,0.030110865
FALSE,Cache County,10/1/99,Hide,Hide,10,1999,44250,44250,45437,45437,1,1187,1187,0.026124084,0.026124084
FALSE,Cache County,10/1/00,Hide,Hide,10,2000,47408,47408,48834,48834,1,1426,1426,0.029200967,0.029200967
FALSE,Cache County,10/1/01,Hide,Hide,10,2001,49352,49352,51179,51179,1,1827,1827,0.035698236,0.035698236
FALSE,Cache County,10/1/02,Hide,Hide,10,2002,50716,50716,53026,53026,1,2310,2310,0.043563535,0.043563535
FALSE,Cache County,10/1/03,Hide,Hide,10,2003,52776,52776,54843,54843,1,2067,2067,0.037689404,0.037689404
FALSE,Cache County,10/1/04,Hide,Hide,10,2004,54227,54227,56261,56261,1,2034,2034,0.03615293,0.03615293
FALSE,Cache County,10/1/05,Hide,Hide,10,2005,55578,55578,57412,57412,1,1834,1834,0.031944541,0.031944541
FALSE,Cache County,10/1/06,Hide,Hide,10,2006,57461,57461,58690,58690,1,1229,1229,0.020940535,0.020940535
FALSE,Cache County,10/1/07,Hide,Hide,10,2007,59805,59805,61205,61205,1,1400,1400,0.022873948,0.022873948
FALSE,Cache County,10/1/08,Hide,Hide,10,2008,59396,59396,61447,61447,1,2051,2051,0.033378359,0.033378359
FALSE,Cache County,10/1/09,Hide,Hide,10,2009,58160,58160,61574,61574,1,3414,3414,0.05544548,0.05544548
FALSE,Cache County,10/1/10,Hide,Hide,10,2010,54126,54126,57600,57600,1,3474,3474,0.0603125,0.0603125
FALSE,Cache County,10/1/11,Hide,Hide,10,2011,53259,53259,56044,56044,1,2785,2785,0.049693098,0.049693098
FALSE,Cache County,10/1/12,Hide,Hide,10,2012,54612,54612,57076,57076,1,2464,2464,0.043170509,0.043170509
FALSE,Cache County,10/1/13,Hide,Hide,10,2013,56006,56006,58148,58148,1,2142,2142,0.036837037,0.036837037
FALSE,Cache County,10/1/14,Hide,Hide,10,2014,57300,57300,59193,59193,1,1893,1893,0.031980133,0.031980133
FALSE,Cache County,10/1/15,Hide,Hide,10,2015,58311,58311,60211,60211,1,1900,1900,0.031555696,0.031555696
FALSE,Cache County,10/1/16,Hide,Hide,10,2016,59809,59809,61612,61612,1,1803,1803,0.02926378,0.02926378
FALSE,Cache County,10/1/17,Hide,Hide,10,2017,61331,61331,63037,63037,1,1706,1706,0.027063471,0.027063471
FALSE,Cache County,10/1/18,Hide,Hide,10,2018,61953,61953,63605,63605,1,1652,1652,0.025972801,0.025972801
FALSE,Cache County,10/1/19,Hide,Hide,10,2019,63057,63057,64373,64373,1,1316,1316,0.020443354,0.020443354
FALSE,Carbon County,10/1/92,Hide,Hide,10,1992,8168,8168,8985,8985,1,817,817,0.090929327,0.090929327
FALSE,Carbon County,10/1/93,Hide,Hide,10,1993,8577,8577,9191,9191,1,614,614,0.066804483,0.066804483
FALSE,Carbon County,10/1/94,Hide,Hide,10,1994,8625,8625,9298,9298,1,673,673,0.072381157,0.072381157
FALSE,Carbon County,10/1/95,Hide,Hide,10,1995,8530,8530,9107,9107,1,577,577,0.063357857,0.063357857
FALSE,Carbon County,10/1/96,Hide,Hide,10,1996,8981,8981,9532,9532,1,551,551,0.057805287,0.057805287
FALSE,Carbon County,10/1/97,Hide,Hide,10,1997,9231,9231,9726,9726,1,495,495,0.05089451,0.05089451
FALSE,Carbon County,10/1/98,Hide,Hide,10,1998,9280,9280,9963,9963,1,683,683,0.068553648,0.068553648
FALSE,Carbon County,10/1/99,Hide,Hide,10,1999,9176,9176,9748,9748,1,572,572,0.058678703,0.058678703
FALSE,Carbon County,10/1/00,Hide,Hide,10,2000,8454,8454,9018,9018,1,564,564,0.062541583,0.062541583
FALSE,Carbon County,10/1/01,Hide,Hide,10,2001,8680,8680,9231,9231,1,551,551,0.059690174,0.059690174
FALSE,Carbon County,10/1/02,Hide,Hide,10,2002,8762,8762,9482,9482,1,720,720,0.075933347,0.075933347
FALSE,Carbon County,10/1/03,Hide,Hide,10,2003,8584,8584,9301,9301,1,717,717,0.077088485,0.077088485
FALSE,Carbon County,10/1/04,Hide,Hide,10,2004,8730,8730,9299,9299,1,569,569,0.061189375,0.061189375
FALSE,Carbon County,10/1/05,Hide,Hide,10,2005,9250,9250,9688,9688,1,438,438,0.04521057,0.04521057
FALSE,Carbon County,10/1/06,Hide,Hide,10,2006,9602,9602,9893,9893,1,291,291,0.029414738,0.029414738
FALSE,Carbon County,10/1/07,Hide,Hide,10,2007,9135,9135,9524,9524,1,389,389,0.040844183,0.040844183
FALSE,Carbon County,10/1/08,Hide,Hide,10,2008,9914,9914,10387,10387,1,473,473,0.045537691,0.045537691
FALSE,Carbon County,10/1/09,Hide,Hide,10,2009,9427,9427,10345,10345,1,918,918,0.088738521,0.088738521
FALSE,Carbon County,10/1/10,Hide,Hide,10,2010,9062,9062,9901,9901,1,839,839,0.084738915,0.084738915
FALSE,Carbon County,10/1/11,Hide,Hide,10,2011,8805,8805,9491,9491,1,686,686,0.072279001,0.072279001
FALSE,Carbon County,10/1/12,Hide,Hide,10,2012,8444,8444,9084,9084,1,640,640,0.070453545,0.070453545
FALSE,Carbon County,10/1/13,Hide,Hide,10,2013,8343,8343,8866,8866,1,523,523,0.058989398,0.058989398
FALSE,Carbon County,10/1/14,Hide,Hide,10,2014,8281,8281,8713,8713,1,432,432,0.049581086,0.049581086
FALSE,Carbon County,10/1/15,Hide,Hide,10,2015,8123,8123,8652,8652,1,529,529,0.061141933,0.061141933
FALSE,Carbon County,10/1/16,Hide,Hide,10,2016,7733,7733,8203,8203,1,470,470,0.057296111,0.057296111
FALSE,Carbon County,10/1/17,Hide,Hide,10,2017,7914,7914,8320,8320,1,406,406,0.048798077,0.048798077
FALSE,Carbon County,10/1/18,Hide,Hide,10,2018,8122,8122,8475,8475,1,353,353,0.041651917,0.041651917
FALSE,Carbon County,10/1/19,Hide,Hide,10,2019,8260,8260,8557,8557,1,297,297,0.034708426,0.034708426
FALSE,Daggett County,10/1/92,Hide,Hide,10,1992,389,389,410,410,1,21,21,0.051219512,0.051219512
FALSE,Daggett County,10/1/93,Hide,Hide,10,1993,379,379,392,392,1,13,13,0.033163265,0.033163265
FALSE,Daggett County,10/1/94,Hide,Hide,10,1994,442,442,477,477,1,35,35,0.073375262,0.073375262
FALSE,Daggett County,10/1/95,Hide,Hide,10,1995,421,421,438,438,1,17,17,0.038812785,0.038812785
FALSE,Daggett County,10/1/96,Hide,Hide,10,1996,392,392,411,411,1,19,19,0.04622871,0.04622871
FALSE,Daggett County,10/1/97,Hide,Hide,10,1997,387,387,405,405,1,18,18,0.044444444,0.044444444
FALSE,Daggett County,10/1/98,Hide,Hide,10,1998,402,402,417,417,1,15,15,0.035971223,0.035971223
FALSE,Daggett County,10/1/99,Hide,Hide,10,1999,448,448,463,463,1,15,15,0.032397408,0.032397408
FALSE,Daggett County,10/1/00,Hide,Hide,10,2000,445,445,465,465,1,20,20,0.043010753,0.043010753
FALSE,Daggett County,10/1/01,Hide,Hide,10,2001,490,490,513,513,1,23,23,0.044834308,0.044834308
FALSE,Daggett County,10/1/02,Hide,Hide,10,2002,482,482,508,508,1,26,26,0.051181102,0.051181102
FALSE,Daggett County,10/1/03,Hide,Hide,10,2003,457,457,483,483,1,26,26,0.053830228,0.053830228
FALSE,Daggett County,10/1/04,Hide,Hide,10,2004,440,440,467,467,1,27,27,0.057815846,0.057815846
FALSE,Daggett County,10/1/05,Hide,Hide,10,2005,496,496,523,523,1,27,27,0.051625239,0.051625239
FALSE,Daggett County,10/1/06,Hide,Hide,10,2006,476,476,497,497,1,21,21,0.042253521,0.042253521
FALSE,Daggett County,10/1/07,Hide,Hide,10,2007,499,499,518,518,1,19,19,0.036679537,0.036679537
FALSE,Daggett County,10/1/08,Hide,Hide,10,2008,429,429,448,448,1,19,19,0.042410714,0.042410714
FALSE,Daggett County,10/1/09,Hide,Hide,10,2009,473,473,504,504,1,31,31,0.061507937,0.061507937
FALSE,Daggett County,10/1/10,Hide,Hide,10,2010,467,467,503,503,1,36,36,0.071570577,0.071570577
FALSE,Daggett County,10/1/11,Hide,Hide,10,2011,438,438,464,464,1,26,26,0.056034483,0.056034483
FALSE,Daggett County,10/1/12,Hide,Hide,10,2012,419,419,441,441,1,22,22,0.049886621,0.049886621
FALSE,Daggett County,10/1/13,Hide,Hide,10,2013,400,400,419,419,1,19,19,0.045346062,0.045346062
FALSE,Daggett County,10/1/14,Hide,Hide,10,2014,421,421,440,440,1,19,19,0.043181818,0.043181818
FALSE,Daggett County,10/1/15,Hide,Hide,10,2015,444,444,465,465,1,21,21,0.04516129,0.04516129
FALSE,Daggett County,10/1/16,Hide,Hide,10,2016,421,421,443,443,1,22,22,0.0496614,0.0496614
FALSE,Daggett County,10/1/17,Hide,Hide,10,2017,400,400,424,424,1,24,24,0.056603774,0.056603774
FALSE,Daggett County,10/1/18,Hide,Hide,10,2018,377,377,394,394,1,17,17,0.043147208,0.043147208
FALSE,Daggett County,10/1/19,Hide,Hide,10,2019,381,381,396,396,1,15,15,0.037878788,0.037878788
FALSE,Davis County,10/1/92,Hide,Hide,10,1992,91452,91452,95584,95584,1,4132,4132,0.043228992,0.043228992
FALSE,Davis County,10/1/93,Hide,Hide,10,1993,98605,98605,102126,102126,1,3521,3521,0.034477019,0.034477019
FALSE,Davis County,10/1/94,Hide,Hide,10,1994,102929,102929,106848,106848,1,3919,3919,0.036678272,0.036678272
FALSE,Davis County,10/1/95,Hide,Hide,10,1995,103451,103451,106855,106855,1,3404,3404,0.031856254,0.031856254
FALSE,Davis County,10/1/96,Hide,Hide,10,1996,109047,109047,112528,112528,1,3481,3481,0.030934523,0.030934523
FALSE,Davis County,10/1/97,Hide,Hide,10,1997,113440,113440,117041,117041,1,3601,3601,0.030766996,0.030766996
FALSE,Davis County,10/1/98,Hide,Hide,10,1998,117398,117398,121444,121444,1,4046,4046,0.033315767,0.033315767
FALSE,Davis County,10/1/99,Hide,Hide,10,1999,120969,120969,124910,124910,1,3941,3941,0.031550717,0.031550717
FALSE,Davis County,10/1/00,Hide,Hide,10,2000,116196,116196,120229,120229,1,4033,4033,0.03354432,0.03354432
FALSE,Davis County,10/1/01,Hide,Hide,10,2001,116746,116746,122015,122015,1,5269,5269,0.043183215,0.043183215
FALSE,Davis County,10/1/02,Hide,Hide,10,2002,119444,119444,125989,125989,1,6545,6545,0.05194898,0.05194898
FALSE,Davis County,10/1/03,Hide,Hide,10,2003,122875,122875,129435,129435,1,6560,6560,0.050681809,0.050681809
FALSE,Davis County,10/1/04,Hide,Hide,10,2004,127464,127464,133344,133344,1,5880,5880,0.044096472,0.044096472
FALSE,Davis County,10/1/05,Hide,Hide,10,2005,132025,132025,137235,137235,1,5210,5210,0.037964076,0.037964076
FALSE,Davis County,10/1/06,Hide,Hide,10,2006,137962,137962,141666,141666,1,3704,3704,0.026146005,0.026146005
FALSE,Davis County,10/1/07,Hide,Hide,10,2007,141800,141800,145813,145813,1,4013,4013,0.027521552,0.027521552
FALSE,Davis County,10/1/08,Hide,Hide,10,2008,140202,140202,145971,145971,1,5769,5769,0.039521549,0.039521549
FALSE,Davis County,10/1/09,Hide,Hide,10,2009,134213,134213,144357,144357,1,10144,10144,0.070270233,0.070270233
FALSE,Davis County,10/1/10,Hide,Hide,10,2010,136594,136594,146793,146793,1,10199,10199,0.06947879,0.06947879
FALSE,Davis County,10/1/11,Hide,Hide,10,2011,138831,138831,147124,147124,1,8293,8293,0.056367418,0.056367418
FALSE,Davis County,10/1/12,Hide,Hide,10,2012,142574,142574,149513,149513,1,6939,6939,0.04641068,0.04641068
FALSE,Davis County,10/1/13,Hide,Hide,10,2013,147624,147624,153763,153763,1,6139,6139,0.03992508,0.03992508
FALSE,Davis County,10/1/14,Hide,Hide,10,2014,151082,151082,156599,156599,1,5517,5517,0.03523011,0.03523011
FALSE,Davis County,10/1/15,Hide,Hide,10,2015,155649,155649,161069,161069,1,5420,5420,0.033650175,0.033650175
FALSE,Davis County,10/1/16,Hide,Hide,10,2016,161323,161323,166405,166405,1,5082,5082,0.030539948,0.030539948
FALSE,Davis County,10/1/17,Hide,Hide,10,2017,163962,163962,169163,169163,1,5201,5201,0.030745494,0.030745494
FALSE,Davis County,10/1/18,Hide,Hide,10,2018,165583,165583,170369,170369,1,4786,4786,0.028091965,0.028091965
FALSE,Davis County,10/1/19,Hide,Hide,10,2019,171236,171236,175171,175171,1,3935,3935,0.022463764,0.022463764
FALSE,Duchesne County,10/1/92,Hide,Hide,10,1992,5017,5017,5492,5492,1,475,475,0.086489439,0.086489439
FALSE,Duchesne County,10/1/93,Hide,Hide,10,1993,5402,5402,5881,5881,1,479,479,0.081448733,0.081448733
FALSE,Duchesne County,10/1/94,Hide,Hide,10,1994,5405,5405,5998,5998,1,593,593,0.098866289,0.098866289
FALSE,Duchesne County,10/1/95,Hide,Hide,10,1995,5165,5165,5691,5691,1,526,526,0.092426639,0.092426639
FALSE,Duchesne County,10/1/96,Hide,Hide,10,1996,5393,5393,5859,5859,1,466,466,0.079535757,0.079535757
FALSE,Duchesne County,10/1/97,Hide,Hide,10,1997,5630,5630,6001,6001,1,371,371,0.061823029,0.061823029
FALSE,Duchesne County,10/1/98,Hide,Hide,10,1998,5604,5604,6118,6118,1,514,514,0.084014384,0.084014384
FALSE,Duchesne County,10/1/99,Hide,Hide,10,1999,5325,5325,5767,5767,1,442,442,0.076642969,0.076642969
FALSE,Duchesne County,10/1/00,Hide,Hide,10,2000,5949,5949,6247,6247,1,298,298,0.047702897,0.047702897
FALSE,Duchesne County,10/1/01,Hide,Hide,10,2001,6730,6730,7114,7114,1,384,384,0.053978071,0.053978071
FALSE,Duchesne County,10/1/02,Hide,Hide,10,2002,6495,6495,6995,6995,1,500,500,0.071479628,0.071479628
FALSE,Duchesne County,10/1/03,Hide,Hide,10,2003,6423,6423,6878,6878,1,455,455,0.066152951,0.066152951
FALSE,Duchesne County,10/1/04,Hide,Hide,10,2004,6841,6841,7219,7219,1,378,378,0.052361823,0.052361823
FALSE,Duchesne County,10/1/05,Hide,Hide,10,2005,7590,7590,7917,7917,1,327,327,0.041303524,0.041303524
FALSE,Duchesne County,10/1/06,Hide,Hide,10,2006,8614,8614,8826,8826,1,212,212,0.024019941,0.024019941
FALSE,Duchesne County,10/1/07,Hide,Hide,10,2007,9053,9053,9276,9276,1,223,223,0.024040535,0.024040535
FALSE,Duchesne County,10/1/08,Hide,Hide,10,2008,10361,10361,10673,10673,1,312,312,0.029232643,0.029232643
FALSE,Duchesne County,10/1/09,Hide,Hide,10,2009,8916,8916,9938,9938,1,1022,1022,0.102837593,0.102837593
FALSE,Duchesne County,10/1/10,Hide,Hide,10,2010,7415,7415,8161,8161,1,746,746,0.091410366,0.091410366
FALSE,Duchesne County,10/1/11,Hide,Hide,10,2011,8059,8059,8589,8589,1,530,530,0.061706834,0.061706834
FALSE,Duchesne County,10/1/12,Hide,Hide,10,2012,8834,8834,9262,9262,1,428,428,0.046210322,0.046210322
FALSE,Duchesne County,10/1/13,Hide,Hide,10,2013,8959,8959,9345,9345,1,386,386,0.041305511,0.041305511
FALSE,Duchesne County,10/1/14,Hide,Hide,10,2014,9232,9232,9597,9597,1,365,365,0.038032719,0.038032719
FALSE,Duchesne County,10/1/15,Hide,Hide,10,2015,7681,7681,8435,8435,1,754,754,0.089389449,0.089389449
FALSE,Duchesne County,10/1/16,Hide,Hide,10,2016,7364,7364,8002,8002,1,638,638,0.079730067,0.079730067
FALSE,Duchesne County,10/1/17,Hide,Hide,10,2017,7540,7540,7949,7949,1,409,409,0.051453013,0.051453013
FALSE,Duchesne County,10/1/18,Hide,Hide,10,2018,7327,7327,7663,7663,1,336,336,0.043847057,0.043847057
FALSE,Duchesne County,10/1/19,Hide,Hide,10,2019,7521,7521,7810,7810,1,289,289,0.037003841,0.037003841
FALSE,Emery County,10/1/92,Hide,Hide,10,1992,4144,4144,4527,4527,1,383,383,0.08460349,0.08460349
FALSE,Emery County,10/1/93,Hide,Hide,10,1993,3889,3889,4208,4208,1,319,319,0.075807985,0.075807985
FALSE,Emery County,10/1/94,Hide,Hide,10,1994,3853,3853,4191,4191,1,338,338,0.08064901,0.08064901
FALSE,Emery County,10/1/95,Hide,Hide,10,1995,3897,3897,4224,4224,1,327,327,0.077414773,0.077414773
FALSE,Emery County,10/1/96,Hide,Hide,10,1996,3863,3863,4167,4167,1,304,304,0.072954164,0.072954164
FALSE,Emery County,10/1/97,Hide,Hide,10,1997,3922,3922,4173,4173,1,251,251,0.060148574,0.060148574
FALSE,Emery County,10/1/98,Hide,Hide,10,1998,3926,3926,4253,4253,1,327,327,0.076886903,0.076886903
FALSE,Emery County,10/1/99,Hide,Hide,10,1999,3792,3792,4039,4039,1,247,247,0.061153751,0.061153751
FALSE,Emery County,10/1/00,Hide,Hide,10,2000,4438,4438,4693,4693,1,255,255,0.054336245,0.054336245
FALSE,Emery County,10/1/01,Hide,Hide,10,2001,4555,4555,4892,4892,1,337,337,0.06888798,0.06888798
FALSE,Emery County,10/1/02,Hide,Hide,10,2002,4483,4483,4846,4846,1,363,363,0.07490714,0.07490714
FALSE,Emery County,10/1/03,Hide,Hide,10,2003,4509,4509,4900,4900,1,391,391,0.079795918,0.079795918
FALSE,Emery County,10/1/04,Hide,Hide,10,2004,4758,4758,5078,5078,1,320,320,0.063016936,0.063016936
FALSE,Emery County,10/1/05,Hide,Hide,10,2005,4979,4979,5216,5216,1,237,237,0.045437117,0.045437117
FALSE,Emery County,10/1/06,Hide,Hide,10,2006,5087,5087,5250,5250,1,163,163,0.031047619,0.031047619
FALSE,Emery County,10/1/07,Hide,Hide,10,2007,4947,4947,5125,5125,1,178,178,0.034731707,0.034731707
FALSE,Emery County,10/1/08,Hide,Hide,10,2008,4755,4755,4964,4964,1,209,209,0.042103143,0.042103143
FALSE,Emery County,10/1/09,Hide,Hide,10,2009,4901,4901,5335,5335,1,434,434,0.081349578,0.081349578
FALSE,Emery County,10/1/10,Hide,Hide,10,2010,4855,4855,5233,5233,1,378,378,0.0722339,0.0722339
FALSE,Emery County,10/1/11,Hide,Hide,10,2011,4629,4629,4991,4991,1,362,362,0.072530555,0.072530555
FALSE,Emery County,10/1/12,Hide,Hide,10,2012,4408,4408,4745,4745,1,337,337,0.071022129,0.071022129
FALSE,Emery County,10/1/13,Hide,Hide,10,2013,4385,4385,4652,4652,1,267,267,0.057394669,0.057394669
FALSE,Emery County,10/1/14,Hide,Hide,10,2014,4259,4259,4497,4497,1,238,238,0.052924172,0.052924172
FALSE,Emery County,10/1/15,Hide,Hide,10,2015,4088,4088,4388,4388,1,300,300,0.068368277,0.068368277
FALSE,Emery County,10/1/16,Hide,Hide,10,2016,3958,3958,4198,4198,1,240,240,0.057170081,0.057170081
FALSE,Emery County,10/1/17,Hide,Hide,10,2017,4011,4011,4216,4216,1,205,205,0.048624288,0.048624288
FALSE,Emery County,10/1/18,Hide,Hide,10,2018,4150,4150,4344,4344,1,194,194,0.0446593,0.0446593
FALSE,Emery County,10/1/19,Hide,Hide,10,2019,4129,4129,4292,4292,1,163,163,0.037977633,0.037977633
FALSE,Garfield County,10/1/92,Hide,Hide,10,1992,1993,1993,2304,2304,1,311,311,0.134982639,0.134982639
FALSE,Garfield County,10/1/93,Hide,Hide,10,1993,2145,2145,2341,2341,1,196,196,0.083724904,0.083724904
FALSE,Garfield County,10/1/94,Hide,Hide,10,1994,2266,2266,2568,2568,1,302,302,0.117601246,0.117601246
FALSE,Garfield County,10/1/95,Hide,Hide,10,1995,2379,2379,2681,2681,1,302,302,0.112644536,0.112644536
FALSE,Garfield County,10/1/96,Hide,Hide,10,1996,2423,2423,2698,2698,1,275,275,0.101927354,0.101927354
FALSE,Garfield County,10/1/97,Hide,Hide,10,1997,2538,2538,2751,2751,1,213,213,0.07742639,0.07742639
FALSE,Garfield County,10/1/98,Hide,Hide,10,1998,2478,2478,2710,2710,1,232,232,0.085608856,0.085608856
FALSE,Garfield County,10/1/99,Hide,Hide,10,1999,2687,2687,2888,2888,1,201,201,0.069598338,0.069598338
FALSE,Garfield County,10/1/00,Hide,Hide,10,2000,2284,2284,2456,2456,1,172,172,0.070032573,0.070032573
FALSE,Garfield County,10/1/01,Hide,Hide,10,2001,2430,2430,2638,2638,1,208,208,0.078847612,0.078847612
FALSE,Garfield County,10/1/02,Hide,Hide,10,2002,2350,2350,2589,2589,1,239,239,0.092313635,0.092313635
FALSE,Garfield County,10/1/03,Hide,Hide,10,2003,2326,2326,2545,2545,1,219,219,0.086051081,0.086051081
FALSE,Garfield County,10/1/04,Hide,Hide,10,2004,2439,2439,2649,2649,1,210,210,0.079275198,0.079275198
FALSE,Garfield County,10/1/05,Hide,Hide,10,2005,2529,2529,2716,2716,1,187,187,0.068851252,0.068851252
FALSE,Garfield County,10/1/06,Hide,Hide,10,2006,2551,2551,2671,2671,1,120,120,0.044926994,0.044926994
FALSE,Garfield County,10/1/07,Hide,Hide,10,2007,2575,2575,2717,2717,1,142,142,0.052263526,0.052263526
FALSE,Garfield County,10/1/08,Hide,Hide,10,2008,2708,2708,2902,2902,1,194,194,0.066850448,0.066850448
FALSE,Garfield County,10/1/09,Hide,Hide,10,2009,2565,2565,2882,2882,1,317,317,0.10999306,0.10999306
FALSE,Garfield County,10/1/10,Hide,Hide,10,2010,2758,2758,3066,3066,1,308,308,0.100456621,0.100456621
FALSE,Garfield County,10/1/11,Hide,Hide,10,2011,2640,2640,2957,2957,1,317,317,0.107203247,0.107203247
FALSE,Garfield County,10/1/12,Hide,Hide,10,2012,2600,2600,2869,2869,1,269,269,0.093760892,0.093760892
FALSE,Garfield County,10/1/13,Hide,Hide,10,2013,2505,2505,2769,2769,1,264,264,0.095341278,0.095341278
FALSE,Garfield County,10/1/14,Hide,Hide,10,2014,2477,2477,2718,2718,1,241,241,0.088668138,0.088668138
FALSE,Garfield County,10/1/15,Hide,Hide,10,2015,2461,2461,2708,2708,1,247,247,0.091211226,0.091211226
FALSE,Garfield County,10/1/16,Hide,Hide,10,2016,2585,2585,2810,2810,1,225,225,0.080071174,0.080071174
FALSE,Garfield County,10/1/17,Hide,Hide,10,2017,2691,2691,2911,2911,1,220,220,0.075575404,0.075575404
FALSE,Garfield County,10/1/18,Hide,Hide,10,2018,2546,2546,2741,2741,1,195,195,0.071141919,0.071141919
FALSE,Garfield County,10/1/19,Hide,Hide,10,2019,2613,2613,2768,2768,1,155,155,0.05599711,0.05599711
FALSE,Grand County,10/1/92,Hide,Hide,10,1992,3894,3894,4206,4206,1,312,312,0.074179743,0.074179743
FALSE,Grand County,10/1/93,Hide,Hide,10,1993,4484,4484,4795,4795,1,311,311,0.064859228,0.064859228
FALSE,Grand County,10/1/94,Hide,Hide,10,1994,4547,4547,4883,4883,1,336,336,0.068810158,0.068810158
FALSE,Grand County,10/1/95,Hide,Hide,10,1995,4686,4686,5010,5010,1,324,324,0.064670659,0.064670659
FALSE,Grand County,10/1/96,Hide,Hide,10,1996,4653,4653,5009,5009,1,356,356,0.07107207,0.07107207
FALSE,Grand County,10/1/97,Hide,Hide,10,1997,4916,4916,5240,5240,1,324,324,0.061832061,0.061832061
FALSE,Grand County,10/1/98,Hide,Hide,10,1998,4986,4986,5366,5366,1,380,380,0.07081625,0.07081625
FALSE,Grand County,10/1/99,Hide,Hide,10,1999,5121,5121,5438,5438,1,317,317,0.05829349,0.05829349
FALSE,Grand County,10/1/00,Hide,Hide,10,2000,4323,4323,4626,4626,1,303,303,0.065499351,0.065499351
FALSE,Grand County,10/1/01,Hide,Hide,10,2001,4462,4462,4797,4797,1,335,335,0.069835314,0.069835314
FALSE,Grand County,10/1/02,Hide,Hide,10,2002,4416,4416,4782,4782,1,366,366,0.076537014,0.076537014
FALSE,Grand County,10/1/03,Hide,Hide,10,2003,4486,4486,4845,4845,1,359,359,0.074097007,0.074097007
FALSE,Grand County,10/1/04,Hide,Hide,10,2004,4487,4487,4832,4832,1,345,345,0.071399007,0.071399007
FALSE,Grand County,10/1/05,Hide,Hide,10,2005,4799,4799,5111,5111,1,312,312,0.061044805,0.061044805
FALSE,Grand County,10/1/06,Hide,Hide,10,2006,4834,4834,5052,5052,1,218,218,0.043151227,0.043151227
FALSE,Grand County,10/1/07,Hide,Hide,10,2007,4906,4906,5167,5167,1,261,261,0.05051287,0.05051287
FALSE,Grand County,10/1/08,Hide,Hide,10,2008,4983,4983,5337,5337,1,354,354,0.066329399,0.066329399
FALSE,Grand County,10/1/09,Hide,Hide,10,2009,4876,4876,5434,5434,1,558,558,0.102686787,0.102686787
FALSE,Grand County,10/1/10,Hide,Hide,10,2010,4743,4743,5308,5308,1,565,565,0.106443105,0.106443105
FALSE,Grand County,10/1/11,Hide,Hide,10,2011,4838,4838,5340,5340,1,502,502,0.094007491,0.094007491
FALSE,Grand County,10/1/12,Hide,Hide,10,2012,4958,4958,5409,5409,1,451,451,0.083379553,0.083379553
FALSE,Grand County,10/1/13,Hide,Hide,10,2013,5072,5072,5492,5492,1,420,420,0.076474873,0.076474873
FALSE,Grand County,10/1/14,Hide,Hide,10,2014,5215,5215,5557,5557,1,342,342,0.061543999,0.061543999
FALSE,Grand County,10/1/15,Hide,Hide,10,2015,5293,5293,5633,5633,1,340,340,0.060358601,0.060358601
FALSE,Grand County,10/1/16,Hide,Hide,10,2016,5422,5422,5751,5751,1,329,329,0.057207442,0.057207442
FALSE,Grand County,10/1/17,Hide,Hide,10,2017,5692,5692,6001,6001,1,309,309,0.051491418,0.051491418
FALSE,Grand County,10/1/18,Hide,Hide,10,2018,5760,5760,6027,6027,1,267,267,0.044300647,0.044300647
FALSE,Grand County,10/1/19,Hide,Hide,10,2019,6059,6059,6278,6278,1,219,219,0.034883721,0.034883721
FALSE,Iron County,10/1/92,Hide,Hide,10,1992,10186,10186,10532,10532,1,346,346,0.03285226,0.03285226
FALSE,Iron County,10/1/93,Hide,Hide,10,1993,11029,11029,11460,11460,1,431,431,0.037609075,0.037609075
FALSE,Iron County,10/1/94,Hide,Hide,10,1994,12101,12101,12563,12563,1,462,462,0.036774656,0.036774656
FALSE,Iron County,10/1/95,Hide,Hide,10,1995,12649,12649,13120,13120,1,471,471,0.03589939,0.03589939
FALSE,Iron County,10/1/96,Hide,Hide,10,1996,13220,13220,13695,13695,1,475,475,0.034684191,0.034684191
FALSE,Iron County,10/1/97,Hide,Hide,10,1997,13837,13837,14344,14344,1,507,507,0.035345789,0.035345789
FALSE,Iron County,10/1/98,Hide,Hide,10,1998,14563,14563,15140,15140,1,577,577,0.038110964,0.038110964
FALSE,Iron County,10/1/99,Hide,Hide,10,1999,14814,14814,15330,15330,1,516,516,0.033659491,0.033659491
FALSE,Iron County,10/1/00,Hide,Hide,10,2000,16458,16458,17048,17048,1,590,590,0.034608165,0.034608165
FALSE,Iron County,10/1/01,Hide,Hide,10,2001,16826,16826,17659,17659,1,833,833,0.047171414,0.047171414
FALSE,Iron County,10/1/02,Hide,Hide,10,2002,16815,16815,17781,17781,1,966,966,0.054327653,0.054327653
FALSE,Iron County,10/1/03,Hide,Hide,10,2003,17183,17183,18106,18106,1,923,923,0.050977576,0.050977576
FALSE,Iron County,10/1/04,Hide,Hide,10,2004,18146,18146,18994,18994,1,848,848,0.044645678,0.044645678
FALSE,Iron County,10/1/05,Hide,Hide,10,2005,19469,19469,20221,20221,1,752,752,0.037189061,0.037189061
FALSE,Iron County,10/1/06,Hide,Hide,10,2006,20729,20729,21316,21316,1,587,587,0.027538,0.027538
FALSE,Iron County,10/1/07,Hide,Hide,10,2007,20080,20080,20763,20763,1,683,683,0.032895054,0.032895054
FALSE,Iron County,10/1/08,Hide,Hide,10,2008,19673,19673,20799,20799,1,1126,1126,0.054137218,0.054137218
FALSE,Iron County,10/1/09,Hide,Hide,10,2009,19115,19115,21011,21011,1,1896,1896,0.090238447,0.090238447
FALSE,Iron County,10/1/10,Hide,Hide,10,2010,18392,18392,20306,20306,1,1914,1914,0.094257855,0.094257855
FALSE,Iron County,10/1/11,Hide,Hide,10,2011,18241,18241,19777,19777,1,1536,1536,0.077665976,0.077665976
FALSE,Iron County,10/1/12,Hide,Hide,10,2012,18236,18236,19508,19508,1,1272,1272,0.065204019,0.065204019
FALSE,Iron County,10/1/13,Hide,Hide,10,2013,18383,18383,19379,19379,1,996,996,0.051395841,0.051395841
FALSE,Iron County,10/1/14,Hide,Hide,10,2014,19071,19071,19979,19979,1,908,908,0.04544772,0.04544772
FALSE,Iron County,10/1/15,Hide,Hide,10,2015,19564,19564,20469,20469,1,905,905,0.0442132,0.0442132
FALSE,Iron County,10/1/16,Hide,Hide,10,2016,20816,20816,21776,21776,1,960,960,0.044085231,0.044085231
FALSE,Iron County,10/1/17,Hide,Hide,10,2017,21598,21598,22477,22477,1,879,879,0.039106642,0.039106642
FALSE,Iron County,10/1/18,Hide,Hide,10,2018,22361,22361,23151,23151,1,790,790,0.034123796,0.034123796
FALSE,Iron County,10/1/19,Hide,Hide,10,2019,23748,23748,24407,24407,1,659,659,0.027000451,0.027000451
FALSE,Juab County,10/1/92,Hide,Hide,10,1992,2934,2934,3158,3158,1,224,224,0.070930969,0.070930969
FALSE,Juab County,10/1/93,Hide,Hide,10,1993,3175,3175,3358,3358,1,183,183,0.054496724,0.054496724
FALSE,Juab County,10/1/94,Hide,Hide,10,1994,3199,3199,3366,3366,1,167,167,0.049613785,0.049613785
FALSE,Juab County,10/1/95,Hide,Hide,10,1995,3168,3168,3322,3322,1,154,154,0.046357616,0.046357616
FALSE,Juab County,10/1/96,Hide,Hide,10,1996,3276,3276,3414,3414,1,138,138,0.040421793,0.040421793
FALSE,Juab County,10/1/97,Hide,Hide,10,1997,3327,3327,3465,3465,1,138,138,0.03982684,0.03982684
FALSE,Juab County,10/1/98,Hide,Hide,10,1998,3511,3511,3685,3685,1,174,174,0.047218453,0.047218453
FALSE,Juab County,10/1/99,Hide,Hide,10,1999,3400,3400,3551,3551,1,151,151,0.042523233,0.042523233
FALSE,Juab County,10/1/00,Hide,Hide,10,2000,3668,3668,3806,3806,1,138,138,0.036258539,0.036258539
FALSE,Juab County,10/1/01,Hide,Hide,10,2001,3566,3566,3777,3777,1,211,211,0.055864443,0.055864443
FALSE,Juab County,10/1/02,Hide,Hide,10,2002,3433,3433,3719,3719,1,286,286,0.076902393,0.076902393
FALSE,Juab County,10/1/03,Hide,Hide,10,2003,3437,3437,3692,3692,1,255,255,0.069068256,0.069068256
FALSE,Juab County,10/1/04,Hide,Hide,10,2004,3611,3611,3830,3830,1,219,219,0.057180157,0.057180157
FALSE,Juab County,10/1/05,Hide,Hide,10,2005,3771,3771,3953,3953,1,182,182,0.046040982,0.046040982
FALSE,Juab County,10/1/06,Hide,Hide,10,2006,3942,3942,4077,4077,1,135,135,0.033112583,0.033112583
FALSE,Juab County,10/1/07,Hide,Hide,10,2007,3999,3999,4137,4137,1,138,138,0.033357505,0.033357505
FALSE,Juab County,10/1/08,Hide,Hide,10,2008,3704,3704,3975,3975,1,271,271,0.068176101,0.068176101
FALSE,Juab County,10/1/09,Hide,Hide,10,2009,3576,3576,3985,3985,1,409,409,0.102634881,0.102634881
FALSE,Juab County,10/1/10,Hide,Hide,10,2010,4204,4204,4633,4633,1,429,429,0.09259659,0.09259659
FALSE,Juab County,10/1/11,Hide,Hide,10,2011,4271,4271,4619,4619,1,348,348,0.075340983,0.075340983
FALSE,Juab County,10/1/12,Hide,Hide,10,2012,4415,4415,4683,4683,1,268,268,0.057228272,0.057228272
FALSE,Juab County,10/1/13,Hide,Hide,10,2013,4509,4509,4733,4733,1,224,224,0.047327277,0.047327277
FALSE,Juab County,10/1/14,Hide,Hide,10,2014,4650,4650,4842,4842,1,192,192,0.039653036,0.039653036
FALSE,Juab County,10/1/15,Hide,Hide,10,2015,4800,4800,4997,4997,1,197,197,0.039423654,0.039423654
FALSE,Juab County,10/1/16,Hide,Hide,10,2016,5095,5095,5274,5274,1,179,179,0.033940083,0.033940083
FALSE,Juab County,10/1/17,Hide,Hide,10,2017,5301,5301,5485,5485,1,184,184,0.033546035,0.033546035
FALSE,Juab County,10/1/18,Hide,Hide,10,2018,5435,5435,5594,5594,1,159,159,0.028423311,0.028423311
FALSE,Juab County,10/1/19,Hide,Hide,10,2019,5650,5650,5781,5781,1,131,131,0.022660439,0.022660439
FALSE,Kane County,10/1/92,Hide,Hide,10,1992,2749,2749,2954,2954,1,205,205,0.069397427,0.069397427
FALSE,Kane County,10/1/93,Hide,Hide,10,1993,2370,2370,2525,2525,1,155,155,0.061386139,0.061386139
FALSE,Kane County,10/1/94,Hide,Hide,10,1994,2483,2483,2773,2773,1,290,290,0.104579877,0.104579877
FALSE,Kane County,10/1/95,Hide,Hide,10,1995,2473,2473,2668,2668,1,195,195,0.073088456,0.073088456
FALSE,Kane County,10/1/96,Hide,Hide,10,1996,2411,2411,2615,2615,1,204,204,0.078011472,0.078011472
FALSE,Kane County,10/1/97,Hide,Hide,10,1997,2488,2488,2596,2596,1,108,108,0.041602465,0.041602465
FALSE,Kane County,10/1/98,Hide,Hide,10,1998,2584,2584,2681,2681,1,97,97,0.03618053,0.03618053
FALSE,Kane County,10/1/99,Hide,Hide,10,1999,2696,2696,2786,2786,1,90,90,0.032304379,0.032304379
FALSE,Kane County,10/1/00,Hide,Hide,10,2000,2893,2893,3014,3014,1,121,121,0.040145985,0.040145985
FALSE,Kane County,10/1/01,Hide,Hide,10,2001,3091,3091,3226,3226,1,135,135,0.041847489,0.041847489
FALSE,Kane County,10/1/02,Hide,Hide,10,2002,2811,2811,2977,2977,1,166,166,0.055760833,0.055760833
FALSE,Kane County,10/1/03,Hide,Hide,10,2003,2935,2935,3118,3118,1,183,183,0.058691469,0.058691469
FALSE,Kane County,10/1/04,Hide,Hide,10,2004,3047,3047,3228,3228,1,181,181,0.056071871,0.056071871
FALSE,Kane County,10/1/05,Hide,Hide,10,2005,3178,3178,3328,3328,1,150,150,0.045072115,0.045072115
FALSE,Kane County,10/1/06,Hide,Hide,10,2006,3362,3362,3471,3471,1,109,109,0.031403054,0.031403054
FALSE,Kane County,10/1/07,Hide,Hide,10,2007,3331,3331,3448,3448,1,117,117,0.033932715,0.033932715
FALSE,Kane County,10/1/08,Hide,Hide,10,2008,3354,3354,3534,3534,1,180,180,0.050933786,0.050933786
FALSE,Kane County,10/1/09,Hide,Hide,10,2009,3276,3276,3562,3562,1,286,286,0.080291971,0.080291971
FALSE,Kane County,10/1/10,Hide,Hide,10,2010,3246,3246,3527,3527,1,281,281,0.079671109,0.079671109
FALSE,Kane County,10/1/11,Hide,Hide,10,2011,3219,3219,3465,3465,1,246,246,0.070995671,0.070995671
FALSE,Kane County,10/1/12,Hide,Hide,10,2012,3246,3246,3463,3463,1,217,217,0.062662431,0.062662431
FALSE,Kane County,10/1/13,Hide,Hide,10,2013,3304,3304,3480,3480,1,176,176,0.050574713,0.050574713
FALSE,Kane County,10/1/14,Hide,Hide,10,2014,3416,3416,3583,3583,1,167,167,0.046608987,0.046608987
FALSE,Kane County,10/1/15,Hide,Hide,10,2015,3507,3507,3666,3666,1,159,159,0.043371522,0.043371522
FALSE,Kane County,10/1/16,Hide,Hide,10,2016,3566,3566,3697,3697,1,131,131,0.035434136,0.035434136
FALSE,Kane County,10/1/17,Hide,Hide,10,2017,3640,3640,3767,3767,1,127,127,0.033713831,0.033713831
FALSE,Kane County,10/1/18,Hide,Hide,10,2018,3660,3660,3776,3776,1,116,116,0.030720339,0.030720339
FALSE,Kane County,10/1/19,Hide,Hide,10,2019,3735,3735,3837,3837,1,102,102,0.026583268,0.026583268
FALSE,Millard County,10/1/92,Hide,Hide,10,1992,4353,4353,4652,4652,1,299,299,0.064273431,0.064273431
FALSE,Millard County,10/1/93,Hide,Hide,10,1993,4536,4536,4769,4769,1,233,233,0.048857203,0.048857203
FALSE,Millard County,10/1/94,Hide,Hide,10,1994,4623,4623,4855,4855,1,232,232,0.047785788,0.047785788
FALSE,Millard County,10/1/95,Hide,Hide,10,1995,4437,4437,4652,4652,1,215,215,0.046216681,0.046216681
FALSE,Millard County,10/1/96,Hide,Hide,10,1996,4576,4576,4762,4762,1,186,186,0.039059219,0.039059219
FALSE,Millard County,10/1/97,Hide,Hide,10,1997,4620,4620,4813,4813,1,193,193,0.04009973,0.04009973
FALSE,Millard County,10/1/98,Hide,Hide,10,1998,4495,4495,4710,4710,1,215,215,0.045647558,0.045647558
FALSE,Millard County,10/1/99,Hide,Hide,10,1999,4382,4382,4564,4564,1,182,182,0.039877301,0.039877301
FALSE,Millard County,10/1/00,Hide,Hide,10,2000,4967,4967,5156,5156,1,189,189,0.036656323,0.036656323
FALSE,Millard County,10/1/01,Hide,Hide,10,2001,5831,5831,6089,6089,1,258,258,0.04237149,0.04237149
FALSE,Millard County,10/1/02,Hide,Hide,10,2002,6106,6106,6392,6392,1,286,286,0.044743429,0.044743429
FALSE,Millard County,10/1/03,Hide,Hide,10,2003,5564,5564,5872,5872,1,308,308,0.052452316,0.052452316
FALSE,Millard County,10/1/04,Hide,Hide,10,2004,5524,5524,5799,5799,1,275,275,0.047421969,0.047421969
FALSE,Millard County,10/1/05,Hide,Hide,10,2005,5878,5878,6115,6115,1,237,237,0.038757155,0.038757155
FALSE,Millard County,10/1/06,Hide,Hide,10,2006,6080,6080,6245,6245,1,165,165,0.026421137,0.026421137
FALSE,Millard County,10/1/07,Hide,Hide,10,2007,5964,5964,6133,6133,1,169,169,0.027555845,0.027555845
FALSE,Millard County,10/1/08,Hide,Hide,10,2008,5973,5973,6209,6209,1,236,236,0.038009341,0.038009341
FALSE,Millard County,10/1/09,Hide,Hide,10,2009,6186,6186,6571,6571,1,385,385,0.058590778,0.058590778
FALSE,Millard County,10/1/10,Hide,Hide,10,2010,6187,6187,6581,6581,1,394,394,0.059869321,0.059869321
FALSE,Millard County,10/1/11,Hide,Hide,10,2011,5788,5788,6100,6100,1,312,312,0.051147541,0.051147541
FALSE,Millard County,10/1/12,Hide,Hide,10,2012,5685,5685,5953,5953,1,268,268,0.045019318,0.045019318
FALSE,Millard County,10/1/13,Hide,Hide,10,2013,5604,5604,5829,5829,1,225,225,0.038600103,0.038600103
FALSE,Millard County,10/1/14,Hide,Hide,10,2014,5746,5746,5960,5960,1,214,214,0.03590604,0.03590604
FALSE,Millard County,10/1/15,Hide,Hide,10,2015,5859,5859,6072,6072,1,213,213,0.035079051,0.035079051
FALSE,Millard County,10/1/16,Hide,Hide,10,2016,6024,6024,6234,6234,1,210,210,0.033686237,0.033686237
FALSE,Millard County,10/1/17,Hide,Hide,10,2017,6291,6291,6492,6492,1,201,201,0.030961183,0.030961183
FALSE,Millard County,10/1/18,Hide,Hide,10,2018,5904,5904,6100,6100,1,196,196,0.032131148,0.032131148
FALSE,Millard County,10/1/19,Hide,Hide,10,2019,5829,5829,5979,5979,1,150,150,0.025087807,0.025087807
FALSE,Morgan County,10/1/92,Hide,Hide,10,1992,2792,2792,2966,2966,1,174,174,0.058664869,0.058664869
FALSE,Morgan County,10/1/93,Hide,Hide,10,1993,2821,2821,2976,2976,1,155,155,0.052083333,0.052083333
FALSE,Morgan County,10/1/94,Hide,Hide,10,1994,3030,3030,3193,3193,1,163,163,0.05104917,0.05104917
FALSE,Morgan County,10/1/95,Hide,Hide,10,1995,3265,3265,3415,3415,1,150,150,0.043923865,0.043923865
FALSE,Morgan County,10/1/96,Hide,Hide,10,1996,3385,3385,3525,3525,1,140,140,0.039716312,0.039716312
FALSE,Morgan County,10/1/97,Hide,Hide,10,1997,3535,3535,3677,3677,1,142,142,0.038618439,0.038618439
FALSE,Morgan County,10/1/98,Hide,Hide,10,1998,3538,3538,3680,3680,1,142,142,0.038586957,0.038586957
FALSE,Morgan County,10/1/99,Hide,Hide,10,1999,3404,3404,3535,3535,1,131,131,0.037057992,0.037057992
FALSE,Morgan County,10/1/00,Hide,Hide,10,2000,3288,3288,3406,3406,1,118,118,0.034644745,0.034644745
FALSE,Morgan County,10/1/01,Hide,Hide,10,2001,3317,3317,3467,3467,1,150,150,0.043265071,0.043265071
FALSE,Morgan County,10/1/02,Hide,Hide,10,2002,3377,3377,3576,3576,1,199,199,0.05564877,0.05564877
FALSE,Morgan County,10/1/03,Hide,Hide,10,2003,3430,3430,3615,3615,1,185,185,0.051175657,0.051175657
FALSE,Morgan County,10/1/04,Hide,Hide,10,2004,3536,3536,3704,3704,1,168,168,0.045356371,0.045356371
FALSE,Morgan County,10/1/05,Hide,Hide,10,2005,3702,3702,3856,3856,1,154,154,0.039937759,0.039937759
FALSE,Morgan County,10/1/06,Hide,Hide,10,2006,3863,3863,3969,3969,1,106,106,0.026706979,0.026706979
FALSE,Morgan County,10/1/07,Hide,Hide,10,2007,3914,3914,4030,4030,1,116,116,0.028784119,0.028784119
FALSE,Morgan County,10/1/08,Hide,Hide,10,2008,3918,3918,4071,4071,1,153,153,0.037582903,0.037582903
FALSE,Morgan County,10/1/09,Hide,Hide,10,2009,3795,3795,4068,4068,1,273,273,0.067109145,0.067109145
FALSE,Morgan County,10/1/10,Hide,Hide,10,2010,4000,4000,4294,4294,1,294,294,0.068467629,0.068467629
FALSE,Morgan County,10/1/11,Hide,Hide,10,2011,4053,4053,4279,4279,1,226,226,0.052816079,0.052816079
FALSE,Morgan County,10/1/12,Hide,Hide,10,2012,4173,4173,4377,4377,1,204,204,0.046607265,0.046607265
FALSE,Morgan County,10/1/13,Hide,Hide,10,2013,4384,4384,4559,4559,1,175,175,0.038385611,0.038385611
FALSE,Morgan County,10/1/14,Hide,Hide,10,2014,4579,4579,4738,4738,1,159,159,0.033558463,0.033558463
FALSE,Morgan County,10/1/15,Hide,Hide,10,2015,4817,4817,4971,4971,1,154,154,0.030979682,0.030979682
FALSE,Morgan County,10/1/16,Hide,Hide,10,2016,5069,5069,5219,5219,1,150,150,0.028741138,0.028741138
FALSE,Morgan County,10/1/17,Hide,Hide,10,2017,5269,5269,5420,5420,1,151,151,0.027859779,0.027859779
FALSE,Morgan County,10/1/18,Hide,Hide,10,2018,5315,5315,5462,5462,1,147,147,0.026913219,0.026913219
FALSE,Morgan County,10/1/19,Hide,Hide,10,2019,5486,5486,5613,5613,1,127,127,0.022626047,0.022626047
FALSE,Piute County,10/1/92,Hide,Hide,10,1992,419,419,452,452,1,33,33,0.07300885,0.07300885
FALSE,Piute County,10/1/93,Hide,Hide,10,1993,469,469,498,498,1,29,29,0.058232932,0.058232932
FALSE,Piute County,10/1/94,Hide,Hide,10,1994,462,462,504,504,1,42,42,0.083333333,0.083333333
FALSE,Piute County,10/1/95,Hide,Hide,10,1995,462,462,489,489,1,27,27,0.055214724,0.055214724
FALSE,Piute County,10/1/96,Hide,Hide,10,1996,512,512,537,537,1,25,25,0.046554935,0.046554935
FALSE,Piute County,10/1/97,Hide,Hide,10,1997,506,506,532,532,1,26,26,0.04887218,0.04887218
FALSE,Piute County,10/1/98,Hide,Hide,10,1998,500,500,527,527,1,27,27,0.051233397,0.051233397
FALSE,Piute County,10/1/99,Hide,Hide,10,1999,494,494,521,521,1,27,27,0.051823417,0.051823417
FALSE,Piute County,10/1/00,Hide,Hide,10,2000,615,615,647,647,1,32,32,0.049459042,0.049459042
FALSE,Piute County,10/1/01,Hide,Hide,10,2001,754,754,798,798,1,44,44,0.055137845,0.055137845
FALSE,Piute County,10/1/02,Hide,Hide,10,2002,720,720,768,768,1,48,48,0.0625,0.0625
FALSE,Piute County,10/1/03,Hide,Hide,10,2003,773,773,817,817,1,44,44,0.053855569,0.053855569
FALSE,Piute County,10/1/04,Hide,Hide,10,2004,838,838,875,875,1,37,37,0.042285714,0.042285714
FALSE,Piute County,10/1/05,Hide,Hide,10,2005,794,794,825,825,1,31,31,0.037575758,0.037575758
FALSE,Piute County,10/1/06,Hide,Hide,10,2006,858,858,881,881,1,23,23,0.026106697,0.026106697
FALSE,Piute County,10/1/07,Hide,Hide,10,2007,895,895,920,920,1,25,25,0.027173913,0.027173913
FALSE,Piute County,10/1/08,Hide,Hide,10,2008,884,884,913,913,1,29,29,0.031763417,0.031763417
FALSE,Piute County,10/1/09,Hide,Hide,10,2009,796,796,857,857,1,61,61,0.07117853,0.07117853
FALSE,Piute County,10/1/10,Hide,Hide,10,2010,504,504,561,561,1,57,57,0.101604278,0.101604278
FALSE,Piute County,10/1/11,Hide,Hide,10,2011,463,463,513,513,1,50,50,0.097465887,0.097465887
FALSE,Piute County,10/1/12,Hide,Hide,10,2012,442,442,482,482,1,40,40,0.082987552,0.082987552
FALSE,Piute County,10/1/13,Hide,Hide,10,2013,445,445,482,482,1,37,37,0.076763485,0.076763485
FALSE,Piute County,10/1/14,Hide,Hide,10,2014,424,424,457,457,1,33,33,0.072210066,0.072210066
FALSE,Piute County,10/1/15,Hide,Hide,10,2015,420,420,448,448,1,28,28,0.0625,0.0625
FALSE,Piute County,10/1/16,Hide,Hide,10,2016,438,438,464,464,1,26,26,0.056034483,0.056034483
FALSE,Piute County,10/1/17,Hide,Hide,10,2017,468,468,491,491,1,23,23,0.046843177,0.046843177
FALSE,Piute County,10/1/18,Hide,Hide,10,2018,456,456,480,480,1,24,24,0.05,0.05
FALSE,Piute County,10/1/19,Hide,Hide,10,2019,463,463,486,486,1,23,23,0.047325103,0.047325103
FALSE,Rich County,10/1/92,Hide,Hide,10,1992,713,713,745,745,1,32,32,0.04295302,0.04295302
FALSE,Rich County,10/1/93,Hide,Hide,10,1993,787,787,811,811,1,24,24,0.029593095,0.029593095
FALSE,Rich County,10/1/94,Hide,Hide,10,1994,829,829,863,863,1,34,34,0.039397451,0.039397451
FALSE,Rich County,10/1/95,Hide,Hide,10,1995,868,868,901,901,1,33,33,0.036625971,0.036625971
FALSE,Rich County,10/1/96,Hide,Hide,10,1996,928,928,959,959,1,31,31,0.032325339,0.032325339
FALSE,Rich County,10/1/97,Hide,Hide,10,1997,941,941,977,977,1,36,36,0.036847492,0.036847492
FALSE,Rich County,10/1/98,Hide,Hide,10,1998,935,935,969,969,1,34,34,0.035087719,0.035087719
FALSE,Rich County,10/1/99,Hide,Hide,10,1999,922,922,960,960,1,38,38,0.039583333,0.039583333
FALSE,Rich County,10/1/00,Hide,Hide,10,2000,1014,1014,1047,1047,1,33,33,0.031518625,0.031518625
FALSE,Rich County,10/1/01,Hide,Hide,10,2001,1250,1250,1285,1285,1,35,35,0.027237354,0.027237354
FALSE,Rich County,10/1/02,Hide,Hide,10,2002,1216,1216,1270,1270,1,54,54,0.042519685,0.042519685
FALSE,Rich County,10/1/03,Hide,Hide,10,2003,1225,1225,1271,1271,1,46,46,0.036191975,0.036191975
FALSE,Rich County,10/1/04,Hide,Hide,10,2004,1262,1262,1307,1307,1,45,45,0.034429992,0.034429992
FALSE,Rich County,10/1/05,Hide,Hide,10,2005,1259,1259,1297,1297,1,38,38,0.029298381,0.029298381
FALSE,Rich County,10/1/06,Hide,Hide,10,2006,1394,1394,1423,1423,1,29,29,0.02037948,0.02037948
FALSE,Rich County,10/1/07,Hide,Hide,10,2007,1405,1405,1439,1439,1,34,34,0.023627519,0.023627519
FALSE,Rich County,10/1/08,Hide,Hide,10,2008,1414,1414,1461,1461,1,47,47,0.032169747,0.032169747
FALSE,Rich County,10/1/09,Hide,Hide,10,2009,1338,1338,1413,1413,1,75,75,0.053078556,0.053078556
FALSE,Rich County,10/1/10,Hide,Hide,10,2010,953,953,1026,1026,1,73,73,0.071150097,0.071150097
FALSE,Rich County,10/1/11,Hide,Hide,10,2011,907,907,973,973,1,66,66,0.067831449,0.067831449
FALSE,Rich County,10/1/12,Hide,Hide,10,2012,889,889,939,939,1,50,50,0.053248136,0.053248136
FALSE,Rich County,10/1/13,Hide,Hide,10,2013,956,956,997,997,1,41,41,0.04112337,0.04112337
FALSE,Rich County,10/1/14,Hide,Hide,10,2014,961,961,999,999,1,38,38,0.038038038,0.038038038
FALSE,Rich County,10/1/15,Hide,Hide,10,2015,987,987,1025,1025,1,38,38,0.037073171,0.037073171
FALSE,Rich County,10/1/16,Hide,Hide,10,2016,1061,1061,1098,1098,1,37,37,0.033697632,0.033697632
FALSE,Rich County,10/1/17,Hide,Hide,10,2017,1130,1130,1167,1167,1,37,37,0.031705227,0.031705227
FALSE,Rich County,10/1/18,Hide,Hide,10,2018,1142,1142,1179,1179,1,37,37,0.031382528,0.031382528
FALSE,Rich County,10/1/19,Hide,Hide,10,2019,1137,1137,1172,1172,1,35,35,0.029863481,0.029863481
FALSE,Salt Lake County,10/1/92,Hide,Hide,10,1992,386720,386720,404129,404129,1,17409,17409,0.043077829,0.043077829
FALSE,Salt Lake County,10/1/93,Hide,Hide,10,1993,414534,414534,428417,428417,1,13883,13883,0.032405343,0.032405343
FALSE,Salt Lake County,10/1/94,Hide,Hide,10,1994,429824,429824,445075,445075,1,15251,15251,0.034266135,0.034266135
FALSE,Salt Lake County,10/1/95,Hide,Hide,10,1995,443349,443349,456354,456354,1,13005,13005,0.028497614,0.028497614
FALSE,Salt Lake County,10/1/96,Hide,Hide,10,1996,451607,451607,464927,464927,1,13320,13320,0.028649659,0.028649659
FALSE,Salt Lake County,10/1/97,Hide,Hide,10,1997,464258,464258,478151,478151,1,13893,13893,0.029055675,0.029055675
FALSE,Salt Lake County,10/1/98,Hide,Hide,10,1998,469473,469473,485402,485402,1,15929,15929,0.032816099,0.032816099
FALSE,Salt Lake County,10/1/99,Hide,Hide,10,1999,475650,475650,490998,490998,1,15348,15348,0.031258783,0.031258783
FALSE,Salt Lake County,10/1/00,Hide,Hide,10,2000,473807,473807,490378,490378,1,16571,16571,0.033792299,0.033792299
FALSE,Salt Lake County,10/1/01,Hide,Hide,10,2001,466002,466002,489975,489975,1,23973,23973,0.048926986,0.048926986
FALSE,Salt Lake County,10/1/02,Hide,Hide,10,2002,464485,464485,495042,495042,1,30557,30557,0.061726076,0.061726076
FALSE,Salt Lake County,10/1/03,Hide,Hide,10,2003,469967,469967,497561,497561,1,27594,27594,0.055458527,0.055458527
FALSE,Salt Lake County,10/1/04,Hide,Hide,10,2004,481397,481397,505225,505225,1,23828,23828,0.047163145,0.047163145
FALSE,Salt Lake County,10/1/05,Hide,Hide,10,2005,503194,503194,523145,523145,1,19951,19951,0.038136654,0.038136654
FALSE,Salt Lake County,10/1/06,Hide,Hide,10,2006,525439,525439,539639,539639,1,14200,14200,0.026313888,0.026313888
FALSE,Salt Lake County,10/1/07,Hide,Hide,10,2007,539267,539267,554637,554637,1,15370,15370,0.027711819,0.027711819
FALSE,Salt Lake County,10/1/08,Hide,Hide,10,2008,535308,535308,557628,557628,1,22320,22320,0.040026684,0.040026684
FALSE,Salt Lake County,10/1/09,Hide,Hide,10,2009,507288,507288,548937,548937,1,41649,41649,0.075872095,0.075872095
FALSE,Salt Lake County,10/1/10,Hide,Hide,10,2010,506463,506463,548340,548340,1,41877,41877,0.0763705,0.0763705
FALSE,Salt Lake County,10/1/11,Hide,Hide,10,2011,512916,512916,546814,546814,1,33898,33898,0.061991829,0.061991829
FALSE,Salt Lake County,10/1/12,Hide,Hide,10,2012,532633,532633,560305,560305,1,27672,27672,0.049387387,0.049387387
FALSE,Salt Lake County,10/1/13,Hide,Hide,10,2013,549317,549317,572748,572748,1,23431,23431,0.040909789,0.040909789
FALSE,Salt Lake County,10/1/14,Hide,Hide,10,2014,556257,556257,577139,577139,1,20882,20882,0.036181925,0.036181925
FALSE,Salt Lake County,10/1/15,Hide,Hide,10,2015,569287,569287,588970,588970,1,19683,19683,0.033419359,0.033419359
FALSE,Salt Lake County,10/1/16,Hide,Hide,10,2016,588242,588242,607111,607111,1,18869,18869,0.031079984,0.031079984
FALSE,Salt Lake County,10/1/17,Hide,Hide,10,2017,597484,597484,616476,616476,1,18992,18992,0.030807363,0.030807363
FALSE,Salt Lake County,10/1/18,Hide,Hide,10,2018,603246,603246,621416,621416,1,18170,18170,0.029239672,0.029239672
FALSE,Salt Lake County,10/1/19,Hide,Hide,10,2019,625845,625845,641114,641114,1,15269,15269,0.023816357,0.023816357
FALSE,San Juan County,10/1/92,Hide,Hide,10,1992,4153,4153,4598,4598,1,445,445,0.096781209,0.096781209
FALSE,San Juan County,10/1/93,Hide,Hide,10,1993,4750,4750,5126,5126,1,376,376,0.073351541,0.073351541
FALSE,San Juan County,10/1/94,Hide,Hide,10,1994,4740,4740,5172,5172,1,432,432,0.083526682,0.083526682
FALSE,San Juan County,10/1/95,Hide,Hide,10,1995,4828,4828,5271,5271,1,443,443,0.084044773,0.084044773
FALSE,San Juan County,10/1/96,Hide,Hide,10,1996,4536,4536,5040,5040,1,504,504,0.1,0.1
FALSE,San Juan County,10/1/97,Hide,Hide,10,1997,4463,4463,4844,4844,1,381,381,0.078654005,0.078654005
FALSE,San Juan County,10/1/98,Hide,Hide,10,1998,4693,4693,5090,5090,1,397,397,0.077996071,0.077996071
FALSE,San Juan County,10/1/99,Hide,Hide,10,1999,4579,4579,4924,4924,1,345,345,0.070064988,0.070064988
FALSE,San Juan County,10/1/00,Hide,Hide,10,2000,4230,4230,4623,4623,1,393,393,0.085009734,0.085009734
FALSE,San Juan County,10/1/01,Hide,Hide,10,2001,4266,4266,4650,4650,1,384,384,0.082580645,0.082580645
FALSE,San Juan County,10/1/02,Hide,Hide,10,2002,4403,4403,4824,4824,1,421,421,0.087271973,0.087271973
FALSE,San Juan County,10/1/03,Hide,Hide,10,2003,4282,4282,4716,4716,1,434,434,0.092027142,0.092027142
FALSE,San Juan County,10/1/04,Hide,Hide,10,2004,4383,4383,4813,4813,1,430,430,0.089341367,0.089341367
FALSE,San Juan County,10/1/05,Hide,Hide,10,2005,4469,4469,4825,4825,1,356,356,0.073782383,0.073782383
FALSE,San Juan County,10/1/06,Hide,Hide,10,2006,4633,4633,4916,4916,1,283,283,0.057567128,0.057567128
FALSE,San Juan County,10/1/07,Hide,Hide,10,2007,4713,4713,4995,4995,1,282,282,0.056456456,0.056456456
FALSE,San Juan County,10/1/08,Hide,Hide,10,2008,4750,4750,5103,5103,1,353,353,0.069174995,0.069174995
FALSE,San Juan County,10/1/09,Hide,Hide,10,2009,4775,4775,5451,5451,1,676,676,0.124013942,0.124013942
FALSE,San Juan County,10/1/10,Hide,Hide,10,2010,5497,5497,6160,6160,1,663,663,0.10762987,0.10762987
FALSE,San Juan County,10/1/11,Hide,Hide,10,2011,5317,5317,5885,5885,1,568,568,0.096516568,0.096516568
FALSE,San Juan County,10/1/12,Hide,Hide,10,2012,5166,5166,5645,5645,1,479,479,0.084853853,0.084853853
FALSE,San Juan County,10/1/13,Hide,Hide,10,2013,5294,5294,5741,5741,1,447,447,0.077861,0.077861
FALSE,San Juan County,10/1/14,Hide,Hide,10,2014,5140,5140,5582,5582,1,442,442,0.079183088,0.079183088
FALSE,San Juan County,10/1/15,Hide,Hide,10,2015,5232,5232,5690,5690,1,458,458,0.080492091,0.080492091
FALSE,San Juan County,10/1/16,Hide,Hide,10,2016,5292,5292,5737,5737,1,445,445,0.077566672,0.077566672
FALSE,San Juan County,10/1/17,Hide,Hide,10,2017,5323,5323,5706,5706,1,383,383,0.067122327,0.067122327
FALSE,San Juan County,10/1/18,Hide,Hide,10,2018,5378,5378,5713,5713,1,335,335,0.058638194,0.058638194
FALSE,San Juan County,10/1/19,Hide,Hide,10,2019,5429,5429,5720,5720,1,291,291,0.050874126,0.050874126
FALSE,Sanpete County,10/1/92,Hide,Hide,10,1992,6256,6256,6869,6869,1,613,613,0.08924152,0.08924152
FALSE,Sanpete County,10/1/93,Hide,Hide,10,1993,6867,6867,7315,7315,1,448,448,0.061244019,0.061244019
FALSE,Sanpete County,10/1/94,Hide,Hide,10,1994,7189,7189,7703,7703,1,514,514,0.066727249,0.066727249
FALSE,Sanpete County,10/1/95,Hide,Hide,10,1995,7408,7408,7883,7883,1,475,475,0.060256248,0.060256248
FALSE,Sanpete County,10/1/96,Hide,Hide,10,1996,7927,7927,8392,8392,1,465,465,0.055409914,0.055409914
FALSE,Sanpete County,10/1/97,Hide,Hide,10,1997,8217,8217,8660,8660,1,443,443,0.051154734,0.051154734
FALSE,Sanpete County,10/1/98,Hide,Hide,10,1998,8524,8524,9031,9031,1,507,507,0.056139962,0.056139962
FALSE,Sanpete County,10/1/99,Hide,Hide,10,1999,8494,8494,8916,8916,1,422,422,0.047330642,0.047330642
FALSE,Sanpete County,10/1/00,Hide,Hide,10,2000,9423,9423,9890,9890,1,467,467,0.047219414,0.047219414
FALSE,Sanpete County,10/1/01,Hide,Hide,10,2001,9781,9781,10347,10347,1,566,566,0.054701846,0.054701846
FALSE,Sanpete County,10/1/02,Hide,Hide,10,2002,9551,9551,10245,10245,1,694,694,0.067740361,0.067740361
FALSE,Sanpete County,10/1/03,Hide,Hide,10,2003,9616,9616,10301,10301,1,685,685,0.066498398,0.066498398
FALSE,Sanpete County,10/1/04,Hide,Hide,10,2004,9670,9670,10303,10303,1,633,633,0.061438416,0.061438416
FALSE,Sanpete County,10/1/05,Hide,Hide,10,2005,10136,10136,10664,10664,1,528,528,0.049512378,0.049512378
FALSE,Sanpete County,10/1/06,Hide,Hide,10,2006,10372,10372,10723,10723,1,351,351,0.032733377,0.032733377
FALSE,Sanpete County,10/1/07,Hide,Hide,10,2007,10604,10604,10966,10966,1,362,362,0.033011125,0.033011125
FALSE,Sanpete County,10/1/08,Hide,Hide,10,2008,10720,10720,11302,11302,1,582,582,0.051495311,0.051495311
FALSE,Sanpete County,10/1/09,Hide,Hide,10,2009,10422,10422,11399,11399,1,977,977,0.085709273,0.085709273
FALSE,Sanpete County,10/1/10,Hide,Hide,10,2010,10364,10364,11446,11446,1,1082,1082,0.09453084,0.09453084
FALSE,Sanpete County,10/1/11,Hide,Hide,10,2011,10342,10342,11152,11152,1,810,810,0.072632712,0.072632712
FALSE,Sanpete County,10/1/12,Hide,Hide,10,2012,10593,10593,11290,11290,1,697,697,0.06173605,0.06173605
FALSE,Sanpete County,10/1/13,Hide,Hide,10,2013,10307,10307,10882,10882,1,575,575,0.052839552,0.052839552
FALSE,Sanpete County,10/1/14,Hide,Hide,10,2014,10654,10654,11144,11144,1,490,490,0.043969849,0.043969849
FALSE,Sanpete County,10/1/15,Hide,Hide,10,2015,10953,10953,11426,11426,1,473,473,0.041396814,0.041396814
FALSE,Sanpete County,10/1/16,Hide,Hide,10,2016,11422,11422,11887,11887,1,465,465,0.039118365,0.039118365
FALSE,Sanpete County,10/1/17,Hide,Hide,10,2017,11673,11673,12146,12146,1,473,473,0.038942862,0.038942862
FALSE,Sanpete County,10/1/18,Hide,Hide,10,2018,12059,12059,12511,12511,1,452,452,0.036128207,0.036128207
FALSE,Sanpete County,10/1/19,Hide,Hide,10,2019,12103,12103,12485,12485,1,382,382,0.030596716,0.030596716
FALSE,Sevier County,10/1/92,Hide,Hide,10,1992,6290,6290,6758,6758,1,468,468,0.069251258,0.069251258
FALSE,Sevier County,10/1/93,Hide,Hide,10,1993,6932,6932,7284,7284,1,352,352,0.048325096,0.048325096
FALSE,Sevier County,10/1/94,Hide,Hide,10,1994,7226,7226,7599,7599,1,373,373,0.049085406,0.049085406
FALSE,Sevier County,10/1/95,Hide,Hide,10,1995,7286,7286,7652,7652,1,366,366,0.047830633,0.047830633
FALSE,Sevier County,10/1/96,Hide,Hide,10,1996,7540,7540,7909,7909,1,369,369,0.046655709,0.046655709
FALSE,Sevier County,10/1/97,Hide,Hide,10,1997,7875,7875,8189,8189,1,314,314,0.03834412,0.03834412
FALSE,Sevier County,10/1/98,Hide,Hide,10,1998,7930,7930,8301,8301,1,371,371,0.04469341,0.04469341
FALSE,Sevier County,10/1/99,Hide,Hide,10,1999,8124,8124,8444,8444,1,320,320,0.037896731,0.037896731
FALSE,Sevier County,10/1/00,Hide,Hide,10,2000,7963,7963,8326,8326,1,363,363,0.043598367,0.043598367
FALSE,Sevier County,10/1/01,Hide,Hide,10,2001,8384,8384,8803,8803,1,419,419,0.04759741,0.04759741
FALSE,Sevier County,10/1/02,Hide,Hide,10,2002,8355,8355,8864,8864,1,509,509,0.057423285,0.057423285
FALSE,Sevier County,10/1/03,Hide,Hide,10,2003,8286,8286,8788,8788,1,502,502,0.05712335,0.05712335
FALSE,Sevier County,10/1/04,Hide,Hide,10,2004,8676,8676,9140,9140,1,464,464,0.050765864,0.050765864
FALSE,Sevier County,10/1/05,Hide,Hide,10,2005,8839,8839,9225,9225,1,386,386,0.041842818,0.041842818
FALSE,Sevier County,10/1/06,Hide,Hide,10,2006,9187,9187,9472,9472,1,285,285,0.030088682,0.030088682
FALSE,Sevier County,10/1/07,Hide,Hide,10,2007,9184,9184,9476,9476,1,292,292,0.03081469,0.03081469
FALSE,Sevier County,10/1/08,Hide,Hide,10,2008,9178,9178,9669,9669,1,491,491,0.050780846,0.050780846
FALSE,Sevier County,10/1/09,Hide,Hide,10,2009,9124,9124,9939,9939,1,815,815,0.082000201,0.082000201
FALSE,Sevier County,10/1/10,Hide,Hide,10,2010,8956,8956,9747,9747,1,791,791,0.081153175,0.081153175
FALSE,Sevier County,10/1/11,Hide,Hide,10,2011,8858,8858,9510,9510,1,652,652,0.068559411,0.068559411
FALSE,Sevier County,10/1/12,Hide,Hide,10,2012,8863,8863,9418,9418,1,555,555,0.058929709,0.058929709
FALSE,Sevier County,10/1/13,Hide,Hide,10,2013,8725,8725,9200,9200,1,475,475,0.051630435,0.051630435
FALSE,Sevier County,10/1/14,Hide,Hide,10,2014,8857,8857,9270,9270,1,413,413,0.044552319,0.044552319
FALSE,Sevier County,10/1/15,Hide,Hide,10,2015,8998,8998,9425,9425,1,427,427,0.04530504,0.04530504
FALSE,Sevier County,10/1/16,Hide,Hide,10,2016,9220,9220,9631,9631,1,411,411,0.042674696,0.042674696
FALSE,Sevier County,10/1/17,Hide,Hide,10,2017,9466,9466,9842,9842,1,376,376,0.038203617,0.038203617
FALSE,Sevier County,10/1/18,Hide,Hide,10,2018,9538,9538,9872,9872,1,334,334,0.033833063,0.033833063
FALSE,Sevier County,10/1/19,Hide,Hide,10,2019,9457,9457,9744,9744,1,287,287,0.029454023,0.029454023
FALSE,State of Utah,10/1/92,Hide,Hide,10,1992,857357,857357,900092,900092,1,42735,42735,0.04747848,0.04747848
FALSE,State of Utah,10/1/93,Hide,Hide,10,1993,922271,922271,958283,958283,1,36012,36012,0.037579713,0.037579713
FALSE,State of Utah,10/1/94,Hide,Hide,10,1994,961853,961853,1000630,1000630,1,38777,38777,0.038752586,0.038752586
FALSE,State of Utah,10/1/95,Hide,Hide,10,1995,985194,985194,1019434,1019434,1,34240,34240,0.033587265,0.033587265
FALSE,State of Utah,10/1/96,Hide,Hide,10,1996,1013422,1013422,1048543,1048543,1,35121,35121,0.03349505,0.03349505
FALSE,State of Utah,10/1/97,Hide,Hide,10,1997,1044044,1044044,1078948,1078948,1,34904,34904,0.03235003,0.03235003
FALSE,State of Utah,10/1/98,Hide,Hide,10,1998,1068900,1068900,1110045,1110045,1,41145,41145,0.037066065,0.037066065
FALSE,State of Utah,10/1/99,Hide,Hide,10,1999,1086557,1086557,1124662,1124662,1,38105,38105,0.033881291,0.033881291
FALSE,State of Utah,10/1/00,Hide,Hide,10,2000,1109801,1109801,1151019,1151019,1,41218,41218,0.035810008,0.035810008
FALSE,State of Utah,10/1/01,Hide,Hide,10,2001,1111871,1111871,1168260,1168260,1,56389,56389,0.048267509,0.048267509
FALSE,State of Utah,10/1/02,Hide,Hide,10,2002,1118631,1118631,1189258,1189258,1,70627,70627,0.05938745,0.05938745
FALSE,State of Utah,10/1/03,Hide,Hide,10,2003,1141147,1141147,1207095,1207095,1,65948,65948,0.054633645,0.054633645
FALSE,State of Utah,10/1/04,Hide,Hide,10,2004,1181765,1181765,1240199,1240199,1,58434,58434,0.047116632,0.047116632
FALSE,State of Utah,10/1/05,Hide,Hide,10,2005,1237195,1237195,1287468,1287468,1,50273,50273,0.039047961,0.039047961
FALSE,State of Utah,10/1/06,Hide,Hide,10,2006,1295807,1295807,1331118,1331118,1,35311,35311,0.026527325,0.026527325
FALSE,State of Utah,10/1/07,Hide,Hide,10,2007,1330040,1330040,1368189,1368189,1,38149,38149,0.027882844,0.027882844
FALSE,State of Utah,10/1/08,Hide,Hide,10,2008,1315096,1315096,1368703,1368703,1,53607,53607,0.039166276,0.039166276
FALSE,State of Utah,10/1/09,Hide,Hide,10,2009,1252086,1252086,1356580,1356580,1,104494,104494,0.077027525,0.077027525
FALSE,State of Utah,10/1/10,Hide,Hide,10,2010,1250248,1250248,1354775,1354775,1,104527,104527,0.077154509,0.077154509
FALSE,State of Utah,10/1/11,Hide,Hide,10,2011,1266619,1266619,1351199,1351199,1,84580,84580,0.062596257,0.062596257
FALSE,State of Utah,10/1/12,Hide,Hide,10,2012,1311679,1311679,1382469,1382469,1,70790,70790,0.051205488,0.051205488
FALSE,State of Utah,10/1/13,Hide,Hide,10,2013,1353091,1353091,1414439,1414439,1,61348,61348,0.043372673,0.043372673
FALSE,State of Utah,10/1/14,Hide,Hide,10,2014,1381195,1381195,1434712,1434712,1,53517,53517,0.037301563,0.037301563
FALSE,State of Utah,10/1/15,Hide,Hide,10,2015,1417555,1417555,1470485,1470485,1,52930,52930,0.035994927,0.035994927
FALSE,State of Utah,10/1/16,Hide,Hide,10,2016,1470735,1470735,1521298,1521298,1,50563,50563,0.033236749,0.033236749
FALSE,State of Utah,10/1/17,Hide,Hide,10,2017,1507859,1507859,1557555,1557555,1,49696,49696,0.031906417,0.031906417
FALSE,State of Utah,10/1/18,Hide,Hide,10,2018,1529811,1529811,1579635,1579635,1,49824,49824,0.031541464,0.031541464
FALSE,State of Utah,10/1/19,Hide,Hide,10,2019,1569807,1569807,1610853,1610853,1,41046,41046,0.02548091,0.02548091
FALSE,Summit County,10/1/92,Hide,Hide,10,1992,9026,9026,9648,9648,1,622,622,0.06446932,0.06446932
FALSE,Summit County,10/1/93,Hide,Hide,10,1993,10133,10133,10630,10630,1,497,497,0.046754468,0.046754468
FALSE,Summit County,10/1/94,Hide,Hide,10,1994,11179,11179,11694,11694,1,515,515,0.044039678,0.044039678
FALSE,Summit County,10/1/95,Hide,Hide,10,1995,11748,11748,12223,12223,1,475,475,0.038861163,0.038861163
FALSE,Summit County,10/1/96,Hide,Hide,10,1996,12569,12569,12997,12997,1,428,428,0.032930676,0.032930676
FALSE,Summit County,10/1/97,Hide,Hide,10,1997,13089,13089,13614,13614,1,525,525,0.038563244,0.038563244
FALSE,Summit County,10/1/98,Hide,Hide,10,1998,13661,13661,14280,14280,1,619,619,0.043347339,0.043347339
FALSE,Summit County,10/1/99,Hide,Hide,10,1999,14120,14120,14780,14780,1,660,660,0.044654939,0.044654939
FALSE,Summit County,10/1/00,Hide,Hide,10,2000,18111,18111,18770,18770,1,659,659,0.035109217,0.035109217
FALSE,Summit County,10/1/01,Hide,Hide,10,2001,18045,18045,19111,19111,1,1066,1066,0.055779394,0.055779394
FALSE,Summit County,10/1/02,Hide,Hide,10,2002,18277,18277,19574,19574,1,1297,1297,0.066261367,0.066261367
FALSE,Summit County,10/1/03,Hide,Hide,10,2003,18824,18824,20017,20017,1,1193,1193,0.059599341,0.059599341
FALSE,Summit County,10/1/04,Hide,Hide,10,2004,19680,19680,20664,20664,1,984,984,0.047619048,0.047619048
FALSE,Summit County,10/1/05,Hide,Hide,10,2005,20903,20903,21719,21719,1,816,816,0.037570791,0.037570791
FALSE,Summit County,10/1/06,Hide,Hide,10,2006,21443,21443,21994,21994,1,551,551,0.025052287,0.025052287
FALSE,Summit County,10/1/07,Hide,Hide,10,2007,21467,21467,22043,22043,1,576,576,0.026130744,0.026130744
FALSE,Summit County,10/1/08,Hide,Hide,10,2008,21569,21569,22439,22439,1,870,870,0.038771781,0.038771781
FALSE,Summit County,10/1/09,Hide,Hide,10,2009,21030,21030,22682,22682,1,1652,1652,0.072833084,0.072833084
FALSE,Summit County,10/1/10,Hide,Hide,10,2010,19153,19153,20701,20701,1,1548,1548,0.074778996,0.074778996
FALSE,Summit County,10/1/11,Hide,Hide,10,2011,19863,19863,21061,21061,1,1198,1198,0.056882389,0.056882389
FALSE,Summit County,10/1/12,Hide,Hide,10,2012,20703,20703,21746,21746,1,1043,1043,0.047962844,0.047962844
FALSE,Summit County,10/1/13,Hide,Hide,10,2013,21307,21307,22176,22176,1,869,869,0.039186508,0.039186508
FALSE,Summit County,10/1/14,Hide,Hide,10,2014,21839,21839,22606,22606,1,767,767,0.033929045,0.033929045
FALSE,Summit County,10/1/15,Hide,Hide,10,2015,22531,22531,23288,23288,1,757,757,0.032506012,0.032506012
FALSE,Summit County,10/1/16,Hide,Hide,10,2016,23323,23323,24068,24068,1,745,745,0.030953964,0.030953964
FALSE,Summit County,10/1/17,Hide,Hide,10,2017,23576,23576,24327,24327,1,751,751,0.030871049,0.030871049
FALSE,Summit County,10/1/18,Hide,Hide,10,2018,23842,23842,24556,24556,1,714,714,0.029076397,0.029076397
FALSE,Summit County,10/1/19,Hide,Hide,10,2019,24821,24821,25403,25403,1,582,582,0.02291068,0.02291068
FALSE,Tooele County,10/1/92,Hide,Hide,10,1992,11623,11623,12459,12459,1,836,836,0.067100088,0.067100088
FALSE,Tooele County,10/1/93,Hide,Hide,10,1993,11498,11498,12105,12105,1,607,607,0.050144568,0.050144568
FALSE,Tooele County,10/1/94,Hide,Hide,10,1994,10992,10992,11684,11684,1,692,692,0.059226292,0.059226292
FALSE,Tooele County,10/1/95,Hide,Hide,10,1995,10787,10787,11399,11399,1,612,612,0.05368892,0.05368892
FALSE,Tooele County,10/1/96,Hide,Hide,10,1996,11194,11194,11782,11782,1,588,588,0.049906637,0.049906637
FALSE,Tooele County,10/1/97,Hide,Hide,10,1997,11533,11533,12050,12050,1,517,517,0.042904564,0.042904564
FALSE,Tooele County,10/1/98,Hide,Hide,10,1998,11890,11890,12526,12526,1,636,636,0.050774389,0.050774389
FALSE,Tooele County,10/1/99,Hide,Hide,10,1999,12751,12751,13395,13395,1,644,644,0.048077641,0.048077641
FALSE,Tooele County,10/1/00,Hide,Hide,10,2000,20134,20134,20949,20949,1,815,815,0.038904005,0.038904005
FALSE,Tooele County,10/1/01,Hide,Hide,10,2001,20547,20547,21678,21678,1,1131,1131,0.05217271,0.05217271
FALSE,Tooele County,10/1/02,Hide,Hide,10,2002,21127,21127,22588,22588,1,1461,1461,0.064680361,0.064680361
FALSE,Tooele County,10/1/03,Hide,Hide,10,2003,22079,22079,23492,23492,1,1413,1413,0.060148136,0.060148136
FALSE,Tooele County,10/1/04,Hide,Hide,10,2004,23068,23068,24340,24340,1,1272,1272,0.052259655,0.052259655
FALSE,Tooele County,10/1/05,Hide,Hide,10,2005,24480,24480,25536,25536,1,1056,1056,0.041353383,0.041353383
FALSE,Tooele County,10/1/06,Hide,Hide,10,2006,25818,25818,26603,26603,1,785,785,0.02950795,0.02950795
FALSE,Tooele County,10/1/07,Hide,Hide,10,2007,26328,26328,27179,27179,1,851,851,0.031310939,0.031310939
FALSE,Tooele County,10/1/08,Hide,Hide,10,2008,26719,26719,28016,28016,1,1297,1297,0.046294974,0.046294974
FALSE,Tooele County,10/1/09,Hide,Hide,10,2009,25546,25546,27918,27918,1,2372,2372,0.084963106,0.084963106
FALSE,Tooele County,10/1/10,Hide,Hide,10,2010,25206,25206,27437,27437,1,2231,2231,0.081313555,0.081313555
FALSE,Tooele County,10/1/11,Hide,Hide,10,2011,25475,25475,27304,27304,1,1829,1829,0.066986522,0.066986522
FALSE,Tooele County,10/1/12,Hide,Hide,10,2012,26378,26378,27987,27987,1,1609,1609,0.057490978,0.057490978
FALSE,Tooele County,10/1/13,Hide,Hide,10,2013,27209,27209,28716,28716,1,1507,1507,0.052479454,0.052479454
FALSE,Tooele County,10/1/14,Hide,Hide,10,2014,27684,27684,29030,29030,1,1346,1346,0.046365828,0.046365828
FALSE,Tooele County,10/1/15,Hide,Hide,10,2015,28608,28608,29811,29811,1,1203,1203,0.040354232,0.040354232
FALSE,Tooele County,10/1/16,Hide,Hide,10,2016,29991,29991,31138,31138,1,1147,1147,0.03683602,0.03683602
FALSE,Tooele County,10/1/17,Hide,Hide,10,2017,31279,31279,32433,32433,1,1154,1154,0.035581044,0.035581044
FALSE,Tooele County,10/1/18,Hide,Hide,10,2018,32246,32246,33359,33359,1,1113,1113,0.033364309,0.033364309
FALSE,Tooele County,10/1/19,Hide,Hide,10,2019,33351,33351,34289,34289,1,938,938,0.027355712,0.027355712
FALSE,Uintah County,10/1/92,Hide,Hide,10,1992,9161,9161,9924,9924,1,763,763,0.076884321,0.076884321
FALSE,Uintah County,10/1/93,Hide,Hide,10,1993,9439,9439,10112,10112,1,673,673,0.066554589,0.066554589
FALSE,Uintah County,10/1/94,Hide,Hide,10,1994,9454,9454,10202,10202,1,748,748,0.073318957,0.073318957
FALSE,Uintah County,10/1/95,Hide,Hide,10,1995,9514,9514,10263,10263,1,749,749,0.07298061,0.07298061
FALSE,Uintah County,10/1/96,Hide,Hide,10,1996,9584,9584,10304,10304,1,720,720,0.069875776,0.069875776
FALSE,Uintah County,10/1/97,Hide,Hide,10,1997,10129,10129,10697,10697,1,568,568,0.053099,0.053099
FALSE,Uintah County,10/1/98,Hide,Hide,10,1998,10306,10306,11037,11037,1,731,731,0.066231766,0.066231766
FALSE,Uintah County,10/1/99,Hide,Hide,10,1999,10604,10604,11233,11233,1,629,629,0.055995727,0.055995727
FALSE,Uintah County,10/1/00,Hide,Hide,10,2000,11062,11062,11570,11570,1,508,508,0.043906655,0.043906655
FALSE,Uintah County,10/1/01,Hide,Hide,10,2001,11887,11887,12471,12471,1,584,584,0.046828642,0.046828642
FALSE,Uintah County,10/1/02,Hide,Hide,10,2002,11915,11915,12713,12713,1,798,798,0.062770393,0.062770393
FALSE,Uintah County,10/1/03,Hide,Hide,10,2003,12537,12537,13268,13268,1,731,731,0.055094965,0.055094965
FALSE,Uintah County,10/1/04,Hide,Hide,10,2004,13269,13269,13935,13935,1,666,666,0.047793326,0.047793326
FALSE,Uintah County,10/1/05,Hide,Hide,10,2005,14508,14508,15029,15029,1,521,521,0.034666312,0.034666312
FALSE,Uintah County,10/1/06,Hide,Hide,10,2006,16349,16349,16694,16694,1,345,345,0.020666108,0.020666108
FALSE,Uintah County,10/1/07,Hide,Hide,10,2007,16784,16784,17173,17173,1,389,389,0.022651837,0.022651837
FALSE,Uintah County,10/1/08,Hide,Hide,10,2008,18750,18750,19206,19206,1,456,456,0.02374258,0.02374258
FALSE,Uintah County,10/1/09,Hide,Hide,10,2009,15225,15225,16993,16993,1,1768,1768,0.104042841,0.104042841
FALSE,Uintah County,10/1/10,Hide,Hide,10,2010,14022,14022,15262,15262,1,1240,1240,0.081247543,0.081247543
FALSE,Uintah County,10/1/11,Hide,Hide,10,2011,14754,14754,15588,15588,1,834,834,0.053502694,0.053502694
FALSE,Uintah County,10/1/12,Hide,Hide,10,2012,15262,15262,15978,15978,1,716,716,0.044811616,0.044811616
FALSE,Uintah County,10/1/13,Hide,Hide,10,2013,14900,14900,15558,15558,1,658,658,0.042293354,0.042293354
FALSE,Uintah County,10/1/14,Hide,Hide,10,2014,15519,15519,16113,16113,1,594,594,0.036864643,0.036864643
FALSE,Uintah County,10/1/15,Hide,Hide,10,2015,13673,13673,14878,14878,1,1205,1205,0.080992069,0.080992069
FALSE,Uintah County,10/1/16,Hide,Hide,10,2016,12642,12642,13838,13838,1,1196,1196,0.086428675,0.086428675
FALSE,Uintah County,10/1/17,Hide,Hide,10,2017,12925,12925,13678,13678,1,753,753,0.055051908,0.055051908
FALSE,Uintah County,10/1/18,Hide,Hide,10,2018,12959,12959,13565,13565,1,606,606,0.044673793,0.044673793
FALSE,Uintah County,10/1/19,Hide,Hide,10,2019,13145,13145,13711,13711,1,566,566,0.041280724,0.041280724
FALSE,United States,10/1/92,Hide,Hide,10,1992,118628,118628000,128026,128026000,1,9398,9398000,0.073,0.073
FALSE,United States,10/1/93,Hide,Hide,10,1993,120823,120823000,129573,129573000,1,8750,8750000,0.068,0.068
FALSE,United States,10/1/94,Hide,Hide,10,1994,124112,124112000,131744,131744000,1,7632,7632000,0.058,0.058
FALSE,United States,10/1/95,Hide,Hide,10,1995,125388,125388000,132716,132716000,1,7328,7328000,0.055,0.055
FALSE,United States,10/1/96,Hide,Hide,10,1996,127890,127890000,134921,134921000,1,7031,7031000,0.052,0.052
FALSE,United States,10/1/97,Hide,Hide,10,1997,130179,130179000,136633,136633000,1,6454,6454000,0.047,0.047
FALSE,United States,10/1/98,Hide,Hide,10,1998,131999,131999000,138279,138279000,1,6280,6280000,0.045,0.045
FALSE,United States,10/1/99,Hide,Hide,10,1999,133993,133993000,139771,139771000,1,5778,5778000,0.041,0.041
FALSE,United States,10/1/00,Hide,Hide,10,2000,137088,137088000,142622,142622000,1,5534,5534000,0.039,0.039
FALSE,United States,10/1/01,Hide,Hide,10,2001,136392,136392000,144086,144086000,1,7694,7694000,0.053,0.053
FALSE,United States,10/1/02,Hide,Hide,10,2002,137008,137008000,145314,145314000,1,8307,8307000,0.057,0.057
FALSE,United States,10/1/03,Hide,Hide,10,2003,137984,137984000,146716,146716000,1,8732,8732000,0.06,0.06
FALSE,United States,10/1/04,Hide,Hide,10,2004,139732,139732000,147793,147793000,1,8061,8061000,0.055,0.055
FALSE,United States,10/1/05,Hide,Hide,10,2005,142548,142548000,150001,150001000,1,7453,7453000,0.05,0.05
FALSE,United States,10/1/06,Hide,Hide,10,2006,145314,145314000,152041,152041000,1,6727,6727000,0.044,0.044
FALSE,United States,10/1/07,Hide,Hide,10,2007,145946,145946000,153183,153183000,1,7237,7237000,0.047,0.047
FALSE,United States,10/1/08,Hide,Hide,10,2008,144802,144802000,154876,154876000,1,10074,10074000,0.065,0.065
FALSE,United States,10/1/09,Hide,Hide,10,2009,138432,138432000,153784,153784000,1,15352,15352000,0.1,0.1
FALSE,United States,10/1/10,Hide,Hide,10,2010,139119,139119000,153635,153635000,1,14516,14516000,0.094,0.094
FALSE,United States,10/1/11,Hide,Hide,10,2011,140368,140368000,153961,153961000,1,13594,13594000,0.088,0.088
FALSE,United States,10/1/12,Hide,Hide,10,2012,143431,143431000,155554,155554000,1,12124,12124000,0.078,0.078
FALSE,United States,10/1/13,Hide,Hide,10,2013,143537,143537000,154673,154673000,1,11136,11136000,0.072,0.072
FALSE,United States,10/1/14,Hide,Hide,10,2014,147427,147427000,156417,156417000,1,8990,8990000,0.057,0.057
FALSE,United States,10/1/15,Hide,Hide,10,2015,149246,149246000,157167,157167000,1,7922,7922000,0.05,0.05
FALSE,United States,10/1/16,Hide,Hide,10,2016,151907,151907000,159734,159734000,1,7827,7827000,0.049,0.049
FALSE,United States,10/1/17,Hide,Hide,10,2017,153779,153779000,160378,160378000,1,6599,6599000,0.041,0.041
FALSE,United States,10/1/18,Hide,Hide,10,2018,156482,156482000,162605,162605000,1,6123,6123000,0.038,0.038
FALSE,United States,10/1/19,Hide,Hide,10,2019,158544,158544000,164401,164401000,1,5857,5857000,0.036,0.036
FALSE,Utah County,10/1/92,Hide,Hide,10,1992,125140,125140,130272,130272,1,5132,5132,0.039394498,0.039394498
FALSE,Utah County,10/1/93,Hide,Hide,10,1993,134491,134491,139120,139120,1,4629,4629,0.033273433,0.033273433
FALSE,Utah County,10/1/94,Hide,Hide,10,1994,141671,141671,146332,146332,1,4661,4661,0.031852226,0.031852226
FALSE,Utah County,10/1/95,Hide,Hide,10,1995,147583,147583,151702,151702,1,4119,4119,0.027151916,0.027151916
FALSE,Utah County,10/1/96,Hide,Hide,10,1996,151062,151062,155561,155561,1,4499,4499,0.028921131,0.028921131
FALSE,Utah County,10/1/97,Hide,Hide,10,1997,154842,154842,159062,159062,1,4220,4220,0.026530535,0.026530535
FALSE,Utah County,10/1/98,Hide,Hide,10,1998,162493,162493,167913,167913,1,5420,5420,0.03227862,0.03227862
FALSE,Utah County,10/1/99,Hide,Hide,10,1999,166974,166974,171652,171652,1,4678,4678,0.027252814,0.027252814
FALSE,Utah County,10/1/00,Hide,Hide,10,2000,177331,177331,182990,182990,1,5659,5659,0.030925187,0.030925187
FALSE,Utah County,10/1/01,Hide,Hide,10,2001,174930,174930,183559,183559,1,8629,8629,0.047009408,0.047009408
FALSE,Utah County,10/1/02,Hide,Hide,10,2002,176380,176380,187595,187595,1,11215,11215,0.059783043,0.059783043
FALSE,Utah County,10/1/03,Hide,Hide,10,2003,180399,180399,190207,190207,1,9808,9808,0.051564874,0.051564874
FALSE,Utah County,10/1/04,Hide,Hide,10,2004,190445,190445,199531,199531,1,9086,9086,0.045536784,0.045536784
FALSE,Utah County,10/1/05,Hide,Hide,10,2005,200134,200134,207961,207961,1,7827,7827,0.037636865,0.037636865
FALSE,Utah County,10/1/06,Hide,Hide,10,2006,211743,211743,217110,217110,1,5367,5367,0.024720188,0.024720188
FALSE,Utah County,10/1/07,Hide,Hide,10,2007,219207,219207,225050,225050,1,5843,5843,0.025963119,0.025963119
FALSE,Utah County,10/1/08,Hide,Hide,10,2008,214232,214232,223368,223368,1,9136,9136,0.040901114,0.040901114
FALSE,Utah County,10/1/09,Hide,Hide,10,2009,204275,204275,221409,221409,1,17134,17134,0.077386195,0.077386195
FALSE,Utah County,10/1/10,Hide,Hide,10,2010,212933,212933,229924,229924,1,16991,16991,0.073898332,0.073898332
FALSE,Utah County,10/1/11,Hide,Hide,10,2011,219040,219040,232571,232571,1,13531,13531,0.058180083,0.058180083
FALSE,Utah County,10/1/12,Hide,Hide,10,2012,230666,230666,242048,242048,1,11382,11382,0.047023731,0.047023731
FALSE,Utah County,10/1/13,Hide,Hide,10,2013,241167,241167,251159,251159,1,9992,9992,0.039783563,0.039783563
FALSE,Utah County,10/1/14,Hide,Hide,10,2014,249151,249151,257907,257907,1,8756,8756,0.033950222,0.033950222
FALSE,Utah County,10/1/15,Hide,Hide,10,2015,260509,260509,269221,269221,1,8712,8712,0.032360031,0.032360031
FALSE,Utah County,10/1/16,Hide,Hide,10,2016,274109,274109,282704,282704,1,8595,8595,0.030402824,0.030402824
FALSE,Utah County,10/1/17,Hide,Hide,10,2017,285543,285543,294042,294042,1,8499,8499,0.028904034,0.028904034
FALSE,Utah County,10/1/18,Hide,Hide,10,2018,292426,292426,300772,300772,1,8346,8346,0.027748594,0.027748594
FALSE,Utah County,10/1/19,Hide,Hide,10,2019,304043,304043,311101,311101,1,7058,7058,0.022687166,0.022687166
FALSE,Wasatch County,10/1/92,Hide,Hide,10,1992,4553,4553,4866,4866,1,313,313,0.06432388,0.06432388
FALSE,Wasatch County,10/1/93,Hide,Hide,10,1993,4845,4845,5163,5163,1,318,318,0.061592098,0.061592098
FALSE,Wasatch County,10/1/94,Hide,Hide,10,1994,5153,5153,5468,5468,1,315,315,0.057607901,0.057607901
FALSE,Wasatch County,10/1/95,Hide,Hide,10,1995,5186,5186,5435,5435,1,249,249,0.045814167,0.045814167
FALSE,Wasatch County,10/1/96,Hide,Hide,10,1996,5483,5483,5725,5725,1,242,242,0.042270742,0.042270742
FALSE,Wasatch County,10/1/97,Hide,Hide,10,1997,5703,5703,5952,5952,1,249,249,0.041834677,0.041834677
FALSE,Wasatch County,10/1/98,Hide,Hide,10,1998,5910,5910,6200,6200,1,290,290,0.046774194,0.046774194
FALSE,Wasatch County,10/1/99,Hide,Hide,10,1999,6050,6050,6351,6351,1,301,301,0.047394111,0.047394111
FALSE,Wasatch County,10/1/00,Hide,Hide,10,2000,7644,7644,7946,7946,1,302,302,0.038006544,0.038006544
FALSE,Wasatch County,10/1/01,Hide,Hide,10,2001,7700,7700,8094,8094,1,394,394,0.048678033,0.048678033
FALSE,Wasatch County,10/1/02,Hide,Hide,10,2002,7755,7755,8288,8288,1,533,533,0.064309846,0.064309846
FALSE,Wasatch County,10/1/03,Hide,Hide,10,2003,8062,8062,8574,8574,1,512,512,0.059715419,0.059715419
FALSE,Wasatch County,10/1/04,Hide,Hide,10,2004,8480,8480,8930,8930,1,450,450,0.050391937,0.050391937
FALSE,Wasatch County,10/1/05,Hide,Hide,10,2005,9086,9086,9453,9453,1,367,367,0.038823654,0.038823654
FALSE,Wasatch County,10/1/06,Hide,Hide,10,2006,10108,10108,10408,10408,1,300,300,0.028823982,0.028823982
FALSE,Wasatch County,10/1/07,Hide,Hide,10,2007,10621,10621,10939,10939,1,318,318,0.029070299,0.029070299
FALSE,Wasatch County,10/1/08,Hide,Hide,10,2008,9863,9863,10328,10328,1,465,465,0.045023238,0.045023238
FALSE,Wasatch County,10/1/09,Hide,Hide,10,2009,9299,9299,10188,10188,1,889,889,0.087259521,0.087259521
FALSE,Wasatch County,10/1/10,Hide,Hide,10,2010,10446,10446,11387,11387,1,941,941,0.082638096,0.082638096
FALSE,Wasatch County,10/1/11,Hide,Hide,10,2011,10766,10766,11509,11509,1,743,743,0.064558172,0.064558172
FALSE,Wasatch County,10/1/12,Hide,Hide,10,2012,11216,11216,11862,11862,1,646,646,0.054459619,0.054459619
FALSE,Wasatch County,10/1/13,Hide,Hide,10,2013,11783,11783,12327,12327,1,544,544,0.04413077,0.04413077
FALSE,Wasatch County,10/1/14,Hide,Hide,10,2014,12312,12312,12785,12785,1,473,473,0.03699648,0.03699648
FALSE,Wasatch County,10/1/15,Hide,Hide,10,2015,12935,12935,13411,13411,1,476,476,0.035493252,0.035493252
FALSE,Wasatch County,10/1/16,Hide,Hide,10,2016,13574,13574,14035,14035,1,461,461,0.032846455,0.032846455
FALSE,Wasatch County,10/1/17,Hide,Hide,10,2017,14329,14329,14813,14813,1,484,484,0.032674003,0.032674003
FALSE,Wasatch County,10/1/18,Hide,Hide,10,2018,14878,14878,15349,15349,1,471,471,0.030686038,0.030686038
FALSE,Wasatch County,10/1/19,Hide,Hide,10,2019,16047,16047,16472,16472,1,425,425,0.02580136,0.02580136
FALSE,Washington County,10/1/92,Hide,Hide,10,1992,22515,22515,23500,23500,1,985,985,0.041914894,0.041914894
FALSE,Washington County,10/1/93,Hide,Hide,10,1993,26617,26617,27511,27511,1,894,894,0.032496092,0.032496092
FALSE,Washington County,10/1/94,Hide,Hide,10,1994,30365,30365,31381,31381,1,1016,1016,0.032376279,0.032376279
FALSE,Washington County,10/1/95,Hide,Hide,10,1995,32387,32387,33483,33483,1,1096,1096,0.032733029,0.032733029
FALSE,Washington County,10/1/96,Hide,Hide,10,1996,33795,33795,35008,35008,1,1213,1213,0.034649223,0.034649223
FALSE,Washington County,10/1/97,Hide,Hide,10,1997,34551,34551,35726,35726,1,1175,1175,0.032889212,0.032889212
FALSE,Washington County,10/1/98,Hide,Hide,10,1998,36452,36452,37901,37901,1,1449,1449,0.038231181,0.038231181
FALSE,Washington County,10/1/99,Hide,Hide,10,1999,37777,37777,39075,39075,1,1298,1298,0.03321817,0.03321817
FALSE,Washington County,10/1/00,Hide,Hide,10,2000,38433,38433,39888,39888,1,1455,1455,0.036477136,0.036477136
FALSE,Washington County,10/1/01,Hide,Hide,10,2001,40670,40670,42503,42503,1,1833,1833,0.043126368,0.043126368
FALSE,Washington County,10/1/02,Hide,Hide,10,2002,43049,43049,45628,45628,1,2579,2579,0.056522311,0.056522311
FALSE,Washington County,10/1/03,Hide,Hide,10,2003,46162,46162,48701,48701,1,2539,2539,0.052134453,0.052134453
FALSE,Washington County,10/1/04,Hide,Hide,10,2004,51030,51030,53500,53500,1,2470,2470,0.046168224,0.046168224
FALSE,Washington County,10/1/05,Hide,Hide,10,2005,56009,56009,58255,58255,1,2246,2246,0.038554631,0.038554631
FALSE,Washington County,10/1/06,Hide,Hide,10,2006,60038,60038,61738,61738,1,1700,1700,0.027535715,0.027535715
FALSE,Washington County,10/1/07,Hide,Hide,10,2007,62468,62468,64312,64312,1,1844,1844,0.02867272,0.02867272
FALSE,Washington County,10/1/08,Hide,Hide,10,2008,57361,57361,61043,61043,1,3682,3682,0.060318136,0.060318136
FALSE,Washington County,10/1/09,Hide,Hide,10,2009,52916,52916,59160,59160,1,6244,6244,0.105544287,0.105544287
FALSE,Washington County,10/1/10,Hide,Hide,10,2010,50527,50527,56414,56414,1,5887,5887,0.104353529,0.104353529
FALSE,Washington County,10/1/11,Hide,Hide,10,2011,51447,51447,56081,56081,1,4634,4634,0.082630481,0.082630481
FALSE,Washington County,10/1/12,Hide,Hide,10,2012,54184,54184,57901,57901,1,3717,3717,0.064195782,0.064195782
FALSE,Washington County,10/1/13,Hide,Hide,10,2013,56914,56914,59942,59942,1,3028,3028,0.050515498,0.050515498
FALSE,Washington County,10/1/14,Hide,Hide,10,2014,59394,59394,62071,62071,1,2677,2677,0.043128031,0.043128031
FALSE,Washington County,10/1/15,Hide,Hide,10,2015,61810,61810,64398,64398,1,2588,2588,0.040187583,0.040187583
FALSE,Washington County,10/1/16,Hide,Hide,10,2016,65867,65867,68322,68322,1,2455,2455,0.035932789,0.035932789
FALSE,Washington County,10/1/17,Hide,Hide,10,2017,69138,69138,71610,71610,1,2472,2472,0.034520318,0.034520318
FALSE,Washington County,10/1/18,Hide,Hide,10,2018,72353,72353,74852,74852,1,2499,2499,0.033385881,0.033385881
FALSE,Washington County,10/1/19,Hide,Hide,10,2019,74829,74829,76985,76985,1,2156,2156,0.028005456,0.028005456
FALSE,Wayne County,10/1/92,Hide,Hide,10,1992,985,985,1070,1070,1,85,85,0.079439252,0.079439252
FALSE,Wayne County,10/1/93,Hide,Hide,10,1993,1051,1051,1126,1126,1,75,75,0.06660746,0.06660746
FALSE,Wayne County,10/1/94,Hide,Hide,10,1994,1101,1101,1192,1192,1,91,91,0.076342282,0.076342282
FALSE,Wayne County,10/1/95,Hide,Hide,10,1995,1263,1263,1351,1351,1,88,88,0.065136936,0.065136936
FALSE,Wayne County,10/1/96,Hide,Hide,10,1996,1266,1266,1336,1336,1,70,70,0.05239521,0.05239521
FALSE,Wayne County,10/1/97,Hide,Hide,10,1997,1381,1381,1448,1448,1,67,67,0.046270718,0.046270718
FALSE,Wayne County,10/1/98,Hide,Hide,10,1998,1349,1349,1445,1445,1,96,96,0.066435986,0.066435986
FALSE,Wayne County,10/1/99,Hide,Hide,10,1999,1413,1413,1481,1481,1,68,68,0.045914922,0.045914922
FALSE,Wayne County,10/1/00,Hide,Hide,10,2000,1252,1252,1314,1314,1,62,62,0.04718417,0.04718417
FALSE,Wayne County,10/1/01,Hide,Hide,10,2001,1452,1452,1520,1520,1,68,68,0.044736842,0.044736842
FALSE,Wayne County,10/1/02,Hide,Hide,10,2002,1297,1297,1394,1394,1,97,97,0.069583931,0.069583931
FALSE,Wayne County,10/1/03,Hide,Hide,10,2003,1203,1203,1297,1297,1,94,94,0.072474942,0.072474942
FALSE,Wayne County,10/1/04,Hide,Hide,10,2004,1227,1227,1313,1313,1,86,86,0.065498858,0.065498858
FALSE,Wayne County,10/1/05,Hide,Hide,10,2005,1294,1294,1365,1365,1,71,71,0.052014652,0.052014652
FALSE,Wayne County,10/1/06,Hide,Hide,10,2006,1328,1328,1382,1382,1,54,54,0.039073806,0.039073806
FALSE,Wayne County,10/1/07,Hide,Hide,10,2007,1332,1332,1391,1391,1,59,59,0.042415528,0.042415528
FALSE,Wayne County,10/1/08,Hide,Hide,10,2008,1351,1351,1442,1442,1,91,91,0.063106796,0.063106796
FALSE,Wayne County,10/1/09,Hide,Hide,10,2009,1384,1384,1510,1510,1,126,126,0.083443709,0.083443709
FALSE,Wayne County,10/1/10,Hide,Hide,10,2010,1436,1436,1573,1573,1,137,137,0.087094723,0.087094723
FALSE,Wayne County,10/1/11,Hide,Hide,10,2011,1211,1211,1362,1362,1,151,151,0.110866373,0.110866373
FALSE,Wayne County,10/1/12,Hide,Hide,10,2012,1206,1206,1356,1356,1,150,150,0.110619469,0.110619469
FALSE,Wayne County,10/1/13,Hide,Hide,10,2013,1255,1255,1404,1404,1,149,149,0.106125356,0.106125356
FALSE,Wayne County,10/1/14,Hide,Hide,10,2014,1255,1255,1384,1384,1,129,129,0.093208092,0.093208092
FALSE,Wayne County,10/1/15,Hide,Hide,10,2015,1296,1296,1422,1422,1,126,126,0.088607595,0.088607595
FALSE,Wayne County,10/1/16,Hide,Hide,10,2016,1303,1303,1414,1414,1,111,111,0.078500707,0.078500707
FALSE,Wayne County,10/1/17,Hide,Hide,10,2017,1368,1368,1470,1470,1,102,102,0.069387755,0.069387755
FALSE,Wayne County,10/1/18,Hide,Hide,10,2018,1330,1330,1408,1408,1,78,78,0.055397727,0.055397727
FALSE,Wayne County,10/1/19,Hide,Hide,10,2019,1353,1353,1427,1427,1,74,74,0.051857043,0.051857043
FALSE,Weber County,10/1/92,Hide,Hide,10,1992,79343,79343,84422,84422,1,5079,5079,0.060162043,0.060162043
FALSE,Weber County,10/1/93,Hide,Hide,10,1993,84915,84915,89178,89178,1,4263,4263,0.04780327,0.04780327
FALSE,Weber County,10/1/94,Hide,Hide,10,1994,88388,88388,92686,92686,1,4298,4298,0.04637162,0.04637162
FALSE,Weber County,10/1/95,Hide,Hide,10,1995,89028,89028,92790,92790,1,3762,3762,0.040543162,0.040543162
FALSE,Weber County,10/1/96,Hide,Hide,10,1996,92879,92879,96899,96899,1,4020,4020,0.041486496,0.041486496
FALSE,Weber County,10/1/97,Hide,Hide,10,1997,95823,95823,99881,99881,1,4058,4058,0.040628348,0.040628348
FALSE,Weber County,10/1/98,Hide,Hide,10,1998,97078,97078,101841,101841,1,4763,4763,0.046768983,0.046768983
FALSE,Weber County,10/1/99,Hide,Hide,10,1999,98622,98622,102965,102965,1,4343,4343,0.042179381,0.042179381
FALSE,Weber County,10/1/00,Hide,Hide,10,2000,95936,95936,100492,100492,1,4556,4556,0.045336942,0.045336942
FALSE,Weber County,10/1/01,Hide,Hide,10,2001,96141,96141,101707,101707,1,5566,5566,0.05472583,0.05472583
FALSE,Weber County,10/1/02,Hide,Hide,10,2002,97797,97797,104450,104450,1,6653,6653,0.063695548,0.063695548
FALSE,Weber County,10/1/03,Hide,Hide,10,2003,99467,99467,106098,106098,1,6631,6631,0.062498822,0.062498822
FALSE,Weber County,10/1/04,Hide,Hide,10,2004,101962,101962,107543,107543,1,5581,5581,0.051895521,0.051895521
FALSE,Weber County,10/1/05,Hide,Hide,10,2005,104108,104108,109043,109043,1,4935,4935,0.045257376,0.045257376
FALSE,Weber County,10/1/06,Hide,Hide,10,2006,106944,106944,110121,110121,1,3177,3177,0.028850083,0.028850083
FALSE,Weber County,10/1/07,Hide,Hide,10,2007,109697,109697,113478,113478,1,3781,3781,0.033319234,0.033319234
FALSE,Weber County,10/1/08,Hide,Hide,10,2008,108436,108436,114141,114141,1,5705,5705,0.04998204,0.04998204
FALSE,Weber County,10/1/09,Hide,Hide,10,2009,103792,103792,113986,113986,1,10194,10194,0.089432036,0.089432036
FALSE,Weber County,10/1/10,Hide,Hide,10,2010,103132,103132,113149,113149,1,10017,10017,0.088529284,0.088529284
FALSE,Weber County,10/1/11,Hide,Hide,10,2011,104248,104248,112574,112574,1,8326,8326,0.073960239,0.073960239
FALSE,Weber County,10/1/12,Hide,Hide,10,2012,106872,106872,113652,113652,1,6780,6780,0.059655791,0.059655791
FALSE,Weber County,10/1/13,Hide,Hide,10,2013,109126,109126,115002,115002,1,5876,5876,0.051094764,0.051094764
FALSE,Weber County,10/1/14,Hide,Hide,10,2014,110243,110243,115220,115220,1,4977,4977,0.043195626,0.043195626
FALSE,Weber County,10/1/15,Hide,Hide,10,2015,113015,113015,117778,117778,1,4763,4763,0.04044049,0.04044049
FALSE,Weber County,10/1/16,Hide,Hide,10,2016,116968,116968,121459,121459,1,4491,4491,0.03697544,0.03697544
FALSE,Weber County,10/1/17,Hide,Hide,10,2017,119161,119161,123794,123794,1,4633,4633,0.037425077,0.037425077
FALSE,Weber County,10/1/18,Hide,Hide,10,2018,121028,121028,125264,125264,1,4236,4236,0.033816579,0.033816579
FALSE,Weber County,10/1/19,Hide,Hide,10,2019,125020,125020,128262,128262,1,3242,3242,0.025276387,0.025276387
FALSE,Beaver County,11/1/92,Hide,Hide,11,1992,1959,1959,2052,2052,1,93,93,0.045321637,0.045321637
FALSE,Beaver County,11/1/93,Hide,Hide,11,1993,2055,2055,2151,2151,1,96,96,0.044630404,0.044630404
FALSE,Beaver County,11/1/94,Hide,Hide,11,1994,2195,2195,2275,2275,1,80,80,0.035164835,0.035164835
FALSE,Beaver County,11/1/95,Hide,Hide,11,1995,2305,2305,2426,2426,1,121,121,0.04987634,0.04987634
FALSE,Beaver County,11/1/96,Hide,Hide,11,1996,2422,2422,2567,2567,1,145,145,0.056486171,0.056486171
FALSE,Beaver County,11/1/97,Hide,Hide,11,1997,2428,2428,2530,2530,1,102,102,0.040316206,0.040316206
FALSE,Beaver County,11/1/98,Hide,Hide,11,1998,2358,2358,2458,2458,1,100,100,0.040683483,0.040683483
FALSE,Beaver County,11/1/99,Hide,Hide,11,1999,2416,2416,2509,2509,1,93,93,0.03706656,0.03706656
FALSE,Beaver County,11/1/00,Hide,Hide,11,2000,2582,2582,2680,2680,1,98,98,0.036567164,0.036567164
FALSE,Beaver County,11/1/01,Hide,Hide,11,2001,3140,3140,3264,3264,1,124,124,0.037990196,0.037990196
FALSE,Beaver County,11/1/02,Hide,Hide,11,2002,2934,2934,3090,3090,1,156,156,0.050485437,0.050485437
FALSE,Beaver County,11/1/03,Hide,Hide,11,2003,2772,2772,2921,2921,1,149,149,0.051009928,0.051009928
FALSE,Beaver County,11/1/04,Hide,Hide,11,2004,2746,2746,2877,2877,1,131,131,0.045533542,0.045533542
FALSE,Beaver County,11/1/05,Hide,Hide,11,2005,2977,2977,3101,3101,1,124,124,0.039987101,0.039987101
FALSE,Beaver County,11/1/06,Hide,Hide,11,2006,3084,3084,3165,3165,1,81,81,0.025592417,0.025592417
FALSE,Beaver County,11/1/07,Hide,Hide,11,2007,3070,3070,3154,3154,1,84,84,0.026632847,0.026632847
FALSE,Beaver County,11/1/08,Hide,Hide,11,2008,3138,3138,3295,3295,1,157,157,0.047647951,0.047647951
FALSE,Beaver County,11/1/09,Hide,Hide,11,2009,3272,3272,3528,3528,1,256,256,0.072562358,0.072562358
FALSE,Beaver County,11/1/10,Hide,Hide,11,2010,2851,2851,3146,3146,1,295,295,0.093769866,0.093769866
FALSE,Beaver County,11/1/11,Hide,Hide,11,2011,2758,2758,2977,2977,1,219,219,0.073563991,0.073563991
FALSE,Beaver County,11/1/12,Hide,Hide,11,2012,2814,2814,2975,2975,1,161,161,0.054117647,0.054117647
FALSE,Beaver County,11/1/13,Hide,Hide,11,2013,2895,2895,3025,3025,1,130,130,0.042975207,0.042975207
FALSE,Beaver County,11/1/14,Hide,Hide,11,2014,2887,2887,3002,3002,1,115,115,0.038307795,0.038307795
FALSE,Beaver County,11/1/15,Hide,Hide,11,2015,2967,2967,3083,3083,1,116,116,0.037625689,0.037625689
FALSE,Beaver County,11/1/16,Hide,Hide,11,2016,2870,2870,3030,3030,1,160,160,0.052805281,0.052805281
FALSE,Beaver County,11/1/17,Hide,Hide,11,2017,2947,2947,3062,3062,1,115,115,0.037557152,0.037557152
FALSE,Beaver County,11/1/18,Hide,Hide,11,2018,2879,2879,2973,2973,1,94,94,0.031617894,0.031617894
FALSE,Beaver County,11/1/19,Hide,Hide,11,2019,2737,2737,2814,2814,1,77,77,0.027363184,0.027363184
FALSE,Box Elder County,11/1/92,Hide,Hide,11,1992,15261,15261,16184,16184,1,923,923,0.057031636,0.057031636
FALSE,Box Elder County,11/1/93,Hide,Hide,11,1993,16982,16982,17892,17892,1,910,910,0.05086072,0.05086072
FALSE,Box Elder County,11/1/94,Hide,Hide,11,1994,17381,17381,18262,18262,1,881,881,0.048242252,0.048242252
FALSE,Box Elder County,11/1/95,Hide,Hide,11,1995,16858,16858,17665,17665,1,807,807,0.045683555,0.045683555
FALSE,Box Elder County,11/1/96,Hide,Hide,11,1996,17509,17509,18244,18244,1,735,735,0.040287218,0.040287218
FALSE,Box Elder County,11/1/97,Hide,Hide,11,1997,18228,18228,19002,19002,1,774,774,0.040732554,0.040732554
FALSE,Box Elder County,11/1/98,Hide,Hide,11,1998,18302,18302,19175,19175,1,873,873,0.045528031,0.045528031
FALSE,Box Elder County,11/1/99,Hide,Hide,11,1999,17662,17662,18415,18415,1,753,753,0.040890578,0.040890578
FALSE,Box Elder County,11/1/00,Hide,Hide,11,2000,19363,19363,20176,20176,1,813,813,0.0402954,0.0402954
FALSE,Box Elder County,11/1/01,Hide,Hide,11,2001,20065,20065,21111,21111,1,1046,1046,0.049547629,0.049547629
FALSE,Box Elder County,11/1/02,Hide,Hide,11,2002,19894,19894,21124,21124,1,1230,1230,0.058227608,0.058227608
FALSE,Box Elder County,11/1/03,Hide,Hide,11,2003,20531,20531,21688,21688,1,1157,1157,0.053347473,0.053347473
FALSE,Box Elder County,11/1/04,Hide,Hide,11,2004,20700,20700,21761,21761,1,1061,1061,0.048756951,0.048756951
FALSE,Box Elder County,11/1/05,Hide,Hide,11,2005,21839,21839,22749,22749,1,910,910,0.040001758,0.040001758
FALSE,Box Elder County,11/1/06,Hide,Hide,11,2006,22393,22393,23019,23019,1,626,626,0.027194926,0.027194926
FALSE,Box Elder County,11/1/07,Hide,Hide,11,2007,22967,22967,23621,23621,1,654,654,0.027687227,0.027687227
FALSE,Box Elder County,11/1/08,Hide,Hide,11,2008,22338,22338,23751,23751,1,1413,1413,0.059492232,0.059492232
FALSE,Box Elder County,11/1/09,Hide,Hide,11,2009,21353,21353,23267,23267,1,1914,1914,0.082262432,0.082262432
FALSE,Box Elder County,11/1/10,Hide,Hide,11,2010,21545,21545,23587,23587,1,2042,2042,0.086573112,0.086573112
FALSE,Box Elder County,11/1/11,Hide,Hide,11,2011,21574,21574,23100,23100,1,1526,1526,0.066060606,0.066060606
FALSE,Box Elder County,11/1/12,Hide,Hide,11,2012,21824,21824,23062,23062,1,1238,1238,0.053681381,0.053681381
FALSE,Box Elder County,11/1/13,Hide,Hide,11,2013,22262,22262,23262,23262,1,1000,1000,0.042988565,0.042988565
FALSE,Box Elder County,11/1/14,Hide,Hide,11,2014,22717,22717,23624,23624,1,907,907,0.038393159,0.038393159
FALSE,Box Elder County,11/1/15,Hide,Hide,11,2015,23218,23218,24091,24091,1,873,873,0.036237599,0.036237599
FALSE,Box Elder County,11/1/16,Hide,Hide,11,2016,24116,24116,24970,24970,1,854,854,0.034201041,0.034201041
FALSE,Box Elder County,11/1/17,Hide,Hide,11,2017,24663,24663,25453,25453,1,790,790,0.031037599,0.031037599
FALSE,Box Elder County,11/1/18,Hide,Hide,11,2018,24758,24758,25502,25502,1,744,744,0.029174182,0.029174182
FALSE,Box Elder County,11/1/19,Hide,Hide,11,2019,25421,25421,26047,26047,1,626,626,0.024033478,0.024033478
FALSE,Cache County,11/1/92,Hide,Hide,11,1992,35595,35595,36859,36859,1,1264,1264,0.034292846,0.034292846
FALSE,Cache County,11/1/93,Hide,Hide,11,1993,38684,38684,39887,39887,1,1203,1203,0.030160203,0.030160203
FALSE,Cache County,11/1/94,Hide,Hide,11,1994,40027,40027,41343,41343,1,1316,1316,0.031831265,0.031831265
FALSE,Cache County,11/1/95,Hide,Hide,11,1995,40669,40669,41907,41907,1,1238,1238,0.029541604,0.029541604
FALSE,Cache County,11/1/96,Hide,Hide,11,1996,40956,40956,42150,42150,1,1194,1194,0.028327402,0.028327402
FALSE,Cache County,11/1/97,Hide,Hide,11,1997,42408,42408,43539,43539,1,1131,1131,0.025976711,0.025976711
FALSE,Cache County,11/1/98,Hide,Hide,11,1998,43716,43716,45020,45020,1,1304,1304,0.028964904,0.028964904
FALSE,Cache County,11/1/99,Hide,Hide,11,1999,44646,44646,45830,45830,1,1184,1184,0.025834606,0.025834606
FALSE,Cache County,11/1/00,Hide,Hide,11,2000,47368,47368,48837,48837,1,1469,1469,0.030079653,0.030079653
FALSE,Cache County,11/1/01,Hide,Hide,11,2001,49376,49376,51258,51258,1,1882,1882,0.03671622,0.03671622
FALSE,Cache County,11/1/02,Hide,Hide,11,2002,50951,50951,53237,53237,1,2286,2286,0.04294006,0.04294006
FALSE,Cache County,11/1/03,Hide,Hide,11,2003,52918,52918,54984,54984,1,2066,2066,0.037574567,0.037574567
FALSE,Cache County,11/1/04,Hide,Hide,11,2004,54362,54362,56355,56355,1,1993,1993,0.035365096,0.035365096
FALSE,Cache County,11/1/05,Hide,Hide,11,2005,55618,55618,57410,57410,1,1792,1792,0.031214074,0.031214074
FALSE,Cache County,11/1/06,Hide,Hide,11,2006,57633,57633,58837,58837,1,1204,1204,0.020463314,0.020463314
FALSE,Cache County,11/1/07,Hide,Hide,11,2007,60112,60112,61537,61537,1,1425,1425,0.0231568,0.0231568
FALSE,Cache County,11/1/08,Hide,Hide,11,2008,59195,59195,61488,61488,1,2293,2293,0.037291829,0.037291829
FALSE,Cache County,11/1/09,Hide,Hide,11,2009,57373,57373,60783,60783,1,3410,3410,0.056101213,0.056101213
FALSE,Cache County,11/1/10,Hide,Hide,11,2010,54134,54134,57558,57558,1,3424,3424,0.059487821,0.059487821
FALSE,Cache County,11/1/11,Hide,Hide,11,2011,53531,53531,56251,56251,1,2720,2720,0.048354696,0.048354696
FALSE,Cache County,11/1/12,Hide,Hide,11,2012,54783,54783,57256,57256,1,2473,2473,0.04319198,0.04319198
FALSE,Cache County,11/1/13,Hide,Hide,11,2013,56163,56163,58257,58257,1,2094,2094,0.035944178,0.035944178
FALSE,Cache County,11/1/14,Hide,Hide,11,2014,57441,57441,59303,59303,1,1862,1862,0.031398074,0.031398074
FALSE,Cache County,11/1/15,Hide,Hide,11,2015,58352,58352,60262,60262,1,1910,1910,0.031694932,0.031694932
FALSE,Cache County,11/1/16,Hide,Hide,11,2016,59967,59967,61773,61773,1,1806,1806,0.029236074,0.029236074
FALSE,Cache County,11/1/17,Hide,Hide,11,2017,61380,61380,63076,63076,1,1696,1696,0.026888198,0.026888198
FALSE,Cache County,11/1/18,Hide,Hide,11,2018,62081,62081,63709,63709,1,1628,1628,0.025553689,0.025553689
FALSE,Cache County,11/1/19,Hide,Hide,11,2019,63193,63193,64518,64518,1,1325,1325,0.020536904,0.020536904
FALSE,Carbon County,11/1/92,Hide,Hide,11,1992,8160,8160,8971,8971,1,811,811,0.090402408,0.090402408
FALSE,Carbon County,11/1/93,Hide,Hide,11,1993,8615,8615,9230,9230,1,615,615,0.066630553,0.066630553
FALSE,Carbon County,11/1/94,Hide,Hide,11,1994,8630,8630,9287,9287,1,657,657,0.070744051,0.070744051
FALSE,Carbon County,11/1/95,Hide,Hide,11,1995,8556,8556,9127,9127,1,571,571,0.06256163,0.06256163
FALSE,Carbon County,11/1/96,Hide,Hide,11,1996,9010,9010,9558,9558,1,548,548,0.05733417,0.05733417
FALSE,Carbon County,11/1/97,Hide,Hide,11,1997,9223,9223,9722,9722,1,499,499,0.051326887,0.051326887
FALSE,Carbon County,11/1/98,Hide,Hide,11,1998,9286,9286,9995,9995,1,709,709,0.070935468,0.070935468
FALSE,Carbon County,11/1/99,Hide,Hide,11,1999,9154,9154,9686,9686,1,532,532,0.054924633,0.054924633
FALSE,Carbon County,11/1/00,Hide,Hide,11,2000,8424,8424,8996,8996,1,572,572,0.063583815,0.063583815
FALSE,Carbon County,11/1/01,Hide,Hide,11,2001,8700,8700,9258,9258,1,558,558,0.060272197,0.060272197
FALSE,Carbon County,11/1/02,Hide,Hide,11,2002,8749,8749,9483,9483,1,734,734,0.077401666,0.077401666
FALSE,Carbon County,11/1/03,Hide,Hide,11,2003,8588,8588,9301,9301,1,713,713,0.076658424,0.076658424
FALSE,Carbon County,11/1/04,Hide,Hide,11,2004,8743,8743,9296,9296,1,553,553,0.059487952,0.059487952
FALSE,Carbon County,11/1/05,Hide,Hide,11,2005,9286,9286,9717,9717,1,431,431,0.044355254,0.044355254
FALSE,Carbon County,11/1/06,Hide,Hide,11,2006,9589,9589,9877,9877,1,288,288,0.029158651,0.029158651
FALSE,Carbon County,11/1/07,Hide,Hide,11,2007,9151,9151,9544,9544,1,393,393,0.041177703,0.041177703
FALSE,Carbon County,11/1/08,Hide,Hide,11,2008,9976,9976,10480,10480,1,504,504,0.048091603,0.048091603
FALSE,Carbon County,11/1/09,Hide,Hide,11,2009,9330,9330,10255,10255,1,925,925,0.090199902,0.090199902
FALSE,Carbon County,11/1/10,Hide,Hide,11,2010,9052,9052,9884,9884,1,832,832,0.084176447,0.084176447
FALSE,Carbon County,11/1/11,Hide,Hide,11,2011,8793,8793,9470,9470,1,677,677,0.071488912,0.071488912
FALSE,Carbon County,11/1/12,Hide,Hide,11,2012,8419,8419,9056,9056,1,637,637,0.070340106,0.070340106
FALSE,Carbon County,11/1/13,Hide,Hide,11,2013,8328,8328,8837,8837,1,509,509,0.057598733,0.057598733
FALSE,Carbon County,11/1/14,Hide,Hide,11,2014,8303,8303,8734,8734,1,431,431,0.049347378,0.049347378
FALSE,Carbon County,11/1/15,Hide,Hide,11,2015,8084,8084,8618,8618,1,534,534,0.061963333,0.061963333
FALSE,Carbon County,11/1/16,Hide,Hide,11,2016,7736,7736,8203,8203,1,467,467,0.056930391,0.056930391
FALSE,Carbon County,11/1/17,Hide,Hide,11,2017,7945,7945,8347,8347,1,402,402,0.048161016,0.048161016
FALSE,Carbon County,11/1/18,Hide,Hide,11,2018,8110,8110,8457,8457,1,347,347,0.041031098,0.041031098
FALSE,Carbon County,11/1/19,Hide,Hide,11,2019,8261,8261,8559,8559,1,298,298,0.034817152,0.034817152
FALSE,Daggett County,11/1/92,Hide,Hide,11,1992,389,389,410,410,1,21,21,0.051219512,0.051219512
FALSE,Daggett County,11/1/93,Hide,Hide,11,1993,388,388,400,400,1,12,12,0.03,0.03
FALSE,Daggett County,11/1/94,Hide,Hide,11,1994,436,436,474,474,1,38,38,0.080168776,0.080168776
FALSE,Daggett County,11/1/95,Hide,Hide,11,1995,416,416,432,432,1,16,16,0.037037037,0.037037037
FALSE,Daggett County,11/1/96,Hide,Hide,11,1996,392,392,409,409,1,17,17,0.041564792,0.041564792
FALSE,Daggett County,11/1/97,Hide,Hide,11,1997,391,391,409,409,1,18,18,0.04400978,0.04400978
FALSE,Daggett County,11/1/98,Hide,Hide,11,1998,404,404,419,419,1,15,15,0.035799523,0.035799523
FALSE,Daggett County,11/1/99,Hide,Hide,11,1999,447,447,462,462,1,15,15,0.032467532,0.032467532
FALSE,Daggett County,11/1/00,Hide,Hide,11,2000,433,433,454,454,1,21,21,0.046255507,0.046255507
FALSE,Daggett County,11/1/01,Hide,Hide,11,2001,498,498,521,521,1,23,23,0.044145873,0.044145873
FALSE,Daggett County,11/1/02,Hide,Hide,11,2002,486,486,512,512,1,26,26,0.05078125,0.05078125
FALSE,Daggett County,11/1/03,Hide,Hide,11,2003,459,459,484,484,1,25,25,0.051652893,0.051652893
FALSE,Daggett County,11/1/04,Hide,Hide,11,2004,437,437,463,463,1,26,26,0.056155508,0.056155508
FALSE,Daggett County,11/1/05,Hide,Hide,11,2005,498,498,526,526,1,28,28,0.053231939,0.053231939
FALSE,Daggett County,11/1/06,Hide,Hide,11,2006,471,471,491,491,1,20,20,0.040733198,0.040733198
FALSE,Daggett County,11/1/07,Hide,Hide,11,2007,501,501,520,520,1,19,19,0.036538462,0.036538462
FALSE,Daggett County,11/1/08,Hide,Hide,11,2008,432,432,452,452,1,20,20,0.044247788,0.044247788
FALSE,Daggett County,11/1/09,Hide,Hide,11,2009,470,470,502,502,1,32,32,0.06374502,0.06374502
FALSE,Daggett County,11/1/10,Hide,Hide,11,2010,461,461,496,496,1,35,35,0.070564516,0.070564516
FALSE,Daggett County,11/1/11,Hide,Hide,11,2011,434,434,458,458,1,24,24,0.052401747,0.052401747
FALSE,Daggett County,11/1/12,Hide,Hide,11,2012,418,418,439,439,1,21,21,0.047835991,0.047835991
FALSE,Daggett County,11/1/13,Hide,Hide,11,2013,404,404,423,423,1,19,19,0.044917258,0.044917258
FALSE,Daggett County,11/1/14,Hide,Hide,11,2014,430,430,450,450,1,20,20,0.044444444,0.044444444
FALSE,Daggett County,11/1/15,Hide,Hide,11,2015,447,447,470,470,1,23,23,0.04893617,0.04893617
FALSE,Daggett County,11/1/16,Hide,Hide,11,2016,414,414,435,435,1,21,21,0.048275862,0.048275862
FALSE,Daggett County,11/1/17,Hide,Hide,11,2017,400,400,422,422,1,22,22,0.052132701,0.052132701
FALSE,Daggett County,11/1/18,Hide,Hide,11,2018,374,374,391,391,1,17,17,0.043478261,0.043478261
FALSE,Daggett County,11/1/19,Hide,Hide,11,2019,380,380,395,395,1,15,15,0.037974684,0.037974684
FALSE,Davis County,11/1/92,Hide,Hide,11,1992,92039,92039,96140,96140,1,4101,4101,0.042656543,0.042656543
FALSE,Davis County,11/1/93,Hide,Hide,11,1993,99247,99247,102710,102710,1,3463,3463,0.033716289,0.033716289
FALSE,Davis County,11/1/94,Hide,Hide,11,1994,102850,102850,106794,106794,1,3944,3944,0.036930914,0.036930914
FALSE,Davis County,11/1/95,Hide,Hide,11,1995,103884,103884,107281,107281,1,3397,3397,0.031664507,0.031664507
FALSE,Davis County,11/1/96,Hide,Hide,11,1996,109438,109438,112963,112963,1,3525,3525,0.031204908,0.031204908
FALSE,Davis County,11/1/97,Hide,Hide,11,1997,113885,113885,117536,117536,1,3651,3651,0.031062823,0.031062823
FALSE,Davis County,11/1/98,Hide,Hide,11,1998,117851,117851,121876,121876,1,4025,4025,0.03302537,0.03302537
FALSE,Davis County,11/1/99,Hide,Hide,11,1999,120410,120410,124230,124230,1,3820,3820,0.030749416,0.030749416
FALSE,Davis County,11/1/00,Hide,Hide,11,2000,116370,116370,120559,120559,1,4189,4189,0.034746473,0.034746473
FALSE,Davis County,11/1/01,Hide,Hide,11,2001,116937,116937,122361,122361,1,5424,5424,0.04432785,0.04432785
FALSE,Davis County,11/1/02,Hide,Hide,11,2002,119595,119595,126167,126167,1,6572,6572,0.052089691,0.052089691
FALSE,Davis County,11/1/03,Hide,Hide,11,2003,123284,123284,129872,129872,1,6588,6588,0.05072687,0.05072687
FALSE,Davis County,11/1/04,Hide,Hide,11,2004,127860,127860,133617,133617,1,5757,5757,0.043085835,0.043085835
FALSE,Davis County,11/1/05,Hide,Hide,11,2005,132431,132431,137543,137543,1,5112,5112,0.037166559,0.037166559
FALSE,Davis County,11/1/06,Hide,Hide,11,2006,138461,138461,142033,142033,1,3572,3572,0.025149085,0.025149085
FALSE,Davis County,11/1/07,Hide,Hide,11,2007,141881,141881,145957,145957,1,4076,4076,0.027926033,0.027926033
FALSE,Davis County,11/1/08,Hide,Hide,11,2008,139618,139618,145986,145986,1,6368,6368,0.043620621,0.043620621
FALSE,Davis County,11/1/09,Hide,Hide,11,2009,134401,134401,144614,144614,1,10213,10213,0.070622485,0.070622485
FALSE,Davis County,11/1/10,Hide,Hide,11,2010,136548,136548,146616,146616,1,10068,10068,0.068669177,0.068669177
FALSE,Davis County,11/1/11,Hide,Hide,11,2011,139052,139052,147124,147124,1,8072,8072,0.054865284,0.054865284
FALSE,Davis County,11/1/12,Hide,Hide,11,2012,142978,142978,149918,149918,1,6940,6940,0.046291973,0.046291973
FALSE,Davis County,11/1/13,Hide,Hide,11,2013,147987,147987,154030,154030,1,6043,6043,0.039232617,0.039232617
FALSE,Davis County,11/1/14,Hide,Hide,11,2014,151439,151439,156904,156904,1,5465,5465,0.034830215,0.034830215
FALSE,Davis County,11/1/15,Hide,Hide,11,2015,156021,156021,161441,161441,1,5420,5420,0.033572636,0.033572636
FALSE,Davis County,11/1/16,Hide,Hide,11,2016,161704,161704,166778,166778,1,5074,5074,0.030423677,0.030423677
FALSE,Davis County,11/1/17,Hide,Hide,11,2017,164018,164018,169188,169188,1,5170,5170,0.030557723,0.030557723
FALSE,Davis County,11/1/18,Hide,Hide,11,2018,166058,166058,170792,170792,1,4734,4734,0.027717926,0.027717926
FALSE,Davis County,11/1/19,Hide,Hide,11,2019,171561,171561,175510,175510,1,3949,3949,0.022500142,0.022500142
FALSE,Duchesne County,11/1/92,Hide,Hide,11,1992,5024,5024,5494,5494,1,470,470,0.08554787,0.08554787
FALSE,Duchesne County,11/1/93,Hide,Hide,11,1993,5364,5364,5852,5852,1,488,488,0.083390294,0.083390294
FALSE,Duchesne County,11/1/94,Hide,Hide,11,1994,5407,5407,5984,5984,1,577,577,0.096423797,0.096423797
FALSE,Duchesne County,11/1/95,Hide,Hide,11,1995,5186,5186,5700,5700,1,514,514,0.090175439,0.090175439
FALSE,Duchesne County,11/1/96,Hide,Hide,11,1996,5415,5415,5884,5884,1,469,469,0.079707682,0.079707682
FALSE,Duchesne County,11/1/97,Hide,Hide,11,1997,5677,5677,6040,6040,1,363,363,0.060099338,0.060099338
FALSE,Duchesne County,11/1/98,Hide,Hide,11,1998,5564,5564,6110,6110,1,546,546,0.089361702,0.089361702
FALSE,Duchesne County,11/1/99,Hide,Hide,11,1999,5383,5383,5778,5778,1,395,395,0.068362755,0.068362755
FALSE,Duchesne County,11/1/00,Hide,Hide,11,2000,5967,5967,6269,6269,1,302,302,0.048173552,0.048173552
FALSE,Duchesne County,11/1/01,Hide,Hide,11,2001,6734,6734,7138,7138,1,404,404,0.056598487,0.056598487
FALSE,Duchesne County,11/1/02,Hide,Hide,11,2002,6518,6518,7020,7020,1,502,502,0.071509972,0.071509972
FALSE,Duchesne County,11/1/03,Hide,Hide,11,2003,6443,6443,6899,6899,1,456,456,0.066096536,0.066096536
FALSE,Duchesne County,11/1/04,Hide,Hide,11,2004,6866,6866,7236,7236,1,370,370,0.051133223,0.051133223
FALSE,Duchesne County,11/1/05,Hide,Hide,11,2005,7616,7616,7935,7935,1,319,319,0.040201638,0.040201638
FALSE,Duchesne County,11/1/06,Hide,Hide,11,2006,8683,8683,8886,8886,1,203,203,0.022844925,0.022844925
FALSE,Duchesne County,11/1/07,Hide,Hide,11,2007,9145,9145,9372,9372,1,227,227,0.024221084,0.024221084
FALSE,Duchesne County,11/1/08,Hide,Hide,11,2008,10452,10452,10822,10822,1,370,370,0.034189614,0.034189614
FALSE,Duchesne County,11/1/09,Hide,Hide,11,2009,8600,8600,9604,9604,1,1004,1004,0.104539775,0.104539775
FALSE,Duchesne County,11/1/10,Hide,Hide,11,2010,7449,7449,8173,8173,1,724,724,0.088584363,0.088584363
FALSE,Duchesne County,11/1/11,Hide,Hide,11,2011,8160,8160,8674,8674,1,514,514,0.059257551,0.059257551
FALSE,Duchesne County,11/1/12,Hide,Hide,11,2012,8816,8816,9250,9250,1,434,434,0.046918919,0.046918919
FALSE,Duchesne County,11/1/13,Hide,Hide,11,2013,9011,9011,9389,9389,1,378,378,0.040259879,0.040259879
FALSE,Duchesne County,11/1/14,Hide,Hide,11,2014,9200,9200,9580,9580,1,380,380,0.039665971,0.039665971
FALSE,Duchesne County,11/1/15,Hide,Hide,11,2015,7609,7609,8377,8377,1,768,768,0.091679599,0.091679599
FALSE,Duchesne County,11/1/16,Hide,Hide,11,2016,7365,7365,7988,7988,1,623,623,0.077991988,0.077991988
FALSE,Duchesne County,11/1/17,Hide,Hide,11,2017,7519,7519,7922,7922,1,403,403,0.050870992,0.050870992
FALSE,Duchesne County,11/1/18,Hide,Hide,11,2018,7352,7352,7680,7680,1,328,328,0.042708333,0.042708333
FALSE,Duchesne County,11/1/19,Hide,Hide,11,2019,7533,7533,7829,7829,1,296,296,0.037808149,0.037808149
FALSE,Emery County,11/1/92,Hide,Hide,11,1992,4072,4072,4450,4450,1,378,378,0.08494382,0.08494382
FALSE,Emery County,11/1/93,Hide,Hide,11,1993,3902,3902,4217,4217,1,315,315,0.074697652,0.074697652
FALSE,Emery County,11/1/94,Hide,Hide,11,1994,3874,3874,4220,4220,1,346,346,0.081990521,0.081990521
FALSE,Emery County,11/1/95,Hide,Hide,11,1995,3909,3909,4229,4229,1,320,320,0.075668007,0.075668007
FALSE,Emery County,11/1/96,Hide,Hide,11,1996,3877,3877,4181,4181,1,304,304,0.072709878,0.072709878
FALSE,Emery County,11/1/97,Hide,Hide,11,1997,3910,3910,4166,4166,1,256,256,0.061449832,0.061449832
FALSE,Emery County,11/1/98,Hide,Hide,11,1998,3896,3896,4216,4216,1,320,320,0.075901328,0.075901328
FALSE,Emery County,11/1/99,Hide,Hide,11,1999,3910,3910,4145,4145,1,235,235,0.056694813,0.056694813
FALSE,Emery County,11/1/00,Hide,Hide,11,2000,4413,4413,4676,4676,1,263,263,0.056244654,0.056244654
FALSE,Emery County,11/1/01,Hide,Hide,11,2001,4541,4541,4880,4880,1,339,339,0.069467213,0.069467213
FALSE,Emery County,11/1/02,Hide,Hide,11,2002,4495,4495,4863,4863,1,368,368,0.075673453,0.075673453
FALSE,Emery County,11/1/03,Hide,Hide,11,2003,4552,4552,4947,4947,1,395,395,0.079846372,0.079846372
FALSE,Emery County,11/1/04,Hide,Hide,11,2004,4738,4738,5050,5050,1,312,312,0.061782178,0.061782178
FALSE,Emery County,11/1/05,Hide,Hide,11,2005,4984,4984,5212,5212,1,228,228,0.043745203,0.043745203
FALSE,Emery County,11/1/06,Hide,Hide,11,2006,5080,5080,5241,5241,1,161,161,0.030719328,0.030719328
FALSE,Emery County,11/1/07,Hide,Hide,11,2007,4960,4960,5140,5140,1,180,180,0.035019455,0.035019455
FALSE,Emery County,11/1/08,Hide,Hide,11,2008,4761,4761,4984,4984,1,223,223,0.044743178,0.044743178
FALSE,Emery County,11/1/09,Hide,Hide,11,2009,4867,4867,5302,5302,1,435,435,0.082044512,0.082044512
FALSE,Emery County,11/1/10,Hide,Hide,11,2010,4848,4848,5224,5224,1,376,376,0.071975498,0.071975498
FALSE,Emery County,11/1/11,Hide,Hide,11,2011,4612,4612,4969,4969,1,357,357,0.071845442,0.071845442
FALSE,Emery County,11/1/12,Hide,Hide,11,2012,4418,4418,4752,4752,1,334,334,0.070286195,0.070286195
FALSE,Emery County,11/1/13,Hide,Hide,11,2013,4376,4376,4643,4643,1,267,267,0.057505923,0.057505923
FALSE,Emery County,11/1/14,Hide,Hide,11,2014,4251,4251,4485,4485,1,234,234,0.052173913,0.052173913
FALSE,Emery County,11/1/15,Hide,Hide,11,2015,4069,4069,4373,4373,1,304,304,0.069517494,0.069517494
FALSE,Emery County,11/1/16,Hide,Hide,11,2016,3953,3953,4191,4191,1,238,238,0.056788356,0.056788356
FALSE,Emery County,11/1/17,Hide,Hide,11,2017,4025,4025,4228,4228,1,203,203,0.048013245,0.048013245
FALSE,Emery County,11/1/18,Hide,Hide,11,2018,4146,4146,4338,4338,1,192,192,0.044260028,0.044260028
FALSE,Emery County,11/1/19,Hide,Hide,11,2019,4145,4145,4309,4309,1,164,164,0.038059875,0.038059875
FALSE,Garfield County,11/1/92,Hide,Hide,11,1992,2008,2008,2298,2298,1,290,290,0.126196693,0.126196693
FALSE,Garfield County,11/1/93,Hide,Hide,11,1993,2156,2156,2367,2367,1,211,211,0.089142374,0.089142374
FALSE,Garfield County,11/1/94,Hide,Hide,11,1994,2256,2256,2573,2573,1,317,317,0.123202487,0.123202487
FALSE,Garfield County,11/1/95,Hide,Hide,11,1995,2390,2390,2677,2677,1,287,287,0.107209563,0.107209563
FALSE,Garfield County,11/1/96,Hide,Hide,11,1996,2432,2432,2704,2704,1,272,272,0.100591716,0.100591716
FALSE,Garfield County,11/1/97,Hide,Hide,11,1997,2543,2543,2753,2753,1,210,210,0.076280421,0.076280421
FALSE,Garfield County,11/1/98,Hide,Hide,11,1998,2486,2486,2723,2723,1,237,237,0.087036357,0.087036357
FALSE,Garfield County,11/1/99,Hide,Hide,11,1999,2635,2635,2829,2829,1,194,194,0.068575468,0.068575468
FALSE,Garfield County,11/1/00,Hide,Hide,11,2000,2294,2294,2471,2471,1,177,177,0.071630919,0.071630919
FALSE,Garfield County,11/1/01,Hide,Hide,11,2001,2426,2426,2642,2642,1,216,216,0.081756245,0.081756245
FALSE,Garfield County,11/1/02,Hide,Hide,11,2002,2356,2356,2589,2589,1,233,233,0.089996138,0.089996138
FALSE,Garfield County,11/1/03,Hide,Hide,11,2003,2346,2346,2559,2559,1,213,213,0.083235639,0.083235639
FALSE,Garfield County,11/1/04,Hide,Hide,11,2004,2446,2446,2653,2653,1,207,207,0.078024877,0.078024877
FALSE,Garfield County,11/1/05,Hide,Hide,11,2005,2519,2519,2700,2700,1,181,181,0.067037037,0.067037037
FALSE,Garfield County,11/1/06,Hide,Hide,11,2006,2566,2566,2681,2681,1,115,115,0.042894442,0.042894442
FALSE,Garfield County,11/1/07,Hide,Hide,11,2007,2590,2590,2741,2741,1,151,151,0.055089383,0.055089383
FALSE,Garfield County,11/1/08,Hide,Hide,11,2008,2695,2695,2906,2906,1,211,211,0.072608396,0.072608396
FALSE,Garfield County,11/1/09,Hide,Hide,11,2009,2586,2586,2905,2905,1,319,319,0.109810671,0.109810671
FALSE,Garfield County,11/1/10,Hide,Hide,11,2010,2747,2747,3050,3050,1,303,303,0.099344262,0.099344262
FALSE,Garfield County,11/1/11,Hide,Hide,11,2011,2618,2618,2922,2922,1,304,304,0.10403833,0.10403833
FALSE,Garfield County,11/1/12,Hide,Hide,11,2012,2593,2593,2856,2856,1,263,263,0.092086835,0.092086835
FALSE,Garfield County,11/1/13,Hide,Hide,11,2013,2508,2508,2767,2767,1,259,259,0.09360318,0.09360318
FALSE,Garfield County,11/1/14,Hide,Hide,11,2014,2502,2502,2744,2744,1,242,242,0.08819242,0.08819242
FALSE,Garfield County,11/1/15,Hide,Hide,11,2015,2465,2465,2714,2714,1,249,249,0.0917465,0.0917465
FALSE,Garfield County,11/1/16,Hide,Hide,11,2016,2602,2602,2823,2823,1,221,221,0.078285512,0.078285512
FALSE,Garfield County,11/1/17,Hide,Hide,11,2017,2669,2669,2893,2893,1,224,224,0.077428275,0.077428275
FALSE,Garfield County,11/1/18,Hide,Hide,11,2018,2548,2548,2742,2742,1,194,194,0.070751276,0.070751276
FALSE,Garfield County,11/1/19,Hide,Hide,11,2019,2612,2612,2767,2767,1,155,155,0.056017347,0.056017347
FALSE,Grand County,11/1/92,Hide,Hide,11,1992,3953,3953,4260,4260,1,307,307,0.072065728,0.072065728
FALSE,Grand County,11/1/93,Hide,Hide,11,1993,4489,4489,4803,4803,1,314,314,0.065375807,0.065375807
FALSE,Grand County,11/1/94,Hide,Hide,11,1994,4526,4526,4866,4866,1,340,340,0.069872585,0.069872585
FALSE,Grand County,11/1/95,Hide,Hide,11,1995,4698,4698,5023,5023,1,325,325,0.064702369,0.064702369
FALSE,Grand County,11/1/96,Hide,Hide,11,1996,4677,4677,5030,5030,1,353,353,0.070178926,0.070178926
FALSE,Grand County,11/1/97,Hide,Hide,11,1997,4890,4890,5225,5225,1,335,335,0.064114833,0.064114833
FALSE,Grand County,11/1/98,Hide,Hide,11,1998,5055,5055,5436,5436,1,381,381,0.0700883,0.0700883
FALSE,Grand County,11/1/99,Hide,Hide,11,1999,4996,4996,5309,5309,1,313,313,0.058956489,0.058956489
FALSE,Grand County,11/1/00,Hide,Hide,11,2000,4328,4328,4631,4631,1,303,303,0.065428633,0.065428633
FALSE,Grand County,11/1/01,Hide,Hide,11,2001,4479,4479,4819,4819,1,340,340,0.070554057,0.070554057
FALSE,Grand County,11/1/02,Hide,Hide,11,2002,4450,4450,4812,4812,1,362,362,0.075228595,0.075228595
FALSE,Grand County,11/1/03,Hide,Hide,11,2003,4467,4467,4822,4822,1,355,355,0.073620904,0.073620904
FALSE,Grand County,11/1/04,Hide,Hide,11,2004,4500,4500,4838,4838,1,338,338,0.06986358,0.06986358
FALSE,Grand County,11/1/05,Hide,Hide,11,2005,4794,4794,5101,5101,1,307,307,0.060184278,0.060184278
FALSE,Grand County,11/1/06,Hide,Hide,11,2006,4863,4863,5077,5077,1,214,214,0.042150877,0.042150877
FALSE,Grand County,11/1/07,Hide,Hide,11,2007,4927,4927,5193,5193,1,266,266,0.0512228,0.0512228
FALSE,Grand County,11/1/08,Hide,Hide,11,2008,4954,4954,5343,5343,1,389,389,0.07280554,0.07280554
FALSE,Grand County,11/1/09,Hide,Hide,11,2009,4852,4852,5408,5408,1,556,556,0.102810651,0.102810651
FALSE,Grand County,11/1/10,Hide,Hide,11,2010,4758,4758,5311,5311,1,553,553,0.104123517,0.104123517
FALSE,Grand County,11/1/11,Hide,Hide,11,2011,4857,4857,5344,5344,1,487,487,0.09113024,0.09113024
FALSE,Grand County,11/1/12,Hide,Hide,11,2012,4967,4967,5413,5413,1,446,446,0.082394236,0.082394236
FALSE,Grand County,11/1/13,Hide,Hide,11,2013,5082,5082,5493,5493,1,411,411,0.074822501,0.074822501
FALSE,Grand County,11/1/14,Hide,Hide,11,2014,5233,5233,5577,5577,1,344,344,0.061681908,0.061681908
FALSE,Grand County,11/1/15,Hide,Hide,11,2015,5306,5306,5644,5644,1,338,338,0.059886605,0.059886605
FALSE,Grand County,11/1/16,Hide,Hide,11,2016,5439,5439,5769,5769,1,330,330,0.057202288,0.057202288
FALSE,Grand County,11/1/17,Hide,Hide,11,2017,5708,5708,6016,6016,1,308,308,0.051196809,0.051196809
FALSE,Grand County,11/1/18,Hide,Hide,11,2018,5773,5773,6038,6038,1,265,265,0.043888705,0.043888705
FALSE,Grand County,11/1/19,Hide,Hide,11,2019,6065,6065,6284,6284,1,219,219,0.034850414,0.034850414
FALSE,Iron County,11/1/92,Hide,Hide,11,1992,10247,10247,10605,10605,1,358,358,0.033757661,0.033757661
FALSE,Iron County,11/1/93,Hide,Hide,11,1993,11107,11107,11538,11538,1,431,431,0.037354828,0.037354828
FALSE,Iron County,11/1/94,Hide,Hide,11,1994,12196,12196,12649,12649,1,453,453,0.035813108,0.035813108
FALSE,Iron County,11/1/95,Hide,Hide,11,1995,12611,12611,13096,13096,1,485,485,0.037034209,0.037034209
FALSE,Iron County,11/1/96,Hide,Hide,11,1996,13333,13333,13811,13811,1,478,478,0.034610093,0.034610093
FALSE,Iron County,11/1/97,Hide,Hide,11,1997,13908,13908,14421,14421,1,513,513,0.035573123,0.035573123
FALSE,Iron County,11/1/98,Hide,Hide,11,1998,14549,14549,15120,15120,1,571,571,0.03776455,0.03776455
FALSE,Iron County,11/1/99,Hide,Hide,11,1999,14998,14998,15509,15509,1,511,511,0.03294861,0.03294861
FALSE,Iron County,11/1/00,Hide,Hide,11,2000,16430,16430,17038,17038,1,608,608,0.03568494,0.03568494
FALSE,Iron County,11/1/01,Hide,Hide,11,2001,16816,16816,17660,17660,1,844,844,0.047791619,0.047791619
FALSE,Iron County,11/1/02,Hide,Hide,11,2002,16848,16848,17816,17816,1,968,968,0.054333184,0.054333184
FALSE,Iron County,11/1/03,Hide,Hide,11,2003,17265,17265,18184,18184,1,919,919,0.050538935,0.050538935
FALSE,Iron County,11/1/04,Hide,Hide,11,2004,18265,18265,19105,19105,1,840,840,0.043967548,0.043967548
FALSE,Iron County,11/1/05,Hide,Hide,11,2005,19555,19555,20290,20290,1,735,735,0.036224741,0.036224741
FALSE,Iron County,11/1/06,Hide,Hide,11,2006,20757,20757,21328,21328,1,571,571,0.026772318,0.026772318
FALSE,Iron County,11/1/07,Hide,Hide,11,2007,20066,20066,20757,20757,1,691,691,0.033289974,0.033289974
FALSE,Iron County,11/1/08,Hide,Hide,11,2008,19582,19582,20838,20838,1,1256,1256,0.060274499,0.060274499
FALSE,Iron County,11/1/09,Hide,Hide,11,2009,19061,19061,20978,20978,1,1917,1917,0.091381447,0.091381447
FALSE,Iron County,11/1/10,Hide,Hide,11,2010,18345,18345,20232,20232,1,1887,1887,0.09326809,0.09326809
FALSE,Iron County,11/1/11,Hide,Hide,11,2011,18239,18239,19731,19731,1,1492,1492,0.075617049,0.075617049
FALSE,Iron County,11/1/12,Hide,Hide,11,2012,18224,18224,19479,19479,1,1255,1255,0.064428359,0.064428359
FALSE,Iron County,11/1/13,Hide,Hide,11,2013,18552,18552,19521,19521,1,969,969,0.04963885,0.04963885
FALSE,Iron County,11/1/14,Hide,Hide,11,2014,19092,19092,20009,20009,1,917,917,0.045829377,0.045829377
FALSE,Iron County,11/1/15,Hide,Hide,11,2015,19642,19642,20545,20545,1,903,903,0.0439523,0.0439523
FALSE,Iron County,11/1/16,Hide,Hide,11,2016,20858,20858,21823,21823,1,965,965,0.044219402,0.044219402
FALSE,Iron County,11/1/17,Hide,Hide,11,2017,21633,21633,22492,22492,1,859,859,0.038191357,0.038191357
FALSE,Iron County,11/1/18,Hide,Hide,11,2018,22487,22487,23271,23271,1,784,784,0.03369,0.03369
FALSE,Iron County,11/1/19,Hide,Hide,11,2019,23826,23826,24487,24487,1,661,661,0.026993915,0.026993915
FALSE,Juab County,11/1/92,Hide,Hide,11,1992,2930,2930,3151,3151,1,221,221,0.070136465,0.070136465
FALSE,Juab County,11/1/93,Hide,Hide,11,1993,3190,3190,3363,3363,1,173,173,0.051442165,0.051442165
FALSE,Juab County,11/1/94,Hide,Hide,11,1994,3229,3229,3396,3396,1,167,167,0.049175501,0.049175501
FALSE,Juab County,11/1/95,Hide,Hide,11,1995,3152,3152,3303,3303,1,151,151,0.045716016,0.045716016
FALSE,Juab County,11/1/96,Hide,Hide,11,1996,3283,3283,3424,3424,1,141,141,0.041179907,0.041179907
FALSE,Juab County,11/1/97,Hide,Hide,11,1997,3336,3336,3477,3477,1,141,141,0.0405522,0.0405522
FALSE,Juab County,11/1/98,Hide,Hide,11,1998,3498,3498,3679,3679,1,181,181,0.049198152,0.049198152
FALSE,Juab County,11/1/99,Hide,Hide,11,1999,3400,3400,3542,3542,1,142,142,0.040090344,0.040090344
FALSE,Juab County,11/1/00,Hide,Hide,11,2000,3684,3684,3823,3823,1,139,139,0.03635888,0.03635888
FALSE,Juab County,11/1/01,Hide,Hide,11,2001,3544,3544,3769,3769,1,225,225,0.059697533,0.059697533
FALSE,Juab County,11/1/02,Hide,Hide,11,2002,3436,3436,3718,3718,1,282,282,0.07584723,0.07584723
FALSE,Juab County,11/1/03,Hide,Hide,11,2003,3459,3459,3717,3717,1,258,258,0.069410815,0.069410815
FALSE,Juab County,11/1/04,Hide,Hide,11,2004,3626,3626,3838,3838,1,212,212,0.055237103,0.055237103
FALSE,Juab County,11/1/05,Hide,Hide,11,2005,3781,3781,3960,3960,1,179,179,0.04520202,0.04520202
FALSE,Juab County,11/1/06,Hide,Hide,11,2006,3957,3957,4085,4085,1,128,128,0.031334149,0.031334149
FALSE,Juab County,11/1/07,Hide,Hide,11,2007,3967,3967,4111,4111,1,144,144,0.035027974,0.035027974
FALSE,Juab County,11/1/08,Hide,Hide,11,2008,3685,3685,3989,3989,1,304,304,0.076209576,0.076209576
FALSE,Juab County,11/1/09,Hide,Hide,11,2009,3660,3660,4073,4073,1,413,413,0.10139946,0.10139946
FALSE,Juab County,11/1/10,Hide,Hide,11,2010,4194,4194,4615,4615,1,421,421,0.091224269,0.091224269
FALSE,Juab County,11/1/11,Hide,Hide,11,2011,4274,4274,4604,4604,1,330,330,0.071676803,0.071676803
FALSE,Juab County,11/1/12,Hide,Hide,11,2012,4426,4426,4690,4690,1,264,264,0.056289979,0.056289979
FALSE,Juab County,11/1/13,Hide,Hide,11,2013,4514,4514,4735,4735,1,221,221,0.046673706,0.046673706
FALSE,Juab County,11/1/14,Hide,Hide,11,2014,4662,4662,4854,4854,1,192,192,0.039555006,0.039555006
FALSE,Juab County,11/1/15,Hide,Hide,11,2015,4826,4826,5023,5023,1,197,197,0.03921959,0.03921959
FALSE,Juab County,11/1/16,Hide,Hide,11,2016,5109,5109,5288,5288,1,179,179,0.033850227,0.033850227
FALSE,Juab County,11/1/17,Hide,Hide,11,2017,5318,5318,5500,5500,1,182,182,0.033090909,0.033090909
FALSE,Juab County,11/1/18,Hide,Hide,11,2018,5450,5450,5607,5607,1,157,157,0.028000713,0.028000713
FALSE,Juab County,11/1/19,Hide,Hide,11,2019,5666,5666,5797,5797,1,131,131,0.022597895,0.022597895
FALSE,Kane County,11/1/92,Hide,Hide,11,1992,2674,2674,2870,2870,1,196,196,0.068292683,0.068292683
FALSE,Kane County,11/1/93,Hide,Hide,11,1993,2444,2444,2612,2612,1,168,168,0.06431853,0.06431853
FALSE,Kane County,11/1/94,Hide,Hide,11,1994,2504,2504,2789,2789,1,285,285,0.102187164,0.102187164
FALSE,Kane County,11/1/95,Hide,Hide,11,1995,2470,2470,2650,2650,1,180,180,0.067924528,0.067924528
FALSE,Kane County,11/1/96,Hide,Hide,11,1996,2415,2415,2605,2605,1,190,190,0.07293666,0.07293666
FALSE,Kane County,11/1/97,Hide,Hide,11,1997,2524,2524,2632,2632,1,108,108,0.041033435,0.041033435
FALSE,Kane County,11/1/98,Hide,Hide,11,1998,2617,2617,2724,2724,1,107,107,0.03928047,0.03928047
FALSE,Kane County,11/1/99,Hide,Hide,11,1999,2735,2735,2827,2827,1,92,92,0.032543332,0.032543332
FALSE,Kane County,11/1/00,Hide,Hide,11,2000,2866,2866,2987,2987,1,121,121,0.040508872,0.040508872
FALSE,Kane County,11/1/01,Hide,Hide,11,2001,3068,3068,3203,3203,1,135,135,0.042147986,0.042147986
FALSE,Kane County,11/1/02,Hide,Hide,11,2002,2822,2822,2985,2985,1,163,163,0.054606365,0.054606365
FALSE,Kane County,11/1/03,Hide,Hide,11,2003,2942,2942,3125,3125,1,183,183,0.05856,0.05856
FALSE,Kane County,11/1/04,Hide,Hide,11,2004,3035,3035,3211,3211,1,176,176,0.054811585,0.054811585
FALSE,Kane County,11/1/05,Hide,Hide,11,2005,3184,3184,3330,3330,1,146,146,0.043843844,0.043843844
FALSE,Kane County,11/1/06,Hide,Hide,11,2006,3384,3384,3490,3490,1,106,106,0.030372493,0.030372493
FALSE,Kane County,11/1/07,Hide,Hide,11,2007,3333,3333,3450,3450,1,117,117,0.033913043,0.033913043
FALSE,Kane County,11/1/08,Hide,Hide,11,2008,3332,3332,3529,3529,1,197,197,0.055823179,0.055823179
FALSE,Kane County,11/1/09,Hide,Hide,11,2009,3291,3291,3582,3582,1,291,291,0.081239531,0.081239531
FALSE,Kane County,11/1/10,Hide,Hide,11,2010,3240,3240,3519,3519,1,279,279,0.079283887,0.079283887
FALSE,Kane County,11/1/11,Hide,Hide,11,2011,3221,3221,3463,3463,1,242,242,0.069881606,0.069881606
FALSE,Kane County,11/1/12,Hide,Hide,11,2012,3255,3255,3467,3467,1,212,212,0.061147967,0.061147967
FALSE,Kane County,11/1/13,Hide,Hide,11,2013,3316,3316,3491,3491,1,175,175,0.050128903,0.050128903
FALSE,Kane County,11/1/14,Hide,Hide,11,2014,3407,3407,3574,3574,1,167,167,0.046726357,0.046726357
FALSE,Kane County,11/1/15,Hide,Hide,11,2015,3515,3515,3675,3675,1,160,160,0.043537415,0.043537415
FALSE,Kane County,11/1/16,Hide,Hide,11,2016,3576,3576,3706,3706,1,130,130,0.035078251,0.035078251
FALSE,Kane County,11/1/17,Hide,Hide,11,2017,3652,3652,3778,3778,1,126,126,0.033350979,0.033350979
FALSE,Kane County,11/1/18,Hide,Hide,11,2018,3664,3664,3781,3781,1,117,117,0.030944195,0.030944195
FALSE,Kane County,11/1/19,Hide,Hide,11,2019,3732,3732,3832,3832,1,100,100,0.026096033,0.026096033
FALSE,Millard County,11/1/92,Hide,Hide,11,1992,4364,4364,4658,4658,1,294,294,0.063117218,0.063117218
FALSE,Millard County,11/1/93,Hide,Hide,11,1993,4550,4550,4772,4772,1,222,222,0.046521375,0.046521375
FALSE,Millard County,11/1/94,Hide,Hide,11,1994,4626,4626,4861,4861,1,235,235,0.048343962,0.048343962
FALSE,Millard County,11/1/95,Hide,Hide,11,1995,4444,4444,4656,4656,1,212,212,0.045532646,0.045532646
FALSE,Millard County,11/1/96,Hide,Hide,11,1996,4584,4584,4767,4767,1,183,183,0.038388924,0.038388924
FALSE,Millard County,11/1/97,Hide,Hide,11,1997,4627,4627,4830,4830,1,203,203,0.042028986,0.042028986
FALSE,Millard County,11/1/98,Hide,Hide,11,1998,4481,4481,4691,4691,1,210,210,0.044766574,0.044766574
FALSE,Millard County,11/1/99,Hide,Hide,11,1999,4480,4480,4655,4655,1,175,175,0.037593985,0.037593985
FALSE,Millard County,11/1/00,Hide,Hide,11,2000,4951,4951,5141,5141,1,190,190,0.03695779,0.03695779
FALSE,Millard County,11/1/01,Hide,Hide,11,2001,5869,5869,6135,6135,1,266,266,0.043357783,0.043357783
FALSE,Millard County,11/1/02,Hide,Hide,11,2002,6124,6124,6410,6410,1,286,286,0.044617785,0.044617785
FALSE,Millard County,11/1/03,Hide,Hide,11,2003,5576,5576,5891,5891,1,315,315,0.053471397,0.053471397
FALSE,Millard County,11/1/04,Hide,Hide,11,2004,5516,5516,5781,5781,1,265,265,0.04583982,0.04583982
FALSE,Millard County,11/1/05,Hide,Hide,11,2005,5871,5871,6103,6103,1,232,232,0.038014091,0.038014091
FALSE,Millard County,11/1/06,Hide,Hide,11,2006,6097,6097,6255,6255,1,158,158,0.025259792,0.025259792
FALSE,Millard County,11/1/07,Hide,Hide,11,2007,5971,5971,6143,6143,1,172,172,0.027999349,0.027999349
FALSE,Millard County,11/1/08,Hide,Hide,11,2008,5981,5981,6233,6233,1,252,252,0.04042997,0.04042997
FALSE,Millard County,11/1/09,Hide,Hide,11,2009,6150,6150,6544,6544,1,394,394,0.060207824,0.060207824
FALSE,Millard County,11/1/10,Hide,Hide,11,2010,6120,6120,6505,6505,1,385,385,0.059185242,0.059185242
FALSE,Millard County,11/1/11,Hide,Hide,11,2011,5755,5755,6061,6061,1,306,306,0.050486718,0.050486718
FALSE,Millard County,11/1/12,Hide,Hide,11,2012,5712,5712,5977,5977,1,265,265,0.044336624,0.044336624
FALSE,Millard County,11/1/13,Hide,Hide,11,2013,5657,5657,5878,5878,1,221,221,0.037597822,0.037597822
FALSE,Millard County,11/1/14,Hide,Hide,11,2014,5812,5812,6028,6028,1,216,216,0.03583278,0.03583278
FALSE,Millard County,11/1/15,Hide,Hide,11,2015,5860,5860,6072,6072,1,212,212,0.034914361,0.034914361
FALSE,Millard County,11/1/16,Hide,Hide,11,2016,6010,6010,6223,6223,1,213,213,0.034227864,0.034227864
FALSE,Millard County,11/1/17,Hide,Hide,11,2017,6300,6300,6499,6499,1,199,199,0.030620095,0.030620095
FALSE,Millard County,11/1/18,Hide,Hide,11,2018,5873,5873,6066,6066,1,193,193,0.031816683,0.031816683
FALSE,Millard County,11/1/19,Hide,Hide,11,2019,5812,5812,5960,5960,1,148,148,0.024832215,0.024832215
FALSE,Morgan County,11/1/92,Hide,Hide,11,1992,2795,2795,2969,2969,1,174,174,0.058605591,0.058605591
FALSE,Morgan County,11/1/93,Hide,Hide,11,1993,2827,2827,2977,2977,1,150,150,0.050386295,0.050386295
FALSE,Morgan County,11/1/94,Hide,Hide,11,1994,3070,3070,3237,3237,1,167,167,0.051590979,0.051590979
FALSE,Morgan County,11/1/95,Hide,Hide,11,1995,3232,3232,3384,3384,1,152,152,0.044917258,0.044917258
FALSE,Morgan County,11/1/96,Hide,Hide,11,1996,3391,3391,3530,3530,1,139,139,0.039376771,0.039376771
FALSE,Morgan County,11/1/97,Hide,Hide,11,1997,3559,3559,3700,3700,1,141,141,0.038108108,0.038108108
FALSE,Morgan County,11/1/98,Hide,Hide,11,1998,3515,3515,3655,3655,1,140,140,0.038303694,0.038303694
FALSE,Morgan County,11/1/99,Hide,Hide,11,1999,3397,3397,3521,3521,1,124,124,0.035217268,0.035217268
FALSE,Morgan County,11/1/00,Hide,Hide,11,2000,3303,3303,3421,3421,1,118,118,0.034492838,0.034492838
FALSE,Morgan County,11/1/01,Hide,Hide,11,2001,3326,3326,3484,3484,1,158,158,0.045350172,0.045350172
FALSE,Morgan County,11/1/02,Hide,Hide,11,2002,3379,3379,3579,3579,1,200,200,0.055881531,0.055881531
FALSE,Morgan County,11/1/03,Hide,Hide,11,2003,3440,3440,3626,3626,1,186,186,0.051296194,0.051296194
FALSE,Morgan County,11/1/04,Hide,Hide,11,2004,3552,3552,3719,3719,1,167,167,0.044904544,0.044904544
FALSE,Morgan County,11/1/05,Hide,Hide,11,2005,3714,3714,3864,3864,1,150,150,0.038819876,0.038819876
FALSE,Morgan County,11/1/06,Hide,Hide,11,2006,3870,3870,3971,3971,1,101,101,0.025434399,0.025434399
FALSE,Morgan County,11/1/07,Hide,Hide,11,2007,3920,3920,4038,4038,1,118,118,0.029222387,0.029222387
FALSE,Morgan County,11/1/08,Hide,Hide,11,2008,3906,3906,4076,4076,1,170,170,0.041707556,0.041707556
FALSE,Morgan County,11/1/09,Hide,Hide,11,2009,3816,3816,4094,4094,1,278,278,0.06790425,0.06790425
FALSE,Morgan County,11/1/10,Hide,Hide,11,2010,3992,3992,4280,4280,1,288,288,0.06728972,0.06728972
FALSE,Morgan County,11/1/11,Hide,Hide,11,2011,4060,4060,4284,4284,1,224,224,0.052287582,0.052287582
FALSE,Morgan County,11/1/12,Hide,Hide,11,2012,4191,4191,4393,4393,1,202,202,0.045982244,0.045982244
FALSE,Morgan County,11/1/13,Hide,Hide,11,2013,4402,4402,4575,4575,1,173,173,0.037814208,0.037814208
FALSE,Morgan County,11/1/14,Hide,Hide,11,2014,4604,4604,4759,4759,1,155,155,0.032569868,0.032569868
FALSE,Morgan County,11/1/15,Hide,Hide,11,2015,4833,4833,4989,4989,1,156,156,0.031268791,0.031268791
FALSE,Morgan County,11/1/16,Hide,Hide,11,2016,5091,5091,5241,5241,1,150,150,0.028620492,0.028620492
FALSE,Morgan County,11/1/17,Hide,Hide,11,2017,5270,5270,5421,5421,1,151,151,0.027854639,0.027854639
FALSE,Morgan County,11/1/18,Hide,Hide,11,2018,5325,5325,5470,5470,1,145,145,0.026508227,0.026508227
FALSE,Morgan County,11/1/19,Hide,Hide,11,2019,5495,5495,5621,5621,1,126,126,0.02241594,0.02241594
FALSE,Piute County,11/1/92,Hide,Hide,11,1992,420,420,452,452,1,32,32,0.07079646,0.07079646
FALSE,Piute County,11/1/93,Hide,Hide,11,1993,463,463,493,493,1,30,30,0.060851927,0.060851927
FALSE,Piute County,11/1/94,Hide,Hide,11,1994,461,461,500,500,1,39,39,0.078,0.078
FALSE,Piute County,11/1/95,Hide,Hide,11,1995,468,468,492,492,1,24,24,0.048780488,0.048780488
FALSE,Piute County,11/1/96,Hide,Hide,11,1996,512,512,538,538,1,26,26,0.048327138,0.048327138
FALSE,Piute County,11/1/97,Hide,Hide,11,1997,513,513,541,541,1,28,28,0.051756007,0.051756007
FALSE,Piute County,11/1/98,Hide,Hide,11,1998,502,502,531,531,1,29,29,0.054613936,0.054613936
FALSE,Piute County,11/1/99,Hide,Hide,11,1999,504,504,528,528,1,24,24,0.045454545,0.045454545
FALSE,Piute County,11/1/00,Hide,Hide,11,2000,622,622,657,657,1,35,35,0.053272451,0.053272451
FALSE,Piute County,11/1/01,Hide,Hide,11,2001,745,745,790,790,1,45,45,0.056962025,0.056962025
FALSE,Piute County,11/1/02,Hide,Hide,11,2002,731,731,778,778,1,47,47,0.060411311,0.060411311
FALSE,Piute County,11/1/03,Hide,Hide,11,2003,777,777,819,819,1,42,42,0.051282051,0.051282051
FALSE,Piute County,11/1/04,Hide,Hide,11,2004,841,841,878,878,1,37,37,0.04214123,0.04214123
FALSE,Piute County,11/1/05,Hide,Hide,11,2005,796,796,826,826,1,30,30,0.036319613,0.036319613
FALSE,Piute County,11/1/06,Hide,Hide,11,2006,856,856,878,878,1,22,22,0.025056948,0.025056948
FALSE,Piute County,11/1/07,Hide,Hide,11,2007,892,892,917,917,1,25,25,0.027262814,0.027262814
FALSE,Piute County,11/1/08,Hide,Hide,11,2008,881,881,914,914,1,33,33,0.036105033,0.036105033
FALSE,Piute County,11/1/09,Hide,Hide,11,2009,756,756,817,817,1,61,61,0.074663403,0.074663403
FALSE,Piute County,11/1/10,Hide,Hide,11,2010,506,506,563,563,1,57,57,0.101243339,0.101243339
FALSE,Piute County,11/1/11,Hide,Hide,11,2011,463,463,512,512,1,49,49,0.095703125,0.095703125
FALSE,Piute County,11/1/12,Hide,Hide,11,2012,445,445,484,484,1,39,39,0.080578512,0.080578512
FALSE,Piute County,11/1/13,Hide,Hide,11,2013,439,439,475,475,1,36,36,0.075789474,0.075789474
FALSE,Piute County,11/1/14,Hide,Hide,11,2014,430,430,463,463,1,33,33,0.071274298,0.071274298
FALSE,Piute County,11/1/15,Hide,Hide,11,2015,417,417,446,446,1,29,29,0.065022422,0.065022422
FALSE,Piute County,11/1/16,Hide,Hide,11,2016,439,439,464,464,1,25,25,0.05387931,0.05387931
FALSE,Piute County,11/1/17,Hide,Hide,11,2017,469,469,492,492,1,23,23,0.046747967,0.046747967
FALSE,Piute County,11/1/18,Hide,Hide,11,2018,457,457,481,481,1,24,24,0.04989605,0.04989605
FALSE,Piute County,11/1/19,Hide,Hide,11,2019,463,463,485,485,1,22,22,0.045360825,0.045360825
FALSE,Rich County,11/1/92,Hide,Hide,11,1992,717,717,749,749,1,32,32,0.042723632,0.042723632
FALSE,Rich County,11/1/93,Hide,Hide,11,1993,783,783,809,809,1,26,26,0.032138443,0.032138443
FALSE,Rich County,11/1/94,Hide,Hide,11,1994,820,820,853,853,1,33,33,0.038686987,0.038686987
FALSE,Rich County,11/1/95,Hide,Hide,11,1995,880,880,912,912,1,32,32,0.035087719,0.035087719
FALSE,Rich County,11/1/96,Hide,Hide,11,1996,923,923,952,952,1,29,29,0.030462185,0.030462185
FALSE,Rich County,11/1/97,Hide,Hide,11,1997,953,953,989,989,1,36,36,0.036400404,0.036400404
FALSE,Rich County,11/1/98,Hide,Hide,11,1998,938,938,971,971,1,33,33,0.033985582,0.033985582
FALSE,Rich County,11/1/99,Hide,Hide,11,1999,918,918,953,953,1,35,35,0.036726128,0.036726128
FALSE,Rich County,11/1/00,Hide,Hide,11,2000,1005,1005,1040,1040,1,35,35,0.033653846,0.033653846
FALSE,Rich County,11/1/01,Hide,Hide,11,2001,1263,1263,1301,1301,1,38,38,0.029208301,0.029208301
FALSE,Rich County,11/1/02,Hide,Hide,11,2002,1231,1231,1285,1285,1,54,54,0.042023346,0.042023346
FALSE,Rich County,11/1/03,Hide,Hide,11,2003,1235,1235,1281,1281,1,46,46,0.035909446,0.035909446
FALSE,Rich County,11/1/04,Hide,Hide,11,2004,1248,1248,1293,1293,1,45,45,0.034802784,0.034802784
FALSE,Rich County,11/1/05,Hide,Hide,11,2005,1264,1264,1302,1302,1,38,38,0.029185868,0.029185868
FALSE,Rich County,11/1/06,Hide,Hide,11,2006,1399,1399,1426,1426,1,27,27,0.018934081,0.018934081
FALSE,Rich County,11/1/07,Hide,Hide,11,2007,1423,1423,1456,1456,1,33,33,0.022664835,0.022664835
FALSE,Rich County,11/1/08,Hide,Hide,11,2008,1420,1420,1472,1472,1,52,52,0.035326087,0.035326087
FALSE,Rich County,11/1/09,Hide,Hide,11,2009,1284,1284,1359,1359,1,75,75,0.055187638,0.055187638
FALSE,Rich County,11/1/10,Hide,Hide,11,2010,943,943,1017,1017,1,74,74,0.072763029,0.072763029
FALSE,Rich County,11/1/11,Hide,Hide,11,2011,902,902,965,965,1,63,63,0.065284974,0.065284974
FALSE,Rich County,11/1/12,Hide,Hide,11,2012,890,890,940,940,1,50,50,0.053191489,0.053191489
FALSE,Rich County,11/1/13,Hide,Hide,11,2013,977,977,1017,1017,1,40,40,0.039331367,0.039331367
FALSE,Rich County,11/1/14,Hide,Hide,11,2014,977,977,1015,1015,1,38,38,0.037438424,0.037438424
FALSE,Rich County,11/1/15,Hide,Hide,11,2015,992,992,1028,1028,1,36,36,0.035019455,0.035019455
FALSE,Rich County,11/1/16,Hide,Hide,11,2016,1058,1058,1095,1095,1,37,37,0.033789954,0.033789954
FALSE,Rich County,11/1/17,Hide,Hide,11,2017,1134,1134,1171,1171,1,37,37,0.031596926,0.031596926
FALSE,Rich County,11/1/18,Hide,Hide,11,2018,1138,1138,1176,1176,1,38,38,0.032312925,0.032312925
FALSE,Rich County,11/1/19,Hide,Hide,11,2019,1129,1129,1164,1164,1,35,35,0.030068729,0.030068729
FALSE,Salt Lake County,11/1/92,Hide,Hide,11,1992,388947,388947,406293,406293,1,17346,17346,0.042693327,0.042693327
FALSE,Salt Lake County,11/1/93,Hide,Hide,11,1993,416704,416704,430547,430547,1,13843,13843,0.032152123,0.032152123
FALSE,Salt Lake County,11/1/94,Hide,Hide,11,1994,431342,431342,446533,446533,1,15191,15191,0.034019882,0.034019882
FALSE,Salt Lake County,11/1/95,Hide,Hide,11,1995,443295,443295,456149,456149,1,12854,12854,0.028179389,0.028179389
FALSE,Salt Lake County,11/1/96,Hide,Hide,11,1996,452542,452542,465886,465886,1,13344,13344,0.0286422,0.0286422
FALSE,Salt Lake County,11/1/97,Hide,Hide,11,1997,464885,464885,479162,479162,1,14277,14277,0.029795768,0.029795768
FALSE,Salt Lake County,11/1/98,Hide,Hide,11,1998,470044,470044,485969,485969,1,15925,15925,0.03276958,0.03276958
FALSE,Salt Lake County,11/1/99,Hide,Hide,11,1999,474328,474328,489280,489280,1,14952,14952,0.030559189,0.030559189
FALSE,Salt Lake County,11/1/00,Hide,Hide,11,2000,475388,475388,492432,492432,1,17044,17044,0.034611885,0.034611885
FALSE,Salt Lake County,11/1/01,Hide,Hide,11,2001,465849,465849,490646,490646,1,24797,24797,0.050539493,0.050539493
FALSE,Salt Lake County,11/1/02,Hide,Hide,11,2002,463753,463753,494176,494176,1,30423,30423,0.061563087,0.061563087
FALSE,Salt Lake County,11/1/03,Hide,Hide,11,2003,470700,470700,498074,498074,1,27374,27374,0.054959705,0.054959705
FALSE,Salt Lake County,11/1/04,Hide,Hide,11,2004,483388,483388,506803,506803,1,23415,23415,0.046201384,0.046201384
FALSE,Salt Lake County,11/1/05,Hide,Hide,11,2005,504823,504823,524419,524419,1,19596,19596,0.037367067,0.037367067
FALSE,Salt Lake County,11/1/06,Hide,Hide,11,2006,527420,527420,541122,541122,1,13702,13702,0.025321462,0.025321462
FALSE,Salt Lake County,11/1/07,Hide,Hide,11,2007,539968,539968,555546,555546,1,15578,15578,0.028040882,0.028040882
FALSE,Salt Lake County,11/1/08,Hide,Hide,11,2008,532965,532965,557922,557922,1,24957,24957,0.044732059,0.044732059
FALSE,Salt Lake County,11/1/09,Hide,Hide,11,2009,506857,506857,548548,548548,1,41691,41691,0.076002465,0.076002465
FALSE,Salt Lake County,11/1/10,Hide,Hide,11,2010,506453,506453,547869,547869,1,41416,41416,0.075594713,0.075594713
FALSE,Salt Lake County,11/1/11,Hide,Hide,11,2011,514064,514064,547098,547098,1,33034,33034,0.060380407,0.060380407
FALSE,Salt Lake County,11/1/12,Hide,Hide,11,2012,533955,533955,561454,561454,1,27499,27499,0.048978189,0.048978189
FALSE,Salt Lake County,11/1/13,Hide,Hide,11,2013,550464,550464,573605,573605,1,23141,23141,0.040343093,0.040343093
FALSE,Salt Lake County,11/1/14,Hide,Hide,11,2014,557064,557064,577669,577669,1,20605,20605,0.035669215,0.035669215
FALSE,Salt Lake County,11/1/15,Hide,Hide,11,2015,570626,570626,590344,590344,1,19718,19718,0.033400865,0.033400865
FALSE,Salt Lake County,11/1/16,Hide,Hide,11,2016,589307,589307,608228,608228,1,18921,18921,0.0311084,0.0311084
FALSE,Salt Lake County,11/1/17,Hide,Hide,11,2017,597909,597909,616727,616727,1,18818,18818,0.03051269,0.03051269
FALSE,Salt Lake County,11/1/18,Hide,Hide,11,2018,604660,604660,622636,622636,1,17976,17976,0.028870801,0.028870801
FALSE,Salt Lake County,11/1/19,Hide,Hide,11,2019,627614,627614,643084,643084,1,15470,15470,0.024055955,0.024055955
FALSE,San Juan County,11/1/92,Hide,Hide,11,1992,4235,4235,4662,4662,1,427,427,0.091591592,0.091591592
FALSE,San Juan County,11/1/93,Hide,Hide,11,1993,4718,4718,5104,5104,1,386,386,0.075626959,0.075626959
FALSE,San Juan County,11/1/94,Hide,Hide,11,1994,4732,4732,5167,5167,1,435,435,0.084188117,0.084188117
FALSE,San Juan County,11/1/95,Hide,Hide,11,1995,4814,4814,5259,5259,1,445,445,0.084616847,0.084616847
FALSE,San Juan County,11/1/96,Hide,Hide,11,1996,4515,4515,5022,5022,1,507,507,0.100955795,0.100955795
FALSE,San Juan County,11/1/97,Hide,Hide,11,1997,4473,4473,4851,4851,1,378,378,0.077922078,0.077922078
FALSE,San Juan County,11/1/98,Hide,Hide,11,1998,4706,4706,5105,5105,1,399,399,0.078158668,0.078158668
FALSE,San Juan County,11/1/99,Hide,Hide,11,1999,4552,4552,4887,4887,1,335,335,0.068549212,0.068549212
FALSE,San Juan County,11/1/00,Hide,Hide,11,2000,4217,4217,4612,4612,1,395,395,0.085646141,0.085646141
FALSE,San Juan County,11/1/01,Hide,Hide,11,2001,4291,4291,4680,4680,1,389,389,0.083119658,0.083119658
FALSE,San Juan County,11/1/02,Hide,Hide,11,2002,4403,4403,4829,4829,1,426,426,0.088217022,0.088217022
FALSE,San Juan County,11/1/03,Hide,Hide,11,2003,4299,4299,4733,4733,1,434,434,0.091696598,0.091696598
FALSE,San Juan County,11/1/04,Hide,Hide,11,2004,4365,4365,4785,4785,1,420,420,0.087774295,0.087774295
FALSE,San Juan County,11/1/05,Hide,Hide,11,2005,4483,4483,4835,4835,1,352,352,0.072802482,0.072802482
FALSE,San Juan County,11/1/06,Hide,Hide,11,2006,4644,4644,4911,4911,1,267,267,0.054367746,0.054367746
FALSE,San Juan County,11/1/07,Hide,Hide,11,2007,4712,4712,4992,4992,1,280,280,0.056089744,0.056089744
FALSE,San Juan County,11/1/08,Hide,Hide,11,2008,4742,4742,5134,5134,1,392,392,0.07635372,0.07635372
FALSE,San Juan County,11/1/09,Hide,Hide,11,2009,4861,4861,5544,5544,1,683,683,0.123196248,0.123196248
FALSE,San Juan County,11/1/10,Hide,Hide,11,2010,5470,5470,6131,6131,1,661,661,0.107812755,0.107812755
FALSE,San Juan County,11/1/11,Hide,Hide,11,2011,5300,5300,5856,5856,1,556,556,0.094945355,0.094945355
FALSE,San Juan County,11/1/12,Hide,Hide,11,2012,5166,5166,5636,5636,1,470,470,0.083392477,0.083392477
FALSE,San Juan County,11/1/13,Hide,Hide,11,2013,5304,5304,5747,5747,1,443,443,0.077083696,0.077083696
FALSE,San Juan County,11/1/14,Hide,Hide,11,2014,5153,5153,5596,5596,1,443,443,0.079163688,0.079163688
FALSE,San Juan County,11/1/15,Hide,Hide,11,2015,5229,5229,5694,5694,1,465,465,0.08166491,0.08166491
FALSE,San Juan County,11/1/16,Hide,Hide,11,2016,5298,5298,5737,5737,1,439,439,0.07652083,0.07652083
FALSE,San Juan County,11/1/17,Hide,Hide,11,2017,5329,5329,5707,5707,1,378,378,0.066234449,0.066234449
FALSE,San Juan County,11/1/18,Hide,Hide,11,2018,5376,5376,5704,5704,1,328,328,0.057503506,0.057503506
FALSE,San Juan County,11/1/19,Hide,Hide,11,2019,5427,5427,5723,5723,1,296,296,0.051721125,0.051721125
FALSE,Sanpete County,11/1/92,Hide,Hide,11,1992,6280,6280,6866,6866,1,586,586,0.085348092,0.085348092
FALSE,Sanpete County,11/1/93,Hide,Hide,11,1993,6872,6872,7320,7320,1,448,448,0.061202186,0.061202186
FALSE,Sanpete County,11/1/94,Hide,Hide,11,1994,7200,7200,7715,7715,1,515,515,0.066753078,0.066753078
FALSE,Sanpete County,11/1/95,Hide,Hide,11,1995,7453,7453,7934,7934,1,481,481,0.060625158,0.060625158
FALSE,Sanpete County,11/1/96,Hide,Hide,11,1996,7957,7957,8424,8424,1,467,467,0.055436847,0.055436847
FALSE,Sanpete County,11/1/97,Hide,Hide,11,1997,8273,8273,8726,8726,1,453,453,0.051913821,0.051913821
FALSE,Sanpete County,11/1/98,Hide,Hide,11,1998,8494,8494,8993,8993,1,499,499,0.055487601,0.055487601
FALSE,Sanpete County,11/1/99,Hide,Hide,11,1999,8606,8606,9008,9008,1,402,402,0.044626998,0.044626998
FALSE,Sanpete County,11/1/00,Hide,Hide,11,2000,9367,9367,9845,9845,1,478,478,0.048552565,0.048552565
FALSE,Sanpete County,11/1/01,Hide,Hide,11,2001,9767,9767,10349,10349,1,582,582,0.056237318,0.056237318
FALSE,Sanpete County,11/1/02,Hide,Hide,11,2002,9621,9621,10318,10318,1,697,697,0.067551851,0.067551851
FALSE,Sanpete County,11/1/03,Hide,Hide,11,2003,9657,9657,10340,10340,1,683,683,0.066054159,0.066054159
FALSE,Sanpete County,11/1/04,Hide,Hide,11,2004,9676,9676,10297,10297,1,621,621,0.060308828,0.060308828
FALSE,Sanpete County,11/1/05,Hide,Hide,11,2005,10136,10136,10648,10648,1,512,512,0.048084147,0.048084147
FALSE,Sanpete County,11/1/06,Hide,Hide,11,2006,10436,10436,10771,10771,1,335,335,0.031102033,0.031102033
FALSE,Sanpete County,11/1/07,Hide,Hide,11,2007,10602,10602,10971,10971,1,369,369,0.033634126,0.033634126
FALSE,Sanpete County,11/1/08,Hide,Hide,11,2008,10666,10666,11321,11321,1,655,655,0.05785708,0.05785708
FALSE,Sanpete County,11/1/09,Hide,Hide,11,2009,10448,10448,11430,11430,1,982,982,0.085914261,0.085914261
FALSE,Sanpete County,11/1/10,Hide,Hide,11,2010,10309,10309,11364,11364,1,1055,1055,0.092837029,0.092837029
FALSE,Sanpete County,11/1/11,Hide,Hide,11,2011,10391,10391,11182,11182,1,791,791,0.070738687,0.070738687
FALSE,Sanpete County,11/1/12,Hide,Hide,11,2012,10600,10600,11296,11296,1,696,696,0.061614731,0.061614731
FALSE,Sanpete County,11/1/13,Hide,Hide,11,2013,10351,10351,10912,10912,1,561,561,0.05141129,0.05141129
FALSE,Sanpete County,11/1/14,Hide,Hide,11,2014,10714,10714,11200,11200,1,486,486,0.043392857,0.043392857
FALSE,Sanpete County,11/1/15,Hide,Hide,11,2015,10976,10976,11449,11449,1,473,473,0.041313652,0.041313652
FALSE,Sanpete County,11/1/16,Hide,Hide,11,2016,11396,11396,11864,11864,1,468,468,0.039447067,0.039447067
FALSE,Sanpete County,11/1/17,Hide,Hide,11,2017,11748,11748,12217,12217,1,469,469,0.03838913,0.03838913
FALSE,Sanpete County,11/1/18,Hide,Hide,11,2018,12048,12048,12494,12494,1,446,446,0.035697135,0.035697135
FALSE,Sanpete County,11/1/19,Hide,Hide,11,2019,12102,12102,12487,12487,1,385,385,0.030832065,0.030832065
FALSE,Sevier County,11/1/92,Hide,Hide,11,1992,6332,6332,6801,6801,1,469,469,0.068960447,0.068960447
FALSE,Sevier County,11/1/93,Hide,Hide,11,1993,6943,6943,7286,7286,1,343,343,0.047076585,0.047076585
FALSE,Sevier County,11/1/94,Hide,Hide,11,1994,7240,7240,7616,7616,1,376,376,0.049369748,0.049369748
FALSE,Sevier County,11/1/95,Hide,Hide,11,1995,7322,7322,7682,7682,1,360,360,0.046862796,0.046862796
FALSE,Sevier County,11/1/96,Hide,Hide,11,1996,7576,7576,7948,7948,1,372,372,0.046804227,0.046804227
FALSE,Sevier County,11/1/97,Hide,Hide,11,1997,7897,7897,8220,8220,1,323,323,0.039294404,0.039294404
FALSE,Sevier County,11/1/98,Hide,Hide,11,1998,7940,7940,8304,8304,1,364,364,0.043834297,0.043834297
FALSE,Sevier County,11/1/99,Hide,Hide,11,1999,8103,8103,8411,8411,1,308,308,0.036618714,0.036618714
FALSE,Sevier County,11/1/00,Hide,Hide,11,2000,7943,7943,8316,8316,1,373,373,0.044853295,0.044853295
FALSE,Sevier County,11/1/01,Hide,Hide,11,2001,8409,8409,8846,8846,1,437,437,0.049400859,0.049400859
FALSE,Sevier County,11/1/02,Hide,Hide,11,2002,8363,8363,8872,8872,1,509,509,0.057371506,0.057371506
FALSE,Sevier County,11/1/03,Hide,Hide,11,2003,8351,8351,8851,8851,1,500,500,0.056490792,0.056490792
FALSE,Sevier County,11/1/04,Hide,Hide,11,2004,8643,8643,9096,9096,1,453,453,0.049802111,0.049802111
FALSE,Sevier County,11/1/05,Hide,Hide,11,2005,8871,8871,9249,9249,1,378,378,0.040869283,0.040869283
FALSE,Sevier County,11/1/06,Hide,Hide,11,2006,9222,9222,9489,9489,1,267,267,0.028137844,0.028137844
FALSE,Sevier County,11/1/07,Hide,Hide,11,2007,9217,9217,9506,9506,1,289,289,0.030401851,0.030401851
FALSE,Sevier County,11/1/08,Hide,Hide,11,2008,9151,9151,9699,9699,1,548,548,0.05650067,0.05650067
FALSE,Sevier County,11/1/09,Hide,Hide,11,2009,9081,9081,9909,9909,1,828,828,0.0835604,0.0835604
FALSE,Sevier County,11/1/10,Hide,Hide,11,2010,8901,8901,9690,9690,1,789,789,0.081424149,0.081424149
FALSE,Sevier County,11/1/11,Hide,Hide,11,2011,8875,8875,9508,9508,1,633,633,0.066575515,0.066575515
FALSE,Sevier County,11/1/12,Hide,Hide,11,2012,8850,8850,9404,9404,1,554,554,0.058911102,0.058911102
FALSE,Sevier County,11/1/13,Hide,Hide,11,2013,8761,8761,9222,9222,1,461,461,0.049989156,0.049989156
FALSE,Sevier County,11/1/14,Hide,Hide,11,2014,8915,8915,9327,9327,1,412,412,0.044172832,0.044172832
FALSE,Sevier County,11/1/15,Hide,Hide,11,2015,9010,9010,9439,9439,1,429,429,0.04544973,0.04544973
FALSE,Sevier County,11/1/16,Hide,Hide,11,2016,9216,9216,9621,9621,1,405,405,0.042095416,0.042095416
FALSE,Sevier County,11/1/17,Hide,Hide,11,2017,9484,9484,9856,9856,1,372,372,0.037743506,0.037743506
FALSE,Sevier County,11/1/18,Hide,Hide,11,2018,9524,9524,9856,9856,1,332,332,0.033685065,0.033685065
FALSE,Sevier County,11/1/19,Hide,Hide,11,2019,9454,9454,9738,9738,1,284,284,0.029164099,0.029164099
FALSE,State of Utah,11/1/92,Hide,Hide,11,1992,862080,862080,904598,904598,1,42518,42518,0.047002094,0.047002094
FALSE,State of Utah,11/1/93,Hide,Hide,11,1993,927221,927221,962796,962796,1,35575,35575,0.036949676,0.036949676
FALSE,State of Utah,11/1/94,Hide,Hide,11,1994,963548,963548,1002231,1002231,1,38683,38683,0.03859689,0.03859689
FALSE,State of Utah,11/1/95,Hide,Hide,11,1995,987184,987184,1021336,1021336,1,34152,34152,0.033438555,0.033438555
FALSE,State of Utah,11/1/96,Hide,Hide,11,1996,1016036,1016036,1051224,1051224,1,35188,35188,0.033473361,0.033473361
FALSE,State of Utah,11/1/97,Hide,Hide,11,1997,1045911,1045911,1081612,1081612,1,35701,35701,0.033007215,0.033007215
FALSE,State of Utah,11/1/98,Hide,Hide,11,1998,1070642,1070642,1111688,1111688,1,41046,41046,0.03692223,0.03692223
FALSE,State of Utah,11/1/99,Hide,Hide,11,1999,1088588,1088588,1125515,1125515,1,36927,36927,0.032808981,0.032808981
FALSE,State of Utah,11/1/00,Hide,Hide,11,2000,1111570,1111570,1153832,1153832,1,42262,42262,0.036627516,0.036627516
FALSE,State of Utah,11/1/01,Hide,Hide,11,2001,1112156,1112156,1170796,1170796,1,58640,58640,0.050085583,0.050085583
FALSE,State of Utah,11/1/02,Hide,Hide,11,2002,1119627,1119627,1190304,1190304,1,70677,70677,0.059377268,0.059377268
FALSE,State of Utah,11/1/03,Hide,Hide,11,2003,1144316,1144316,1209932,1209932,1,65616,65616,0.054231147,0.054231147
FALSE,State of Utah,11/1/04,Hide,Hide,11,2004,1185640,1185640,1243005,1243005,1,57365,57365,0.046150257,0.046150257
FALSE,State of Utah,11/1/05,Hide,Hide,11,2005,1241636,1241636,1290896,1290896,1,49260,49260,0.038159542,0.038159542
FALSE,State of Utah,11/1/06,Hide,Hide,11,2006,1300853,1300853,1334954,1334954,1,34101,34101,0.0255447,0.0255447
FALSE,State of Utah,11/1/07,Hide,Hide,11,2007,1330828,1330828,1369818,1369818,1,38990,38990,0.028463635,0.028463635
FALSE,State of Utah,11/1/08,Hide,Hide,11,2008,1309344,1309344,1365637,1365637,1,56293,56293,0.041221057,0.041221057
FALSE,State of Utah,11/1/09,Hide,Hide,11,2009,1249870,1249870,1355221,1355221,1,105351,105351,0.077737137,0.077737137
FALSE,State of Utah,11/1/10,Hide,Hide,11,2010,1250532,1250532,1354026,1354026,1,103494,103494,0.076434278,0.076434278
FALSE,State of Utah,11/1/11,Hide,Hide,11,2011,1269973,1269973,1352773,1352773,1,82800,82800,0.061207608,0.061207608
FALSE,State of Utah,11/1/12,Hide,Hide,11,2012,1315424,1315424,1385729,1385729,1,70305,70305,0.050735028,0.050735028
FALSE,State of Utah,11/1/13,Hide,Hide,11,2013,1356215,1356215,1416452,1416452,1,60237,60237,0.042526679,0.042526679
FALSE,State of Utah,11/1/14,Hide,Hide,11,2014,1384724,1384724,1437708,1437708,1,52984,52984,0.036853102,0.036853102
FALSE,State of Utah,11/1/15,Hide,Hide,11,2015,1420993,1420993,1474015,1474015,1,53022,53022,0.03597114,0.03597114
FALSE,State of Utah,11/1/16,Hide,Hide,11,2016,1474174,1474174,1524784,1524784,1,50610,50610,0.033191586,0.033191586
FALSE,State of Utah,11/1/17,Hide,Hide,11,2017,1510301,1510301,1559523,1559523,1,49222,49222,0.031562215,0.031562215
FALSE,State of Utah,11/1/18,Hide,Hide,11,2018,1530422,1530422,1580279,1580279,1,49857,49857,0.031549492,0.031549492
FALSE,State of Utah,11/1/19,Hide,Hide,11,2019,1577859,1577859,1617037,1617037,1,39178,39178,0.024228264,0.024228264
FALSE,Summit County,11/1/92,Hide,Hide,11,1992,9124,9124,9738,9738,1,614,614,0.063051961,0.063051961
FALSE,Summit County,11/1/93,Hide,Hide,11,1993,10244,10244,10731,10731,1,487,487,0.045382537,0.045382537
FALSE,Summit County,11/1/94,Hide,Hide,11,1994,11236,11236,11752,11752,1,516,516,0.04390742,0.04390742
FALSE,Summit County,11/1/95,Hide,Hide,11,1995,11781,11781,12255,12255,1,474,474,0.038678091,0.038678091
FALSE,Summit County,11/1/96,Hide,Hide,11,1996,12628,12628,13055,13055,1,427,427,0.032707775,0.032707775
FALSE,Summit County,11/1/97,Hide,Hide,11,1997,13209,13209,13756,13756,1,547,547,0.039764466,0.039764466
FALSE,Summit County,11/1/98,Hide,Hide,11,1998,13783,13783,14407,14407,1,624,624,0.043312279,0.043312279
FALSE,Summit County,11/1/99,Hide,Hide,11,1999,14507,14507,15144,15144,1,637,637,0.042062863,0.042062863
FALSE,Summit County,11/1/00,Hide,Hide,11,2000,18048,18048,18717,18717,1,669,669,0.035742908,0.035742908
FALSE,Summit County,11/1/01,Hide,Hide,11,2001,18029,18029,19168,19168,1,1139,1139,0.059421953,0.059421953
FALSE,Summit County,11/1/02,Hide,Hide,11,2002,18259,18259,19550,19550,1,1291,1291,0.066035806,0.066035806
FALSE,Summit County,11/1/03,Hide,Hide,11,2003,18870,18870,20049,20049,1,1179,1179,0.058805925,0.058805925
FALSE,Summit County,11/1/04,Hide,Hide,11,2004,19770,19770,20733,20733,1,963,963,0.046447692,0.046447692
FALSE,Summit County,11/1/05,Hide,Hide,11,2005,20906,20906,21701,21701,1,795,795,0.036634256,0.036634256
FALSE,Summit County,11/1/06,Hide,Hide,11,2006,21465,21465,21998,21998,1,533,533,0.024229475,0.024229475
FALSE,Summit County,11/1/07,Hide,Hide,11,2007,21391,21391,21981,21981,1,590,590,0.026841363,0.026841363
FALSE,Summit County,11/1/08,Hide,Hide,11,2008,21267,21267,22228,22228,1,961,961,0.043233759,0.043233759
FALSE,Summit County,11/1/09,Hide,Hide,11,2009,20913,20913,22542,22542,1,1629,1629,0.072265105,0.072265105
FALSE,Summit County,11/1/10,Hide,Hide,11,2010,19408,19408,20932,20932,1,1524,1524,0.072807185,0.072807185
FALSE,Summit County,11/1/11,Hide,Hide,11,2011,19984,19984,21152,21152,1,1168,1168,0.055219365,0.055219365
FALSE,Summit County,11/1/12,Hide,Hide,11,2012,20868,20868,21910,21910,1,1042,1042,0.047558193,0.047558193
FALSE,Summit County,11/1/13,Hide,Hide,11,2013,21358,21358,22214,22214,1,856,856,0.038534258,0.038534258
FALSE,Summit County,11/1/14,Hide,Hide,11,2014,21849,21849,22609,22609,1,760,760,0.033614932,0.033614932
FALSE,Summit County,11/1/15,Hide,Hide,11,2015,22606,22606,23368,23368,1,762,762,0.032608696,0.032608696
FALSE,Summit County,11/1/16,Hide,Hide,11,2016,23336,23336,24087,24087,1,751,751,0.031178644,0.031178644
FALSE,Summit County,11/1/17,Hide,Hide,11,2017,23512,23512,24256,24256,1,744,744,0.030672823,0.030672823
FALSE,Summit County,11/1/18,Hide,Hide,11,2018,23954,23954,24658,24658,1,704,704,0.028550572,0.028550572
FALSE,Summit County,11/1/19,Hide,Hide,11,2019,24888,24888,25476,25476,1,588,588,0.023080546,0.023080546
FALSE,Tooele County,11/1/92,Hide,Hide,11,1992,11625,11625,12485,12485,1,860,860,0.068882659,0.068882659
FALSE,Tooele County,11/1/93,Hide,Hide,11,1993,11440,11440,12037,12037,1,597,597,0.049597076,0.049597076
FALSE,Tooele County,11/1/94,Hide,Hide,11,1994,10939,10939,11628,11628,1,689,689,0.059253526,0.059253526
FALSE,Tooele County,11/1/95,Hide,Hide,11,1995,10839,10839,11440,11440,1,601,601,0.052534965,0.052534965
FALSE,Tooele County,11/1/96,Hide,Hide,11,1996,11212,11212,11792,11792,1,580,580,0.049185889,0.049185889
FALSE,Tooele County,11/1/97,Hide,Hide,11,1997,11505,11505,12029,12029,1,524,524,0.043561393,0.043561393
FALSE,Tooele County,11/1/98,Hide,Hide,11,1998,11797,11797,12441,12441,1,644,644,0.051764328,0.051764328
FALSE,Tooele County,11/1/99,Hide,Hide,11,1999,13631,13631,14268,14268,1,637,637,0.04464536,0.04464536
FALSE,Tooele County,11/1/00,Hide,Hide,11,2000,20235,20235,21073,21073,1,838,838,0.039766526,0.039766526
FALSE,Tooele County,11/1/01,Hide,Hide,11,2001,20578,20578,21753,21753,1,1175,1175,0.054015538,0.054015538
FALSE,Tooele County,11/1/02,Hide,Hide,11,2002,21126,21126,22607,22607,1,1481,1481,0.065510683,0.065510683
FALSE,Tooele County,11/1/03,Hide,Hide,11,2003,22137,22137,23520,23520,1,1383,1383,0.05880102,0.05880102
FALSE,Tooele County,11/1/04,Hide,Hide,11,2004,23184,23184,24429,24429,1,1245,1245,0.050964018,0.050964018
FALSE,Tooele County,11/1/05,Hide,Hide,11,2005,24581,24581,25629,25629,1,1048,1048,0.040891178,0.040891178
FALSE,Tooele County,11/1/06,Hide,Hide,11,2006,25875,25875,26636,26636,1,761,761,0.028570356,0.028570356
FALSE,Tooele County,11/1/07,Hide,Hide,11,2007,26436,26436,27293,27293,1,857,857,0.031399993,0.031399993
FALSE,Tooele County,11/1/08,Hide,Hide,11,2008,26647,26647,28082,28082,1,1435,1435,0.051100349,0.051100349
FALSE,Tooele County,11/1/09,Hide,Hide,11,2009,25466,25466,27858,27858,1,2392,2392,0.085864025,0.085864025
FALSE,Tooele County,11/1/10,Hide,Hide,11,2010,25194,25194,27397,27397,1,2203,2203,0.080410264,0.080410264
FALSE,Tooele County,11/1/11,Hide,Hide,11,2011,25506,25506,27288,27288,1,1782,1782,0.06530343,0.06530343
FALSE,Tooele County,11/1/12,Hide,Hide,11,2012,26443,26443,28050,28050,1,1607,1607,0.057290553,0.057290553
FALSE,Tooele County,11/1/13,Hide,Hide,11,2013,27271,27271,28772,28772,1,1501,1501,0.052168775,0.052168775
FALSE,Tooele County,11/1/14,Hide,Hide,11,2014,27754,27754,29072,29072,1,1318,1318,0.045335718,0.045335718
FALSE,Tooele County,11/1/15,Hide,Hide,11,2015,28735,28735,29946,29946,1,1211,1211,0.040439458,0.040439458
FALSE,Tooele County,11/1/16,Hide,Hide,11,2016,30128,30128,31272,31272,1,1144,1144,0.036582246,0.036582246
FALSE,Tooele County,11/1/17,Hide,Hide,11,2017,31330,31330,32466,32466,1,1136,1136,0.034990452,0.034990452
FALSE,Tooele County,11/1/18,Hide,Hide,11,2018,32298,32298,33410,33410,1,1112,1112,0.033283448,0.033283448
FALSE,Tooele County,11/1/19,Hide,Hide,11,2019,33458,33458,34389,34389,1,931,931,0.02707261,0.02707261
FALSE,Uintah County,11/1/92,Hide,Hide,11,1992,9197,9197,9954,9954,1,757,757,0.076049829,0.076049829
FALSE,Uintah County,11/1/93,Hide,Hide,11,1993,9418,9418,10100,10100,1,682,682,0.067524752,0.067524752
FALSE,Uintah County,11/1/94,Hide,Hide,11,1994,9528,9528,10265,10265,1,737,737,0.07179737,0.07179737
FALSE,Uintah County,11/1/95,Hide,Hide,11,1995,9490,9490,10236,10236,1,746,746,0.072880031,0.072880031
FALSE,Uintah County,11/1/96,Hide,Hide,11,1996,9620,9620,10331,10331,1,711,711,0.068821992,0.068821992
FALSE,Uintah County,11/1/97,Hide,Hide,11,1997,10157,10157,10709,10709,1,552,552,0.051545429,0.051545429
FALSE,Uintah County,11/1/98,Hide,Hide,11,1998,10305,10305,11080,11080,1,775,775,0.069945848,0.069945848
FALSE,Uintah County,11/1/99,Hide,Hide,11,1999,10616,10616,11193,11193,1,577,577,0.051550076,0.051550076
FALSE,Uintah County,11/1/00,Hide,Hide,11,2000,11158,11158,11666,11666,1,508,508,0.043545345,0.043545345
FALSE,Uintah County,11/1/01,Hide,Hide,11,2001,11907,11907,12521,12521,1,614,614,0.049037617,0.049037617
FALSE,Uintah County,11/1/02,Hide,Hide,11,2002,11975,11975,12782,12782,1,807,807,0.06313566,0.06313566
FALSE,Uintah County,11/1/03,Hide,Hide,11,2003,12592,12592,13329,13329,1,737,737,0.05529297,0.05529297
FALSE,Uintah County,11/1/04,Hide,Hide,11,2004,13313,13313,13961,13961,1,648,648,0.046415013,0.046415013
FALSE,Uintah County,11/1/05,Hide,Hide,11,2005,14700,14700,15206,15206,1,506,506,0.033276338,0.033276338
FALSE,Uintah County,11/1/06,Hide,Hide,11,2006,16468,16468,16801,16801,1,333,333,0.019820249,0.019820249
FALSE,Uintah County,11/1/07,Hide,Hide,11,2007,16840,16840,17237,17237,1,397,397,0.02303185,0.02303185
FALSE,Uintah County,11/1/08,Hide,Hide,11,2008,18642,18642,19174,19174,1,532,532,0.027745906,0.027745906
FALSE,Uintah County,11/1/09,Hide,Hide,11,2009,14921,14921,16653,16653,1,1732,1732,0.104005284,0.104005284
FALSE,Uintah County,11/1/10,Hide,Hide,11,2010,14109,14109,15324,15324,1,1215,1215,0.079287392,0.079287392
FALSE,Uintah County,11/1/11,Hide,Hide,11,2011,14865,14865,15672,15672,1,807,807,0.051493109,0.051493109
FALSE,Uintah County,11/1/12,Hide,Hide,11,2012,15215,15215,15944,15944,1,729,729,0.045722529,0.045722529
FALSE,Uintah County,11/1/13,Hide,Hide,11,2013,14940,14940,15585,15585,1,645,645,0.041385948,0.041385948
FALSE,Uintah County,11/1/14,Hide,Hide,11,2014,15530,15530,16144,16144,1,614,614,0.038032706,0.038032706
FALSE,Uintah County,11/1/15,Hide,Hide,11,2015,13510,13510,14762,14762,1,1252,1252,0.084812356,0.084812356
FALSE,Uintah County,11/1/16,Hide,Hide,11,2016,12574,12574,13726,13726,1,1152,1152,0.083928311,0.083928311
FALSE,Uintah County,11/1/17,Hide,Hide,11,2017,12959,12959,13692,13692,1,733,733,0.053534911,0.053534911
FALSE,Uintah County,11/1/18,Hide,Hide,11,2018,12981,12981,13578,13578,1,597,597,0.043968184,0.043968184
FALSE,Uintah County,11/1/19,Hide,Hide,11,2019,13144,13144,13735,13735,1,591,591,0.043028759,0.043028759
FALSE,United States,11/1/92,Hide,Hide,11,1992,118876,118876000,128441,128441000,1,9565,9565000,0.074,0.074
FALSE,United States,11/1/93,Hide,Hide,11,1993,121169,121169000,129711,129711000,1,8542,8542000,0.066,0.066
FALSE,United States,11/1/94,Hide,Hide,11,1994,124516,124516000,131891,131891000,1,7375,7375000,0.056,0.056
FALSE,United States,11/1/95,Hide,Hide,11,1995,125188,125188000,132614,132614000,1,7426,7426000,0.056,0.056
FALSE,United States,11/1/96,Hide,Hide,11,1996,127771,127771000,135007,135007000,1,7236,7236000,0.054,0.054
FALSE,United States,11/1/97,Hide,Hide,11,1997,130653,130653000,136961,136961000,1,6308,6308000,0.046,0.046
FALSE,United States,11/1/98,Hide,Hide,11,1998,132280,132280000,138381,138381000,1,6100,6100000,0.044,0.044
FALSE,United States,11/1/99,Hide,Hide,11,1999,134309,134309000,140025,140025000,1,5716,5716000,0.041,0.041
FALSE,United States,11/1/00,Hide,Hide,11,2000,137322,137322000,142962,142962000,1,5639,5639000,0.039,0.039
FALSE,United States,11/1/01,Hide,Hide,11,2001,136238,136238000,144240,144240000,1,8003,8003000,0.055,0.055
FALSE,United States,11/1/02,Hide,Hide,11,2002,136521,136521000,145041,145041000,1,8520,8520000,0.059,0.059
FALSE,United States,11/1/03,Hide,Hide,11,2003,138424,138424000,147000,147000000,1,8576,8576000,0.058,0.058
FALSE,United States,11/1/04,Hide,Hide,11,2004,140231,140231000,148162,148162000,1,7932,7932000,0.054,0.054
FALSE,United States,11/1/05,Hide,Hide,11,2005,142499,142499000,150065,150065000,1,7566,7566000,0.05,0.05
FALSE,United States,11/1/06,Hide,Hide,11,2006,145534,145534000,152406,152406000,1,6872,6872000,0.045,0.045
FALSE,United States,11/1/07,Hide,Hide,11,2007,146595,146595000,153835,153835000,1,7240,7240000,0.047,0.047
FALSE,United States,11/1/08,Hide,Hide,11,2008,144100,144100000,154639,154639000,1,10538,10538000,0.068,0.068
FALSE,United States,11/1/09,Hide,Hide,11,2009,138659,138659000,153878,153878000,1,15219,15219000,0.099,0.099
FALSE,United States,11/1/10,Hide,Hide,11,2010,139044,139044000,154125,154125000,1,15081,15081000,0.098,0.098
FALSE,United States,11/1/11,Hide,Hide,11,2011,140826,140826000,154128,154128000,1,13302,13302000,0.086,0.086
FALSE,United States,11/1/12,Hide,Hide,11,2012,143333,143333000,155338,155338000,1,12005,12005000,0.077,0.077
FALSE,United States,11/1/13,Hide,Hide,11,2013,144479,144479000,155265,155265000,1,10787,10787000,0.069,0.069
FALSE,United States,11/1/14,Hide,Hide,11,2014,147404,147404000,156494,156494000,1,9090,9090000,0.058,0.058
FALSE,United States,11/1/15,Hide,Hide,11,2015,149463,149463000,157463,157463000,1,8000,8000000,0.051,0.051
FALSE,United States,11/1/16,Hide,Hide,11,2016,152063,152063000,159551,159551000,1,7488,7488000,0.047,0.047
FALSE,United States,11/1/17,Hide,Hide,11,2017,153813,153813000,160510,160510000,1,6697,6697000,0.042,0.042
FALSE,United States,11/1/18,Hide,Hide,11,2018,156628,156628000,162662,162662000,1,6034,6034000,0.037,0.037
FALSE,United States,11/1/19,Hide,Hide,11,2019,158536,158536000,164347,164347000,1,5811,5811000,0.035,0.035
FALSE,Utah County,11/1/92,Hide,Hide,11,1992,125973,125973,131166,131166,1,5193,5193,0.039591053,0.039591053
FALSE,Utah County,11/1/93,Hide,Hide,11,1993,135419,135419,139930,139930,1,4511,4511,0.032237547,0.032237547
FALSE,Utah County,11/1/94,Hide,Hide,11,1994,141436,141436,146072,146072,1,4636,4636,0.031737773,0.031737773
FALSE,Utah County,11/1/95,Hide,Hide,11,1995,148230,148230,152303,152303,1,4073,4073,0.026742743,0.026742743
FALSE,Utah County,11/1/96,Hide,Hide,11,1996,151612,151612,156073,156073,1,4461,4461,0.028582779,0.028582779
FALSE,Utah County,11/1/97,Hide,Hide,11,1997,155095,155095,159402,159402,1,4307,4307,0.027019736,0.027019736
FALSE,Utah County,11/1/98,Hide,Hide,11,1998,162725,162725,168278,168278,1,5553,5553,0.032998966,0.032998966
FALSE,Utah County,11/1/99,Hide,Hide,11,1999,168499,168499,173075,173075,1,4576,4576,0.026439405,0.026439405
FALSE,Utah County,11/1/00,Hide,Hide,11,2000,177419,177419,183163,183163,1,5744,5744,0.031360045,0.031360045
FALSE,Utah County,11/1/01,Hide,Hide,11,2001,174502,174502,183656,183656,1,9154,9154,0.049843185,0.049843185
FALSE,Utah County,11/1/02,Hide,Hide,11,2002,176696,176696,187854,187854,1,11158,11158,0.059397191,0.059397191
FALSE,Utah County,11/1/03,Hide,Hide,11,2003,181398,181398,191190,191190,1,9792,9792,0.051216068,0.051216068
FALSE,Utah County,11/1/04,Hide,Hide,11,2004,191020,191020,199886,199886,1,8866,8866,0.044355283,0.044355283
FALSE,Utah County,11/1/05,Hide,Hide,11,2005,200934,200934,208630,208630,1,7696,7696,0.036888271,0.036888271
FALSE,Utah County,11/1/06,Hide,Hide,11,2006,213039,213039,218163,218163,1,5124,5124,0.023487026,0.023487026
FALSE,Utah County,11/1/07,Hide,Hide,11,2007,218959,218959,224965,224965,1,6006,6006,0.026697486,0.026697486
FALSE,Utah County,11/1/08,Hide,Hide,11,2008,213161,213161,223403,223403,1,10242,10242,0.0458454,0.0458454
FALSE,Utah County,11/1/09,Hide,Hide,11,2009,205279,205279,222552,222552,1,17273,17273,0.077613322,0.077613322
FALSE,Utah County,11/1/10,Hide,Hide,11,2010,213007,213007,229786,229786,1,16779,16779,0.073020114,0.073020114
FALSE,Utah County,11/1/11,Hide,Hide,11,2011,219829,219829,232958,232958,1,13129,13129,0.056357798,0.056357798
FALSE,Utah County,11/1/12,Hide,Hide,11,2012,231699,231699,243038,243038,1,11339,11339,0.046655256,0.046655256
FALSE,Utah County,11/1/13,Hide,Hide,11,2013,241560,241560,251422,251422,1,9862,9862,0.039224889,0.039224889
FALSE,Utah County,11/1/14,Hide,Hide,11,2014,250008,250008,258687,258687,1,8679,8679,0.033550198,0.033550198
FALSE,Utah County,11/1/15,Hide,Hide,11,2015,261490,261490,270190,270190,1,8700,8700,0.032199563,0.032199563
FALSE,Utah County,11/1/16,Hide,Hide,11,2016,275002,275002,283600,283600,1,8598,8598,0.030317348,0.030317348
FALSE,Utah County,11/1/17,Hide,Hide,11,2017,286447,286447,294899,294899,1,8452,8452,0.02866066,0.02866066
FALSE,Utah County,11/1/18,Hide,Hide,11,2018,293268,293268,301528,301528,1,8260,8260,0.027393808,0.027393808
FALSE,Utah County,11/1/19,Hide,Hide,11,2019,304925,304925,312105,312105,1,7180,7180,0.023005078,0.023005078
FALSE,Wasatch County,11/1/92,Hide,Hide,11,1992,4570,4570,4891,4891,1,321,321,0.06563075,0.06563075
FALSE,Wasatch County,11/1/93,Hide,Hide,11,1993,4880,4880,5187,5187,1,307,307,0.059186428,0.059186428
FALSE,Wasatch County,11/1/94,Hide,Hide,11,1994,5158,5158,5473,5473,1,315,315,0.057555271,0.057555271
FALSE,Wasatch County,11/1/95,Hide,Hide,11,1995,5195,5195,5435,5435,1,240,240,0.044158234,0.044158234
FALSE,Wasatch County,11/1/96,Hide,Hide,11,1996,5506,5506,5748,5748,1,242,242,0.042101601,0.042101601
FALSE,Wasatch County,11/1/97,Hide,Hide,11,1997,5748,5748,6009,6009,1,261,261,0.043434848,0.043434848
FALSE,Wasatch County,11/1/98,Hide,Hide,11,1998,5986,5986,6272,6272,1,286,286,0.04559949,0.04559949
FALSE,Wasatch County,11/1/99,Hide,Hide,11,1999,6210,6210,6494,6494,1,284,284,0.043732676,0.043732676
FALSE,Wasatch County,11/1/00,Hide,Hide,11,2000,7556,7556,7865,7865,1,309,309,0.039287985,0.039287985
FALSE,Wasatch County,11/1/01,Hide,Hide,11,2001,7694,7694,8117,8117,1,423,423,0.05211285,0.05211285
FALSE,Wasatch County,11/1/02,Hide,Hide,11,2002,7723,7723,8252,8252,1,529,529,0.064105671,0.064105671
FALSE,Wasatch County,11/1/03,Hide,Hide,11,2003,8048,8048,8564,8564,1,516,516,0.060252219,0.060252219
FALSE,Wasatch County,11/1/04,Hide,Hide,11,2004,8537,8537,8973,8973,1,436,436,0.048590215,0.048590215
FALSE,Wasatch County,11/1/05,Hide,Hide,11,2005,9188,9188,9549,9549,1,361,361,0.037805006,0.037805006
FALSE,Wasatch County,11/1/06,Hide,Hide,11,2006,10165,10165,10452,10452,1,287,287,0.02745886,0.02745886
FALSE,Wasatch County,11/1/07,Hide,Hide,11,2007,10591,10591,10910,10910,1,319,319,0.02923923,0.02923923
FALSE,Wasatch County,11/1/08,Hide,Hide,11,2008,9703,9703,10227,10227,1,524,524,0.051236922,0.051236922
FALSE,Wasatch County,11/1/09,Hide,Hide,11,2009,9443,9443,10349,10349,1,906,906,0.08754469,0.08754469
FALSE,Wasatch County,11/1/10,Hide,Hide,11,2010,10527,10527,11453,11453,1,926,926,0.080852178,0.080852178
FALSE,Wasatch County,11/1/11,Hide,Hide,11,2011,10780,10780,11510,11510,1,730,730,0.06342311,0.06342311
FALSE,Wasatch County,11/1/12,Hide,Hide,11,2012,11297,11297,11935,11935,1,638,638,0.053456221,0.053456221
FALSE,Wasatch County,11/1/13,Hide,Hide,11,2013,11877,11877,12414,12414,1,537,537,0.043257612,0.043257612
FALSE,Wasatch County,11/1/14,Hide,Hide,11,2014,12327,12327,12788,12788,1,461,461,0.036049421,0.036049421
FALSE,Wasatch County,11/1/15,Hide,Hide,11,2015,12962,12962,13446,13446,1,484,484,0.035995835,0.035995835
FALSE,Wasatch County,11/1/16,Hide,Hide,11,2016,13613,13613,14077,14077,1,464,464,0.032961569,0.032961569
FALSE,Wasatch County,11/1/17,Hide,Hide,11,2017,14359,14359,14833,14833,1,474,474,0.031955774,0.031955774
FALSE,Wasatch County,11/1/18,Hide,Hide,11,2018,14974,14974,15444,15444,1,470,470,0.03043253,0.03043253
FALSE,Wasatch County,11/1/19,Hide,Hide,11,2019,16132,16132,16560,16560,1,428,428,0.025845411,0.025845411
FALSE,Washington County,11/1/92,Hide,Hide,11,1992,22709,22709,23693,23693,1,984,984,0.041531254,0.041531254
FALSE,Washington County,11/1/93,Hide,Hide,11,1993,27021,27021,27893,27893,1,872,872,0.031262324,0.031262324
FALSE,Washington County,11/1/94,Hide,Hide,11,1994,30515,30515,31550,31550,1,1035,1035,0.032805071,0.032805071
FALSE,Washington County,11/1/95,Hide,Hide,11,1995,32619,32619,33728,33728,1,1109,1109,0.032880693,0.032880693
FALSE,Washington County,11/1/96,Hide,Hide,11,1996,33732,33732,34970,34970,1,1238,1238,0.035401773,0.035401773
FALSE,Washington County,11/1/97,Hide,Hide,11,1997,34676,34676,35840,35840,1,1164,1164,0.032477679,0.032477679
FALSE,Washington County,11/1/98,Hide,Hide,11,1998,36716,36716,38153,38153,1,1437,1437,0.037664142,0.037664142
FALSE,Washington County,11/1/99,Hide,Hide,11,1999,37804,37804,39096,39096,1,1292,1292,0.033046859,0.033046859
FALSE,Washington County,11/1/00,Hide,Hide,11,2000,38659,38659,40155,40155,1,1496,1496,0.037255634,0.037255634
FALSE,Washington County,11/1/01,Hide,Hide,11,2001,40666,40666,42580,42580,1,1914,1914,0.044950681,0.044950681
FALSE,Washington County,11/1/02,Hide,Hide,11,2002,43219,43219,45813,45813,1,2594,2594,0.056621483,0.056621483
FALSE,Washington County,11/1/03,Hide,Hide,11,2003,46698,46698,49249,49249,1,2551,2551,0.051798006,0.051798006
FALSE,Washington County,11/1/04,Hide,Hide,11,2004,51461,51461,53884,53884,1,2423,2423,0.044966966,0.044966966
FALSE,Washington County,11/1/05,Hide,Hide,11,2005,56513,56513,58713,58713,1,2200,2200,0.037470407,0.037470407
FALSE,Washington County,11/1/06,Hide,Hide,11,2006,60144,60144,61801,61801,1,1657,1657,0.026811864,0.026811864
FALSE,Washington County,11/1/07,Hide,Hide,11,2007,62432,62432,64342,64342,1,1910,1910,0.02968512,0.02968512
FALSE,Washington County,11/1/08,Hide,Hide,11,2008,56877,56877,60966,60966,1,4089,4089,0.06707017,0.06707017
FALSE,Washington County,11/1/09,Hide,Hide,11,2009,52542,52542,58760,58760,1,6218,6218,0.105820286,0.105820286
FALSE,Washington County,11/1/10,Hide,Hide,11,2010,50443,50443,56239,56239,1,5796,5796,0.103060154,0.103060154
FALSE,Washington County,11/1/11,Hide,Hide,11,2011,51691,51691,56229,56229,1,4538,4538,0.080705686,0.080705686
FALSE,Washington County,11/1/12,Hide,Hide,11,2012,54378,54378,58064,58064,1,3686,3686,0.063481675,0.063481675
FALSE,Washington County,11/1/13,Hide,Hide,11,2013,57186,57186,60136,60136,1,2950,2950,0.049055474,0.049055474
FALSE,Washington County,11/1/14,Hide,Hide,11,2014,59583,59583,62254,62254,1,2671,2671,0.042904874,0.042904874
FALSE,Washington County,11/1/15,Hide,Hide,11,2015,62135,62135,64732,64732,1,2597,2597,0.040119261,0.040119261
FALSE,Washington County,11/1/16,Hide,Hide,11,2016,66151,66151,68598,68598,1,2447,2447,0.035671594,0.035671594
FALSE,Washington County,11/1/17,Hide,Hide,11,2017,69518,69518,71979,71979,1,2461,2461,0.034190528,0.034190528
FALSE,Washington County,11/1/18,Hide,Hide,11,2018,72478,72478,74967,74967,1,2489,2489,0.033201275,0.033201275
FALSE,Washington County,11/1/19,Hide,Hide,11,2019,74946,74946,77108,77108,1,2162,2162,0.028038595,0.028038595
FALSE,Wayne County,11/1/92,Hide,Hide,11,1992,986,986,1073,1073,1,87,87,0.081081081,0.081081081
FALSE,Wayne County,11/1/93,Hide,Hide,11,1993,1050,1050,1128,1128,1,78,78,0.069148936,0.069148936
FALSE,Wayne County,11/1/94,Hide,Hide,11,1994,1110,1110,1196,1196,1,86,86,0.071906355,0.071906355
FALSE,Wayne County,11/1/95,Hide,Hide,11,1995,1255,1255,1337,1337,1,82,82,0.061331339,0.061331339
FALSE,Wayne County,11/1/96,Hide,Hide,11,1996,1272,1272,1343,1343,1,71,71,0.052866716,0.052866716
FALSE,Wayne County,11/1/97,Hide,Hide,11,1997,1403,1403,1474,1474,1,71,71,0.04816825,0.04816825
FALSE,Wayne County,11/1/98,Hide,Hide,11,1998,1341,1341,1436,1436,1,95,95,0.066155989,0.066155989
FALSE,Wayne County,11/1/99,Hide,Hide,11,1999,1403,1403,1468,1468,1,65,65,0.044277929,0.044277929
FALSE,Wayne County,11/1/00,Hide,Hide,11,2000,1251,1251,1316,1316,1,65,65,0.049392097,0.049392097
FALSE,Wayne County,11/1/01,Hide,Hide,11,2001,1458,1458,1529,1529,1,71,71,0.046435579,0.046435579
FALSE,Wayne County,11/1/02,Hide,Hide,11,2002,1299,1299,1394,1394,1,95,95,0.068149211,0.068149211
FALSE,Wayne County,11/1/03,Hide,Hide,11,2003,1206,1206,1299,1299,1,93,93,0.071593533,0.071593533
FALSE,Wayne County,11/1/04,Hide,Hide,11,2004,1218,1218,1301,1301,1,83,83,0.063797079,0.063797079
FALSE,Wayne County,11/1/05,Hide,Hide,11,2005,1298,1298,1368,1368,1,70,70,0.051169591,0.051169591
FALSE,Wayne County,11/1/06,Hide,Hide,11,2006,1329,1329,1383,1383,1,54,54,0.039045553,0.039045553
FALSE,Wayne County,11/1/07,Hide,Hide,11,2007,1340,1340,1400,1400,1,60,60,0.042857143,0.042857143
FALSE,Wayne County,11/1/08,Hide,Hide,11,2008,1356,1356,1454,1454,1,98,98,0.067400275,0.067400275
FALSE,Wayne County,11/1/09,Hide,Hide,11,2009,1394,1394,1524,1524,1,130,130,0.085301837,0.085301837
FALSE,Wayne County,11/1/10,Hide,Hide,11,2010,1418,1418,1553,1553,1,135,135,0.086928525,0.086928525
FALSE,Wayne County,11/1/11,Hide,Hide,11,2011,1197,1197,1346,1346,1,149,149,0.110698366,0.110698366
FALSE,Wayne County,11/1/12,Hide,Hide,11,2012,1199,1199,1349,1349,1,150,150,0.111193477,0.111193477
FALSE,Wayne County,11/1/13,Hide,Hide,11,2013,1262,1262,1408,1408,1,146,146,0.103693182,0.103693182
FALSE,Wayne County,11/1/14,Hide,Hide,11,2014,1267,1267,1396,1396,1,129,129,0.092406877,0.092406877
FALSE,Wayne County,11/1/15,Hide,Hide,11,2015,1301,1301,1426,1426,1,125,125,0.087657784,0.087657784
FALSE,Wayne County,11/1/16,Hide,Hide,11,2016,1306,1306,1418,1418,1,112,112,0.078984485,0.078984485
FALSE,Wayne County,11/1/17,Hide,Hide,11,2017,1365,1365,1463,1463,1,98,98,0.066985646,0.066985646
FALSE,Wayne County,11/1/18,Hide,Hide,11,2018,1330,1330,1409,1409,1,79,79,0.056068133,0.056068133
FALSE,Wayne County,11/1/19,Hide,Hide,11,2019,1354,1354,1429,1429,1,75,75,0.052484255,0.052484255
FALSE,Weber County,11/1/92,Hide,Hide,11,1992,79802,79802,84848,84848,1,5046,5046,0.059471054,0.059471054
FALSE,Weber County,11/1/93,Hide,Hide,11,1993,85410,85410,89577,89577,1,4167,4167,0.046518638,0.046518638
FALSE,Weber County,11/1/94,Hide,Hide,11,1994,88400,88400,92693,92693,1,4293,4293,0.046314177,0.046314177
FALSE,Weber County,11/1/95,Hide,Hide,11,1995,89301,89301,93102,93102,1,3801,3801,0.040826191,0.040826191
FALSE,Weber County,11/1/96,Hide,Hide,11,1996,93119,93119,97143,97143,1,4024,4024,0.041423468,0.041423468
FALSE,Weber County,11/1/97,Hide,Hide,11,1997,95977,95977,100138,100138,1,4161,4161,0.041552657,0.041552657
FALSE,Weber County,11/1/98,Hide,Hide,11,1998,97354,97354,102037,102037,1,4683,4683,0.045895116,0.045895116
FALSE,Weber County,11/1/99,Hide,Hide,11,1999,98355,98355,102546,102546,1,4191,4191,0.040869463,0.040869463
FALSE,Weber County,11/1/00,Hide,Hide,11,2000,96063,96063,100749,100749,1,4686,4686,0.046511628,0.046511628
FALSE,Weber County,11/1/01,Hide,Hide,11,2001,96260,96260,102085,102085,1,5825,5825,0.057060293,0.057060293
FALSE,Weber County,11/1/02,Hide,Hide,11,2002,97775,97775,104505,104505,1,6730,6730,0.064398833,0.064398833
FALSE,Weber County,11/1/03,Hide,Hide,11,2003,99723,99723,106244,106244,1,6521,6521,0.061377584,0.061377584
FALSE,Weber County,11/1/04,Hide,Hide,11,2004,102138,102138,107674,107674,1,5536,5536,0.051414455,0.051414455
FALSE,Weber County,11/1/05,Hide,Hide,11,2005,104240,104240,109084,109084,1,4844,4844,0.044406146,0.044406146
FALSE,Weber County,11/1/06,Hide,Hide,11,2006,107378,107378,110473,110473,1,3095,3095,0.028015895,0.028015895
FALSE,Weber County,11/1/07,Hide,Hide,11,2007,109739,109739,113534,113534,1,3795,3795,0.03342611,0.03342611
FALSE,Weber County,11/1/08,Hide,Hide,11,2008,108075,108075,114501,114501,1,6426,6426,0.056121781,0.056121781
FALSE,Weber County,11/1/09,Hide,Hide,11,2009,103623,103623,113819,113819,1,10196,10196,0.089580826,0.089580826
FALSE,Weber County,11/1/10,Hide,Hide,11,2010,102986,102986,112866,112866,1,9880,9880,0.087537434,0.087537434
FALSE,Weber County,11/1/11,Hide,Hide,11,2011,104405,104405,112532,112532,1,8127,8127,0.072219458,0.072219458
FALSE,Weber County,11/1/12,Hide,Hide,11,2012,107064,107064,113790,113790,1,6726,6726,0.059108885,0.059108885
FALSE,Weber County,11/1/13,Hide,Hide,11,2013,109238,109238,114997,114997,1,5759,5759,0.050079567,0.050079567
FALSE,Weber County,11/1/14,Hide,Hide,11,2014,110540,110540,115436,115436,1,4896,4896,0.042413112,0.042413112
FALSE,Weber County,11/1/15,Hide,Hide,11,2015,113306,113306,118087,118087,1,4781,4781,0.040487098,0.040487098
FALSE,Weber County,11/1/16,Hide,Hide,11,2016,117207,117207,121696,121696,1,4489,4489,0.036886997,0.036886997
FALSE,Weber County,11/1/17,Hide,Hide,11,2017,119311,119311,123895,123895,1,4584,4584,0.036999072,0.036999072
FALSE,Weber County,11/1/18,Hide,Hide,11,2018,121343,121343,125592,125592,1,4249,4249,0.033831773,0.033831773
FALSE,Weber County,11/1/19,Hide,Hide,11,2019,125309,125309,128482,128482,1,3173,3173,0.024696066,0.024696066
FALSE,Beaver County,12/1/92,Hide,Hide,12,1992,1966,1966,2058,2058,1,92,92,0.044703596,0.044703596
FALSE,Beaver County,12/1/93,Hide,Hide,12,1993,2052,2052,2146,2146,1,94,94,0.043802423,0.043802423
FALSE,Beaver County,12/1/94,Hide,Hide,12,1994,2195,2195,2273,2273,1,78,78,0.034315882,0.034315882
FALSE,Beaver County,12/1/95,Hide,Hide,12,1995,2325,2325,2452,2452,1,127,127,0.051794454,0.051794454
FALSE,Beaver County,12/1/96,Hide,Hide,12,1996,2435,2435,2582,2582,1,147,147,0.05693261,0.05693261
FALSE,Beaver County,12/1/97,Hide,Hide,12,1997,2420,2420,2521,2521,1,101,101,0.040063467,0.040063467
FALSE,Beaver County,12/1/98,Hide,Hide,12,1998,2363,2363,2459,2459,1,96,96,0.03904026,0.03904026
FALSE,Beaver County,12/1/99,Hide,Hide,12,1999,2468,2468,2559,2559,1,91,91,0.035560766,0.035560766
FALSE,Beaver County,12/1/00,Hide,Hide,12,2000,2574,2574,2674,2674,1,100,100,0.037397158,0.037397158
FALSE,Beaver County,12/1/01,Hide,Hide,12,2001,3127,3127,3252,3252,1,125,125,0.038437884,0.038437884
FALSE,Beaver County,12/1/02,Hide,Hide,12,2002,2927,2927,3085,3085,1,158,158,0.051215559,0.051215559
FALSE,Beaver County,12/1/03,Hide,Hide,12,2003,2802,2802,2948,2948,1,146,146,0.049525102,0.049525102
FALSE,Beaver County,12/1/04,Hide,Hide,12,2004,2772,2772,2903,2903,1,131,131,0.045125732,0.045125732
FALSE,Beaver County,12/1/05,Hide,Hide,12,2005,2966,2966,3086,3086,1,120,120,0.038885288,0.038885288
FALSE,Beaver County,12/1/06,Hide,Hide,12,2006,3101,3101,3178,3178,1,77,77,0.024229075,0.024229075
FALSE,Beaver County,12/1/07,Hide,Hide,12,2007,3065,3065,3149,3149,1,84,84,0.026675135,0.026675135
FALSE,Beaver County,12/1/08,Hide,Hide,12,2008,3170,3170,3344,3344,1,174,174,0.052033493,0.052033493
FALSE,Beaver County,12/1/09,Hide,Hide,12,2009,3135,3135,3405,3405,1,270,270,0.079295154,0.079295154
FALSE,Beaver County,12/1/10,Hide,Hide,12,2010,2831,2831,3118,3118,1,287,287,0.092046183,0.092046183
FALSE,Beaver County,12/1/11,Hide,Hide,12,2011,2742,2742,2955,2955,1,213,213,0.072081218,0.072081218
FALSE,Beaver County,12/1/12,Hide,Hide,12,2012,2845,2845,3002,3002,1,157,157,0.052298468,0.052298468
FALSE,Beaver County,12/1/13,Hide,Hide,12,2013,2902,2902,3032,3032,1,130,130,0.042875989,0.042875989
FALSE,Beaver County,12/1/14,Hide,Hide,12,2014,2952,2952,3066,3066,1,114,114,0.037181996,0.037181996
FALSE,Beaver County,12/1/15,Hide,Hide,12,2015,2972,2972,3088,3088,1,116,116,0.037564767,0.037564767
FALSE,Beaver County,12/1/16,Hide,Hide,12,2016,2879,2879,3035,3035,1,156,156,0.051400329,0.051400329
FALSE,Beaver County,12/1/17,Hide,Hide,12,2017,2938,2938,3053,3053,1,115,115,0.037667868,0.037667868
FALSE,Beaver County,12/1/18,Hide,Hide,12,2018,2855,2855,2947,2947,1,92,92,0.031218188,0.031218188
FALSE,Beaver County,12/1/19,Hide,Hide,12,2019,2712,2712,2790,2790,1,78,78,0.027956989,0.027956989
FALSE,Box Elder County,12/1/92,Hide,Hide,12,1992,15402,15402,16330,16330,1,928,928,0.056827924,0.056827924
FALSE,Box Elder County,12/1/93,Hide,Hide,12,1993,16964,16964,17869,17869,1,905,905,0.050646371,0.050646371
FALSE,Box Elder County,12/1/94,Hide,Hide,12,1994,17363,17363,18236,18236,1,873,873,0.04787234,0.04787234
FALSE,Box Elder County,12/1/95,Hide,Hide,12,1995,16940,16940,17750,17750,1,810,810,0.045633803,0.045633803
FALSE,Box Elder County,12/1/96,Hide,Hide,12,1996,17554,17554,18280,18280,1,726,726,0.039715536,0.039715536
FALSE,Box Elder County,12/1/97,Hide,Hide,12,1997,18270,18270,19059,19059,1,789,789,0.041397765,0.041397765
FALSE,Box Elder County,12/1/98,Hide,Hide,12,1998,18139,18139,18993,18993,1,854,854,0.044963934,0.044963934
FALSE,Box Elder County,12/1/99,Hide,Hide,12,1999,17995,17995,18734,18734,1,739,739,0.039446995,0.039446995
FALSE,Box Elder County,12/1/00,Hide,Hide,12,2000,19310,19310,20154,20154,1,844,844,0.041877543,0.041877543
FALSE,Box Elder County,12/1/01,Hide,Hide,12,2001,20027,20027,21106,21106,1,1079,1079,0.051122903,0.051122903
FALSE,Box Elder County,12/1/02,Hide,Hide,12,2002,19930,19930,21156,21156,1,1226,1226,0.057950463,0.057950463
FALSE,Box Elder County,12/1/03,Hide,Hide,12,2003,20654,20654,21801,21801,1,1147,1147,0.052612265,0.052612265
FALSE,Box Elder County,12/1/04,Hide,Hide,12,2004,20748,20748,21797,21797,1,1049,1049,0.048125889,0.048125889
FALSE,Box Elder County,12/1/05,Hide,Hide,12,2005,21849,21849,22733,22733,1,884,884,0.038886201,0.038886201
FALSE,Box Elder County,12/1/06,Hide,Hide,12,2006,22504,22504,23114,23114,1,610,610,0.026390932,0.026390932
FALSE,Box Elder County,12/1/07,Hide,Hide,12,2007,23021,23021,23688,23688,1,667,667,0.028157717,0.028157717
FALSE,Box Elder County,12/1/08,Hide,Hide,12,2008,22101,22101,23658,23658,1,1557,1557,0.065812833,0.065812833
FALSE,Box Elder County,12/1/09,Hide,Hide,12,2009,21387,21387,23314,23314,1,1927,1927,0.082654199,0.082654199
FALSE,Box Elder County,12/1/10,Hide,Hide,12,2010,21441,21441,23456,23456,1,2015,2015,0.085905525,0.085905525
FALSE,Box Elder County,12/1/11,Hide,Hide,12,2011,21564,21564,23038,23038,1,1474,1474,0.063981248,0.063981248
FALSE,Box Elder County,12/1/12,Hide,Hide,12,2012,21890,21890,23108,23108,1,1218,1218,0.052709019,0.052709019
FALSE,Box Elder County,12/1/13,Hide,Hide,12,2013,22340,22340,23318,23318,1,978,978,0.041941847,0.041941847
FALSE,Box Elder County,12/1/14,Hide,Hide,12,2014,22816,22816,23717,23717,1,901,901,0.037989628,0.037989628
FALSE,Box Elder County,12/1/15,Hide,Hide,12,2015,23294,23294,24173,24173,1,879,879,0.036362884,0.036362884
FALSE,Box Elder County,12/1/16,Hide,Hide,12,2016,24168,24168,25023,25023,1,855,855,0.034168565,0.034168565
FALSE,Box Elder County,12/1/17,Hide,Hide,12,2017,24680,24680,25456,25456,1,776,776,0.030483972,0.030483972
FALSE,Box Elder County,12/1/18,Hide,Hide,12,2018,24810,24810,25551,25551,1,741,741,0.029000822,0.029000822
FALSE,Box Elder County,12/1/19,Hide,Hide,12,2019,25419,25419,26049,26049,1,630,630,0.024185189,0.024185189
FALSE,Cache County,12/1/92,Hide,Hide,12,1992,35807,35807,37096,37096,1,1289,1289,0.034747682,0.034747682
FALSE,Cache County,12/1/93,Hide,Hide,12,1993,38733,38733,39914,39914,1,1181,1181,0.029588616,0.029588616
FALSE,Cache County,12/1/94,Hide,Hide,12,1994,40025,40025,41342,41342,1,1317,1317,0.031856224,0.031856224
FALSE,Cache County,12/1/95,Hide,Hide,12,1995,40797,40797,42040,42040,1,1243,1243,0.029567079,0.029567079
FALSE,Cache County,12/1/96,Hide,Hide,12,1996,41118,41118,42315,42315,1,1197,1197,0.028287841,0.028287841
FALSE,Cache County,12/1/97,Hide,Hide,12,1997,42663,42663,43834,43834,1,1171,1171,0.026714423,0.026714423
FALSE,Cache County,12/1/98,Hide,Hide,12,1998,43599,43599,44852,44852,1,1253,1253,0.027936324,0.027936324
FALSE,Cache County,12/1/99,Hide,Hide,12,1999,45130,45130,46329,46329,1,1199,1199,0.025880118,0.025880118
FALSE,Cache County,12/1/00,Hide,Hide,12,2000,47304,47304,48804,48804,1,1500,1500,0.030735186,0.030735186
FALSE,Cache County,12/1/01,Hide,Hide,12,2001,49386,49386,51337,51337,1,1951,1951,0.038003779,0.038003779
FALSE,Cache County,12/1/02,Hide,Hide,12,2002,51116,51116,53374,53374,1,2258,2258,0.042305242,0.042305242
FALSE,Cache County,12/1/03,Hide,Hide,12,2003,53048,53048,55112,55112,1,2064,2064,0.037451009,0.037451009
FALSE,Cache County,12/1/04,Hide,Hide,12,2004,54604,54604,56550,56550,1,1946,1946,0.034412025,0.034412025
FALSE,Cache County,12/1/05,Hide,Hide,12,2005,55645,55645,57364,57364,1,1719,1719,0.02996653,0.02996653
FALSE,Cache County,12/1/06,Hide,Hide,12,2006,57912,57912,59085,59085,1,1173,1173,0.019852755,0.019852755
FALSE,Cache County,12/1/07,Hide,Hide,12,2007,60345,60345,61778,61778,1,1433,1433,0.02319596,0.02319596
FALSE,Cache County,12/1/08,Hide,Hide,12,2008,59086,59086,61659,61659,1,2573,2573,0.041729512,0.041729512
FALSE,Cache County,12/1/09,Hide,Hide,12,2009,56446,56446,59866,59866,1,3420,3420,0.057127585,0.057127585
FALSE,Cache County,12/1/10,Hide,Hide,12,2010,54065,54065,57432,57432,1,3367,3367,0.058625853,0.058625853
FALSE,Cache County,12/1/11,Hide,Hide,12,2011,53856,53856,56535,56535,1,2679,2679,0.047386575,0.047386575
FALSE,Cache County,12/1/12,Hide,Hide,12,2012,54951,54951,57421,57421,1,2470,2470,0.043015621,0.043015621
FALSE,Cache County,12/1/13,Hide,Hide,12,2013,56297,56297,58345,58345,1,2048,2048,0.035101551,0.035101551
FALSE,Cache County,12/1/14,Hide,Hide,12,2014,57552,57552,59375,59375,1,1823,1823,0.030703158,0.030703158
FALSE,Cache County,12/1/15,Hide,Hide,12,2015,58489,58489,60405,60405,1,1916,1916,0.031719229,0.031719229
FALSE,Cache County,12/1/16,Hide,Hide,12,2016,60113,60113,61923,61923,1,1810,1810,0.02922985,0.02922985
FALSE,Cache County,12/1/17,Hide,Hide,12,2017,61364,61364,63044,63044,1,1680,1680,0.026648055,0.026648055
FALSE,Cache County,12/1/18,Hide,Hide,12,2018,62209,62209,63804,63804,1,1595,1595,0.024998433,0.024998433
FALSE,Cache County,12/1/19,Hide,Hide,12,2019,63288,63288,64638,64638,1,1350,1350,0.020885547,0.020885547
FALSE,Carbon County,12/1/92,Hide,Hide,12,1992,8155,8155,8951,8951,1,796,796,0.088928611,0.088928611
FALSE,Carbon County,12/1/93,Hide,Hide,12,1993,8643,8643,9273,9273,1,630,630,0.067939178,0.067939178
FALSE,Carbon County,12/1/94,Hide,Hide,12,1994,8625,8625,9267,9267,1,642,642,0.069278084,0.069278084
FALSE,Carbon County,12/1/95,Hide,Hide,12,1995,8593,8593,9159,9159,1,566,566,0.061797139,0.061797139
FALSE,Carbon County,12/1/96,Hide,Hide,12,1996,9042,9042,9584,9584,1,542,542,0.056552588,0.056552588
FALSE,Carbon County,12/1/97,Hide,Hide,12,1997,9220,9220,9724,9724,1,504,504,0.051830522,0.051830522
FALSE,Carbon County,12/1/98,Hide,Hide,12,1998,9280,9280,10008,10008,1,728,728,0.072741807,0.072741807
FALSE,Carbon County,12/1/99,Hide,Hide,12,1999,9134,9134,9634,9634,1,500,500,0.051899523,0.051899523
FALSE,Carbon County,12/1/00,Hide,Hide,12,2000,8406,8406,8986,8986,1,580,580,0.064544848,0.064544848
FALSE,Carbon County,12/1/01,Hide,Hide,12,2001,8710,8710,9281,9281,1,571,571,0.061523543,0.061523543
FALSE,Carbon County,12/1/02,Hide,Hide,12,2002,8738,8738,9477,9477,1,739,739,0.077978263,0.077978263
FALSE,Carbon County,12/1/03,Hide,Hide,12,2003,8594,8594,9297,9297,1,703,703,0.07561579,0.07561579
FALSE,Carbon County,12/1/04,Hide,Hide,12,2004,8765,8765,9301,9301,1,536,536,0.057628212,0.057628212
FALSE,Carbon County,12/1/05,Hide,Hide,12,2005,9312,9312,9732,9732,1,420,420,0.043156597,0.043156597
FALSE,Carbon County,12/1/06,Hide,Hide,12,2006,9558,9558,9849,9849,1,291,291,0.029546147,0.029546147
FALSE,Carbon County,12/1/07,Hide,Hide,12,2007,9216,9216,9609,9609,1,393,393,0.040899157,0.040899157
FALSE,Carbon County,12/1/08,Hide,Hide,12,2008,10001,10001,10552,10552,1,551,551,0.052217589,0.052217589
FALSE,Carbon County,12/1/09,Hide,Hide,12,2009,9233,9233,10154,10154,1,921,921,0.090703171,0.090703171
FALSE,Carbon County,12/1/10,Hide,Hide,12,2010,9026,9026,9845,9845,1,819,819,0.083189436,0.083189436
FALSE,Carbon County,12/1/11,Hide,Hide,12,2011,8783,8783,9453,9453,1,670,670,0.07087697,0.07087697
FALSE,Carbon County,12/1/12,Hide,Hide,12,2012,8410,8410,9040,9040,1,630,630,0.069690265,0.069690265
FALSE,Carbon County,12/1/13,Hide,Hide,12,2013,8313,8313,8807,8807,1,494,494,0.056091745,0.056091745
FALSE,Carbon County,12/1/14,Hide,Hide,12,2014,8318,8318,8751,8751,1,433,433,0.049480059,0.049480059
FALSE,Carbon County,12/1/15,Hide,Hide,12,2015,8040,8040,8577,8577,1,537,537,0.062609304,0.062609304
FALSE,Carbon County,12/1/16,Hide,Hide,12,2016,7758,7758,8221,8221,1,463,463,0.056319183,0.056319183
FALSE,Carbon County,12/1/17,Hide,Hide,12,2017,7975,7975,8372,8372,1,397,397,0.047419971,0.047419971
FALSE,Carbon County,12/1/18,Hide,Hide,12,2018,8097,8097,8440,8440,1,343,343,0.04063981,0.04063981
FALSE,Carbon County,12/1/19,Hide,Hide,12,2019,8255,8255,8555,8555,1,300,300,0.035067212,0.035067212
FALSE,Daggett County,12/1/92,Hide,Hide,12,1992,386,386,406,406,1,20,20,0.049261084,0.049261084
FALSE,Daggett County,12/1/93,Hide,Hide,12,1993,401,401,413,413,1,12,12,0.02905569,0.02905569
FALSE,Daggett County,12/1/94,Hide,Hide,12,1994,430,430,470,470,1,40,40,0.085106383,0.085106383
FALSE,Daggett County,12/1/95,Hide,Hide,12,1995,411,411,427,427,1,16,16,0.037470726,0.037470726
FALSE,Daggett County,12/1/96,Hide,Hide,12,1996,392,392,408,408,1,16,16,0.039215686,0.039215686
FALSE,Daggett County,12/1/97,Hide,Hide,12,1997,395,395,413,413,1,18,18,0.043583535,0.043583535
FALSE,Daggett County,12/1/98,Hide,Hide,12,1998,407,407,422,422,1,15,15,0.035545024,0.035545024
FALSE,Daggett County,12/1/99,Hide,Hide,12,1999,445,445,460,460,1,15,15,0.032608696,0.032608696
FALSE,Daggett County,12/1/00,Hide,Hide,12,2000,424,424,446,446,1,22,22,0.049327354,0.049327354
FALSE,Daggett County,12/1/01,Hide,Hide,12,2001,501,501,524,524,1,23,23,0.04389313,0.04389313
FALSE,Daggett County,12/1/02,Hide,Hide,12,2002,484,484,510,510,1,26,26,0.050980392,0.050980392
FALSE,Daggett County,12/1/03,Hide,Hide,12,2003,464,464,489,489,1,25,25,0.051124744,0.051124744
FALSE,Daggett County,12/1/04,Hide,Hide,12,2004,440,440,466,466,1,26,26,0.055793991,0.055793991
FALSE,Daggett County,12/1/05,Hide,Hide,12,2005,496,496,525,525,1,29,29,0.055238095,0.055238095
FALSE,Daggett County,12/1/06,Hide,Hide,12,2006,470,470,489,489,1,19,19,0.038854806,0.038854806
FALSE,Daggett County,12/1/07,Hide,Hide,12,2007,500,500,518,518,1,18,18,0.034749035,0.034749035
FALSE,Daggett County,12/1/08,Hide,Hide,12,2008,433,433,454,454,1,21,21,0.046255507,0.046255507
FALSE,Daggett County,12/1/09,Hide,Hide,12,2009,465,465,499,499,1,34,34,0.068136273,0.068136273
FALSE,Daggett County,12/1/10,Hide,Hide,12,2010,452,452,485,485,1,33,33,0.068041237,0.068041237
FALSE,Daggett County,12/1/11,Hide,Hide,12,2011,430,430,453,453,1,23,23,0.050772627,0.050772627
FALSE,Daggett County,12/1/12,Hide,Hide,12,2012,417,417,438,438,1,21,21,0.047945205,0.047945205
FALSE,Daggett County,12/1/13,Hide,Hide,12,2013,411,411,429,429,1,18,18,0.041958042,0.041958042
FALSE,Daggett County,12/1/14,Hide,Hide,12,2014,439,439,459,459,1,20,20,0.043572985,0.043572985
FALSE,Daggett County,12/1/15,Hide,Hide,12,2015,449,449,473,473,1,24,24,0.050739958,0.050739958
FALSE,Daggett County,12/1/16,Hide,Hide,12,2016,411,411,431,431,1,20,20,0.046403712,0.046403712
FALSE,Daggett County,12/1/17,Hide,Hide,12,2017,397,397,416,416,1,19,19,0.045673077,0.045673077
FALSE,Daggett County,12/1/18,Hide,Hide,12,2018,372,372,389,389,1,17,17,0.043701799,0.043701799
FALSE,Daggett County,12/1/19,Hide,Hide,12,2019,378,378,392,392,1,14,14,0.035714286,0.035714286
FALSE,Davis County,12/1/92,Hide,Hide,12,1992,92674,92674,96723,96723,1,4049,4049,0.041861812,0.041861812
FALSE,Davis County,12/1/93,Hide,Hide,12,1993,99880,99880,103317,103317,1,3437,3437,0.033266549,0.033266549
FALSE,Davis County,12/1/94,Hide,Hide,12,1994,102533,102533,106465,106465,1,3932,3932,0.036932325,0.036932325
FALSE,Davis County,12/1/95,Hide,Hide,12,1995,104469,104469,107867,107867,1,3398,3398,0.031501757,0.031501757
FALSE,Davis County,12/1/96,Hide,Hide,12,1996,109867,109867,113407,113407,1,3540,3540,0.031215004,0.031215004
FALSE,Davis County,12/1/97,Hide,Hide,12,1997,114409,114409,118120,118120,1,3711,3711,0.031417203,0.031417203
FALSE,Davis County,12/1/98,Hide,Hide,12,1998,118458,118458,122462,122462,1,4004,4004,0.032695857,0.032695857
FALSE,Davis County,12/1/99,Hide,Hide,12,1999,119466,119466,123174,123174,1,3708,3708,0.030103756,0.030103756
FALSE,Davis County,12/1/00,Hide,Hide,12,2000,116540,116540,120891,120891,1,4351,4351,0.035991099,0.035991099
FALSE,Davis County,12/1/01,Hide,Hide,12,2001,117235,117235,122817,122817,1,5582,5582,0.045449734,0.045449734
FALSE,Davis County,12/1/02,Hide,Hide,12,2002,119873,119873,126477,126477,1,6604,6604,0.052215027,0.052215027
FALSE,Davis County,12/1/03,Hide,Hide,12,2003,123697,123697,130291,130291,1,6594,6594,0.050609789,0.050609789
FALSE,Davis County,12/1/04,Hide,Hide,12,2004,128141,128141,133787,133787,1,5646,5646,0.04220141,0.04220141
FALSE,Davis County,12/1/05,Hide,Hide,12,2005,133022,133022,137991,137991,1,4969,4969,0.036009595,0.036009595
FALSE,Davis County,12/1/06,Hide,Hide,12,2006,138978,138978,142421,142421,1,3443,3443,0.024174806,0.024174806
FALSE,Davis County,12/1/07,Hide,Hide,12,2007,141783,141783,145909,145909,1,4126,4126,0.028277899,0.028277899
FALSE,Davis County,12/1/08,Hide,Hide,12,2008,138811,138811,145852,145852,1,7041,7041,0.048274964,0.048274964
FALSE,Davis County,12/1/09,Hide,Hide,12,2009,134845,134845,145103,145103,1,10258,10258,0.07069461,0.07069461
FALSE,Davis County,12/1/10,Hide,Hide,12,2010,136576,136576,146489,146489,1,9913,9913,0.06767061,0.06767061
FALSE,Davis County,12/1/11,Hide,Hide,12,2011,139254,139254,147152,147152,1,7898,7898,0.053672393,0.053672393
FALSE,Davis County,12/1/12,Hide,Hide,12,2012,143466,143466,150382,150382,1,6916,6916,0.045989547,0.045989547
FALSE,Davis County,12/1/13,Hide,Hide,12,2013,148285,148285,154241,154241,1,5956,5956,0.038614895,0.038614895
FALSE,Davis County,12/1/14,Hide,Hide,12,2014,151925,151925,157334,157334,1,5409,5409,0.034379092,0.034379092
FALSE,Davis County,12/1/15,Hide,Hide,12,2015,156279,156279,161697,161697,1,5418,5418,0.033507115,0.033507115
FALSE,Davis County,12/1/16,Hide,Hide,12,2016,161913,161913,166983,166983,1,5070,5070,0.030362372,0.030362372
FALSE,Davis County,12/1/17,Hide,Hide,12,2017,164161,164161,169280,169280,1,5119,5119,0.030239839,0.030239839
FALSE,Davis County,12/1/18,Hide,Hide,12,2018,166574,166574,171246,171246,1,4672,4672,0.027282389,0.027282389
FALSE,Davis County,12/1/19,Hide,Hide,12,2019,171833,171833,175816,175816,1,3983,3983,0.022654366,0.022654366
FALSE,Duchesne County,12/1/92,Hide,Hide,12,1992,5033,5033,5507,5507,1,474,474,0.086072272,0.086072272
FALSE,Duchesne County,12/1/93,Hide,Hide,12,1993,5300,5300,5809,5809,1,509,509,0.087622655,0.087622655
FALSE,Duchesne County,12/1/94,Hide,Hide,12,1994,5409,5409,5966,5966,1,557,557,0.093362387,0.093362387
FALSE,Duchesne County,12/1/95,Hide,Hide,12,1995,5211,5211,5714,5714,1,503,503,0.088029401,0.088029401
FALSE,Duchesne County,12/1/96,Hide,Hide,12,1996,5414,5414,5877,5877,1,463,463,0.078781691,0.078781691
FALSE,Duchesne County,12/1/97,Hide,Hide,12,1997,5725,5725,6084,6084,1,359,359,0.059007232,0.059007232
FALSE,Duchesne County,12/1/98,Hide,Hide,12,1998,5527,5527,6105,6105,1,578,578,0.094676495,0.094676495
FALSE,Duchesne County,12/1/99,Hide,Hide,12,1999,5452,5452,5805,5805,1,353,353,0.060809647,0.060809647
FALSE,Duchesne County,12/1/00,Hide,Hide,12,2000,6003,6003,6314,6314,1,311,311,0.049255622,0.049255622
FALSE,Duchesne County,12/1/01,Hide,Hide,12,2001,6696,6696,7119,7119,1,423,423,0.059418458,0.059418458
FALSE,Duchesne County,12/1/02,Hide,Hide,12,2002,6542,6542,7041,7041,1,499,499,0.070870615,0.070870615
FALSE,Duchesne County,12/1/03,Hide,Hide,12,2003,6494,6494,6945,6945,1,451,451,0.064938805,0.064938805
FALSE,Duchesne County,12/1/04,Hide,Hide,12,2004,6926,6926,7287,7287,1,361,361,0.049540277,0.049540277
FALSE,Duchesne County,12/1/05,Hide,Hide,12,2005,7635,7635,7940,7940,1,305,305,0.038413098,0.038413098
FALSE,Duchesne County,12/1/06,Hide,Hide,12,2006,8754,8754,8952,8952,1,198,198,0.022117962,0.022117962
FALSE,Duchesne County,12/1/07,Hide,Hide,12,2007,9258,9258,9494,9494,1,236,236,0.024857805,0.024857805
FALSE,Duchesne County,12/1/08,Hide,Hide,12,2008,10492,10492,10942,10942,1,450,450,0.041125937,0.041125937
FALSE,Duchesne County,12/1/09,Hide,Hide,12,2009,8239,8239,9194,9194,1,955,955,0.10387209,0.10387209
FALSE,Duchesne County,12/1/10,Hide,Hide,12,2010,7483,7483,8174,8174,1,691,691,0.084536335,0.084536335
FALSE,Duchesne County,12/1/11,Hide,Hide,12,2011,8291,8291,8782,8782,1,491,491,0.055909816,0.055909816
FALSE,Duchesne County,12/1/12,Hide,Hide,12,2012,8806,8806,9242,9242,1,436,436,0.047175936,0.047175936
FALSE,Duchesne County,12/1/13,Hide,Hide,12,2013,9084,9084,9454,9454,1,370,370,0.039136873,0.039136873
FALSE,Duchesne County,12/1/14,Hide,Hide,12,2014,9112,9112,9524,9524,1,412,412,0.043259135,0.043259135
FALSE,Duchesne County,12/1/15,Hide,Hide,12,2015,7561,7561,8340,8340,1,779,779,0.093405276,0.093405276
FALSE,Duchesne County,12/1/16,Hide,Hide,12,2016,7380,7380,7984,7984,1,604,604,0.075651303,0.075651303
FALSE,Duchesne County,12/1/17,Hide,Hide,12,2017,7486,7486,7876,7876,1,390,390,0.049517522,0.049517522
FALSE,Duchesne County,12/1/18,Hide,Hide,12,2018,7377,7377,7697,7697,1,320,320,0.041574639,0.041574639
FALSE,Duchesne County,12/1/19,Hide,Hide,12,2019,7531,7531,7842,7842,1,311,311,0.03965825,0.03965825
FALSE,Emery County,12/1/92,Hide,Hide,12,1992,3986,3986,4357,4357,1,371,371,0.085150333,0.085150333
FALSE,Emery County,12/1/93,Hide,Hide,12,1993,3904,3904,4222,4222,1,318,318,0.075319754,0.075319754
FALSE,Emery County,12/1/94,Hide,Hide,12,1994,3893,3893,4243,4243,1,350,350,0.082488805,0.082488805
FALSE,Emery County,12/1/95,Hide,Hide,12,1995,3921,3921,4235,4235,1,314,314,0.074144038,0.074144038
FALSE,Emery County,12/1/96,Hide,Hide,12,1996,3885,3885,4189,4189,1,304,304,0.072571019,0.072571019
FALSE,Emery County,12/1/97,Hide,Hide,12,1997,3898,3898,4165,4165,1,267,267,0.064105642,0.064105642
FALSE,Emery County,12/1/98,Hide,Hide,12,1998,3858,3858,4170,4170,1,312,312,0.074820144,0.074820144
FALSE,Emery County,12/1/99,Hide,Hide,12,1999,4060,4060,4284,4284,1,224,224,0.052287582,0.052287582
FALSE,Emery County,12/1/00,Hide,Hide,12,2000,4392,4392,4663,4663,1,271,271,0.058117092,0.058117092
FALSE,Emery County,12/1/01,Hide,Hide,12,2001,4502,4502,4842,4842,1,340,340,0.070218918,0.070218918
FALSE,Emery County,12/1/02,Hide,Hide,12,2002,4510,4510,4883,4883,1,373,373,0.076387467,0.076387467
FALSE,Emery County,12/1/03,Hide,Hide,12,2003,4602,4602,4998,4998,1,396,396,0.079231693,0.079231693
FALSE,Emery County,12/1/04,Hide,Hide,12,2004,4723,4723,5025,5025,1,302,302,0.060099502,0.060099502
FALSE,Emery County,12/1/05,Hide,Hide,12,2005,4983,4983,5202,5202,1,219,219,0.042099193,0.042099193
FALSE,Emery County,12/1/06,Hide,Hide,12,2006,5073,5073,5234,5234,1,161,161,0.030760413,0.030760413
FALSE,Emery County,12/1/07,Hide,Hide,12,2007,4962,4962,5142,5142,1,180,180,0.035005834,0.035005834
FALSE,Emery County,12/1/08,Hide,Hide,12,2008,4785,4785,5028,5028,1,243,243,0.048329356,0.048329356
FALSE,Emery County,12/1/09,Hide,Hide,12,2009,4843,4843,5271,5271,1,428,428,0.081199013,0.081199013
FALSE,Emery County,12/1/10,Hide,Hide,12,2010,4831,4831,5207,5207,1,376,376,0.072210486,0.072210486
FALSE,Emery County,12/1/11,Hide,Hide,12,2011,4570,4570,4922,4922,1,352,352,0.071515644,0.071515644
FALSE,Emery County,12/1/12,Hide,Hide,12,2012,4430,4430,4760,4760,1,330,330,0.069327731,0.069327731
FALSE,Emery County,12/1/13,Hide,Hide,12,2013,4377,4377,4644,4644,1,267,267,0.05749354,0.05749354
FALSE,Emery County,12/1/14,Hide,Hide,12,2014,4243,4243,4472,4472,1,229,229,0.051207513,0.051207513
FALSE,Emery County,12/1/15,Hide,Hide,12,2015,4048,4048,4354,4354,1,306,306,0.070280202,0.070280202
FALSE,Emery County,12/1/16,Hide,Hide,12,2016,3949,3949,4184,4184,1,235,235,0.056166348,0.056166348
FALSE,Emery County,12/1/17,Hide,Hide,12,2017,4043,4043,4246,4246,1,203,203,0.047809703,0.047809703
FALSE,Emery County,12/1/18,Hide,Hide,12,2018,4142,4142,4332,4332,1,190,190,0.043859649,0.043859649
FALSE,Emery County,12/1/19,Hide,Hide,12,2019,4158,4158,4323,4323,1,165,165,0.038167939,0.038167939
FALSE,Garfield County,12/1/92,Hide,Hide,12,1992,2027,2027,2299,2299,1,272,272,0.11831231,0.11831231
FALSE,Garfield County,12/1/93,Hide,Hide,12,1993,2172,2172,2399,2399,1,227,227,0.094622759,0.094622759
FALSE,Garfield County,12/1/94,Hide,Hide,12,1994,2252,2252,2579,2579,1,327,327,0.126793331,0.126793331
FALSE,Garfield County,12/1/95,Hide,Hide,12,1995,2395,2395,2669,2669,1,274,274,0.102660172,0.102660172
FALSE,Garfield County,12/1/96,Hide,Hide,12,1996,2444,2444,2710,2710,1,266,266,0.098154982,0.098154982
FALSE,Garfield County,12/1/97,Hide,Hide,12,1997,2548,2548,2760,2760,1,212,212,0.076811594,0.076811594
FALSE,Garfield County,12/1/98,Hide,Hide,12,1998,2504,2504,2745,2745,1,241,241,0.087795993,0.087795993
FALSE,Garfield County,12/1/99,Hide,Hide,12,1999,2571,2571,2757,2757,1,186,186,0.067464635,0.067464635
FALSE,Garfield County,12/1/00,Hide,Hide,12,2000,2313,2313,2496,2496,1,183,183,0.073317308,0.073317308
FALSE,Garfield County,12/1/01,Hide,Hide,12,2001,2412,2412,2635,2635,1,223,223,0.084629981,0.084629981
FALSE,Garfield County,12/1/02,Hide,Hide,12,2002,2353,2353,2582,2582,1,229,229,0.088690937,0.088690937
FALSE,Garfield County,12/1/03,Hide,Hide,12,2003,2373,2373,2582,2582,1,209,209,0.080945004,0.080945004
FALSE,Garfield County,12/1/04,Hide,Hide,12,2004,2455,2455,2658,2658,1,203,203,0.076373213,0.076373213
FALSE,Garfield County,12/1/05,Hide,Hide,12,2005,2512,2512,2684,2684,1,172,172,0.064083458,0.064083458
FALSE,Garfield County,12/1/06,Hide,Hide,12,2006,2585,2585,2697,2697,1,112,112,0.041527623,0.041527623
FALSE,Garfield County,12/1/07,Hide,Hide,12,2007,2598,2598,2756,2756,1,158,158,0.057329463,0.057329463
FALSE,Garfield County,12/1/08,Hide,Hide,12,2008,2674,2674,2906,2906,1,232,232,0.079834825,0.079834825
FALSE,Garfield County,12/1/09,Hide,Hide,12,2009,2617,2617,2935,2935,1,318,318,0.10834753,0.10834753
FALSE,Garfield County,12/1/10,Hide,Hide,12,2010,2731,2731,3033,3033,1,302,302,0.099571381,0.099571381
FALSE,Garfield County,12/1/11,Hide,Hide,12,2011,2597,2597,2887,2887,1,290,290,0.100450294,0.100450294
FALSE,Garfield County,12/1/12,Hide,Hide,12,2012,2586,2586,2844,2844,1,258,258,0.0907173,0.0907173
FALSE,Garfield County,12/1/13,Hide,Hide,12,2013,2506,2506,2760,2760,1,254,254,0.092028986,0.092028986
FALSE,Garfield County,12/1/14,Hide,Hide,12,2014,2527,2527,2768,2768,1,241,241,0.087066474,0.087066474
FALSE,Garfield County,12/1/15,Hide,Hide,12,2015,2477,2477,2728,2728,1,251,251,0.092008798,0.092008798
FALSE,Garfield County,12/1/16,Hide,Hide,12,2016,2618,2618,2836,2836,1,218,218,0.076868829,0.076868829
FALSE,Garfield County,12/1/17,Hide,Hide,12,2017,2643,2643,2870,2870,1,227,227,0.079094077,0.079094077
FALSE,Garfield County,12/1/18,Hide,Hide,12,2018,2556,2556,2748,2748,1,192,192,0.069868996,0.069868996
FALSE,Garfield County,12/1/19,Hide,Hide,12,2019,2609,2609,2765,2765,1,156,156,0.05641953,0.05641953
FALSE,Grand County,12/1/92,Hide,Hide,12,1992,4009,4009,4310,4310,1,301,301,0.069837587,0.069837587
FALSE,Grand County,12/1/93,Hide,Hide,12,1993,4498,4498,4814,4814,1,316,316,0.065641878,0.065641878
FALSE,Grand County,12/1/94,Hide,Hide,12,1994,4508,4508,4848,4848,1,340,340,0.070132013,0.070132013
FALSE,Grand County,12/1/95,Hide,Hide,12,1995,4725,4725,5052,5052,1,327,327,0.064726841,0.064726841
FALSE,Grand County,12/1/96,Hide,Hide,12,1996,4709,4709,5057,5057,1,348,348,0.068815503,0.068815503
FALSE,Grand County,12/1/97,Hide,Hide,12,1997,4871,4871,5220,5220,1,349,349,0.066858238,0.066858238
FALSE,Grand County,12/1/98,Hide,Hide,12,1998,5127,5127,5508,5508,1,381,381,0.069172113,0.069172113
FALSE,Grand County,12/1/99,Hide,Hide,12,1999,4839,4839,5147,5147,1,308,308,0.059840684,0.059840684
FALSE,Grand County,12/1/00,Hide,Hide,12,2000,4337,4337,4643,4643,1,306,306,0.065905664,0.065905664
FALSE,Grand County,12/1/01,Hide,Hide,12,2001,4486,4486,4832,4832,1,346,346,0.07160596,0.07160596
FALSE,Grand County,12/1/02,Hide,Hide,12,2002,4492,4492,4850,4850,1,358,358,0.073814433,0.073814433
FALSE,Grand County,12/1/03,Hide,Hide,12,2003,4451,4451,4805,4805,1,354,354,0.073673257,0.073673257
FALSE,Grand County,12/1/04,Hide,Hide,12,2004,4520,4520,4852,4852,1,332,332,0.068425392,0.068425392
FALSE,Grand County,12/1/05,Hide,Hide,12,2005,4774,4774,5072,5072,1,298,298,0.058753943,0.058753943
FALSE,Grand County,12/1/06,Hide,Hide,12,2006,4904,4904,5117,5117,1,213,213,0.041625953,0.041625953
FALSE,Grand County,12/1/07,Hide,Hide,12,2007,4942,4942,5212,5212,1,270,270,0.05180353,0.05180353
FALSE,Grand County,12/1/08,Hide,Hide,12,2008,4918,4918,5345,5345,1,427,427,0.079887746,0.079887746
FALSE,Grand County,12/1/09,Hide,Hide,12,2009,4835,4835,5385,5385,1,550,550,0.102135562,0.102135562
FALSE,Grand County,12/1/10,Hide,Hide,12,2010,4768,4768,5311,5311,1,543,543,0.102240633,0.102240633
FALSE,Grand County,12/1/11,Hide,Hide,12,2011,4876,4876,5349,5349,1,473,473,0.088427744,0.088427744
FALSE,Grand County,12/1/12,Hide,Hide,12,2012,4978,4978,5419,5419,1,441,441,0.081380328,0.081380328
FALSE,Grand County,12/1/13,Hide,Hide,12,2013,5092,5092,5493,5493,1,401,401,0.073002003,0.073002003
FALSE,Grand County,12/1/14,Hide,Hide,12,2014,5246,5246,5591,5591,1,345,345,0.061706314,0.061706314
FALSE,Grand County,12/1/15,Hide,Hide,12,2015,5319,5319,5656,5656,1,337,337,0.059582744,0.059582744
FALSE,Grand County,12/1/16,Hide,Hide,12,2016,5460,5460,5791,5791,1,331,331,0.057157658,0.057157658
FALSE,Grand County,12/1/17,Hide,Hide,12,2017,5721,5721,6026,6026,1,305,305,0.050614006,0.050614006
FALSE,Grand County,12/1/18,Hide,Hide,12,2018,5793,5793,6055,6055,1,262,262,0.043270025,0.043270025
FALSE,Grand County,12/1/19,Hide,Hide,12,2019,6067,6067,6289,6289,1,222,222,0.03529973,0.03529973
FALSE,Iron County,12/1/92,Hide,Hide,12,1992,10307,10307,10689,10689,1,382,382,0.035737674,0.035737674
FALSE,Iron County,12/1/93,Hide,Hide,12,1993,11185,11185,11616,11616,1,431,431,0.037103994,0.037103994
FALSE,Iron County,12/1/94,Hide,Hide,12,1994,12303,12303,12741,12741,1,438,438,0.034377207,0.034377207
FALSE,Iron County,12/1/95,Hide,Hide,12,1995,12558,12558,13056,13056,1,498,498,0.038143382,0.038143382
FALSE,Iron County,12/1/96,Hide,Hide,12,1996,13434,13434,13911,13911,1,477,477,0.034289411,0.034289411
FALSE,Iron County,12/1/97,Hide,Hide,12,1997,13988,13988,14511,14511,1,523,523,0.036041624,0.036041624
FALSE,Iron County,12/1/98,Hide,Hide,12,1998,14499,14499,15063,15063,1,564,564,0.03744274,0.03744274
FALSE,Iron County,12/1/99,Hide,Hide,12,1999,15242,15242,15749,15749,1,507,507,0.03219252,0.03219252
FALSE,Iron County,12/1/00,Hide,Hide,12,2000,16372,16372,17004,17004,1,632,632,0.037167725,0.037167725
FALSE,Iron County,12/1/01,Hide,Hide,12,2001,16808,16808,17665,17665,1,857,857,0.048514011,0.048514011
FALSE,Iron County,12/1/02,Hide,Hide,12,2002,16849,16849,17818,17818,1,969,969,0.054383208,0.054383208
FALSE,Iron County,12/1/03,Hide,Hide,12,2003,17358,17358,18269,18269,1,911,911,0.049865893,0.049865893
FALSE,Iron County,12/1/04,Hide,Hide,12,2004,18421,18421,19249,19249,1,828,828,0.043015222,0.043015222
FALSE,Iron County,12/1/05,Hide,Hide,12,2005,19600,19600,20308,20308,1,708,708,0.034863108,0.034863108
FALSE,Iron County,12/1/06,Hide,Hide,12,2006,20737,20737,21293,21293,1,556,556,0.026111868,0.026111868
FALSE,Iron County,12/1/07,Hide,Hide,12,2007,20075,20075,20776,20776,1,701,701,0.033740855,0.033740855
FALSE,Iron County,12/1/08,Hide,Hide,12,2008,19533,19533,20937,20937,1,1404,1404,0.067058318,0.067058318
FALSE,Iron County,12/1/09,Hide,Hide,12,2009,18938,18938,20874,20874,1,1936,1936,0.092746958,0.092746958
FALSE,Iron County,12/1/10,Hide,Hide,12,2010,18294,18294,20154,20154,1,1860,1860,0.092289372,0.092289372
FALSE,Iron County,12/1/11,Hide,Hide,12,2011,18209,18209,19659,19659,1,1450,1450,0.073757567,0.073757567
FALSE,Iron County,12/1/12,Hide,Hide,12,2012,18183,18183,19414,19414,1,1231,1231,0.06340785,0.06340785
FALSE,Iron County,12/1/13,Hide,Hide,12,2013,18740,18740,19684,19684,1,944,944,0.047957732,0.047957732
FALSE,Iron County,12/1/14,Hide,Hide,12,2014,19137,19137,20062,20062,1,925,925,0.046107068,0.046107068
FALSE,Iron County,12/1/15,Hide,Hide,12,2015,19763,19763,20661,20661,1,898,898,0.04346353,0.04346353
FALSE,Iron County,12/1/16,Hide,Hide,12,2016,20935,20935,21907,21907,1,972,972,0.04436938,0.04436938
FALSE,Iron County,12/1/17,Hide,Hide,12,2017,21641,21641,22475,22475,1,834,834,0.037107898,0.037107898
FALSE,Iron County,12/1/18,Hide,Hide,12,2018,22600,22600,23377,23377,1,777,777,0.033237798,0.033237798
FALSE,Iron County,12/1/19,Hide,Hide,12,2019,23889,23889,24561,24561,1,672,672,0.027360449,0.027360449
FALSE,Juab County,12/1/92,Hide,Hide,12,1992,2937,2937,3154,3154,1,217,217,0.068801522,0.068801522
FALSE,Juab County,12/1/93,Hide,Hide,12,1993,3183,3183,3345,3345,1,162,162,0.048430493,0.048430493
FALSE,Juab County,12/1/94,Hide,Hide,12,1994,3248,3248,3415,3415,1,167,167,0.048901903,0.048901903
FALSE,Juab County,12/1/95,Hide,Hide,12,1995,3151,3151,3298,3298,1,147,147,0.044572468,0.044572468
FALSE,Juab County,12/1/96,Hide,Hide,12,1996,3297,3297,3440,3440,1,143,143,0.041569767,0.041569767
FALSE,Juab County,12/1/97,Hide,Hide,12,1997,3344,3344,3488,3488,1,144,144,0.041284404,0.041284404
FALSE,Juab County,12/1/98,Hide,Hide,12,1998,3485,3485,3671,3671,1,186,186,0.050667393,0.050667393
FALSE,Juab County,12/1/99,Hide,Hide,12,1999,3433,3433,3569,3569,1,136,136,0.038105912,0.038105912
FALSE,Juab County,12/1/00,Hide,Hide,12,2000,3679,3679,3820,3820,1,141,141,0.036910995,0.036910995
FALSE,Juab County,12/1/01,Hide,Hide,12,2001,3504,3504,3744,3744,1,240,240,0.064102564,0.064102564
FALSE,Juab County,12/1/02,Hide,Hide,12,2002,3428,3428,3706,3706,1,278,278,0.075013492,0.075013492
FALSE,Juab County,12/1/03,Hide,Hide,12,2003,3483,3483,3743,3743,1,260,260,0.069462998,0.069462998
FALSE,Juab County,12/1/04,Hide,Hide,12,2004,3644,3644,3850,3850,1,206,206,0.053506494,0.053506494
FALSE,Juab County,12/1/05,Hide,Hide,12,2005,3797,3797,3970,3970,1,173,173,0.043576826,0.043576826
FALSE,Juab County,12/1/06,Hide,Hide,12,2006,3967,3967,4090,4090,1,123,123,0.03007335,0.03007335
FALSE,Juab County,12/1/07,Hide,Hide,12,2007,3911,3911,4064,4064,1,153,153,0.037647638,0.037647638
FALSE,Juab County,12/1/08,Hide,Hide,12,2008,3667,3667,4001,4001,1,334,334,0.08347913,0.08347913
FALSE,Juab County,12/1/09,Hide,Hide,12,2009,3782,3782,4197,4197,1,415,415,0.098880152,0.098880152
FALSE,Juab County,12/1/10,Hide,Hide,12,2010,4183,4183,4595,4595,1,412,412,0.089662677,0.089662677
FALSE,Juab County,12/1/11,Hide,Hide,12,2011,4263,4263,4578,4578,1,315,315,0.068807339,0.068807339
FALSE,Juab County,12/1/12,Hide,Hide,12,2012,4426,4426,4686,4686,1,260,260,0.055484422,0.055484422
FALSE,Juab County,12/1/13,Hide,Hide,12,2013,4524,4524,4741,4741,1,217,217,0.045770934,0.045770934
FALSE,Juab County,12/1/14,Hide,Hide,12,2014,4669,4669,4861,4861,1,192,192,0.039498046,0.039498046
FALSE,Juab County,12/1/15,Hide,Hide,12,2015,4860,4860,5057,5057,1,197,197,0.038955903,0.038955903
FALSE,Juab County,12/1/16,Hide,Hide,12,2016,5124,5124,5303,5303,1,179,179,0.033754479,0.033754479
FALSE,Juab County,12/1/17,Hide,Hide,12,2017,5336,5336,5515,5515,1,179,179,0.032456936,0.032456936
FALSE,Juab County,12/1/18,Hide,Hide,12,2018,5465,5465,5621,5621,1,156,156,0.027753069,0.027753069
FALSE,Juab County,12/1/19,Hide,Hide,12,2019,5675,5675,5808,5808,1,133,133,0.022899449,0.022899449
FALSE,Kane County,12/1/92,Hide,Hide,12,1992,2600,2600,2791,2791,1,191,191,0.068434253,0.068434253
FALSE,Kane County,12/1/93,Hide,Hide,12,1993,2501,2501,2682,2682,1,181,181,0.06748695,0.06748695
FALSE,Kane County,12/1/94,Hide,Hide,12,1994,2517,2517,2791,2791,1,274,274,0.098172698,0.098172698
FALSE,Kane County,12/1/95,Hide,Hide,12,1995,2456,2456,2626,2626,1,170,170,0.064737243,0.064737243
FALSE,Kane County,12/1/96,Hide,Hide,12,1996,2423,2423,2597,2597,1,174,174,0.067000385,0.067000385
FALSE,Kane County,12/1/97,Hide,Hide,12,1997,2566,2566,2673,2673,1,107,107,0.040029929,0.040029929
FALSE,Kane County,12/1/98,Hide,Hide,12,1998,2650,2650,2765,2765,1,115,115,0.04159132,0.04159132
FALSE,Kane County,12/1/99,Hide,Hide,12,1999,2768,2768,2863,2863,1,95,95,0.033181977,0.033181977
FALSE,Kane County,12/1/00,Hide,Hide,12,2000,2869,2869,2992,2992,1,123,123,0.041109626,0.041109626
FALSE,Kane County,12/1/01,Hide,Hide,12,2001,3020,3020,3156,3156,1,136,136,0.043092522,0.043092522
FALSE,Kane County,12/1/02,Hide,Hide,12,2002,2841,2841,3003,3003,1,162,162,0.053946054,0.053946054
FALSE,Kane County,12/1/03,Hide,Hide,12,2003,2962,2962,3144,3144,1,182,182,0.057888041,0.057888041
FALSE,Kane County,12/1/04,Hide,Hide,12,2004,3027,3027,3200,3200,1,173,173,0.0540625,0.0540625
FALSE,Kane County,12/1/05,Hide,Hide,12,2005,3195,3195,3337,3337,1,142,142,0.042553191,0.042553191
FALSE,Kane County,12/1/06,Hide,Hide,12,2006,3403,3403,3508,3508,1,105,105,0.029931585,0.029931585
FALSE,Kane County,12/1/07,Hide,Hide,12,2007,3331,3331,3447,3447,1,116,116,0.033652451,0.033652451
FALSE,Kane County,12/1/08,Hide,Hide,12,2008,3307,3307,3521,3521,1,214,214,0.060778188,0.060778188
FALSE,Kane County,12/1/09,Hide,Hide,12,2009,3301,3301,3595,3595,1,294,294,0.08178025,0.08178025
FALSE,Kane County,12/1/10,Hide,Hide,12,2010,3238,3238,3514,3514,1,276,276,0.078542971,0.078542971
FALSE,Kane County,12/1/11,Hide,Hide,12,2011,3222,3222,3460,3460,1,238,238,0.068786127,0.068786127
FALSE,Kane County,12/1/12,Hide,Hide,12,2012,3263,3263,3470,3470,1,207,207,0.059654179,0.059654179
FALSE,Kane County,12/1/13,Hide,Hide,12,2013,3328,3328,3503,3503,1,175,175,0.04995718,0.04995718
FALSE,Kane County,12/1/14,Hide,Hide,12,2014,3402,3402,3567,3567,1,165,165,0.046257359,0.046257359
FALSE,Kane County,12/1/15,Hide,Hide,12,2015,3522,3522,3680,3680,1,158,158,0.042934783,0.042934783
FALSE,Kane County,12/1/16,Hide,Hide,12,2016,3586,3586,3715,3715,1,129,129,0.034724092,0.034724092
FALSE,Kane County,12/1/17,Hide,Hide,12,2017,3663,3663,3788,3788,1,125,125,0.032998944,0.032998944
FALSE,Kane County,12/1/18,Hide,Hide,12,2018,3668,3668,3786,3786,1,118,118,0.031167459,0.031167459
FALSE,Kane County,12/1/19,Hide,Hide,12,2019,3725,3725,3823,3823,1,98,98,0.025634319,0.025634319
FALSE,Millard County,12/1/92,Hide,Hide,12,1992,4385,4385,4672,4672,1,287,287,0.061429795,0.061429795
FALSE,Millard County,12/1/93,Hide,Hide,12,1993,4540,4540,4754,4754,1,214,214,0.045014724,0.045014724
FALSE,Millard County,12/1/94,Hide,Hide,12,1994,4620,4620,4858,4858,1,238,238,0.048991354,0.048991354
FALSE,Millard County,12/1/95,Hide,Hide,12,1995,4455,4455,4664,4664,1,209,209,0.044811321,0.044811321
FALSE,Millard County,12/1/96,Hide,Hide,12,1996,4589,4589,4771,4771,1,182,182,0.038147139,0.038147139
FALSE,Millard County,12/1/97,Hide,Hide,12,1997,4624,4624,4835,4835,1,211,211,0.043640124,0.043640124
FALSE,Millard County,12/1/98,Hide,Hide,12,1998,4472,4472,4675,4675,1,203,203,0.04342246,0.04342246
FALSE,Millard County,12/1/99,Hide,Hide,12,1999,4626,4626,4797,4797,1,171,171,0.03564728,0.03564728
FALSE,Millard County,12/1/00,Hide,Hide,12,2000,4949,4949,5141,5141,1,192,192,0.03734682,0.03734682
FALSE,Millard County,12/1/01,Hide,Hide,12,2001,5858,5858,6130,6130,1,272,272,0.044371941,0.044371941
FALSE,Millard County,12/1/02,Hide,Hide,12,2002,6061,6061,6349,6349,1,288,288,0.045361474,0.045361474
FALSE,Millard County,12/1/03,Hide,Hide,12,2003,5638,5638,5957,5957,1,319,319,0.053550445,0.053550445
FALSE,Millard County,12/1/04,Hide,Hide,12,2004,5558,5558,5814,5814,1,256,256,0.044031648,0.044031648
FALSE,Millard County,12/1/05,Hide,Hide,12,2005,5870,5870,6096,6096,1,226,226,0.037073491,0.037073491
FALSE,Millard County,12/1/06,Hide,Hide,12,2006,6121,6121,6273,6273,1,152,152,0.024230831,0.024230831
FALSE,Millard County,12/1/07,Hide,Hide,12,2007,5943,5943,6117,6117,1,174,174,0.028445316,0.028445316
FALSE,Millard County,12/1/08,Hide,Hide,12,2008,6003,6003,6275,6275,1,272,272,0.043346614,0.043346614
FALSE,Millard County,12/1/09,Hide,Hide,12,2009,6083,6083,6485,6485,1,402,402,0.061989206,0.061989206
FALSE,Millard County,12/1/10,Hide,Hide,12,2010,6028,6028,6400,6400,1,372,372,0.058125,0.058125
FALSE,Millard County,12/1/11,Hide,Hide,12,2011,5722,5722,6022,6022,1,300,300,0.049817336,0.049817336
FALSE,Millard County,12/1/12,Hide,Hide,12,2012,5733,5733,5995,5995,1,262,262,0.043703086,0.043703086
FALSE,Millard County,12/1/13,Hide,Hide,12,2013,5725,5725,5941,5941,1,216,216,0.036357516,0.036357516
FALSE,Millard County,12/1/14,Hide,Hide,12,2014,5886,5886,6103,6103,1,217,217,0.035556284,0.035556284
FALSE,Millard County,12/1/15,Hide,Hide,12,2015,5871,5871,6082,6082,1,211,211,0.034692535,0.034692535
FALSE,Millard County,12/1/16,Hide,Hide,12,2016,6038,6038,6253,6253,1,215,215,0.034383496,0.034383496
FALSE,Millard County,12/1/17,Hide,Hide,12,2017,6272,6272,6471,6471,1,199,199,0.030752588,0.030752588
FALSE,Millard County,12/1/18,Hide,Hide,12,2018,5842,5842,6031,6031,1,189,189,0.031338087,0.031338087
FALSE,Millard County,12/1/19,Hide,Hide,12,2019,5779,5779,5926,5926,1,147,147,0.02480594,0.02480594
FALSE,Morgan County,12/1/92,Hide,Hide,12,1992,2793,2793,2966,2966,1,173,173,0.058327714,0.058327714
FALSE,Morgan County,12/1/93,Hide,Hide,12,1993,2828,2828,2971,2971,1,143,143,0.048131942,0.048131942
FALSE,Morgan County,12/1/94,Hide,Hide,12,1994,3100,3100,3270,3270,1,170,170,0.051987768,0.051987768
FALSE,Morgan County,12/1/95,Hide,Hide,12,1995,3215,3215,3369,3369,1,154,154,0.045710893,0.045710893
FALSE,Morgan County,12/1/96,Hide,Hide,12,1996,3402,3402,3540,3540,1,138,138,0.038983051,0.038983051
FALSE,Morgan County,12/1/97,Hide,Hide,12,1997,3573,3573,3713,3713,1,140,140,0.03770536,0.03770536
FALSE,Morgan County,12/1/98,Hide,Hide,12,1998,3487,3487,3627,3627,1,140,140,0.038599393,0.038599393
FALSE,Morgan County,12/1/99,Hide,Hide,12,1999,3387,3387,3506,3506,1,119,119,0.033941814,0.033941814
FALSE,Morgan County,12/1/00,Hide,Hide,12,2000,3319,3319,3439,3439,1,120,120,0.034893864,0.034893864
FALSE,Morgan County,12/1/01,Hide,Hide,12,2001,3337,3337,3503,3503,1,166,166,0.047387953,0.047387953
FALSE,Morgan County,12/1/02,Hide,Hide,12,2002,3380,3380,3579,3579,1,199,199,0.055602123,0.055602123
FALSE,Morgan County,12/1/03,Hide,Hide,12,2003,3448,3448,3635,3635,1,187,187,0.051444292,0.051444292
FALSE,Morgan County,12/1/04,Hide,Hide,12,2004,3570,3570,3736,3736,1,166,166,0.044432548,0.044432548
FALSE,Morgan County,12/1/05,Hide,Hide,12,2005,3730,3730,3875,3875,1,145,145,0.037419355,0.037419355
FALSE,Morgan County,12/1/06,Hide,Hide,12,2006,3870,3870,3966,3966,1,96,96,0.024205749,0.024205749
FALSE,Morgan County,12/1/07,Hide,Hide,12,2007,3924,3924,4044,4044,1,120,120,0.029673591,0.029673591
FALSE,Morgan County,12/1/08,Hide,Hide,12,2008,3891,3891,4081,4081,1,190,190,0.046557216,0.046557216
FALSE,Morgan County,12/1/09,Hide,Hide,12,2009,3849,3849,4131,4131,1,282,282,0.068264343,0.068264343
FALSE,Morgan County,12/1/10,Hide,Hide,12,2010,3981,3981,4261,4261,1,280,280,0.065712274,0.065712274
FALSE,Morgan County,12/1/11,Hide,Hide,12,2011,4063,4063,4285,4285,1,222,222,0.051808635,0.051808635
FALSE,Morgan County,12/1/12,Hide,Hide,12,2012,4213,4213,4412,4412,1,199,199,0.045104261,0.045104261
FALSE,Morgan County,12/1/13,Hide,Hide,12,2013,4422,4422,4593,4593,1,171,171,0.037230568,0.037230568
FALSE,Morgan County,12/1/14,Hide,Hide,12,2014,4632,4632,4784,4784,1,152,152,0.031772575,0.031772575
FALSE,Morgan County,12/1/15,Hide,Hide,12,2015,4851,4851,5009,5009,1,158,158,0.031543222,0.031543222
FALSE,Morgan County,12/1/16,Hide,Hide,12,2016,5116,5116,5268,5268,1,152,152,0.028853455,0.028853455
FALSE,Morgan County,12/1/17,Hide,Hide,12,2017,5270,5270,5419,5419,1,149,149,0.027495848,0.027495848
FALSE,Morgan County,12/1/18,Hide,Hide,12,2018,5333,5333,5476,5476,1,143,143,0.026113952,0.026113952
FALSE,Morgan County,12/1/19,Hide,Hide,12,2019,5498,5498,5623,5623,1,125,125,0.022230126,0.022230126
FALSE,Piute County,12/1/92,Hide,Hide,12,1992,419,419,449,449,1,30,30,0.066815145,0.066815145
FALSE,Piute County,12/1/93,Hide,Hide,12,1993,456,456,488,488,1,32,32,0.06557377,0.06557377
FALSE,Piute County,12/1/94,Hide,Hide,12,1994,459,459,495,495,1,36,36,0.072727273,0.072727273
FALSE,Piute County,12/1/95,Hide,Hide,12,1995,474,474,497,497,1,23,23,0.046277666,0.046277666
FALSE,Piute County,12/1/96,Hide,Hide,12,1996,509,509,536,536,1,27,27,0.050373134,0.050373134
FALSE,Piute County,12/1/97,Hide,Hide,12,1997,518,518,546,546,1,28,28,0.051282051,0.051282051
FALSE,Piute County,12/1/98,Hide,Hide,12,1998,503,503,534,534,1,31,31,0.058052434,0.058052434
FALSE,Piute County,12/1/99,Hide,Hide,12,1999,522,522,544,544,1,22,22,0.040441176,0.040441176
FALSE,Piute County,12/1/00,Hide,Hide,12,2000,637,637,675,675,1,38,38,0.056296296,0.056296296
FALSE,Piute County,12/1/01,Hide,Hide,12,2001,729,729,774,774,1,45,45,0.058139535,0.058139535
FALSE,Piute County,12/1/02,Hide,Hide,12,2002,739,739,786,786,1,47,47,0.059796438,0.059796438
FALSE,Piute County,12/1/03,Hide,Hide,12,2003,785,785,826,826,1,41,41,0.049636804,0.049636804
FALSE,Piute County,12/1/04,Hide,Hide,12,2004,842,842,879,879,1,37,37,0.042093288,0.042093288
FALSE,Piute County,12/1/05,Hide,Hide,12,2005,802,802,832,832,1,30,30,0.036057692,0.036057692
FALSE,Piute County,12/1/06,Hide,Hide,12,2006,862,862,883,883,1,21,21,0.023782559,0.023782559
FALSE,Piute County,12/1/07,Hide,Hide,12,2007,887,887,911,911,1,24,24,0.026344676,0.026344676
FALSE,Piute County,12/1/08,Hide,Hide,12,2008,875,875,914,914,1,39,39,0.042669584,0.042669584
FALSE,Piute County,12/1/09,Hide,Hide,12,2009,704,704,765,765,1,61,61,0.079738562,0.079738562
FALSE,Piute County,12/1/10,Hide,Hide,12,2010,507,507,564,564,1,57,57,0.10106383,0.10106383
FALSE,Piute County,12/1/11,Hide,Hide,12,2011,462,462,510,510,1,48,48,0.094117647,0.094117647
FALSE,Piute County,12/1/12,Hide,Hide,12,2012,450,450,488,488,1,38,38,0.077868852,0.077868852
FALSE,Piute County,12/1/13,Hide,Hide,12,2013,435,435,470,470,1,35,35,0.074468085,0.074468085
FALSE,Piute County,12/1/14,Hide,Hide,12,2014,437,437,470,470,1,33,33,0.070212766,0.070212766
FALSE,Piute County,12/1/15,Hide,Hide,12,2015,417,417,446,446,1,29,29,0.065022422,0.065022422
FALSE,Piute County,12/1/16,Hide,Hide,12,2016,441,441,466,466,1,25,25,0.053648069,0.053648069
FALSE,Piute County,12/1/17,Hide,Hide,12,2017,468,468,490,490,1,22,22,0.044897959,0.044897959
FALSE,Piute County,12/1/18,Hide,Hide,12,2018,457,457,481,481,1,24,24,0.04989605,0.04989605
FALSE,Piute County,12/1/19,Hide,Hide,12,2019,462,462,484,484,1,22,22,0.045454545,0.045454545
FALSE,Rich County,12/1/92,Hide,Hide,12,1992,725,725,756,756,1,31,31,0.041005291,0.041005291
FALSE,Rich County,12/1/93,Hide,Hide,12,1993,774,774,802,802,1,28,28,0.034912718,0.034912718
FALSE,Rich County,12/1/94,Hide,Hide,12,1994,813,813,845,845,1,32,32,0.037869822,0.037869822
FALSE,Rich County,12/1/95,Hide,Hide,12,1995,896,896,928,928,1,32,32,0.034482759,0.034482759
FALSE,Rich County,12/1/96,Hide,Hide,12,1996,915,915,943,943,1,28,28,0.029692471,0.029692471
FALSE,Rich County,12/1/97,Hide,Hide,12,1997,964,964,1000,1000,1,36,36,0.036,0.036
FALSE,Rich County,12/1/98,Hide,Hide,12,1998,943,943,976,976,1,33,33,0.033811475,0.033811475
FALSE,Rich County,12/1/99,Hide,Hide,12,1999,920,920,953,953,1,33,33,0.034627492,0.034627492
FALSE,Rich County,12/1/00,Hide,Hide,12,2000,1008,1008,1046,1046,1,38,38,0.036328872,0.036328872
FALSE,Rich County,12/1/01,Hide,Hide,12,2001,1260,1260,1301,1301,1,41,41,0.03151422,0.03151422
FALSE,Rich County,12/1/02,Hide,Hide,12,2002,1235,1235,1289,1289,1,54,54,0.04189294,0.04189294
FALSE,Rich County,12/1/03,Hide,Hide,12,2003,1254,1254,1300,1300,1,46,46,0.035384615,0.035384615
FALSE,Rich County,12/1/04,Hide,Hide,12,2004,1244,1244,1289,1289,1,45,45,0.034910784,0.034910784
FALSE,Rich County,12/1/05,Hide,Hide,12,2005,1273,1273,1310,1310,1,37,37,0.028244275,0.028244275
FALSE,Rich County,12/1/06,Hide,Hide,12,2006,1410,1410,1436,1436,1,26,26,0.01810585,0.01810585
FALSE,Rich County,12/1/07,Hide,Hide,12,2007,1426,1426,1458,1458,1,32,32,0.021947874,0.021947874
FALSE,Rich County,12/1/08,Hide,Hide,12,2008,1428,1428,1486,1486,1,58,58,0.039030956,0.039030956
FALSE,Rich County,12/1/09,Hide,Hide,12,2009,1212,1212,1288,1288,1,76,76,0.059006211,0.059006211
FALSE,Rich County,12/1/10,Hide,Hide,12,2010,933,933,1008,1008,1,75,75,0.074404762,0.074404762
FALSE,Rich County,12/1/11,Hide,Hide,12,2011,897,897,956,956,1,59,59,0.061715481,0.061715481
FALSE,Rich County,12/1/12,Hide,Hide,12,2012,898,898,948,948,1,50,50,0.052742616,0.052742616
FALSE,Rich County,12/1/13,Hide,Hide,12,2013,995,995,1034,1034,1,39,39,0.037717602,0.037717602
FALSE,Rich County,12/1/14,Hide,Hide,12,2014,993,993,1030,1030,1,37,37,0.03592233,0.03592233
FALSE,Rich County,12/1/15,Hide,Hide,12,2015,1002,1002,1036,1036,1,34,34,0.032818533,0.032818533
FALSE,Rich County,12/1/16,Hide,Hide,12,2016,1064,1064,1102,1102,1,38,38,0.034482759,0.034482759
FALSE,Rich County,12/1/17,Hide,Hide,12,2017,1132,1132,1170,1170,1,38,38,0.032478632,0.032478632
FALSE,Rich County,12/1/18,Hide,Hide,12,2018,1133,1133,1171,1171,1,38,38,0.032450897,0.032450897
FALSE,Rich County,12/1/19,Hide,Hide,12,2019,1120,1120,1155,1155,1,35,35,0.03030303,0.03030303
FALSE,Salt Lake County,12/1/92,Hide,Hide,12,1992,391220,391220,408381,408381,1,17161,17161,0.042022033,0.042022033
FALSE,Salt Lake County,12/1/93,Hide,Hide,12,1993,418789,418789,432665,432665,1,13876,13876,0.032071002,0.032071002
FALSE,Salt Lake County,12/1/94,Hide,Hide,12,1994,433182,433182,448208,448208,1,15026,15026,0.033524614,0.033524614
FALSE,Salt Lake County,12/1/95,Hide,Hide,12,1995,442959,442959,455796,455796,1,12837,12837,0.028163915,0.028163915
FALSE,Salt Lake County,12/1/96,Hide,Hide,12,1996,453633,453633,466925,466925,1,13292,13292,0.028467099,0.028467099
FALSE,Salt Lake County,12/1/97,Hide,Hide,12,1997,465171,465171,479834,479834,1,14663,14663,0.030558485,0.030558485
FALSE,Salt Lake County,12/1/98,Hide,Hide,12,1998,470743,470743,486702,486702,1,15959,15959,0.032790085,0.032790085
FALSE,Salt Lake County,12/1/99,Hide,Hide,12,1999,472379,472379,486958,486958,1,14579,14579,0.029938927,0.029938927
FALSE,Salt Lake County,12/1/00,Hide,Hide,12,2000,476401,476401,493956,493956,1,17555,17555,0.035539603,0.035539603
FALSE,Salt Lake County,12/1/01,Hide,Hide,12,2001,466555,466555,492275,492275,1,25720,25720,0.05224722,0.05224722
FALSE,Salt Lake County,12/1/02,Hide,Hide,12,2002,463298,463298,493519,493519,1,30221,30221,0.061235738,0.061235738
FALSE,Salt Lake County,12/1/03,Hide,Hide,12,2003,471089,471089,498240,498240,1,27151,27151,0.054493818,0.054493818
FALSE,Salt Lake County,12/1/04,Hide,Hide,12,2004,484929,484929,507903,507903,1,22974,22974,0.045233046,0.045233046
FALSE,Salt Lake County,12/1/05,Hide,Hide,12,2005,506844,506844,525881,525881,1,19037,19037,0.036200205,0.036200205
FALSE,Salt Lake County,12/1/06,Hide,Hide,12,2006,529486,529486,542678,542678,1,13192,13192,0.024309075,0.024309075
FALSE,Salt Lake County,12/1/07,Hide,Hide,12,2007,540903,540903,556537,556537,1,15634,15634,0.028091573,0.028091573
FALSE,Salt Lake County,12/1/08,Hide,Hide,12,2008,530156,530156,558271,558271,1,28115,28115,0.050360846,0.050360846
FALSE,Salt Lake County,12/1/09,Hide,Hide,12,2009,506407,506407,548027,548027,1,41620,41620,0.075945163,0.075945163
FALSE,Salt Lake County,12/1/10,Hide,Hide,12,2010,506680,506680,547467,547467,1,40787,40787,0.074501294,0.074501294
FALSE,Salt Lake County,12/1/11,Hide,Hide,12,2011,515662,515662,547959,547959,1,32297,32297,0.058940541,0.058940541
FALSE,Salt Lake County,12/1/12,Hide,Hide,12,2012,535265,535265,562508,562508,1,27243,27243,0.048431311,0.048431311
FALSE,Salt Lake County,12/1/13,Hide,Hide,12,2013,551249,551249,574143,574143,1,22894,22894,0.039875083,0.039875083
FALSE,Salt Lake County,12/1/14,Hide,Hide,12,2014,557946,557946,578268,578268,1,20322,20322,0.035142875,0.035142875
FALSE,Salt Lake County,12/1/15,Hide,Hide,12,2015,572023,572023,591727,591727,1,19704,19704,0.03329914,0.03329914
FALSE,Salt Lake County,12/1/16,Hide,Hide,12,2016,590372,590372,609314,609314,1,18942,18942,0.03108742,0.03108742
FALSE,Salt Lake County,12/1/17,Hide,Hide,12,2017,598233,598233,616886,616886,1,18653,18653,0.030237353,0.030237353
FALSE,Salt Lake County,12/1/18,Hide,Hide,12,2018,606181,606181,623899,623899,1,17718,17718,0.028398827,0.028398827
FALSE,Salt Lake County,12/1/19,Hide,Hide,12,2019,629502,629502,645323,645323,1,15821,15821,0.024516405,0.024516405
FALSE,San Juan County,12/1/92,Hide,Hide,12,1992,4337,4337,4745,4745,1,408,408,0.085985248,0.085985248
FALSE,San Juan County,12/1/93,Hide,Hide,12,1993,4679,4679,5076,5076,1,397,397,0.07821119,0.07821119
FALSE,San Juan County,12/1/94,Hide,Hide,12,1994,4721,4721,5158,5158,1,437,437,0.084722761,0.084722761
FALSE,San Juan County,12/1/95,Hide,Hide,12,1995,4793,4793,5246,5246,1,453,453,0.086351506,0.086351506
FALSE,San Juan County,12/1/96,Hide,Hide,12,1996,4498,4498,5002,5002,1,504,504,0.100759696,0.100759696
FALSE,San Juan County,12/1/97,Hide,Hide,12,1997,4489,4489,4868,4868,1,379,379,0.077855382,0.077855382
FALSE,San Juan County,12/1/98,Hide,Hide,12,1998,4709,4709,5111,5111,1,402,402,0.078653884,0.078653884
FALSE,San Juan County,12/1/99,Hide,Hide,12,1999,4534,4534,4866,4866,1,332,332,0.068228524,0.068228524
FALSE,San Juan County,12/1/00,Hide,Hide,12,2000,4204,4204,4597,4597,1,393,393,0.085490537,0.085490537
FALSE,San Juan County,12/1/01,Hide,Hide,12,2001,4310,4310,4703,4703,1,393,393,0.083563683,0.083563683
FALSE,San Juan County,12/1/02,Hide,Hide,12,2002,4394,4394,4824,4824,1,430,430,0.089137645,0.089137645
FALSE,San Juan County,12/1/03,Hide,Hide,12,2003,4327,4327,4763,4763,1,436,436,0.091538946,0.091538946
FALSE,San Juan County,12/1/04,Hide,Hide,12,2004,4352,4352,4763,4763,1,411,411,0.086290153,0.086290153
FALSE,San Juan County,12/1/05,Hide,Hide,12,2005,4498,4498,4843,4843,1,345,345,0.071236837,0.071236837
FALSE,San Juan County,12/1/06,Hide,Hide,12,2006,4660,4660,4911,4911,1,251,251,0.051109754,0.051109754
FALSE,San Juan County,12/1/07,Hide,Hide,12,2007,4700,4700,4978,4978,1,278,278,0.055845721,0.055845721
FALSE,San Juan County,12/1/08,Hide,Hide,12,2008,4721,4721,5157,5157,1,436,436,0.084545278,0.084545278
FALSE,San Juan County,12/1/09,Hide,Hide,12,2009,4972,4972,5658,5658,1,686,686,0.121244256,0.121244256
FALSE,San Juan County,12/1/10,Hide,Hide,12,2010,5435,5435,6092,6092,1,657,657,0.107846356,0.107846356
FALSE,San Juan County,12/1/11,Hide,Hide,12,2011,5281,5281,5825,5825,1,544,544,0.093390558,0.093390558
FALSE,San Juan County,12/1/12,Hide,Hide,12,2012,5169,5169,5632,5632,1,463,463,0.082208807,0.082208807
FALSE,San Juan County,12/1/13,Hide,Hide,12,2013,5297,5297,5736,5736,1,439,439,0.07653417,0.07653417
FALSE,San Juan County,12/1/14,Hide,Hide,12,2014,5179,5179,5622,5622,1,443,443,0.078797581,0.078797581
FALSE,San Juan County,12/1/15,Hide,Hide,12,2015,5230,5230,5704,5704,1,474,474,0.083099579,0.083099579
FALSE,San Juan County,12/1/16,Hide,Hide,12,2016,5302,5302,5736,5736,1,434,434,0.075662483,0.075662483
FALSE,San Juan County,12/1/17,Hide,Hide,12,2017,5329,5329,5701,5701,1,372,372,0.06525171,0.06525171
FALSE,San Juan County,12/1/18,Hide,Hide,12,2018,5380,5380,5701,5701,1,321,321,0.056305911,0.056305911
FALSE,San Juan County,12/1/19,Hide,Hide,12,2019,5424,5424,5724,5724,1,300,300,0.052410901,0.052410901
FALSE,Sanpete County,12/1/92,Hide,Hide,12,1992,6328,6328,6885,6885,1,557,557,0.080900508,0.080900508
FALSE,Sanpete County,12/1/93,Hide,Hide,12,1993,6863,6863,7318,7318,1,455,455,0.062175458,0.062175458
FALSE,Sanpete County,12/1/94,Hide,Hide,12,1994,7199,7199,7710,7710,1,511,511,0.066277562,0.066277562
FALSE,Sanpete County,12/1/95,Hide,Hide,12,1995,7503,7503,7990,7990,1,487,487,0.060951189,0.060951189
FALSE,Sanpete County,12/1/96,Hide,Hide,12,1996,7984,7984,8454,8454,1,470,470,0.055594985,0.055594985
FALSE,Sanpete County,12/1/97,Hide,Hide,12,1997,8319,8319,8790,8790,1,471,471,0.053583618,0.053583618
FALSE,Sanpete County,12/1/98,Hide,Hide,12,1998,8469,8469,8959,8959,1,490,490,0.054693604,0.054693604
FALSE,Sanpete County,12/1/99,Hide,Hide,12,1999,8742,8742,9131,9131,1,389,389,0.042602125,0.042602125
FALSE,Sanpete County,12/1/00,Hide,Hide,12,2000,9314,9314,9803,9803,1,489,489,0.049882689,0.049882689
FALSE,Sanpete County,12/1/01,Hide,Hide,12,2001,9709,9709,10310,10310,1,601,601,0.058292919,0.058292919
FALSE,Sanpete County,12/1/02,Hide,Hide,12,2002,9674,9674,10372,10372,1,698,698,0.067296568,0.067296568
FALSE,Sanpete County,12/1/03,Hide,Hide,12,2003,9707,9707,10385,10385,1,678,678,0.065286471,0.065286471
FALSE,Sanpete County,12/1/04,Hide,Hide,12,2004,9718,9718,10327,10327,1,609,609,0.058971628,0.058971628
FALSE,Sanpete County,12/1/05,Hide,Hide,12,2005,10129,10129,10622,10622,1,493,493,0.046413105,0.046413105
FALSE,Sanpete County,12/1/06,Hide,Hide,12,2006,10510,10510,10832,10832,1,322,322,0.029726736,0.029726736
FALSE,Sanpete County,12/1/07,Hide,Hide,12,2007,10572,10572,10950,10950,1,378,378,0.034520548,0.034520548
FALSE,Sanpete County,12/1/08,Hide,Hide,12,2008,10607,10607,11342,11342,1,735,735,0.064803386,0.064803386
FALSE,Sanpete County,12/1/09,Hide,Hide,12,2009,10469,10469,11449,11449,1,980,980,0.085596995,0.085596995
FALSE,Sanpete County,12/1/10,Hide,Hide,12,2010,10239,10239,11259,11259,1,1020,1020,0.090594191,0.090594191
FALSE,Sanpete County,12/1/11,Hide,Hide,12,2011,10430,10430,11207,11207,1,777,777,0.069331668,0.069331668
FALSE,Sanpete County,12/1/12,Hide,Hide,12,2012,10597,10597,11290,11290,1,693,693,0.061381754,0.061381754
FALSE,Sanpete County,12/1/13,Hide,Hide,12,2013,10407,10407,10955,10955,1,548,548,0.050022821,0.050022821
FALSE,Sanpete County,12/1/14,Hide,Hide,12,2014,10781,10781,11263,11263,1,482,482,0.042794992,0.042794992
FALSE,Sanpete County,12/1/15,Hide,Hide,12,2015,11026,11026,11501,11501,1,475,475,0.041300756,0.041300756
FALSE,Sanpete County,12/1/16,Hide,Hide,12,2016,11388,11388,11859,11859,1,471,471,0.039716671,0.039716671
FALSE,Sanpete County,12/1/17,Hide,Hide,12,2017,11805,11805,12269,12269,1,464,464,0.037818893,0.037818893
FALSE,Sanpete County,12/1/18,Hide,Hide,12,2018,12035,12035,12475,12475,1,440,440,0.035270541,0.035270541
FALSE,Sanpete County,12/1/19,Hide,Hide,12,2019,12095,12095,12485,12485,1,390,390,0.031237485,0.031237485
FALSE,Sevier County,12/1/92,Hide,Hide,12,1992,6385,6385,6849,6849,1,464,464,0.067747116,0.067747116
FALSE,Sevier County,12/1/93,Hide,Hide,12,1993,6943,6943,7279,7279,1,336,336,0.046160187,0.046160187
FALSE,Sevier County,12/1/94,Hide,Hide,12,1994,7244,7244,7627,7627,1,383,383,0.050216337,0.050216337
FALSE,Sevier County,12/1/95,Hide,Hide,12,1995,7364,7364,7720,7720,1,356,356,0.04611399,0.04611399
FALSE,Sevier County,12/1/96,Hide,Hide,12,1996,7615,7615,7985,7985,1,370,370,0.046336882,0.046336882
FALSE,Sevier County,12/1/97,Hide,Hide,12,1997,7910,7910,8243,8243,1,333,333,0.040397913,0.040397913
FALSE,Sevier County,12/1/98,Hide,Hide,12,1998,7954,7954,8315,8315,1,361,361,0.043415514,0.043415514
FALSE,Sevier County,12/1/99,Hide,Hide,12,1999,8083,8083,8379,8379,1,296,296,0.035326411,0.035326411
FALSE,Sevier County,12/1/00,Hide,Hide,12,2000,7942,7942,8319,8319,1,377,377,0.045317947,0.045317947
FALSE,Sevier County,12/1/01,Hide,Hide,12,2001,8404,8404,8861,8861,1,457,457,0.051574314,0.051574314
FALSE,Sevier County,12/1/02,Hide,Hide,12,2002,8351,8351,8860,8860,1,509,509,0.05744921,0.05744921
FALSE,Sevier County,12/1/03,Hide,Hide,12,2003,8446,8446,8942,8942,1,496,496,0.055468575,0.055468575
FALSE,Sevier County,12/1/04,Hide,Hide,12,2004,8623,8623,9066,9066,1,443,443,0.048863887,0.048863887
FALSE,Sevier County,12/1/05,Hide,Hide,12,2005,8895,8895,9260,9260,1,365,365,0.039416847,0.039416847
FALSE,Sevier County,12/1/06,Hide,Hide,12,2006,9258,9258,9506,9506,1,248,248,0.026088786,0.026088786
FALSE,Sevier County,12/1/07,Hide,Hide,12,2007,9243,9243,9531,9531,1,288,288,0.030217186,0.030217186
FALSE,Sevier County,12/1/08,Hide,Hide,12,2008,9134,9134,9740,9740,1,606,606,0.062217659,0.062217659
FALSE,Sevier County,12/1/09,Hide,Hide,12,2009,9015,9015,9852,9852,1,837,837,0.084957369,0.084957369
FALSE,Sevier County,12/1/10,Hide,Hide,12,2010,8839,8839,9625,9625,1,786,786,0.081662338,0.081662338
FALSE,Sevier County,12/1/11,Hide,Hide,12,2011,8878,8878,9496,9496,1,618,618,0.065080034,0.065080034
FALSE,Sevier County,12/1/12,Hide,Hide,12,2012,8833,8833,9385,9385,1,552,552,0.058817262,0.058817262
FALSE,Sevier County,12/1/13,Hide,Hide,12,2013,8801,8801,9248,9248,1,447,447,0.048334775,0.048334775
FALSE,Sevier County,12/1/14,Hide,Hide,12,2014,8981,8981,9393,9393,1,412,412,0.043862451,0.043862451
FALSE,Sevier County,12/1/15,Hide,Hide,12,2015,9034,9034,9464,9464,1,430,430,0.045435334,0.045435334
FALSE,Sevier County,12/1/16,Hide,Hide,12,2016,9236,9236,9636,9636,1,400,400,0.041511,0.041511
FALSE,Sevier County,12/1/17,Hide,Hide,12,2017,9487,9487,9854,9854,1,367,367,0.037243759,0.037243759
FALSE,Sevier County,12/1/18,Hide,Hide,12,2018,9496,9496,9827,9827,1,331,331,0.033682711,0.033682711
FALSE,Sevier County,12/1/19,Hide,Hide,12,2019,9438,9438,9720,9720,1,282,282,0.029012346,0.029012346
FALSE,State of Utah,12/1/92,Hide,Hide,12,1992,867096,867096,909236,909236,1,42140,42140,0.046346603,0.046346603
FALSE,State of Utah,12/1/93,Hide,Hide,12,1993,931929,931929,967373,967373,1,35444,35444,0.036639435,0.036639435
FALSE,State of Utah,12/1/94,Hide,Hide,12,1994,965292,965292,1003593,1003593,1,38301,38301,0.038163877,0.038163877
FALSE,State of Utah,12/1/95,Hide,Hide,12,1995,988860,988860,1023117,1023117,1,34257,34257,0.033482974,0.033482974
FALSE,State of Utah,12/1/96,Hide,Hide,12,1996,1018849,1018849,1053858,1053858,1,35009,35009,0.033219846,0.033219846
FALSE,State of Utah,12/1/97,Hide,Hide,12,1997,1047658,1047658,1084270,1084270,1,36612,36612,0.033766497,0.033766497
FALSE,State of Utah,12/1/98,Hide,Hide,12,1998,1072145,1072145,1113053,1113053,1,40908,40908,0.036752967,0.036752967
FALSE,State of Utah,12/1/99,Hide,Hide,12,1999,1090865,1090865,1126784,1126784,1,35919,35919,0.031877449,0.031877449
FALSE,State of Utah,12/1/00,Hide,Hide,12,2000,1112923,1112923,1156309,1156309,1,43386,43386,0.037521112,0.037521112
FALSE,State of Utah,12/1/01,Hide,Hide,12,2001,1112743,1112743,1173734,1173734,1,60991,60991,0.051963222,0.051963222
FALSE,State of Utah,12/1/02,Hide,Hide,12,2002,1120481,1120481,1191037,1191037,1,70556,70556,0.059239134,0.059239134
FALSE,State of Utah,12/1/03,Hide,Hide,12,2003,1147489,1147489,1212795,1212795,1,65306,65306,0.053847518,0.053847518
FALSE,State of Utah,12/1/04,Hide,Hide,12,2004,1189844,1189844,1246200,1246200,1,56356,56356,0.045222276,0.045222276
FALSE,State of Utah,12/1/05,Hide,Hide,12,2005,1246305,1246305,1294101,1294101,1,47796,47796,0.036933748,0.036933748
FALSE,State of Utah,12/1/06,Hide,Hide,12,2006,1305872,1305872,1338908,1338908,1,33036,33036,0.024673839,0.024673839
FALSE,State of Utah,12/1/07,Hide,Hide,12,2007,1331216,1331216,1371033,1371033,1,39817,39817,0.029041606,0.029041606
FALSE,State of Utah,12/1/08,Hide,Hide,12,2008,1302419,1302419,1377498,1377498,1,75079,75079,0.05450389,0.05450389
FALSE,State of Utah,12/1/09,Hide,Hide,12,2009,1248472,1248472,1354722,1354722,1,106250,106250,0.078429375,0.078429375
FALSE,State of Utah,12/1/10,Hide,Hide,12,2010,1251055,1251055,1353411,1353411,1,102356,102356,0.075628172,0.075628172
FALSE,State of Utah,12/1/11,Hide,Hide,12,2011,1273494,1273494,1354655,1354655,1,81161,81161,0.059912671,0.059912671
FALSE,State of Utah,12/1/12,Hide,Hide,12,2012,1319092,1319092,1388824,1388824,1,69732,69732,0.050209386,0.050209386
FALSE,State of Utah,12/1/13,Hide,Hide,12,2013,1359114,1359114,1418146,1418146,1,59032,59032,0.04162618,0.04162618
FALSE,State of Utah,12/1/14,Hide,Hide,12,2014,1388215,1388215,1440711,1440711,1,52496,52496,0.036437565,0.036437565
FALSE,State of Utah,12/1/15,Hide,Hide,12,2015,1424843,1424843,1478059,1478059,1,53216,53216,0.036003975,0.036003975
FALSE,State of Utah,12/1/16,Hide,Hide,12,2016,1477613,1477613,1528295,1528295,1,50682,50682,0.033162446,0.033162446
FALSE,State of Utah,12/1/17,Hide,Hide,12,2017,1512427,1512427,1561207,1561207,1,48780,48780,0.031245056,0.031245056
FALSE,State of Utah,12/1/18,Hide,Hide,12,2018,1530275,1530275,1580097,1580097,1,49822,49822,0.031530976,0.031530976
FALSE,State of Utah,12/1/19,Hide,Hide,12,2019,1582820,1582820,1622443,1622443,1,39623,39623,0.024421813,0.024421813
FALSE,Summit County,12/1/92,Hide,Hide,12,1992,9228,9228,9833,9833,1,605,605,0.061527509,0.061527509
FALSE,Summit County,12/1/93,Hide,Hide,12,1993,10338,10338,10823,10823,1,485,485,0.044811974,0.044811974
FALSE,Summit County,12/1/94,Hide,Hide,12,1994,11288,11288,11796,11796,1,508,508,0.043065446,0.043065446
FALSE,Summit County,12/1/95,Hide,Hide,12,1995,11819,11819,12292,12292,1,473,473,0.038480312,0.038480312
FALSE,Summit County,12/1/96,Hide,Hide,12,1996,12682,12682,13108,13108,1,426,426,0.032499237,0.032499237
FALSE,Summit County,12/1/97,Hide,Hide,12,1997,13348,13348,13916,13916,1,568,568,0.040816327,0.040816327
FALSE,Summit County,12/1/98,Hide,Hide,12,1998,13917,13917,14550,14550,1,633,633,0.043505155,0.043505155
FALSE,Summit County,12/1/99,Hide,Hide,12,1999,15077,15077,15695,15695,1,618,618,0.039375597,0.039375597
FALSE,Summit County,12/1/00,Hide,Hide,12,2000,17876,17876,18558,18558,1,682,682,0.03674965,0.03674965
FALSE,Summit County,12/1/01,Hide,Hide,12,2001,18026,18026,19224,19224,1,1198,1198,0.062317936,0.062317936
FALSE,Summit County,12/1/02,Hide,Hide,12,2002,18256,18256,19536,19536,1,1280,1280,0.065520066,0.065520066
FALSE,Summit County,12/1/03,Hide,Hide,12,2003,18926,18926,20091,20091,1,1165,1165,0.057986163,0.057986163
FALSE,Summit County,12/1/04,Hide,Hide,12,2004,19880,19880,20826,20826,1,946,946,0.045423989,0.045423989
FALSE,Summit County,12/1/05,Hide,Hide,12,2005,20870,20870,21637,21637,1,767,767,0.035448537,0.035448537
FALSE,Summit County,12/1/06,Hide,Hide,12,2006,21426,21426,21946,21946,1,520,520,0.023694523,0.023694523
FALSE,Summit County,12/1/07,Hide,Hide,12,2007,21286,21286,21887,21887,1,601,601,0.027459222,0.027459222
FALSE,Summit County,12/1/08,Hide,Hide,12,2008,20859,20859,21926,21926,1,1067,1067,0.048663687,0.048663687
FALSE,Summit County,12/1/09,Hide,Hide,12,2009,20692,20692,22290,22290,1,1598,1598,0.071691341,0.071691341
FALSE,Summit County,12/1/10,Hide,Hide,12,2010,19768,19768,21262,21262,1,1494,1494,0.070266203,0.070266203
FALSE,Summit County,12/1/11,Hide,Hide,12,2011,20155,20155,21297,21297,1,1142,1142,0.053622576,0.053622576
FALSE,Summit County,12/1/12,Hide,Hide,12,2012,20948,20948,21983,21983,1,1035,1035,0.047081836,0.047081836
FALSE,Summit County,12/1/13,Hide,Hide,12,2013,21433,21433,22279,22279,1,846,846,0.037972979,0.037972979
FALSE,Summit County,12/1/14,Hide,Hide,12,2014,21867,21867,22621,22621,1,754,754,0.03333186,0.03333186
FALSE,Summit County,12/1/15,Hide,Hide,12,2015,22665,22665,23430,23430,1,765,765,0.032650448,0.032650448
FALSE,Summit County,12/1/16,Hide,Hide,12,2016,23411,23411,24166,24166,1,755,755,0.031242241,0.031242241
FALSE,Summit County,12/1/17,Hide,Hide,12,2017,23500,23500,24237,24237,1,737,737,0.030408054,0.030408054
FALSE,Summit County,12/1/18,Hide,Hide,12,2018,24032,24032,24722,24722,1,690,690,0.027910363,0.027910363
FALSE,Summit County,12/1/19,Hide,Hide,12,2019,24942,24942,25541,25541,1,599,599,0.023452488,0.023452488
FALSE,Tooele County,12/1/92,Hide,Hide,12,1992,11626,11626,12485,12485,1,859,859,0.068802563,0.068802563
FALSE,Tooele County,12/1/93,Hide,Hide,12,1993,11315,11315,11915,11915,1,600,600,0.050356693,0.050356693
FALSE,Tooele County,12/1/94,Hide,Hide,12,1994,10904,10904,11583,11583,1,679,679,0.058620392,0.058620392
FALSE,Tooele County,12/1/95,Hide,Hide,12,1995,10881,10881,11478,11478,1,597,597,0.052012546,0.052012546
FALSE,Tooele County,12/1/96,Hide,Hide,12,1996,11205,11205,11779,11779,1,574,574,0.048730792,0.048730792
FALSE,Tooele County,12/1/97,Hide,Hide,12,1997,11388,11388,11921,11921,1,533,533,0.044711014,0.044711014
FALSE,Tooele County,12/1/98,Hide,Hide,12,1998,11611,11611,12256,12256,1,645,645,0.052627285,0.052627285
FALSE,Tooele County,12/1/99,Hide,Hide,12,1999,14813,14813,15458,15458,1,645,645,0.041725967,0.041725967
FALSE,Tooele County,12/1/00,Hide,Hide,12,2000,20249,20249,21104,21104,1,855,855,0.040513647,0.040513647
FALSE,Tooele County,12/1/01,Hide,Hide,12,2001,20619,20619,21840,21840,1,1221,1221,0.055906593,0.055906593
FALSE,Tooele County,12/1/02,Hide,Hide,12,2002,21143,21143,22642,22642,1,1499,1499,0.066204399,0.066204399
FALSE,Tooele County,12/1/03,Hide,Hide,12,2003,22171,22171,23536,23536,1,1365,1365,0.057996261,0.057996261
FALSE,Tooele County,12/1/04,Hide,Hide,12,2004,23283,23283,24490,24490,1,1207,1207,0.049285423,0.049285423
FALSE,Tooele County,12/1/05,Hide,Hide,12,2005,24697,24697,25730,25730,1,1033,1033,0.040147688,0.040147688
FALSE,Tooele County,12/1/06,Hide,Hide,12,2006,25894,25894,26620,26620,1,726,726,0.027272727,0.027272727
FALSE,Tooele County,12/1/07,Hide,Hide,12,2007,26593,26593,27456,27456,1,863,863,0.03143211,0.03143211
FALSE,Tooele County,12/1/08,Hide,Hide,12,2008,26572,26572,28174,28174,1,1602,1602,0.056860936,0.056860936
FALSE,Tooele County,12/1/09,Hide,Hide,12,2009,25370,25370,27763,27763,1,2393,2393,0.086193855,0.086193855
FALSE,Tooele County,12/1/10,Hide,Hide,12,2010,25184,25184,27362,27362,1,2178,2178,0.079599444,0.079599444
FALSE,Tooele County,12/1/11,Hide,Hide,12,2011,25553,25553,27296,27296,1,1743,1743,0.06385551,0.06385551
FALSE,Tooele County,12/1/12,Hide,Hide,12,2012,26497,26497,28098,28098,1,1601,1601,0.056979144,0.056979144
FALSE,Tooele County,12/1/13,Hide,Hide,12,2013,27306,27306,28801,28801,1,1495,1495,0.05190792,0.05190792
FALSE,Tooele County,12/1/14,Hide,Hide,12,2014,27819,27819,29108,29108,1,1289,1289,0.044283359,0.044283359
FALSE,Tooele County,12/1/16,Hide,Hide,12,2016,30273,30273,31418,31418,1,1145,1145,0.036444077,0.036444077
FALSE,Tooele County,12/1/17,Hide,Hide,12,2017,31411,31411,32530,32530,1,1119,1119,0.034399016,0.034399016
FALSE,Tooele County,12/1/18,Hide,Hide,12,2018,32344,32344,33450,33450,1,1106,1106,0.033064275,0.033064275
FALSE,Tooele County,12/1/19,Hide,Hide,12,2019,33535,33535,34465,34465,1,930,930,0.026983897,0.026983897
FALSE,Uintah County,12/1/92,Hide,Hide,12,1992,9179,9179,9931,9931,1,752,752,0.075722485,0.075722485
FALSE,Uintah County,12/1/93,Hide,Hide,12,1993,9412,9412,10115,10115,1,703,703,0.069500741,0.069500741
FALSE,Uintah County,12/1/94,Hide,Hide,12,1994,9603,9603,10331,10331,1,728,728,0.070467525,0.070467525
FALSE,Uintah County,12/1/95,Hide,Hide,12,1995,9459,9459,10203,10203,1,744,744,0.072919729,0.072919729
FALSE,Uintah County,12/1/96,Hide,Hide,12,1996,9679,9679,10369,10369,1,690,690,0.066544508,0.066544508
FALSE,Uintah County,12/1/97,Hide,Hide,12,1997,10196,10196,10737,10737,1,541,541,0.050386514,0.050386514
FALSE,Uintah County,12/1/98,Hide,Hide,12,1998,10273,10273,11094,11094,1,821,821,0.074003966,0.074003966
FALSE,Uintah County,12/1/99,Hide,Hide,12,1999,10649,10649,11180,11180,1,531,531,0.047495528,0.047495528
FALSE,Uintah County,12/1/00,Hide,Hide,12,2000,11260,11260,11767,11767,1,507,507,0.043086598,0.043086598
FALSE,Uintah County,12/1/01,Hide,Hide,12,2001,11888,11888,12534,12534,1,646,646,0.051539812,0.051539812
FALSE,Uintah County,12/1/02,Hide,Hide,12,2002,12059,12059,12868,12868,1,809,809,0.062869133,0.062869133
FALSE,Uintah County,12/1/03,Hide,Hide,12,2003,12624,12624,13363,13363,1,739,739,0.055301953,0.055301953
FALSE,Uintah County,12/1/04,Hide,Hide,12,2004,13393,13393,14019,14019,1,626,626,0.044653684,0.044653684
FALSE,Uintah County,12/1/05,Hide,Hide,12,2005,14903,14903,15391,15391,1,488,488,0.031706842,0.031706842
FALSE,Uintah County,12/1/06,Hide,Hide,12,2006,16589,16589,16917,16917,1,328,328,0.019388781,0.019388781
FALSE,Uintah County,12/1/07,Hide,Hide,12,2007,16948,16948,17352,17352,1,404,404,0.023282619,0.023282619
FALSE,Uintah County,12/1/08,Hide,Hide,12,2008,18426,18426,19083,19083,1,657,657,0.034428549,0.034428549
FALSE,Uintah County,12/1/09,Hide,Hide,12,2009,14586,14586,16221,16221,1,1635,1635,0.100795265,0.100795265
FALSE,Uintah County,12/1/10,Hide,Hide,12,2010,14204,14204,15373,15373,1,1169,1169,0.076042412,0.076042412
FALSE,Uintah County,12/1/11,Hide,Hide,12,2011,15003,15003,15787,15787,1,784,784,0.049661114,0.049661114
FALSE,Uintah County,12/1/12,Hide,Hide,12,2012,15147,15147,15883,15883,1,736,736,0.046338853,0.046338853
FALSE,Uintah County,12/1/13,Hide,Hide,12,2013,15026,15026,15653,15653,1,627,627,0.040056219,0.040056219
FALSE,Uintah County,12/1/14,Hide,Hide,12,2014,15486,15486,16145,16145,1,659,659,0.040817591,0.040817591
FALSE,Uintah County,12/1/15,Hide,Hide,12,2015,13344,13344,14643,14643,1,1299,1299,0.08871133,0.08871133
FALSE,Uintah County,12/1/16,Hide,Hide,12,2016,12567,12567,13664,13664,1,1097,1097,0.080283958,0.080283958
FALSE,Uintah County,12/1/17,Hide,Hide,12,2017,12986,12986,13691,13691,1,705,705,0.051493682,0.051493682
FALSE,Uintah County,12/1/18,Hide,Hide,12,2018,12997,12997,13584,13584,1,587,587,0.043212603,0.043212603
FALSE,Uintah County,12/1/19,Hide,Hide,12,2019,13128,13128,13753,13753,1,625,625,0.04544463,0.04544463
FALSE,United States,12/1/92,Hide,Hide,12,1992,118997,118997000,128554,128554000,1,9557,9557000,0.074,0.074
FALSE,United States,12/1/93,Hide,Hide,12,1993,121464,121464000,129941,129941000,1,8477,8477000,0.065,0.065
FALSE,United States,12/1/94,Hide,Hide,12,1994,124721,124721000,131951,131951000,1,7230,7230000,0.055,0.055
FALSE,United States,12/1/95,Hide,Hide,12,1995,125088,125088000,132511,132511000,1,7423,7423000,0.056,0.056
FALSE,United States,12/1/96,Hide,Hide,12,1996,127860,127860000,135113,135113000,1,7253,7253000,0.054,0.054
FALSE,United States,12/1/97,Hide,Hide,12,1997,130679,130679000,137155,137155000,1,6476,6476000,0.047,0.047
FALSE,United States,12/1/98,Hide,Hide,12,1998,132602,132602000,138634,138634000,1,6032,6032000,0.044,0.044
FALSE,United States,12/1/99,Hide,Hide,12,1999,134523,134523000,140177,140177000,1,5653,5653000,0.04,0.04
FALSE,United States,12/1/00,Hide,Hide,12,2000,137614,137614000,143248,143248000,1,5634,5634000,0.039,0.039
FALSE,United States,12/1/01,Hide,Hide,12,2001,136047,136047000,144305,144305000,1,8258,8258000,0.057,0.057
FALSE,United States,12/1/02,Hide,Hide,12,2002,136426,136426000,145066,145066000,1,8640,8640000,0.06,0.06
FALSE,United States,12/1/03,Hide,Hide,12,2003,138411,138411000,146729,146729000,1,8317,8317000,0.057,0.057
FALSE,United States,12/1/04,Hide,Hide,12,2004,140125,140125000,148059,148059000,1,7934,7934000,0.054,0.054
FALSE,United States,12/1/05,Hide,Hide,12,2005,142752,142752000,150030,150030000,1,7279,7279000,0.049,0.049
FALSE,United States,12/1/06,Hide,Hide,12,2006,145970,145970000,152732,152732000,1,6762,6762000,0.044,0.044
FALSE,United States,12/1/07,Hide,Hide,12,2007,146273,146273000,153918,153918000,1,7645,7645000,0.05,0.05
FALSE,United States,12/1/08,Hide,Hide,12,2008,143369,143369000,154655,154655000,1,11286,11286000,0.073,0.073
FALSE,United States,12/1/09,Hide,Hide,12,2009,138013,138013000,153111,153111000,1,15098,15098000,0.099,0.099
FALSE,United States,12/1/10,Hide,Hide,12,2010,139301,139301000,153650,153650000,1,14348,14348000,0.093,0.093
FALSE,United States,12/1/11,Hide,Hide,12,2011,140902,140902000,153995,153995000,1,13093,13093000,0.085,0.085
FALSE,United States,12/1/12,Hide,Hide,12,2012,143330,143330000,155628,155628000,1,12298,12298000,0.079,0.079
FALSE,United States,12/1/13,Hide,Hide,12,2013,144778,144778000,155182,155182000,1,10404,10404000,0.067,0.067
FALSE,United States,12/1/14,Hide,Hide,12,2014,147615,147615000,156332,156332000,1,8717,8717000,0.056,0.056
FALSE,United States,12/1/15,Hide,Hide,12,2015,150128,150128000,158035,158035000,1,7907,7907000,0.05,0.05
FALSE,United States,12/1/16,Hide,Hide,12,2016,152216,152216000,159710,159710000,1,7495,7495000,0.047,0.047
FALSE,United States,12/1/17,Hide,Hide,12,2017,153977,153977000,160538,160538000,1,6561,6561000,0.041,0.041
FALSE,United States,12/1/18,Hide,Hide,12,2018,156825,156825000,163111,163111000,1,6286,6286000,0.039,0.039
FALSE,United States,12/1/19,Hide,Hide,12,2019,158803,158803000,164556,164556000,1,5753,5753000,0.035,0.035
FALSE,Utah County,12/1/92,Hide,Hide,12,1992,126677,126677,131912,131912,1,5235,5235,0.039685548,0.039685548
FALSE,Utah County,12/1/93,Hide,Hide,12,1993,136543,136543,140980,140980,1,4437,4437,0.031472549,0.031472549
FALSE,Utah County,12/1/94,Hide,Hide,12,1994,141401,141401,145982,145982,1,4581,4581,0.031380581,0.031380581
FALSE,Utah County,12/1/95,Hide,Hide,12,1995,148535,148535,152609,152609,1,4074,4074,0.026695673,0.026695673
FALSE,Utah County,12/1/96,Hide,Hide,12,1996,152011,152011,156429,156429,1,4418,4418,0.028242845,0.028242845
FALSE,Utah County,12/1/97,Hide,Hide,12,1997,155635,155635,160064,160064,1,4429,4429,0.027670182,0.027670182
FALSE,Utah County,12/1/98,Hide,Hide,12,1998,162930,162930,168505,168505,1,5575,5575,0.033085072,0.033085072
FALSE,Utah County,12/1/99,Hide,Hide,12,1999,170155,170155,174711,174711,1,4556,4556,0.026077351,0.026077351
FALSE,Utah County,12/1/00,Hide,Hide,12,2000,177445,177445,183328,183328,1,5883,5883,0.032090024,0.032090024
FALSE,Utah County,12/1/01,Hide,Hide,12,2001,174121,174121,183821,183821,1,9700,9700,0.052768726,0.052768726
FALSE,Utah County,12/1/02,Hide,Hide,12,2002,176767,176767,187730,187730,1,10963,10963,0.058397699,0.058397699
FALSE,Utah County,12/1/03,Hide,Hide,12,2003,182343,182343,192098,192098,1,9755,9755,0.050781372,0.050781372
FALSE,Utah County,12/1/04,Hide,Hide,12,2004,191709,191709,200317,200317,1,8608,8608,0.04297189,0.04297189
FALSE,Utah County,12/1/05,Hide,Hide,12,2005,201899,201899,209325,209325,1,7426,7426,0.035475935,0.035475935
FALSE,Utah County,12/1/06,Hide,Hide,12,2006,214268,214268,219290,219290,1,5022,5022,0.022901181,0.022901181
FALSE,Utah County,12/1/07,Hide,Hide,12,2007,218391,218391,224654,224654,1,6263,6263,0.027878426,0.027878426
FALSE,Utah County,12/1/08,Hide,Hide,12,2008,211836,211836,223354,223354,1,11518,11518,0.051568362,0.051568362
FALSE,Utah County,12/1/09,Hide,Hide,12,2009,206976,206976,224065,224065,1,17089,17089,0.076268047,0.076268047
FALSE,Utah County,12/1/10,Hide,Hide,12,2010,213276,213276,229826,229826,1,16550,16550,0.072011,0.072011
FALSE,Utah County,12/1/11,Hide,Hide,12,2011,220369,220369,233156,233156,1,12787,12787,0.054843109,0.054843109
FALSE,Utah County,12/1/12,Hide,Hide,12,2012,232470,232470,243768,243768,1,11298,11298,0.046347347,0.046347347
FALSE,Utah County,12/1/13,Hide,Hide,12,2013,242007,242007,251735,251735,1,9728,9728,0.038643812,0.038643812
FALSE,Utah County,12/1/14,Hide,Hide,12,2014,250838,250838,259428,259428,1,8590,8590,0.033111306,0.033111306
FALSE,Utah County,12/1/15,Hide,Hide,12,2015,262637,262637,271324,271324,1,8687,8687,0.032017072,0.032017072
FALSE,Utah County,12/1/16,Hide,Hide,12,2016,275945,275945,284543,284543,1,8598,8598,0.030216874,0.030216874
FALSE,Utah County,12/1/17,Hide,Hide,12,2017,287309,287309,295703,295703,1,8394,8394,0.028386591,0.028386591
FALSE,Utah County,12/1/18,Hide,Hide,12,2018,294141,294141,302261,302261,1,8120,8120,0.0268642,0.0268642
FALSE,Utah County,12/1/19,Hide,Hide,12,2019,305517,305517,312909,312909,1,7392,7392,0.023623482,0.023623482
FALSE,Wasatch County,12/1/92,Hide,Hide,12,1992,4592,4592,4920,4920,1,328,328,0.066666667,0.066666667
FALSE,Wasatch County,12/1/93,Hide,Hide,12,1993,4907,4907,5201,5201,1,294,294,0.056527591,0.056527591
FALSE,Wasatch County,12/1/94,Hide,Hide,12,1994,5153,5153,5468,5468,1,315,315,0.057607901,0.057607901
FALSE,Wasatch County,12/1/95,Hide,Hide,12,1995,5212,5212,5451,5451,1,239,239,0.043845166,0.043845166
FALSE,Wasatch County,12/1/96,Hide,Hide,12,1996,5538,5538,5777,5777,1,239,239,0.041370954,0.041370954
FALSE,Wasatch County,12/1/97,Hide,Hide,12,1997,5807,5807,6081,6081,1,274,274,0.045058379,0.045058379
FALSE,Wasatch County,12/1/98,Hide,Hide,12,1998,6074,6074,6358,6358,1,284,284,0.044668135,0.044668135
FALSE,Wasatch County,12/1/99,Hide,Hide,12,1999,6452,6452,6716,6716,1,264,264,0.039309113,0.039309113
FALSE,Wasatch County,12/1/00,Hide,Hide,12,2000,7426,7426,7744,7744,1,318,318,0.04106405,0.04106405
FALSE,Wasatch County,12/1/01,Hide,Hide,12,2001,7670,7670,8125,8125,1,455,455,0.056,0.056
FALSE,Wasatch County,12/1/02,Hide,Hide,12,2002,7706,7706,8230,8230,1,524,524,0.063669502,0.063669502
FALSE,Wasatch County,12/1/03,Hide,Hide,12,2003,8051,8051,8568,8568,1,517,517,0.060340803,0.060340803
FALSE,Wasatch County,12/1/04,Hide,Hide,12,2004,8597,8597,9018,9018,1,421,421,0.046684409,0.046684409
FALSE,Wasatch County,12/1/05,Hide,Hide,12,2005,9275,9275,9628,9628,1,353,353,0.036663897,0.036663897
FALSE,Wasatch County,12/1/06,Hide,Hide,12,2006,10208,10208,10482,10482,1,274,274,0.02614005,0.02614005
FALSE,Wasatch County,12/1/07,Hide,Hide,12,2007,10481,10481,10800,10800,1,319,319,0.029537037,0.029537037
FALSE,Wasatch County,12/1/08,Hide,Hide,12,2008,9522,9522,10113,10113,1,591,591,0.058439632,0.058439632
FALSE,Wasatch County,12/1/09,Hide,Hide,12,2009,9651,9651,10572,10572,1,921,921,0.087116913,0.087116913
FALSE,Wasatch County,12/1/10,Hide,Hide,12,2010,10590,10590,11498,11498,1,908,908,0.078970256,0.078970256
FALSE,Wasatch County,12/1/11,Hide,Hide,12,2011,10784,10784,11504,11504,1,720,720,0.062586926,0.062586926
FALSE,Wasatch County,12/1/12,Hide,Hide,12,2012,11351,11351,11980,11980,1,629,629,0.052504174,0.052504174
FALSE,Wasatch County,12/1/13,Hide,Hide,12,2013,11971,11971,12502,12502,1,531,531,0.042473204,0.042473204
FALSE,Wasatch County,12/1/14,Hide,Hide,12,2014,12373,12373,12825,12825,1,452,452,0.035243665,0.035243665
FALSE,Wasatch County,12/1/15,Hide,Hide,12,2015,13016,13016,13505,13505,1,489,489,0.036208812,0.036208812
FALSE,Wasatch County,12/1/16,Hide,Hide,12,2016,13690,13690,14159,14159,1,469,469,0.033123808,0.033123808
FALSE,Wasatch County,12/1/17,Hide,Hide,12,2017,14366,14366,14832,14832,1,466,466,0.031418554,0.031418554
FALSE,Wasatch County,12/1/18,Hide,Hide,12,2018,15074,15074,15540,15540,1,466,466,0.02998713,0.02998713
FALSE,Wasatch County,12/1/19,Hide,Hide,12,2019,16211,16211,16644,16644,1,433,433,0.026015381,0.026015381
FALSE,Washington County,12/1/92,Hide,Hide,12,1992,22924,22924,23915,23915,1,991,991,0.041438428,0.041438428
FALSE,Washington County,12/1/93,Hide,Hide,12,1993,27465,27465,28318,28318,1,853,853,0.030122184,0.030122184
FALSE,Washington County,12/1/94,Hide,Hide,12,1994,30648,30648,31683,31683,1,1035,1035,0.032667361,0.032667361
FALSE,Washington County,12/1/95,Hide,Hide,12,1995,32801,32801,33922,33922,1,1121,1121,0.033046401,0.033046401
FALSE,Washington County,12/1/96,Hide,Hide,12,1996,33683,33683,34942,34942,1,1259,1259,0.036031137,0.036031137
FALSE,Washington County,12/1/97,Hide,Hide,12,1997,34867,34867,36037,36037,1,1170,1170,0.032466632,0.032466632
FALSE,Washington County,12/1/98,Hide,Hide,12,1998,36916,36916,38331,38331,1,1415,1415,0.03691529,0.03691529
FALSE,Washington County,12/1/99,Hide,Hide,12,1999,37714,37714,39008,39008,1,1294,1294,0.033172683,0.033172683
FALSE,Washington County,12/1/00,Hide,Hide,12,2000,38943,38943,40494,40494,1,1551,1551,0.038301971,0.038301971
FALSE,Washington County,12/1/01,Hide,Hide,12,2001,40800,40800,42792,42792,1,1992,1992,0.046550757,0.046550757
FALSE,Washington County,12/1/02,Hide,Hide,12,2002,43440,43440,46026,46026,1,2586,2586,0.056185634,0.056185634
FALSE,Washington County,12/1/03,Hide,Hide,12,2003,47085,47085,49638,49638,1,2553,2553,0.05143237,0.05143237
FALSE,Washington County,12/1/04,Hide,Hide,12,2004,51859,51859,54237,54237,1,2378,2378,0.043844608,0.043844608
FALSE,Washington County,12/1/05,Hide,Hide,12,2005,57100,57100,59227,59227,1,2127,2127,0.035912675,0.035912675
FALSE,Washington County,12/1/06,Hide,Hide,12,2006,60416,60416,62058,62058,1,1642,1642,0.026459119,0.026459119
FALSE,Washington County,12/1/07,Hide,Hide,12,2007,62172,62172,64184,64184,1,2012,2012,0.031347376,0.031347376
FALSE,Washington County,12/1/08,Hide,Hide,12,2008,56379,56379,60899,60899,1,4520,4520,0.074221252,0.074221252
FALSE,Washington County,12/1/09,Hide,Hide,12,2009,52098,52098,58187,58187,1,6089,6089,0.104645368,0.104645368
FALSE,Washington County,12/1/10,Hide,Hide,12,2010,50433,50433,56114,56114,1,5681,5681,0.101240332,0.101240332
FALSE,Washington County,12/1/11,Hide,Hide,12,2011,51927,51927,56359,56359,1,4432,4432,0.078638727,0.078638727
FALSE,Washington County,12/1/12,Hide,Hide,12,2012,54474,54474,58122,58122,1,3648,3648,0.06276453,0.06276453
FALSE,Washington County,12/1/13,Hide,Hide,12,2013,57563,57563,60451,60451,1,2888,2888,0.04777423,0.04777423
FALSE,Washington County,12/1/14,Hide,Hide,12,2014,59765,59765,62425,62425,1,2660,2660,0.042611133,0.042611133
FALSE,Washington County,12/1/15,Hide,Hide,12,2015,62438,62438,65044,65044,1,2606,2606,0.040065187,0.040065187
FALSE,Washington County,12/1/16,Hide,Hide,12,2016,66449,66449,68892,68892,1,2443,2443,0.035461302,0.035461302
FALSE,Washington County,12/1/17,Hide,Hide,12,2017,69926,69926,72380,72380,1,2454,2454,0.033904393,0.033904393
FALSE,Washington County,12/1/18,Hide,Hide,12,2018,72583,72583,75048,75048,1,2465,2465,0.032845645,0.032845645
FALSE,Washington County,12/1/19,Hide,Hide,12,2019,75004,75004,77197,77197,1,2193,2193,0.02840784,0.02840784
FALSE,Wayne County,12/1/92,Hide,Hide,12,1992,981,981,1069,1069,1,88,88,0.082319925,0.082319925
FALSE,Wayne County,12/1/93,Hide,Hide,12,1993,1048,1048,1131,1131,1,83,83,0.073386384,0.073386384
FALSE,Wayne County,12/1/94,Hide,Hide,12,1994,1124,1124,1206,1206,1,82,82,0.067993367,0.067993367
FALSE,Wayne County,12/1/95,Hide,Hide,12,1995,1252,1252,1329,1329,1,77,77,0.057938299,0.057938299
FALSE,Wayne County,12/1/96,Hide,Hide,12,1996,1278,1278,1351,1351,1,73,73,0.054034049,0.054034049
FALSE,Wayne County,12/1/97,Hide,Hide,12,1997,1419,1419,1494,1494,1,75,75,0.050200803,0.050200803
FALSE,Wayne County,12/1/98,Hide,Hide,12,1998,1342,1342,1436,1436,1,94,94,0.06545961,0.06545961
FALSE,Wayne County,12/1/99,Hide,Hide,12,1999,1376,1376,1438,1438,1,62,62,0.043115438,0.043115438
FALSE,Wayne County,12/1/00,Hide,Hide,12,2000,1259,1259,1327,1327,1,68,68,0.051243406,0.051243406
FALSE,Wayne County,12/1/01,Hide,Hide,12,2001,1452,1452,1527,1527,1,75,75,0.049115914,0.049115914
FALSE,Wayne County,12/1/02,Hide,Hide,12,2002,1299,1299,1390,1390,1,91,91,0.065467626,0.065467626
FALSE,Wayne County,12/1/03,Hide,Hide,12,2003,1220,1220,1311,1311,1,91,91,0.069412662,0.069412662
FALSE,Wayne County,12/1/04,Hide,Hide,12,2004,1217,1217,1297,1297,1,80,80,0.061680802,0.061680802
FALSE,Wayne County,12/1/05,Hide,Hide,12,2005,1300,1300,1368,1368,1,68,68,0.049707602,0.049707602
FALSE,Wayne County,12/1/06,Hide,Hide,12,2006,1334,1334,1387,1387,1,53,53,0.038211968,0.038211968
FALSE,Wayne County,12/1/07,Hide,Hide,12,2007,1336,1336,1397,1397,1,61,61,0.043664996,0.043664996
FALSE,Wayne County,12/1/08,Hide,Hide,12,2008,1358,1358,1463,1463,1,105,105,0.071770335,0.071770335
FALSE,Wayne County,12/1/09,Hide,Hide,12,2009,1404,1404,1536,1536,1,132,132,0.0859375,0.0859375
FALSE,Wayne County,12/1/10,Hide,Hide,12,2010,1399,1399,1532,1532,1,133,133,0.086814621,0.086814621
FALSE,Wayne County,12/1/11,Hide,Hide,12,2011,1190,1190,1337,1337,1,147,147,0.109947644,0.109947644
FALSE,Wayne County,12/1/12,Hide,Hide,12,2012,1192,1192,1343,1343,1,151,151,0.112434847,0.112434847
FALSE,Wayne County,12/1/13,Hide,Hide,12,2013,1266,1266,1407,1407,1,141,141,0.10021322,0.10021322
FALSE,Wayne County,12/1/14,Hide,Hide,12,2014,1274,1274,1403,1403,1,129,129,0.09194583,0.09194583
FALSE,Wayne County,12/1/15,Hide,Hide,12,2015,1311,1311,1434,1434,1,123,123,0.085774059,0.085774059
FALSE,Wayne County,12/1/16,Hide,Hide,12,2016,1312,1312,1424,1424,1,112,112,0.078651685,0.078651685
FALSE,Wayne County,12/1/17,Hide,Hide,12,2017,1360,1360,1455,1455,1,95,95,0.065292096,0.065292096
FALSE,Wayne County,12/1/18,Hide,Hide,12,2018,1333,1333,1413,1413,1,80,80,0.056617127,0.056617127
FALSE,Wayne County,12/1/19,Hide,Hide,12,2019,1348,1348,1424,1424,1,76,76,0.053370787,0.053370787
FALSE,Weber County,12/1/92,Hide,Hide,12,1992,80292,80292,85270,85270,1,4978,4978,0.058379266,0.058379266
FALSE,Weber County,12/1/93,Hide,Hide,12,1993,85935,85935,90034,90034,1,4099,4099,0.045527245,0.045527245
FALSE,Weber County,12/1/94,Hide,Hide,12,1994,88270,88270,92519,92519,1,4249,4249,0.045925702,0.045925702
FALSE,Weber County,12/1/95,Hide,Hide,12,1995,89705,89705,93551,93551,1,3846,3846,0.041111266,0.041111266
FALSE,Weber County,12/1/96,Hide,Hide,12,1996,93404,93404,97380,97380,1,3976,3976,0.040829739,0.040829739
FALSE,Weber County,12/1/97,Hide,Hide,12,1997,96036,96036,100301,100301,1,4265,4265,0.042522009,0.042522009
FALSE,Weber County,12/1/98,Hide,Hide,12,1998,97671,97671,102291,102291,1,4620,4620,0.045165264,0.045165264
FALSE,Weber County,12/1/99,Hide,Hide,12,1999,97905,97905,101960,101960,1,4055,4055,0.039770498,0.039770498
FALSE,Weber County,12/1/00,Hide,Hide,12,2000,96241,96241,101087,101087,1,4846,4846,0.047938904,0.047938904
FALSE,Weber County,12/1/01,Hide,Hide,12,2001,96497,96497,102544,102544,1,6047,6047,0.058969808,0.058969808
FALSE,Weber County,12/1/02,Hide,Hide,12,2002,97864,97864,104666,104666,1,6802,6802,0.064987675,0.064987675
FALSE,Weber County,12/1/03,Hide,Hide,12,2003,99925,99925,106356,106356,1,6431,6431,0.060466734,0.060466734
FALSE,Weber County,12/1/04,Hide,Hide,12,2004,102185,102185,107642,107642,1,5457,5457,0.050695825,0.050695825
FALSE,Weber County,12/1/05,Hide,Hide,12,2005,104421,104421,109079,109079,1,4658,4658,0.042702995,0.042702995
FALSE,Weber County,12/1/06,Hide,Hide,12,2006,107882,107882,110949,110949,1,3067,3067,0.027643332,0.027643332
FALSE,Weber County,12/1/07,Hide,Hide,12,2007,109725,109725,113594,113594,1,3869,3869,0.034059898,0.034059898
FALSE,Weber County,12/1/08,Hide,Hide,12,2008,107663,107663,114909,114909,1,7246,7246,0.063058594,0.063058594
FALSE,Weber County,12/1/09,Hide,Hide,12,2009,103451,103451,113507,113507,1,10056,10056,0.088593655,0.088593655
FALSE,Weber County,12/1/10,Hide,Hide,12,2010,102913,102913,112572,112572,1,9659,9659,0.085802864,0.085802864
FALSE,Weber County,12/1/11,Hide,Hide,12,2011,104639,104639,112575,112575,1,7936,7936,0.070495225,0.070495225
FALSE,Weber County,12/1/12,Hide,Hide,12,2012,107236,107236,113916,113916,1,6680,6680,0.058639699,0.058639699
FALSE,Weber County,12/1/13,Hide,Hide,12,2013,109232,109232,114847,114847,1,5615,5615,0.048891133,0.048891133
FALSE,Weber County,12/1/14,Hide,Hide,12,2014,110903,110903,115745,115745,1,4842,4842,0.041833341,0.041833341
FALSE,Weber County,12/1/15,Hide,Hide,12,2015,113555,113555,118359,118359,1,4804,4804,0.040588379,0.040588379
FALSE,Weber County,12/1/16,Hide,Hide,12,2016,117386,117386,121877,121877,1,4491,4491,0.036848626,0.036848626
FALSE,Weber County,12/1/17,Hide,Hide,12,2017,119584,119584,124064,124064,1,4480,4480,0.036110395,0.036110395
FALSE,Weber County,12/1/18,Hide,Hide,12,2018,121647,121647,125921,125921,1,4274,4274,0.033941916,0.033941916
FALSE,Weber County,12/1/19,Hide,Hide,12,2019,125525,125525,128662,128662,1,3137,3137,0.024381713,0.024381713
FALSE,Beaver County,2/1/93,Hide,Hide,2,1993,1989,1989,2084,2084,1,95,95,0.045585413,0.045585413
FALSE,Beaver County,2/1/94,Hide,Hide,2,1994,2046,2046,2137,2137,1,91,91,0.04258306,0.04258306
FALSE,Beaver County,2/1/95,Hide,Hide,2,1995,2203,2203,2278,2278,1,75,75,0.032923617,0.032923617
FALSE,Beaver County,2/1/96,Hide,Hide,2,1996,2352,2352,2478,2478,1,126,126,0.050847458,0.050847458
FALSE,Beaver County,2/1/97,Hide,Hide,2,1997,2441,2441,2583,2583,1,142,142,0.054974835,0.054974835
FALSE,Beaver County,2/1/98,Hide,Hide,2,1998,2406,2406,2520,2520,1,114,114,0.045238095,0.045238095
FALSE,Beaver County,2/1/99,Hide,Hide,2,1999,2384,2384,2475,2475,1,91,91,0.036767677,0.036767677
FALSE,Beaver County,2/1/00,Hide,Hide,2,2000,2566,2566,2653,2653,1,87,87,0.032793064,0.032793064
FALSE,Beaver County,2/1/01,Hide,Hide,2,2001,2615,2615,2719,2719,1,104,104,0.038249356,0.038249356
FALSE,Beaver County,2/1/02,Hide,Hide,2,2002,3026,3026,3157,3157,1,131,131,0.04149509,0.04149509
FALSE,Beaver County,2/1/03,Hide,Hide,2,2003,2865,2865,3023,3023,1,158,158,0.052265961,0.052265961
FALSE,Beaver County,2/1/04,Hide,Hide,2,2004,2940,2940,3082,3082,1,142,142,0.046073978,0.046073978
FALSE,Beaver County,2/1/05,Hide,Hide,2,2005,2861,2861,2989,2989,1,128,128,0.042823687,0.042823687
FALSE,Beaver County,2/1/06,Hide,Hide,2,2006,2953,2953,3063,3063,1,110,110,0.035912504,0.035912504
FALSE,Beaver County,2/1/07,Hide,Hide,2,2007,3155,3155,3228,3228,1,73,73,0.022614622,0.022614622
FALSE,Beaver County,2/1/08,Hide,Hide,2,2008,2986,2986,3069,3069,1,83,83,0.02704464,0.02704464
FALSE,Beaver County,2/1/09,Hide,Hide,2,2009,3227,3227,3424,3424,1,197,197,0.057535047,0.057535047
FALSE,Beaver County,2/1/10,Hide,Hide,2,2010,2868,2868,3168,3168,1,300,300,0.09469697,0.09469697
FALSE,Beaver County,2/1/11,Hide,Hide,2,2011,2816,2816,3087,3087,1,271,271,0.087787496,0.087787496
FALSE,Beaver County,2/1/12,Hide,Hide,2,2012,2723,2723,2921,2921,1,198,198,0.067785005,0.067785005
FALSE,Beaver County,2/1/13,Hide,Hide,2,2013,2878,2878,3030,3030,1,152,152,0.050165017,0.050165017
FALSE,Beaver County,2/1/14,Hide,Hide,2,2014,2911,2911,3040,3040,1,129,129,0.042434211,0.042434211
FALSE,Beaver County,2/1/15,Hide,Hide,2,2015,3044,3044,3158,3158,1,114,114,0.036098797,0.036098797
FALSE,Beaver County,2/1/16,Hide,Hide,2,2016,2984,2984,3106,3106,1,122,122,0.039278815,0.039278815
FALSE,Beaver County,2/1/17,Hide,Hide,2,2017,2907,2907,3054,3054,1,147,147,0.048133595,0.048133595
FALSE,Beaver County,2/1/18,Hide,Hide,2,2018,2914,2914,3027,3027,1,113,113,0.03733069,0.03733069
FALSE,Beaver County,2/1/19,Hide,Hide,2,2019,2821,2821,2911,2911,1,90,90,0.030917211,0.030917211
FALSE,Beaver County,2/1/20,Hide,Hide,2,2020,2707,2707,2793,2793,1,86,86,0.030791264,0.030791264
FALSE,Box Elder County,2/1/93,Hide,Hide,2,1993,15828,15828,16751,16751,1,923,923,0.055101188,0.055101188
FALSE,Box Elder County,2/1/94,Hide,Hide,2,1994,16899,16899,17797,17797,1,898,898,0.050457942,0.050457942
FALSE,Box Elder County,2/1/95,Hide,Hide,2,1995,17281,17281,18127,18127,1,846,846,0.046670712,0.046670712
FALSE,Box Elder County,2/1/96,Hide,Hide,2,1996,17028,17028,17832,17832,1,804,804,0.045087483,0.045087483
FALSE,Box Elder County,2/1/97,Hide,Hide,2,1997,17714,17714,18413,18413,1,699,699,0.037962309,0.037962309
FALSE,Box Elder County,2/1/98,Hide,Hide,2,1998,18296,18296,19126,19126,1,830,830,0.043396424,0.043396424
FALSE,Box Elder County,2/1/99,Hide,Hide,2,1999,17820,17820,18667,18667,1,847,847,0.04537419,0.04537419
FALSE,Box Elder County,2/1/00,Hide,Hide,2,2000,18745,18745,19467,19467,1,722,722,0.037088406,0.037088406
FALSE,Box Elder County,2/1/01,Hide,Hide,2,2001,19235,19235,20117,20117,1,882,882,0.043843515,0.043843515
FALSE,Box Elder County,2/1/02,Hide,Hide,2,2002,19926,19926,21066,21066,1,1140,1140,0.054115637,0.054115637
FALSE,Box Elder County,2/1/03,Hide,Hide,2,2003,19901,19901,21103,21103,1,1202,1202,0.056958726,0.056958726
FALSE,Box Elder County,2/1/04,Hide,Hide,2,2004,20898,20898,22033,22033,1,1135,1135,0.051513639,0.051513639
FALSE,Box Elder County,2/1/05,Hide,Hide,2,2005,20958,20958,21986,21986,1,1028,1028,0.046757027,0.046757027
FALSE,Box Elder County,2/1/06,Hide,Hide,2,2006,21866,21866,22689,22689,1,823,823,0.036273084,0.036273084
FALSE,Box Elder County,2/1/07,Hide,Hide,2,2007,22745,22745,23338,23338,1,593,593,0.025409204,0.025409204
FALSE,Box Elder County,2/1/08,Hide,Hide,2,2008,23006,23006,23712,23712,1,706,706,0.029773954,0.029773954
FALSE,Box Elder County,2/1/09,Hide,Hide,2,2009,21642,21642,23434,23434,1,1792,1792,0.076470086,0.076470086
FALSE,Box Elder County,2/1/10,Hide,Hide,2,2010,21469,21469,23417,23417,1,1948,1948,0.083187428,0.083187428
FALSE,Box Elder County,2/1/11,Hide,Hide,2,2011,21315,21315,23247,23247,1,1932,1932,0.083107498,0.083107498
FALSE,Box Elder County,2/1/12,Hide,Hide,2,2012,21541,21541,22942,22942,1,1401,1401,0.061067039,0.061067039
FALSE,Box Elder County,2/1/13,Hide,Hide,2,2013,21988,21988,23159,23159,1,1171,1171,0.050563496,0.050563496
FALSE,Box Elder County,2/1/14,Hide,Hide,2,2014,22449,22449,23385,23385,1,936,936,0.040025657,0.040025657
FALSE,Box Elder County,2/1/15,Hide,Hide,2,2015,22986,22986,23885,23885,1,899,899,0.037638685,0.037638685
FALSE,Box Elder County,2/1/16,Hide,Hide,2,2016,23461,23461,24350,24350,1,889,889,0.03650924,0.03650924
FALSE,Box Elder County,2/1/17,Hide,Hide,2,2017,24294,24294,25144,25144,1,850,850,0.033805282,0.033805282
FALSE,Box Elder County,2/1/18,Hide,Hide,2,2018,24674,24674,25428,25428,1,754,754,0.029652352,0.029652352
FALSE,Box Elder County,2/1/19,Hide,Hide,2,2019,24942,24942,25670,25670,1,728,728,0.028359953,0.028359953
FALSE,Box Elder County,2/1/20,Hide,Hide,2,2020,25449,25449,26191,26191,1,742,742,0.028330342,0.028330342
FALSE,Cache County,2/1/93,Hide,Hide,2,1993,36368,36368,37631,37631,1,1263,1263,0.033562754,0.033562754
FALSE,Cache County,2/1/94,Hide,Hide,2,1994,38805,38805,39953,39953,1,1148,1148,0.028733762,0.028733762
FALSE,Cache County,2/1/95,Hide,Hide,2,1995,40029,40029,41331,41331,1,1302,1302,0.031501778,0.031501778
FALSE,Cache County,2/1/96,Hide,Hide,2,1996,40758,40758,42000,42000,1,1242,1242,0.029571429,0.029571429
FALSE,Cache County,2/1/97,Hide,Hide,2,1997,41660,41660,42844,42844,1,1184,1184,0.027635141,0.027635141
FALSE,Cache County,2/1/98,Hide,Hide,2,1998,43051,43051,44312,44312,1,1261,1261,0.028457303,0.028457303
FALSE,Cache County,2/1/99,Hide,Hide,2,1999,43529,43529,44703,44703,1,1174,1174,0.02626222,0.02626222
FALSE,Cache County,2/1/00,Hide,Hide,2,2000,46006,46006,47257,47257,1,1251,1251,0.026472269,0.026472269
FALSE,Cache County,2/1/01,Hide,Hide,2,2001,47265,47265,48833,48833,1,1568,1568,0.032109434,0.032109434
FALSE,Cache County,2/1/02,Hide,Hide,2,2002,49673,49673,51733,51733,1,2060,2060,0.039819844,0.039819844
FALSE,Cache County,2/1/03,Hide,Hide,2,2003,51118,51118,53338,53338,1,2220,2220,0.041621358,0.041621358
FALSE,Cache County,2/1/04,Hide,Hide,2,2004,53456,53456,55506,55506,1,2050,2050,0.036932944,0.036932944
FALSE,Cache County,2/1/05,Hide,Hide,2,2005,55083,55083,56971,56971,1,1888,1888,0.033139668,0.033139668
FALSE,Cache County,2/1/06,Hide,Hide,2,2006,55928,55928,57480,57480,1,1552,1552,0.027000696,0.027000696
FALSE,Cache County,2/1/07,Hide,Hide,2,2007,58742,58742,59849,59849,1,1107,1107,0.01849655,0.01849655
FALSE,Cache County,2/1/08,Hide,Hide,2,2008,60284,60284,61729,61729,1,1445,1445,0.023408771,0.023408771
FALSE,Cache County,2/1/09,Hide,Hide,2,2009,58928,58928,62015,62015,1,3087,3087,0.049778279,0.049778279
FALSE,Cache County,2/1/10,Hide,Hide,2,2010,54769,54769,58217,58217,1,3448,3448,0.059226686,0.059226686
FALSE,Cache County,2/1/11,Hide,Hide,2,2011,53977,53977,57204,57204,1,3227,3227,0.056412139,0.056412139
FALSE,Cache County,2/1/12,Hide,Hide,2,2012,54218,54218,56877,56877,1,2659,2659,0.046750004,0.046750004
FALSE,Cache County,2/1/13,Hide,Hide,2,2013,55210,55210,57630,57630,1,2420,2420,0.041992018,0.041992018
FALSE,Cache County,2/1/14,Hide,Hide,2,2014,56563,56563,58516,58516,1,1953,1953,0.033375487,0.033375487
FALSE,Cache County,2/1/15,Hide,Hide,2,2015,57720,57720,59494,59494,1,1774,1774,0.029818133,0.029818133
FALSE,Cache County,2/1/16,Hide,Hide,2,2016,58812,58812,60745,60745,1,1933,1933,0.031821549,0.031821549
FALSE,Cache County,2/1/17,Hide,Hide,2,2017,60381,60381,62176,62176,1,1795,1795,0.02886966,0.02886966
FALSE,Cache County,2/1/18,Hide,Hide,2,2018,61267,61267,62919,62919,1,1652,1652,0.02625598,0.02625598
FALSE,Cache County,2/1/19,Hide,Hide,2,2019,62496,62496,64021,64021,1,1525,1525,0.023820309,0.023820309
FALSE,Cache County,2/1/20,Hide,Hide,2,2020,62914,62914,64424,64424,1,1510,1510,0.02343847,0.02343847
FALSE,Carbon County,2/1/93,Hide,Hide,2,1993,8152,8152,8902,8902,1,750,750,0.08425073,0.08425073
FALSE,Carbon County,2/1/94,Hide,Hide,2,1994,8678,8678,9362,9362,1,684,684,0.073061312,0.073061312
FALSE,Carbon County,2/1/95,Hide,Hide,2,1995,8579,8579,9192,9192,1,613,613,0.066688425,0.066688425
FALSE,Carbon County,2/1/96,Hide,Hide,2,1996,8683,8683,9251,9251,1,568,568,0.061398768,0.061398768
FALSE,Carbon County,2/1/97,Hide,Hide,2,1997,9114,9114,9626,9626,1,512,512,0.053189279,0.053189279
FALSE,Carbon County,2/1/98,Hide,Hide,2,1998,9234,9234,9755,9755,1,521,521,0.053408508,0.053408508
FALSE,Carbon County,2/1/99,Hide,Hide,2,1999,9240,9240,9977,9977,1,737,737,0.073869901,0.073869901
FALSE,Carbon County,2/1/00,Hide,Hide,2,2000,9085,9085,9549,9549,1,464,464,0.048591476,0.048591476
FALSE,Carbon County,2/1/01,Hide,Hide,2,2001,8374,8374,8972,8972,1,598,598,0.066651806,0.066651806
FALSE,Carbon County,2/1/02,Hide,Hide,2,2002,8744,8744,9346,9346,1,602,602,0.064412583,0.064412583
FALSE,Carbon County,2/1/03,Hide,Hide,2,2003,8726,8726,9461,9461,1,735,735,0.077687348,0.077687348
FALSE,Carbon County,2/1/04,Hide,Hide,2,2004,8602,8602,9274,9274,1,672,672,0.072460643,0.072460643
FALSE,Carbon County,2/1/05,Hide,Hide,2,2005,8847,8847,9355,9355,1,508,508,0.054302512,0.054302512
FALSE,Carbon County,2/1/06,Hide,Hide,2,2006,9357,9357,9748,9748,1,391,391,0.040110792,0.040110792
FALSE,Carbon County,2/1/07,Hide,Hide,2,2007,9467,9467,9771,9771,1,304,304,0.031112476,0.031112476
FALSE,Carbon County,2/1/08,Hide,Hide,2,2008,9404,9404,9800,9800,1,396,396,0.040408163,0.040408163
FALSE,Carbon County,2/1/09,Hide,Hide,2,2009,9943,9943,10618,10618,1,675,675,0.063571294,0.063571294
FALSE,Carbon County,2/1/10,Hide,Hide,2,2010,9095,9095,9985,9985,1,890,890,0.089133701,0.089133701
FALSE,Carbon County,2/1/11,Hide,Hide,2,2011,8927,8927,9706,9706,1,779,779,0.080259633,0.080259633
FALSE,Carbon County,2/1/12,Hide,Hide,2,2012,8769,8769,9431,9431,1,662,662,0.070194041,0.070194041
FALSE,Carbon County,2/1/13,Hide,Hide,2,2013,8429,8429,9041,9041,1,612,612,0.067691627,0.067691627
FALSE,Carbon County,2/1/14,Hide,Hide,2,2014,8271,8271,8735,8735,1,464,464,0.053119634,0.053119634
FALSE,Carbon County,2/1/15,Hide,Hide,2,2015,8308,8308,8756,8756,1,448,448,0.051164915,0.051164915
FALSE,Carbon County,2/1/16,Hide,Hide,2,2016,7968,7968,8498,8498,1,530,530,0.062367616,0.062367616
FALSE,Carbon County,2/1/17,Hide,Hide,2,2017,7823,7823,8270,8270,1,447,447,0.054050786,0.054050786
FALSE,Carbon County,2/1/18,Hide,Hide,2,2018,8020,8020,8411,8411,1,391,391,0.046486744,0.046486744
FALSE,Carbon County,2/1/19,Hide,Hide,2,2019,8096,8096,8433,8433,1,337,337,0.039962054,0.039962054
FALSE,Carbon County,2/1/20,Hide,Hide,2,2020,8223,8223,8577,8577,1,354,354,0.041273172,0.041273172
FALSE,Daggett County,2/1/93,Hide,Hide,2,1993,382,382,400,400,1,18,18,0.045,0.045
FALSE,Daggett County,2/1/94,Hide,Hide,2,1994,432,432,446,446,1,14,14,0.031390135,0.031390135
FALSE,Daggett County,2/1/95,Hide,Hide,2,1995,422,422,461,461,1,39,39,0.084598698,0.084598698
FALSE,Daggett County,2/1/96,Hide,Hide,2,1996,400,400,415,415,1,15,15,0.036144578,0.036144578
FALSE,Daggett County,2/1/97,Hide,Hide,2,1997,394,394,410,410,1,16,16,0.03902439,0.03902439
FALSE,Daggett County,2/1/98,Hide,Hide,2,1998,406,406,424,424,1,18,18,0.04245283,0.04245283
FALSE,Daggett County,2/1/99,Hide,Hide,2,1999,412,412,428,428,1,16,16,0.037383178,0.037383178
FALSE,Daggett County,2/1/00,Hide,Hide,2,2000,441,441,456,456,1,15,15,0.032894737,0.032894737
FALSE,Daggett County,2/1/01,Hide,Hide,2,2001,417,417,440,440,1,23,23,0.052272727,0.052272727
FALSE,Daggett County,2/1/02,Hide,Hide,2,2002,498,498,521,521,1,23,23,0.044145873,0.044145873
FALSE,Daggett County,2/1/03,Hide,Hide,2,2003,467,467,493,493,1,26,26,0.052738337,0.052738337
FALSE,Daggett County,2/1/04,Hide,Hide,2,2004,486,486,512,512,1,26,26,0.05078125,0.05078125
FALSE,Daggett County,2/1/05,Hide,Hide,2,2005,452,452,476,476,1,24,24,0.050420168,0.050420168
FALSE,Daggett County,2/1/06,Hide,Hide,2,2006,488,488,517,517,1,29,29,0.056092843,0.056092843
FALSE,Daggett County,2/1/07,Hide,Hide,2,2007,487,487,505,505,1,18,18,0.035643564,0.035643564
FALSE,Daggett County,2/1/08,Hide,Hide,2,2008,474,474,492,492,1,18,18,0.036585366,0.036585366
FALSE,Daggett County,2/1/09,Hide,Hide,2,2009,433,433,457,457,1,24,24,0.052516411,0.052516411
FALSE,Daggett County,2/1/10,Hide,Hide,2,2010,460,460,495,495,1,35,35,0.070707071,0.070707071
FALSE,Daggett County,2/1/11,Hide,Hide,2,2011,439,439,470,470,1,31,31,0.065957447,0.065957447
FALSE,Daggett County,2/1/12,Hide,Hide,2,2012,421,421,443,443,1,22,22,0.0496614,0.0496614
FALSE,Daggett County,2/1/13,Hide,Hide,2,2013,415,415,437,437,1,22,22,0.050343249,0.050343249
FALSE,Daggett County,2/1/14,Hide,Hide,2,2014,419,419,436,436,1,17,17,0.038990826,0.038990826
FALSE,Daggett County,2/1/15,Hide,Hide,2,2015,449,449,470,470,1,21,21,0.044680851,0.044680851
FALSE,Daggett County,2/1/16,Hide,Hide,2,2016,452,452,477,477,1,25,25,0.052410901,0.052410901
FALSE,Daggett County,2/1/17,Hide,Hide,2,2017,415,415,433,433,1,18,18,0.041570439,0.041570439
FALSE,Daggett County,2/1/18,Hide,Hide,2,2018,387,387,404,404,1,17,17,0.042079208,0.042079208
FALSE,Daggett County,2/1/19,Hide,Hide,2,2019,373,373,391,391,1,18,18,0.046035806,0.046035806
FALSE,Daggett County,2/1/20,Hide,Hide,2,2020,372,372,386,386,1,14,14,0.03626943,0.03626943
FALSE,Davis County,2/1/93,Hide,Hide,2,1993,93909,93909,97817,97817,1,3908,3908,0.039952156,0.039952156
FALSE,Davis County,2/1/94,Hide,Hide,2,1994,100835,100835,104305,104305,1,3470,3470,0.03326782,0.03326782
FALSE,Davis County,2/1/95,Hide,Hide,2,1995,101812,101812,105638,105638,1,3826,3826,0.036218028,0.036218028
FALSE,Davis County,2/1/96,Hide,Hide,2,1996,105872,105872,109302,109302,1,3430,3430,0.031380945,0.031380945
FALSE,Davis County,2/1/97,Hide,Hide,2,1997,110739,110739,114211,114211,1,3472,3472,0.030399874,0.030399874
FALSE,Davis County,2/1/98,Hide,Hide,2,1998,115281,115281,119160,119160,1,3879,3879,0.03255287,0.03255287
FALSE,Davis County,2/1/99,Hide,Hide,2,1999,119668,119668,123667,123667,1,3999,3999,0.03233684,0.03233684
FALSE,Davis County,2/1/00,Hide,Hide,2,2000,117610,117610,121151,121151,1,3541,3541,0.029227988,0.029227988
FALSE,Davis County,2/1/01,Hide,Hide,2,2001,116886,116886,121508,121508,1,4622,4622,0.038038648,0.038038648
FALSE,Davis County,2/1/02,Hide,Hide,2,2002,117684,117684,123588,123588,1,5904,5904,0.047771628,0.047771628
FALSE,Davis County,2/1/03,Hide,Hide,2,2003,120693,120693,127312,127312,1,6619,6619,0.051990386,0.051990386
FALSE,Davis County,2/1/04,Hide,Hide,2,2004,124458,124458,130985,130985,1,6527,6527,0.049830133,0.049830133
FALSE,Davis County,2/1/05,Hide,Hide,2,2005,128545,128545,134076,134076,1,5531,5531,0.041252722,0.041252722
FALSE,Davis County,2/1/06,Hide,Hide,2,2006,134547,134547,139168,139168,1,4621,4621,0.033204472,0.033204472
FALSE,Davis County,2/1/07,Hide,Hide,2,2007,139836,139836,143115,143115,1,3279,3279,0.022911644,0.022911644
FALSE,Davis County,2/1/08,Hide,Hide,2,2008,141385,141385,145599,145599,1,4214,4214,0.028942506,0.028942506
FALSE,Davis County,2/1/09,Hide,Hide,2,2009,137049,137049,145352,145352,1,8303,8303,0.057123397,0.057123397
FALSE,Davis County,2/1/10,Hide,Hide,2,2010,136023,136023,146319,146319,1,10296,10296,0.070366801,0.070366801
FALSE,Davis County,2/1/11,Hide,Hide,2,2011,136820,136820,146370,146370,1,9550,9550,0.06524561,0.06524561
FALSE,Davis County,2/1/12,Hide,Hide,2,2012,139726,139726,147413,147413,1,7687,7687,0.052146012,0.052146012
FALSE,Davis County,2/1/13,Hide,Hide,2,2013,144415,144415,151209,151209,1,6794,6794,0.044931188,0.044931188
FALSE,Davis County,2/1/14,Hide,Hide,2,2014,148864,148864,154657,154657,1,5793,5793,0.037457082,0.037457082
FALSE,Davis County,2/1/15,Hide,Hide,2,2015,152891,152891,158217,158217,1,5326,5326,0.033662628,0.033662628
FALSE,Davis County,2/1/16,Hide,Hide,2,2016,156753,156753,162148,162148,1,5395,5395,0.033272072,0.033272072
FALSE,Davis County,2/1/17,Hide,Hide,2,2017,162309,162309,167448,167448,1,5139,5139,0.030690125,0.030690125
FALSE,Davis County,2/1/18,Hide,Hide,2,2018,164564,164564,169541,169541,1,4977,4977,0.029355731,0.029355731
FALSE,Davis County,2/1/19,Hide,Hide,2,2019,167527,167527,172057,172057,1,4530,4530,0.026328484,0.026328484
FALSE,Davis County,2/1/20,Hide,Hide,2,2020,171298,171298,176174,176174,1,4876,4876,0.027677183,0.027677183
FALSE,Duchesne County,2/1/93,Hide,Hide,2,1993,5057,5057,5554,5554,1,497,497,0.089485056,0.089485056
FALSE,Duchesne County,2/1/94,Hide,Hide,2,1994,5188,5188,5761,5761,1,573,573,0.099461899,0.099461899
FALSE,Duchesne County,2/1/95,Hide,Hide,2,1995,5374,5374,5898,5898,1,524,524,0.088843676,0.088843676
FALSE,Duchesne County,2/1/96,Hide,Hide,2,1996,5261,5261,5759,5759,1,498,498,0.086473346,0.086473346
FALSE,Duchesne County,2/1/97,Hide,Hide,2,1997,5423,5423,5842,5842,1,419,419,0.071722013,0.071722013
FALSE,Duchesne County,2/1/98,Hide,Hide,2,1998,5775,5775,6150,6150,1,375,375,0.06097561,0.06097561
FALSE,Duchesne County,2/1/99,Hide,Hide,2,1999,5495,5495,6118,6118,1,623,623,0.101830664,0.101830664
FALSE,Duchesne County,2/1/00,Hide,Hide,2,2000,5627,5627,5924,5924,1,297,297,0.050135044,0.050135044
FALSE,Duchesne County,2/1/01,Hide,Hide,2,2001,6097,6097,6425,6425,1,328,328,0.051050584,0.051050584
FALSE,Duchesne County,2/1/02,Hide,Hide,2,2002,6555,6555,7003,7003,1,448,448,0.063972583,0.063972583
FALSE,Duchesne County,2/1/03,Hide,Hide,2,2003,6500,6500,6981,6981,1,481,481,0.068901304,0.068901304
FALSE,Duchesne County,2/1/04,Hide,Hide,2,2004,6687,6687,7121,7121,1,434,434,0.060946496,0.060946496
FALSE,Duchesne County,2/1/05,Hide,Hide,2,2005,7082,7082,7427,7427,1,345,345,0.046452134,0.046452134
FALSE,Duchesne County,2/1/06,Hide,Hide,2,2006,7777,7777,8054,8054,1,277,277,0.034392848,0.034392848
FALSE,Duchesne County,2/1/07,Hide,Hide,2,2007,8916,8916,9107,9107,1,191,191,0.020972878,0.020972878
FALSE,Duchesne County,2/1/08,Hide,Hide,2,2008,9474,9474,9726,9726,1,252,252,0.025909932,0.025909932
FALSE,Duchesne County,2/1/09,Hide,Hide,2,2009,10228,10228,10880,10880,1,652,652,0.059926471,0.059926471
FALSE,Duchesne County,2/1/10,Hide,Hide,2,2010,7667,7667,8516,8516,1,849,849,0.099694692,0.099694692
FALSE,Duchesne County,2/1/11,Hide,Hide,2,2011,7612,7612,8237,8237,1,625,625,0.07587714,0.07587714
FALSE,Duchesne County,2/1/12,Hide,Hide,2,2012,8540,8540,8986,8986,1,446,446,0.049632762,0.049632762
FALSE,Duchesne County,2/1/13,Hide,Hide,2,2013,8821,8821,9240,9240,1,419,419,0.04534632,0.04534632
FALSE,Duchesne County,2/1/14,Hide,Hide,2,2014,9216,9216,9568,9568,1,352,352,0.036789298,0.036789298
FALSE,Duchesne County,2/1/15,Hide,Hide,2,2015,8786,8786,9312,9312,1,526,526,0.056486254,0.056486254
FALSE,Duchesne County,2/1/16,Hide,Hide,2,2016,7484,7484,8283,8283,1,799,799,0.096462634,0.096462634
FALSE,Duchesne County,2/1/17,Hide,Hide,2,2017,7456,7456,7999,7999,1,543,543,0.067883485,0.067883485
FALSE,Duchesne County,2/1/18,Hide,Hide,2,2018,7441,7441,7795,7795,1,354,354,0.045413727,0.045413727
FALSE,Duchesne County,2/1/19,Hide,Hide,2,2019,7407,7407,7716,7716,1,309,309,0.040046656,0.040046656
FALSE,Duchesne County,2/1/20,Hide,Hide,2,2020,7453,7453,7843,7843,1,390,390,0.04972587,0.04972587
FALSE,Emery County,2/1/93,Hide,Hide,2,1993,3819,3819,4175,4175,1,356,356,0.085269461,0.085269461
FALSE,Emery County,2/1/94,Hide,Hide,2,1994,3883,3883,4217,4217,1,334,334,0.079203225,0.079203225
FALSE,Emery County,2/1/95,Hide,Hide,2,1995,3915,3915,4259,4259,1,344,344,0.080770134,0.080770134
FALSE,Emery County,2/1/96,Hide,Hide,2,1996,3932,3932,4245,4245,1,313,313,0.073733804,0.073733804
FALSE,Emery County,2/1/97,Hide,Hide,2,1997,3885,3885,4184,4184,1,299,299,0.071462715,0.071462715
FALSE,Emery County,2/1/98,Hide,Hide,2,1998,3885,3885,4185,4185,1,300,300,0.071684588,0.071684588
FALSE,Emery County,2/1/99,Hide,Hide,2,1999,3790,3790,4088,4088,1,298,298,0.072896282,0.072896282
FALSE,Emery County,2/1/00,Hide,Hide,2,2000,4351,4351,4561,4561,1,210,210,0.046042535,0.046042535
FALSE,Emery County,2/1/01,Hide,Hide,2,2001,4364,4364,4652,4652,1,288,288,0.061908856,0.061908856
FALSE,Emery County,2/1/02,Hide,Hide,2,2002,4419,4419,4750,4750,1,331,331,0.069684211,0.069684211
FALSE,Emery County,2/1/03,Hide,Hide,2,2003,4532,4532,4917,4917,1,385,385,0.078299776,0.078299776
FALSE,Emery County,2/1/04,Hide,Hide,2,2004,4696,4696,5085,5085,1,389,389,0.076499508,0.076499508
FALSE,Emery County,2/1/05,Hide,Hide,2,2005,4724,4724,5009,5009,1,285,285,0.056897584,0.056897584
FALSE,Emery County,2/1/06,Hide,Hide,2,2006,4994,4994,5197,5197,1,203,203,0.039060997,0.039060997
FALSE,Emery County,2/1/07,Hide,Hide,2,2007,5040,5040,5204,5204,1,164,164,0.03151422,0.03151422
FALSE,Emery County,2/1/08,Hide,Hide,2,2008,4946,4946,5126,5126,1,180,180,0.035115099,0.035115099
FALSE,Emery County,2/1/09,Hide,Hide,2,2009,4822,4822,5111,5111,1,289,289,0.056544707,0.056544707
FALSE,Emery County,2/1/10,Hide,Hide,2,2010,4857,4857,5260,5260,1,403,403,0.07661597,0.07661597
FALSE,Emery County,2/1/11,Hide,Hide,2,2011,4768,4768,5147,5147,1,379,379,0.073635127,0.073635127
FALSE,Emery County,2/1/12,Hide,Hide,2,2012,4453,4453,4800,4800,1,347,347,0.072291667,0.072291667
FALSE,Emery County,2/1/13,Hide,Hide,2,2013,4450,4450,4767,4767,1,317,317,0.066498846,0.066498846
FALSE,Emery County,2/1/14,Hide,Hide,2,2014,4408,4408,4669,4669,1,261,261,0.055900621,0.055900621
FALSE,Emery County,2/1/15,Hide,Hide,2,2015,4209,4209,4437,4437,1,228,228,0.051386072,0.051386072
FALSE,Emery County,2/1/16,Hide,Hide,2,2016,4017,4017,4318,4318,1,301,301,0.069708198,0.069708198
FALSE,Emery County,2/1/17,Hide,Hide,2,2017,3942,3942,4171,4171,1,229,229,0.054902901,0.054902901
FALSE,Emery County,2/1/18,Hide,Hide,2,2018,4075,4075,4279,4279,1,204,204,0.04767469,0.04767469
FALSE,Emery County,2/1/19,Hide,Hide,2,2019,4150,4150,4336,4336,1,186,186,0.042896679,0.042896679
FALSE,Emery County,2/1/20,Hide,Hide,2,2020,4139,4139,4335,4335,1,196,196,0.045213379,0.045213379
FALSE,Garfield County,2/1/93,Hide,Hide,2,1993,2063,2063,2314,2314,1,251,251,0.108470182,0.108470182
FALSE,Garfield County,2/1/94,Hide,Hide,2,1994,2226,2226,2472,2472,1,246,246,0.099514563,0.099514563
FALSE,Garfield County,2/1/95,Hide,Hide,2,1995,2250,2250,2589,2589,1,339,339,0.130938586,0.130938586
FALSE,Garfield County,2/1/96,Hide,Hide,2,1996,2391,2391,2646,2646,1,255,255,0.096371882,0.096371882
FALSE,Garfield County,2/1/97,Hide,Hide,2,1997,2481,2481,2729,2729,1,248,248,0.090875779,0.090875779
FALSE,Garfield County,2/1/98,Hide,Hide,2,1998,2542,2542,2771,2771,1,229,229,0.082641646,0.082641646
FALSE,Garfield County,2/1/99,Hide,Hide,2,1999,2575,2575,2816,2816,1,241,241,0.085582386,0.085582386
FALSE,Garfield County,2/1/00,Hide,Hide,2,2000,2438,2438,2608,2608,1,170,170,0.065184049,0.065184049
FALSE,Garfield County,2/1/01,Hide,Hide,2,2001,2357,2357,2552,2552,1,195,195,0.076410658,0.076410658
FALSE,Garfield County,2/1/02,Hide,Hide,2,2002,2368,2368,2611,2611,1,243,243,0.09306779,0.09306779
FALSE,Garfield County,2/1/03,Hide,Hide,2,2003,2331,2331,2559,2559,1,228,228,0.089097304,0.089097304
FALSE,Garfield County,2/1/04,Hide,Hide,2,2004,2425,2425,2628,2628,1,203,203,0.077245053,0.077245053
FALSE,Garfield County,2/1/05,Hide,Hide,2,2005,2471,2471,2670,2670,1,199,199,0.074531835,0.074531835
FALSE,Garfield County,2/1/06,Hide,Hide,2,2006,2518,2518,2671,2671,1,153,153,0.057281917,0.057281917
FALSE,Garfield County,2/1/07,Hide,Hide,2,2007,2616,2616,2727,2727,1,111,111,0.04070407,0.04070407
FALSE,Garfield County,2/1/08,Hide,Hide,2,2008,2593,2593,2754,2754,1,161,161,0.058460421,0.058460421
FALSE,Garfield County,2/1/09,Hide,Hide,2,2009,2622,2622,2894,2894,1,272,272,0.09398756,0.09398756
FALSE,Garfield County,2/1/10,Hide,Hide,2,2010,2697,2697,3012,3012,1,315,315,0.104581673,0.104581673
FALSE,Garfield County,2/1/11,Hide,Hide,2,2011,2693,2693,3005,3005,1,312,312,0.103826955,0.103826955
FALSE,Garfield County,2/1/12,Hide,Hide,2,2012,2573,2573,2843,2843,1,270,270,0.094970102,0.094970102
FALSE,Garfield County,2/1/13,Hide,Hide,2,2013,2570,2570,2823,2823,1,253,253,0.089620971,0.089620971
FALSE,Garfield County,2/1/14,Hide,Hide,2,2014,2486,2486,2727,2727,1,241,241,0.088375504,0.088375504
FALSE,Garfield County,2/1/15,Hide,Hide,2,2015,2553,2553,2796,2796,1,243,243,0.086909871,0.086909871
FALSE,Garfield County,2/1/16,Hide,Hide,2,2016,2510,2510,2757,2757,1,247,247,0.089590134,0.089590134
FALSE,Garfield County,2/1/17,Hide,Hide,2,2017,2642,2642,2858,2858,1,216,216,0.075577327,0.075577327
FALSE,Garfield County,2/1/18,Hide,Hide,2,2018,2599,2599,2827,2827,1,228,228,0.080650867,0.080650867
FALSE,Garfield County,2/1/19,Hide,Hide,2,2019,2586,2586,2769,2769,1,183,183,0.066088841,0.066088841
FALSE,Garfield County,2/1/20,Hide,Hide,2,2020,2611,2611,2802,2802,1,191,191,0.068165596,0.068165596
FALSE,Grand County,2/1/93,Hide,Hide,2,1993,4124,4124,4409,4409,1,285,285,0.064640508,0.064640508
FALSE,Grand County,2/1/94,Hide,Hide,2,1994,4525,4525,4847,4847,1,322,322,0.066432845,0.066432845
FALSE,Grand County,2/1/95,Hide,Hide,2,1995,4512,4512,4845,4845,1,333,333,0.06873065,0.06873065
FALSE,Grand County,2/1/96,Hide,Hide,2,1996,4790,4790,5126,5126,1,336,336,0.065548186,0.065548186
FALSE,Grand County,2/1/97,Hide,Hide,2,1997,4782,4782,5115,5115,1,333,333,0.065102639,0.065102639
FALSE,Grand County,2/1/98,Hide,Hide,2,1998,4860,4860,5230,5230,1,370,370,0.070745698,0.070745698
FALSE,Grand County,2/1/99,Hide,Hide,2,1999,5228,5228,5606,5606,1,378,378,0.067427756,0.067427756
FALSE,Grand County,2/1/00,Hide,Hide,2,2000,4534,4534,4835,4835,1,301,301,0.062254395,0.062254395
FALSE,Grand County,2/1/01,Hide,Hide,2,2001,4352,4352,4666,4666,1,314,314,0.067295328,0.067295328
FALSE,Grand County,2/1/02,Hide,Hide,2,2002,4481,4481,4838,4838,1,357,357,0.073790823,0.073790823
FALSE,Grand County,2/1/03,Hide,Hide,2,2003,4556,4556,4912,4912,1,356,356,0.07247557,0.07247557
FALSE,Grand County,2/1/04,Hide,Hide,2,2004,4447,4447,4804,4804,1,357,357,0.074313072,0.074313072
FALSE,Grand County,2/1/05,Hide,Hide,2,2005,4565,4565,4886,4886,1,321,321,0.065697912,0.065697912
FALSE,Grand County,2/1/06,Hide,Hide,2,2006,4738,4738,5013,5013,1,275,275,0.054857371,0.054857371
FALSE,Grand County,2/1/07,Hide,Hide,2,2007,4978,4978,5195,5195,1,217,217,0.041770934,0.041770934
FALSE,Grand County,2/1/08,Hide,Hide,2,2008,4944,4944,5216,5216,1,272,272,0.052147239,0.052147239
FALSE,Grand County,2/1/09,Hide,Hide,2,2009,4859,4859,5352,5352,1,493,493,0.092115097,0.092115097
FALSE,Grand County,2/1/10,Hide,Hide,2,2010,4820,4820,5362,5362,1,542,542,0.101081686,0.101081686
FALSE,Grand County,2/1/11,Hide,Hide,2,2011,4771,4771,5306,5306,1,535,535,0.10082925,0.10082925
FALSE,Grand County,2/1/12,Hide,Hide,2,2012,4914,4914,5370,5370,1,456,456,0.084916201,0.084916201
FALSE,Grand County,2/1/13,Hide,Hide,2,2013,4997,4997,5430,5430,1,433,433,0.079742173,0.079742173
FALSE,Grand County,2/1/14,Hide,Hide,2,2014,5120,5120,5497,5497,1,377,377,0.068582863,0.068582863
FALSE,Grand County,2/1/15,Hide,Hide,2,2015,5246,5246,5589,5589,1,343,343,0.061370549,0.061370549
FALSE,Grand County,2/1/16,Hide,Hide,2,2016,5347,5347,5683,5683,1,336,336,0.059123702,0.059123702
FALSE,Grand County,2/1/17,Hide,Hide,2,2017,5507,5507,5836,5836,1,329,329,0.056374229,0.056374229
FALSE,Grand County,2/1/18,Hide,Hide,2,2018,5753,5753,6048,6048,1,295,295,0.048776455,0.048776455
FALSE,Grand County,2/1/19,Hide,Hide,2,2019,5836,5836,6090,6090,1,254,254,0.041707718,0.041707718
FALSE,Grand County,2/1/20,Hide,Hide,2,2020,6094,6094,6384,6384,1,290,290,0.045426065,0.045426065
FALSE,Iron County,2/1/93,Hide,Hide,2,1993,10441,10441,10859,10859,1,418,418,0.038493416,0.038493416
FALSE,Iron County,2/1/94,Hide,Hide,2,1994,11356,11356,11786,11786,1,430,430,0.036483964,0.036483964
FALSE,Iron County,2/1/95,Hide,Hide,2,1995,12449,12449,12865,12865,1,416,416,0.032335795,0.032335795
FALSE,Iron County,2/1/96,Hide,Hide,2,1996,12517,12517,13037,13037,1,520,520,0.039886477,0.039886477
FALSE,Iron County,2/1/97,Hide,Hide,2,1997,13596,13596,14057,14057,1,461,461,0.032795049,0.032795049
FALSE,Iron County,2/1/98,Hide,Hide,2,1998,14128,14128,14677,14677,1,549,549,0.037405464,0.037405464
FALSE,Iron County,2/1/99,Hide,Hide,2,1999,14393,14393,14946,14946,1,553,553,0.036999866,0.036999866
FALSE,Iron County,2/1/00,Hide,Hide,2,2000,15819,15819,16319,16319,1,500,500,0.030639132,0.030639132
FALSE,Iron County,2/1/01,Hide,Hide,2,2001,16148,16148,16844,16844,1,696,696,0.041320351,0.041320351
FALSE,Iron County,2/1/02,Hide,Hide,2,2002,16857,16857,17742,17742,1,885,885,0.049881637,0.049881637
FALSE,Iron County,2/1/03,Hide,Hide,2,2003,16770,16770,17739,17739,1,969,969,0.054625402,0.054625402
FALSE,Iron County,2/1/04,Hide,Hide,2,2004,17573,17573,18457,18457,1,884,884,0.047895108,0.047895108
FALSE,Iron County,2/1/05,Hide,Hide,2,2005,18709,18709,19513,19513,1,804,804,0.0412033,0.0412033
FALSE,Iron County,2/1/06,Hide,Hide,2,2006,19758,19758,20417,20417,1,659,659,0.032277024,0.032277024
FALSE,Iron County,2/1/07,Hide,Hide,2,2007,20643,20643,21176,21176,1,533,533,0.025170004,0.025170004
FALSE,Iron County,2/1/08,Hide,Hide,2,2008,20102,20102,20835,20835,1,733,733,0.035181186,0.035181186
FALSE,Iron County,2/1/09,Hide,Hide,2,2009,19414,19414,21089,21089,1,1675,1675,0.079425293,0.079425293
FALSE,Iron County,2/1/10,Hide,Hide,2,2010,18627,18627,20588,20588,1,1961,1961,0.09524966,0.09524966
FALSE,Iron County,2/1/11,Hide,Hide,2,2011,18236,18236,20030,20030,1,1794,1794,0.089565652,0.089565652
FALSE,Iron County,2/1/12,Hide,Hide,2,2012,18161,18161,19554,19554,1,1393,1393,0.071238621,0.071238621
FALSE,Iron County,2/1/13,Hide,Hide,2,2013,18151,18151,19322,19322,1,1171,1171,0.060604492,0.060604492
FALSE,Iron County,2/1/14,Hide,Hide,2,2014,18996,18996,19906,19906,1,910,910,0.04571486,0.04571486
FALSE,Iron County,2/1/15,Hide,Hide,2,2015,19239,19239,20164,20164,1,925,925,0.045873835,0.045873835
FALSE,Iron County,2/1/16,Hide,Hide,2,2016,20042,20042,20945,20945,1,903,903,0.043112915,0.043112915
FALSE,Iron County,2/1/17,Hide,Hide,2,2017,21099,21099,22076,22076,1,977,977,0.044256206,0.044256206
FALSE,Iron County,2/1/18,Hide,Hide,2,2018,21702,21702,22500,22500,1,798,798,0.035466667,0.035466667
FALSE,Iron County,2/1/19,Hide,Hide,2,2019,22807,22807,23564,23564,1,757,757,0.032125276,0.032125276
FALSE,Iron County,2/1/20,Hide,Hide,2,2020,24004,24004,24792,24792,1,788,788,0.031784447,0.031784447
FALSE,Juab County,2/1/93,Hide,Hide,2,1993,2954,2954,3166,3166,1,212,212,0.066961466,0.066961466
FALSE,Juab County,2/1/94,Hide,Hide,2,1994,3150,3150,3297,3297,1,147,147,0.044585987,0.044585987
FALSE,Juab County,2/1/95,Hide,Hide,2,1995,3238,3238,3408,3408,1,170,170,0.049882629,0.049882629
FALSE,Juab County,2/1/96,Hide,Hide,2,1996,3196,3196,3336,3336,1,140,140,0.041966427,0.041966427
FALSE,Juab County,2/1/97,Hide,Hide,2,1997,3325,3325,3465,3465,1,140,140,0.04040404,0.04040404
FALSE,Juab County,2/1/98,Hide,Hide,2,1998,3367,3367,3518,3518,1,151,151,0.042922115,0.042922115
FALSE,Juab County,2/1/99,Hide,Hide,2,1999,3449,3449,3636,3636,1,187,187,0.051430143,0.051430143
FALSE,Juab County,2/1/00,Hide,Hide,2,2000,3536,3536,3664,3664,1,128,128,0.034934498,0.034934498
FALSE,Juab County,2/1/01,Hide,Hide,2,2001,3642,3642,3797,3797,1,155,155,0.040821701,0.040821701
FALSE,Juab County,2/1/02,Hide,Hide,2,2002,3423,3423,3684,3684,1,261,261,0.070846906,0.070846906
FALSE,Juab County,2/1/03,Hide,Hide,2,2003,3404,3404,3674,3674,1,270,270,0.073489385,0.073489385
FALSE,Juab County,2/1/04,Hide,Hide,2,2004,3528,3528,3789,3789,1,261,261,0.06888361,0.06888361
FALSE,Juab County,2/1/05,Hide,Hide,2,2005,3679,3679,3873,3873,1,194,194,0.050090369,0.050090369
FALSE,Juab County,2/1/06,Hide,Hide,2,2006,3828,3828,3987,3987,1,159,159,0.039879609,0.039879609
FALSE,Juab County,2/1/07,Hide,Hide,2,2007,3967,3967,4086,4086,1,119,119,0.029123837,0.029123837
FALSE,Juab County,2/1/08,Hide,Hide,2,2008,3796,3796,3966,3966,1,170,170,0.042864347,0.042864347
FALSE,Juab County,2/1/09,Hide,Hide,2,2009,3631,3631,4007,4007,1,376,376,0.093835787,0.093835787
FALSE,Juab County,2/1/10,Hide,Hide,2,2010,4042,4042,4459,4459,1,417,417,0.093518726,0.093518726
FALSE,Juab County,2/1/11,Hide,Hide,2,2011,4167,4167,4567,4567,1,400,400,0.087584848,0.087584848
FALSE,Juab County,2/1/12,Hide,Hide,2,2012,4251,4251,4548,4548,1,297,297,0.06530343,0.06530343
FALSE,Juab County,2/1/13,Hide,Hide,2,2013,4413,4413,4664,4664,1,251,251,0.053816467,0.053816467
FALSE,Juab County,2/1/14,Hide,Hide,2,2014,4548,4548,4754,4754,1,206,206,0.043331931,0.043331931
FALSE,Juab County,2/1/15,Hide,Hide,2,2015,4672,4672,4866,4866,1,194,194,0.039868475,0.039868475
FALSE,Juab County,2/1/16,Hide,Hide,2,2016,4928,4928,5127,5127,1,199,199,0.038814121,0.038814121
FALSE,Juab County,2/1/17,Hide,Hide,2,2017,5163,5163,5344,5344,1,181,181,0.03386976,0.03386976
FALSE,Juab County,2/1/18,Hide,Hide,2,2018,5368,5368,5537,5537,1,169,169,0.030521943,0.030521943
FALSE,Juab County,2/1/19,Hide,Hide,2,2019,5502,5502,5657,5657,1,155,155,0.027399682,0.027399682
FALSE,Juab County,2/1/20,Hide,Hide,2,2020,5653,5653,5801,5801,1,148,148,0.025512843,0.025512843
FALSE,Kane County,2/1/93,Hide,Hide,2,1993,2463,2463,2648,2648,1,185,185,0.069864048,0.069864048
FALSE,Kane County,2/1/94,Hide,Hide,2,1994,2543,2543,2743,2743,1,200,200,0.072912869,0.072912869
FALSE,Kane County,2/1/95,Hide,Hide,2,1995,2508,2508,2763,2763,1,255,255,0.092290988,0.092290988
FALSE,Kane County,2/1/96,Hide,Hide,2,1996,2398,2398,2567,2567,1,169,169,0.065835606,0.065835606
FALSE,Kane County,2/1/97,Hide,Hide,2,1997,2453,2453,2598,2598,1,145,145,0.055812163,0.055812163
FALSE,Kane County,2/1/98,Hide,Hide,2,1998,2627,2627,2731,2731,1,104,104,0.038081289,0.038081289
FALSE,Kane County,2/1/99,Hide,Hide,2,1999,2690,2690,2808,2808,1,118,118,0.042022792,0.042022792
FALSE,Kane County,2/1/00,Hide,Hide,2,2000,2835,2835,2938,2938,1,103,103,0.035057862,0.035057862
FALSE,Kane County,2/1/01,Hide,Hide,2,2001,2940,2940,3071,3071,1,131,131,0.042657115,0.042657115
FALSE,Kane County,2/1/02,Hide,Hide,2,2002,2897,2897,3040,3040,1,143,143,0.047039474,0.047039474
FALSE,Kane County,2/1/03,Hide,Hide,2,2003,2893,2893,3058,3058,1,165,165,0.053956835,0.053956835
FALSE,Kane County,2/1/04,Hide,Hide,2,2004,3032,3032,3214,3214,1,182,182,0.056627256,0.056627256
FALSE,Kane County,2/1/05,Hide,Hide,2,2005,3020,3020,3189,3189,1,169,169,0.052994669,0.052994669
FALSE,Kane County,2/1/06,Hide,Hide,2,2006,3242,3242,3375,3375,1,133,133,0.039407407,0.039407407
FALSE,Kane County,2/1/07,Hide,Hide,2,2007,3424,3424,3528,3528,1,104,104,0.029478458,0.029478458
FALSE,Kane County,2/1/08,Hide,Hide,2,2008,3310,3310,3427,3427,1,117,117,0.034140648,0.034140648
FALSE,Kane County,2/1/09,Hide,Hide,2,2009,3254,3254,3498,3498,1,244,244,0.069754145,0.069754145
FALSE,Kane County,2/1/10,Hide,Hide,2,2010,3308,3308,3597,3597,1,289,289,0.080344732,0.080344732
FALSE,Kane County,2/1/11,Hide,Hide,2,2011,3242,3242,3513,3513,1,271,271,0.077142044,0.077142044
FALSE,Kane County,2/1/12,Hide,Hide,2,2012,3226,3226,3464,3464,1,238,238,0.068706697,0.068706697
FALSE,Kane County,2/1/13,Hide,Hide,2,2013,3275,3275,3470,3470,1,195,195,0.056195965,0.056195965
FALSE,Kane County,2/1/14,Hide,Hide,2,2014,3351,3351,3528,3528,1,177,177,0.050170068,0.050170068
FALSE,Kane County,2/1/15,Hide,Hide,2,2015,3410,3410,3573,3573,1,163,163,0.045619927,0.045619927
FALSE,Kane County,2/1/16,Hide,Hide,2,2016,3535,3535,3688,3688,1,153,153,0.0414859,0.0414859
FALSE,Kane County,2/1/17,Hide,Hide,2,2017,3598,3598,3726,3726,1,128,128,0.034353194,0.034353194
FALSE,Kane County,2/1/18,Hide,Hide,2,2018,3676,3676,3798,3798,1,122,122,0.03212217,0.03212217
FALSE,Kane County,2/1/19,Hide,Hide,2,2019,3674,3674,3792,3792,1,118,118,0.031118143,0.031118143
FALSE,Kane County,2/1/20,Hide,Hide,2,2020,3727,3727,3845,3845,1,118,118,0.030689207,0.030689207
FALSE,Millard County,2/1/93,Hide,Hide,2,1993,4428,4428,4700,4700,1,272,272,0.05787234,0.05787234
FALSE,Millard County,2/1/94,Hide,Hide,2,1994,4476,4476,4689,4689,1,213,213,0.045425464,0.045425464
FALSE,Millard County,2/1/95,Hide,Hide,2,1995,4589,4589,4833,4833,1,244,244,0.05048624,0.05048624
FALSE,Millard County,2/1/96,Hide,Hide,2,1996,4498,4498,4702,4702,1,204,204,0.043385793,0.043385793
FALSE,Millard County,2/1/97,Hide,Hide,2,1997,4576,4576,4757,4757,1,181,181,0.038049191,0.038049191
FALSE,Millard County,2/1/98,Hide,Hide,2,1998,4577,4577,4795,4795,1,218,218,0.045464025,0.045464025
FALSE,Millard County,2/1/99,Hide,Hide,2,1999,4500,4500,4697,4697,1,197,197,0.041941665,0.041941665
FALSE,Millard County,2/1/00,Hide,Hide,2,2000,4926,4926,5092,5092,1,166,166,0.032600157,0.032600157
FALSE,Millard County,2/1/01,Hide,Hide,2,2001,5016,5016,5216,5216,1,200,200,0.038343558,0.038343558
FALSE,Millard County,2/1/02,Hide,Hide,2,2002,5741,5741,6019,6019,1,278,278,0.046187074,0.046187074
FALSE,Millard County,2/1/03,Hide,Hide,2,2003,5784,5784,6077,6077,1,293,293,0.04821458,0.04821458
FALSE,Millard County,2/1/04,Hide,Hide,2,2004,5879,5879,6197,6197,1,318,318,0.051315152,0.051315152
FALSE,Millard County,2/1/05,Hide,Hide,2,2005,5715,5715,5964,5964,1,249,249,0.041750503,0.041750503
FALSE,Millard County,2/1/06,Hide,Hide,2,2006,5907,5907,6117,6117,1,210,210,0.034330554,0.034330554
FALSE,Millard County,2/1/07,Hide,Hide,2,2007,6171,6171,6314,6314,1,143,143,0.022648084,0.022648084
FALSE,Millard County,2/1/08,Hide,Hide,2,2008,5790,5790,5968,5968,1,178,178,0.029825737,0.029825737
FALSE,Millard County,2/1/09,Hide,Hide,2,2009,6072,6072,6385,6385,1,313,313,0.049021143,0.049021143
FALSE,Millard County,2/1/10,Hide,Hide,2,2010,5914,5914,6321,6321,1,407,407,0.064388546,0.064388546
FALSE,Millard County,2/1/11,Hide,Hide,2,2011,5885,5885,6232,6232,1,347,347,0.055680359,0.055680359
FALSE,Millard County,2/1/12,Hide,Hide,2,2012,5684,5684,5974,5974,1,290,290,0.048543689,0.048543689
FALSE,Millard County,2/1/13,Hide,Hide,2,2013,5743,5743,6001,6001,1,258,258,0.042992835,0.042992835
FALSE,Millard County,2/1/14,Hide,Hide,2,2014,5835,5835,6043,6043,1,208,208,0.03441999,0.03441999
FALSE,Millard County,2/1/15,Hide,Hide,2,2015,5993,5993,6209,6209,1,216,216,0.034788211,0.034788211
FALSE,Millard County,2/1/16,Hide,Hide,2,2016,5901,5901,6110,6110,1,209,209,0.034206219,0.034206219
FALSE,Millard County,2/1/17,Hide,Hide,2,2017,6157,6157,6375,6375,1,218,218,0.034196078,0.034196078
FALSE,Millard County,2/1/18,Hide,Hide,2,2018,6154,6154,6353,6353,1,199,199,0.031323784,0.031323784
FALSE,Millard County,2/1/19,Hide,Hide,2,2019,5813,5813,5993,5993,1,180,180,0.030035041,0.030035041
FALSE,Millard County,2/1/20,Hide,Hide,2,2020,5833,5833,6006,6006,1,173,173,0.028804529,0.028804529
FALSE,Morgan County,2/1/93,Hide,Hide,2,1993,2784,2784,2957,2957,1,173,173,0.058505242,0.058505242
FALSE,Morgan County,2/1/94,Hide,Hide,2,1994,2814,2814,2947,2947,1,133,133,0.045130641,0.045130641
FALSE,Morgan County,2/1/95,Hide,Hide,2,1995,3143,3143,3311,3311,1,168,168,0.050739958,0.050739958
FALSE,Morgan County,2/1/96,Hide,Hide,2,1996,3256,3256,3410,3410,1,154,154,0.04516129,0.04516129
FALSE,Morgan County,2/1/97,Hide,Hide,2,1997,3427,3427,3564,3564,1,137,137,0.038439955,0.038439955
FALSE,Morgan County,2/1/98,Hide,Hide,2,1998,3571,3571,3710,3710,1,139,139,0.037466307,0.037466307
FALSE,Morgan County,2/1/99,Hide,Hide,2,1999,3436,3436,3577,3577,1,141,141,0.039418507,0.039418507
FALSE,Morgan County,2/1/00,Hide,Hide,2,2000,3355,3355,3468,3468,1,113,113,0.032583622,0.032583622
FALSE,Morgan County,2/1/01,Hide,Hide,2,2001,3344,3344,3469,3469,1,125,125,0.036033439,0.036033439
FALSE,Morgan County,2/1/02,Hide,Hide,2,2002,3345,3345,3525,3525,1,180,180,0.05106383,0.05106383
FALSE,Morgan County,2/1/03,Hide,Hide,2,2003,3383,3383,3576,3576,1,193,193,0.053970917,0.053970917
FALSE,Morgan County,2/1/04,Hide,Hide,2,2004,3461,3461,3645,3645,1,184,184,0.05048011,0.05048011
FALSE,Morgan County,2/1/05,Hide,Hide,2,2005,3604,3604,3769,3769,1,165,165,0.043778191,0.043778191
FALSE,Morgan County,2/1/06,Hide,Hide,2,2006,3768,3768,3901,3901,1,133,133,0.034093822,0.034093822
FALSE,Morgan County,2/1/07,Hide,Hide,2,2007,3864,3864,3957,3957,1,93,93,0.023502654,0.023502654
FALSE,Morgan County,2/1/08,Hide,Hide,2,2008,3932,3932,4054,4054,1,122,122,0.030093735,0.030093735
FALSE,Morgan County,2/1/09,Hide,Hide,2,2009,3854,3854,4083,4083,1,229,229,0.056086211,0.056086211
FALSE,Morgan County,2/1/10,Hide,Hide,2,2010,3917,3917,4206,4206,1,289,289,0.068711365,0.068711365
FALSE,Morgan County,2/1/11,Hide,Hide,2,2011,3960,3960,4222,4222,1,262,262,0.062055898,0.062055898
FALSE,Morgan County,2/1/12,Hide,Hide,2,2012,4065,4065,4285,4285,1,220,220,0.05134189,0.05134189
FALSE,Morgan County,2/1/13,Hide,Hide,2,2013,4257,4257,4451,4451,1,194,194,0.043585711,0.043585711
FALSE,Morgan County,2/1/14,Hide,Hide,2,2014,4464,4464,4630,4630,1,166,166,0.035853132,0.035853132
FALSE,Morgan County,2/1/15,Hide,Hide,2,2015,4689,4689,4838,4838,1,149,149,0.03079785,0.03079785
FALSE,Morgan County,2/1/16,Hide,Hide,2,2016,4889,4889,5048,5048,1,159,159,0.031497623,0.031497623
FALSE,Morgan County,2/1/17,Hide,Hide,2,2017,5171,5171,5327,5327,1,156,156,0.029284776,0.029284776
FALSE,Morgan County,2/1/18,Hide,Hide,2,2018,5266,5266,5412,5412,1,146,146,0.026977088,0.026977088
FALSE,Morgan County,2/1/19,Hide,Hide,2,2019,5354,5354,5496,5496,1,142,142,0.025836972,0.025836972
FALSE,Morgan County,2/1/20,Hide,Hide,2,2020,5471,5471,5614,5614,1,143,143,0.025472034,0.025472034
FALSE,Piute County,2/1/93,Hide,Hide,2,1993,416,416,441,441,1,25,25,0.056689342,0.056689342
FALSE,Piute County,2/1/94,Hide,Hide,2,1994,443,443,480,480,1,37,37,0.077083333,0.077083333
FALSE,Piute County,2/1/95,Hide,Hide,2,1995,459,459,490,490,1,31,31,0.063265306,0.063265306
FALSE,Piute County,2/1/96,Hide,Hide,2,1996,482,482,504,504,1,22,22,0.043650794,0.043650794
FALSE,Piute County,2/1/97,Hide,Hide,2,1997,501,501,529,529,1,28,28,0.052930057,0.052930057
FALSE,Piute County,2/1/98,Hide,Hide,2,1998,513,513,538,538,1,25,25,0.046468401,0.046468401
FALSE,Piute County,2/1/99,Hide,Hide,2,1999,508,508,542,542,1,34,34,0.062730627,0.062730627
FALSE,Piute County,2/1/00,Hide,Hide,2,2000,559,559,581,581,1,22,22,0.037865749,0.037865749
FALSE,Piute County,2/1/01,Hide,Hide,2,2001,678,678,720,720,1,42,42,0.058333333,0.058333333
FALSE,Piute County,2/1/02,Hide,Hide,2,2002,694,694,739,739,1,45,45,0.060893099,0.060893099
FALSE,Piute County,2/1/03,Hide,Hide,2,2003,742,742,788,788,1,46,46,0.058375635,0.058375635
FALSE,Piute County,2/1/04,Hide,Hide,2,2004,810,810,848,848,1,38,38,0.044811321,0.044811321
FALSE,Piute County,2/1/05,Hide,Hide,2,2005,837,837,875,875,1,38,38,0.043428571,0.043428571
FALSE,Piute County,2/1/06,Hide,Hide,2,2006,826,826,856,856,1,30,30,0.035046729,0.035046729
FALSE,Piute County,2/1/07,Hide,Hide,2,2007,895,895,913,913,1,18,18,0.019715225,0.019715225
FALSE,Piute County,2/1/08,Hide,Hide,2,2008,873,873,896,896,1,23,23,0.025669643,0.025669643
FALSE,Piute County,2/1/09,Hide,Hide,2,2009,854,854,904,904,1,50,50,0.055309735,0.055309735
FALSE,Piute County,2/1/10,Hide,Hide,2,2010,598,598,657,657,1,59,59,0.089802131,0.089802131
FALSE,Piute County,2/1/11,Hide,Hide,2,2011,504,504,561,561,1,57,57,0.101604278,0.101604278
FALSE,Piute County,2/1/12,Hide,Hide,2,2012,462,462,507,507,1,45,45,0.088757396,0.088757396
FALSE,Piute County,2/1/13,Hide,Hide,2,2013,455,455,492,492,1,37,37,0.075203252,0.075203252
FALSE,Piute County,2/1/14,Hide,Hide,2,2014,430,430,462,462,1,32,32,0.069264069,0.069264069
FALSE,Piute County,2/1/15,Hide,Hide,2,2015,447,447,480,480,1,33,33,0.06875,0.06875
FALSE,Piute County,2/1/16,Hide,Hide,2,2016,419,419,448,448,1,29,29,0.064732143,0.064732143
FALSE,Piute County,2/1/17,Hide,Hide,2,2017,448,448,473,473,1,25,25,0.052854123,0.052854123
FALSE,Piute County,2/1/18,Hide,Hide,2,2018,463,463,485,485,1,22,22,0.045360825,0.045360825
FALSE,Piute County,2/1/19,Hide,Hide,2,2019,458,458,481,481,1,23,23,0.047817048,0.047817048
FALSE,Piute County,2/1/20,Hide,Hide,2,2020,455,455,480,480,1,25,25,0.052083333,0.052083333
FALSE,Rich County,2/1/93,Hide,Hide,2,1993,740,740,767,767,1,27,27,0.035202086,0.035202086
FALSE,Rich County,2/1/94,Hide,Hide,2,1994,751,751,781,781,1,30,30,0.038412292,0.038412292
FALSE,Rich County,2/1/95,Hide,Hide,2,1995,814,814,847,847,1,33,33,0.038961039,0.038961039
FALSE,Rich County,2/1/96,Hide,Hide,2,1996,931,931,965,965,1,34,34,0.035233161,0.035233161
FALSE,Rich County,2/1/97,Hide,Hide,2,1997,897,897,924,924,1,27,27,0.029220779,0.029220779
FALSE,Rich County,2/1/98,Hide,Hide,2,1998,974,974,1008,1008,1,34,34,0.033730159,0.033730159
FALSE,Rich County,2/1/99,Hide,Hide,2,1999,961,961,993,993,1,32,32,0.032225579,0.032225579
FALSE,Rich County,2/1/00,Hide,Hide,2,2000,947,947,978,978,1,31,31,0.031697342,0.031697342
FALSE,Rich County,2/1/01,Hide,Hide,2,2001,1038,1038,1079,1079,1,41,41,0.037998146,0.037998146
FALSE,Rich County,2/1/02,Hide,Hide,2,2002,1226,1226,1271,1271,1,45,45,0.035405193,0.035405193
FALSE,Rich County,2/1/03,Hide,Hide,2,2003,1212,1212,1264,1264,1,52,52,0.041139241,0.041139241
FALSE,Rich County,2/1/04,Hide,Hide,2,2004,1302,1302,1347,1347,1,45,45,0.033407572,0.033407572
FALSE,Rich County,2/1/05,Hide,Hide,2,2005,1248,1248,1292,1292,1,44,44,0.034055728,0.034055728
FALSE,Rich County,2/1/06,Hide,Hide,2,2006,1319,1319,1355,1355,1,36,36,0.026568266,0.026568266
FALSE,Rich County,2/1/07,Hide,Hide,2,2007,1440,1440,1463,1463,1,23,23,0.015721121,0.015721121
FALSE,Rich County,2/1/08,Hide,Hide,2,2008,1386,1386,1416,1416,1,30,30,0.021186441,0.021186441
FALSE,Rich County,2/1/09,Hide,Hide,2,2009,1434,1434,1503,1503,1,69,69,0.045908184,0.045908184
FALSE,Rich County,2/1/10,Hide,Hide,2,2010,1063,1063,1141,1141,1,78,78,0.068361087,0.068361087
FALSE,Rich County,2/1/11,Hide,Hide,2,2011,916,916,993,993,1,77,77,0.0775428,0.0775428
FALSE,Rich County,2/1/12,Hide,Hide,2,2012,895,895,947,947,1,52,52,0.054910243,0.054910243
FALSE,Rich County,2/1/13,Hide,Hide,2,2013,924,924,973,973,1,49,49,0.050359712,0.050359712
FALSE,Rich County,2/1/14,Hide,Hide,2,2014,1006,1006,1045,1045,1,39,39,0.037320574,0.037320574
FALSE,Rich County,2/1/15,Hide,Hide,2,2015,1019,1019,1056,1056,1,37,37,0.035037879,0.035037879
FALSE,Rich County,2/1/16,Hide,Hide,2,2016,1028,1028,1060,1060,1,32,32,0.030188679,0.030188679
FALSE,Rich County,2/1/17,Hide,Hide,2,2017,1084,1084,1122,1122,1,38,38,0.033868093,0.033868093
FALSE,Rich County,2/1/18,Hide,Hide,2,2018,1123,1123,1161,1161,1,38,38,0.032730405,0.032730405
FALSE,Rich County,2/1/19,Hide,Hide,2,2019,1134,1134,1172,1172,1,38,38,0.032423208,0.032423208
FALSE,Rich County,2/1/20,Hide,Hide,2,2020,1131,1131,1171,1171,1,40,40,0.034158839,0.034158839
FALSE,Salt Lake County,2/1/93,Hide,Hide,2,1993,395486,395486,411953,411953,1,16467,16467,0.039973007,0.039973007
FALSE,Salt Lake County,2/1/94,Hide,Hide,2,1994,422154,422154,436257,436257,1,14103,14103,0.032327275,0.032327275
FALSE,Salt Lake County,2/1/95,Hide,Hide,2,1995,436903,436903,451382,451382,1,14479,14479,0.032077043,0.032077043
FALSE,Salt Lake County,2/1/96,Hide,Hide,2,1996,442889,442889,456166,456166,1,13277,13277,0.029105633,0.029105633
FALSE,Salt Lake County,2/1/97,Hide,Hide,2,1997,456246,456246,469178,469178,1,12932,12932,0.0275631,0.0275631
FALSE,Salt Lake County,2/1/98,Hide,Hide,2,1998,464894,464894,480296,480296,1,15402,15402,0.032067725,0.032067725
FALSE,Salt Lake County,2/1/99,Hide,Hide,2,1999,472260,472260,488370,488370,1,16110,16110,0.032987284,0.032987284
FALSE,Salt Lake County,2/1/00,Hide,Hide,2,2000,469327,469327,483458,483458,1,14131,14131,0.029229013,0.029229013
FALSE,Salt Lake County,2/1/01,Hide,Hide,2,2001,476246,476246,494961,494961,1,18715,18715,0.03781106,0.03781106
FALSE,Salt Lake County,2/1/02,Hide,Hide,2,2002,467782,467782,495350,495350,1,27568,27568,0.055653578,0.055653578
FALSE,Salt Lake County,2/1/03,Hide,Hide,2,2003,464375,464375,494021,494021,1,29646,29646,0.060009595,0.060009595
FALSE,Salt Lake County,2/1/04,Hide,Hide,2,2004,471013,471013,497691,497691,1,26678,26678,0.053603541,0.053603541
FALSE,Salt Lake County,2/1/05,Hide,Hide,2,2005,487926,487926,509996,509996,1,22070,22070,0.043274849,0.043274849
FALSE,Salt Lake County,2/1/06,Hide,Hide,2,2006,510984,510984,528658,528658,1,17674,17674,0.033431822,0.033431822
FALSE,Salt Lake County,2/1/07,Hide,Hide,2,2007,532847,532847,545243,545243,1,12396,12396,0.022734817,0.022734817
FALSE,Salt Lake County,2/1/08,Hide,Hide,2,2008,542597,542597,558304,558304,1,15707,15707,0.028133418,0.028133418
FALSE,Salt Lake County,2/1/09,Hide,Hide,2,2009,524070,524070,558190,558190,1,34120,34120,0.06112614,0.06112614
FALSE,Salt Lake County,2/1/10,Hide,Hide,2,2010,505732,505732,547438,547438,1,41706,41706,0.07618397,0.07618397
FALSE,Salt Lake County,2/1/11,Hide,Hide,2,2011,507742,507742,546965,546965,1,39223,39223,0.071710256,0.071710256
FALSE,Salt Lake County,2/1/12,Hide,Hide,2,2012,519457,519457,550660,550660,1,31203,31203,0.05666473,0.05666473
FALSE,Salt Lake County,2/1/13,Hide,Hide,2,2013,538325,538325,564702,564702,1,26377,26377,0.046709592,0.046709592
FALSE,Salt Lake County,2/1/14,Hide,Hide,2,2014,551722,551722,574060,574060,1,22338,22338,0.038912309,0.038912309
FALSE,Salt Lake County,2/1/15,Hide,Hide,2,2015,560091,560091,579974,579974,1,19883,19883,0.034282571,0.034282571
FALSE,Salt Lake County,2/1/16,Hide,Hide,2,2016,575185,575185,594802,594802,1,19617,19617,0.032980723,0.032980723
FALSE,Salt Lake County,2/1/17,Hide,Hide,2,2017,592446,592446,611549,611549,1,19103,19103,0.031237072,0.031237072
FALSE,Salt Lake County,2/1/18,Hide,Hide,2,2018,598609,598609,616987,616987,1,18378,18378,0.029786689,0.029786689
FALSE,Salt Lake County,2/1/19,Hide,Hide,2,2019,609514,609514,626655,626655,1,17141,17141,0.027353169,0.027353169
FALSE,Salt Lake County,2/1/20,Hide,Hide,2,2020,626607,626607,645621,645621,1,19014,19014,0.029450715,0.029450715
FALSE,San Juan County,2/1/93,Hide,Hide,2,1993,4560,4560,4932,4932,1,372,372,0.075425791,0.075425791
FALSE,San Juan County,2/1/94,Hide,Hide,2,1994,4618,4618,5040,5040,1,422,422,0.083730159,0.083730159
FALSE,San Juan County,2/1/95,Hide,Hide,2,1995,4708,4708,5146,5146,1,438,438,0.085114652,0.085114652
FALSE,San Juan County,2/1/96,Hide,Hide,2,1996,4741,4741,5212,5212,1,471,471,0.090368381,0.090368381
FALSE,San Juan County,2/1/97,Hide,Hide,2,1997,4477,4477,4960,4960,1,483,483,0.097379032,0.097379032
FALSE,San Juan County,2/1/98,Hide,Hide,2,1998,4529,4529,4912,4912,1,383,383,0.077972313,0.077972313
FALSE,San Juan County,2/1/99,Hide,Hide,2,1999,4707,4707,5110,5110,1,403,403,0.078864971,0.078864971
FALSE,San Juan County,2/1/00,Hide,Hide,2,2000,4494,4494,4836,4836,1,342,342,0.070719603,0.070719603
FALSE,San Juan County,2/1/01,Hide,Hide,2,2001,4176,4176,4561,4561,1,385,385,0.084411313,0.084411313
FALSE,San Juan County,2/1/02,Hide,Hide,2,2002,4327,4327,4724,4724,1,397,397,0.08403895,0.08403895
FALSE,San Juan County,2/1/03,Hide,Hide,2,2003,4357,4357,4789,4789,1,432,432,0.090206724,0.090206724
FALSE,San Juan County,2/1/04,Hide,Hide,2,2004,4397,4397,4843,4843,1,446,446,0.092091679,0.092091679
FALSE,San Juan County,2/1/05,Hide,Hide,2,2005,4345,4345,4744,4744,1,399,399,0.084106239,0.084106239
FALSE,San Juan County,2/1/06,Hide,Hide,2,2006,4532,4532,4856,4856,1,324,324,0.066721582,0.066721582
FALSE,San Juan County,2/1/07,Hide,Hide,2,2007,4699,4699,4931,4931,1,232,232,0.04704928,0.04704928
FALSE,San Juan County,2/1/08,Hide,Hide,2,2008,4652,4652,4935,4935,1,283,283,0.057345491,0.057345491
FALSE,San Juan County,2/1/09,Hide,Hide,2,2009,4662,4662,5178,5178,1,516,516,0.099652375,0.099652375
FALSE,San Juan County,2/1/10,Hide,Hide,2,2010,5211,5211,5891,5891,1,680,680,0.115430317,0.115430317
FALSE,San Juan County,2/1/11,Hide,Hide,2,2011,5382,5382,6021,6021,1,639,639,0.10612855,0.10612855
FALSE,San Juan County,2/1/12,Hide,Hide,2,2012,5247,5247,5775,5775,1,528,528,0.091428571,0.091428571
FALSE,San Juan County,2/1/13,Hide,Hide,2,2013,5168,5168,5622,5622,1,454,454,0.08075418,0.08075418
FALSE,San Juan County,2/1/14,Hide,Hide,2,2014,5249,5249,5678,5678,1,429,429,0.075554773,0.075554773
FALSE,San Juan County,2/1/15,Hide,Hide,2,2015,5248,5248,5693,5693,1,445,445,0.078166169,0.078166169
FALSE,San Juan County,2/1/16,Hide,Hide,2,2016,5245,5245,5734,5734,1,489,489,0.085280781,0.085280781
FALSE,San Juan County,2/1/17,Hide,Hide,2,2017,5294,5294,5717,5717,1,423,423,0.073989855,0.073989855
FALSE,San Juan County,2/1/18,Hide,Hide,2,2018,5319,5319,5677,5677,1,358,358,0.063061476,0.063061476
FALSE,San Juan County,2/1/19,Hide,Hide,2,2019,5412,5412,5719,5719,1,307,307,0.053680713,0.053680713
FALSE,San Juan County,2/1/20,Hide,Hide,2,2020,5409,5409,5769,5769,1,360,360,0.062402496,0.062402496
FALSE,Sanpete County,2/1/93,Hide,Hide,2,1993,6471,6471,6978,6978,1,507,507,0.072656922,0.072656922
FALSE,Sanpete County,2/1/94,Hide,Hide,2,1994,6841,6841,7322,7322,1,481,481,0.065692434,0.065692434
FALSE,Sanpete County,2/1/95,Hide,Hide,2,1995,7188,7188,7684,7684,1,496,496,0.064549714,0.064549714
FALSE,Sanpete County,2/1/96,Hide,Hide,2,1996,7595,7595,8086,8086,1,491,491,0.060722236,0.060722236
FALSE,Sanpete County,2/1/97,Hide,Hide,2,1997,8042,8042,8516,8516,1,474,474,0.055659934,0.055659934
FALSE,Sanpete County,2/1/98,Hide,Hide,2,1998,8368,8368,8879,8879,1,511,511,0.057551526,0.057551526
FALSE,Sanpete County,2/1/99,Hide,Hide,2,1999,8481,8481,8962,8962,1,481,481,0.053671056,0.053671056
FALSE,Sanpete County,2/1/00,Hide,Hide,2,2000,8974,8974,9357,9357,1,383,383,0.040931923,0.040931923
FALSE,Sanpete County,2/1/01,Hide,Hide,2,2001,9275,9275,9786,9786,1,511,511,0.052217454,0.052217454
FALSE,Sanpete County,2/1/02,Hide,Hide,2,2002,9561,9561,10195,10195,1,634,634,0.062187347,0.062187347
FALSE,Sanpete County,2/1/03,Hide,Hide,2,2003,9663,9663,10364,10364,1,701,701,0.067637978,0.067637978
FALSE,Sanpete County,2/1/04,Hide,Hide,2,2004,9852,9852,10517,10517,1,665,665,0.063230959,0.063230959
FALSE,Sanpete County,2/1/05,Hide,Hide,2,2005,9826,9826,10416,10416,1,590,590,0.056643625,0.056643625
FALSE,Sanpete County,2/1/06,Hide,Hide,2,2006,10131,10131,10584,10584,1,453,453,0.042800454,0.042800454
FALSE,Sanpete County,2/1/07,Hide,Hide,2,2007,10638,10638,10945,10945,1,307,307,0.028049338,0.028049338
FALSE,Sanpete County,2/1/08,Hide,Hide,2,2008,10477,10477,10876,10876,1,399,399,0.036686282,0.036686282
FALSE,Sanpete County,2/1/09,Hide,Hide,2,2009,10491,10491,11364,11364,1,873,873,0.076821542,0.076821542
FALSE,Sanpete County,2/1/10,Hide,Hide,2,2010,10483,10483,11462,11462,1,979,979,0.085412668,0.085412668
FALSE,Sanpete County,2/1/11,Hide,Hide,2,2011,10122,10122,11073,11073,1,951,951,0.085884584,0.085884584
FALSE,Sanpete County,2/1/12,Hide,Hide,2,2012,10483,10483,11243,11243,1,760,760,0.067597616,0.067597616
FALSE,Sanpete County,2/1/13,Hide,Hide,2,2013,10578,10578,11255,11255,1,677,677,0.060151044,0.060151044
FALSE,Sanpete County,2/1/14,Hide,Hide,2,2014,10498,10498,11023,11023,1,525,525,0.047627688,0.047627688
FALSE,Sanpete County,2/1/15,Hide,Hide,2,2015,10907,10907,11384,11384,1,477,477,0.041900914,0.041900914
FALSE,Sanpete County,2/1/16,Hide,Hide,2,2016,11154,11154,11634,11634,1,480,480,0.041258381,0.041258381
FALSE,Sanpete County,2/1/17,Hide,Hide,2,2017,11416,11416,11888,11888,1,472,472,0.039703903,0.039703903
FALSE,Sanpete County,2/1/18,Hide,Hide,2,2018,11858,11858,12314,12314,1,456,456,0.037031022,0.037031022
FALSE,Sanpete County,2/1/19,Hide,Hide,2,2019,12035,12035,12461,12461,1,426,426,0.034186662,0.034186662
FALSE,Sanpete County,2/1/20,Hide,Hide,2,2020,12160,12160,12550,12550,1,390,390,0.031075697,0.031075697
FALSE,Sevier County,2/1/93,Hide,Hide,2,1993,6500,6500,6939,6939,1,439,439,0.0632656,0.0632656
FALSE,Sevier County,2/1/94,Hide,Hide,2,1994,6953,6953,7288,7288,1,335,335,0.045965971,0.045965971
FALSE,Sevier County,2/1/95,Hide,Hide,2,1995,7237,7237,7632,7632,1,395,395,0.051755765,0.051755765
FALSE,Sevier County,2/1/96,Hide,Hide,2,1996,7439,7439,7794,7794,1,355,355,0.045547857,0.045547857
FALSE,Sevier County,2/1/97,Hide,Hide,2,1997,7683,7683,8031,8031,1,348,348,0.043332088,0.043332088
FALSE,Sevier County,2/1/98,Hide,Hide,2,1998,7922,7922,8282,8282,1,360,360,0.043467761,0.043467761
FALSE,Sevier County,2/1/99,Hide,Hide,2,1999,8003,8003,8367,8367,1,364,364,0.043504243,0.043504243
FALSE,Sevier County,2/1/00,Hide,Hide,2,2000,8054,8054,8339,8339,1,285,285,0.03417676,0.03417676
FALSE,Sevier County,2/1/01,Hide,Hide,2,2001,7986,7986,8364,8364,1,378,378,0.045193687,0.045193687
FALSE,Sevier County,2/1/02,Hide,Hide,2,2002,8357,8357,8847,8847,1,490,490,0.055386007,0.055386007
FALSE,Sevier County,2/1/03,Hide,Hide,2,2003,8264,8264,8776,8776,1,512,512,0.05834093,0.05834093
FALSE,Sevier County,2/1/04,Hide,Hide,2,2004,8673,8673,9161,9161,1,488,488,0.053269294,0.053269294
FALSE,Sevier County,2/1/05,Hide,Hide,2,2005,8629,8629,9060,9060,1,431,431,0.047571744,0.047571744
FALSE,Sevier County,2/1/06,Hide,Hide,2,2006,8936,8936,9274,9274,1,338,338,0.036445978,0.036445978
FALSE,Sevier County,2/1/07,Hide,Hide,2,2007,9301,9301,9523,9523,1,222,222,0.023311982,0.023311982
FALSE,Sevier County,2/1/08,Hide,Hide,2,2008,9256,9256,9552,9552,1,296,296,0.030988275,0.030988275
FALSE,Sevier County,2/1/09,Hide,Hide,2,2009,9103,9103,9801,9801,1,698,698,0.071217223,0.071217223
FALSE,Sevier County,2/1/10,Hide,Hide,2,2010,8882,8882,9720,9720,1,838,838,0.086213992,0.086213992
FALSE,Sevier County,2/1/11,Hide,Hide,2,2011,8755,8755,9527,9527,1,772,772,0.081032854,0.081032854
FALSE,Sevier County,2/1/12,Hide,Hide,2,2012,8858,8858,9463,9463,1,605,605,0.063933214,0.063933214
FALSE,Sevier County,2/1/13,Hide,Hide,2,2013,8802,8802,9342,9342,1,540,540,0.057803468,0.057803468
FALSE,Sevier County,2/1/14,Hide,Hide,2,2014,8863,8863,9287,9287,1,424,424,0.045655217,0.045655217
FALSE,Sevier County,2/1/15,Hide,Hide,2,2015,9102,9102,9519,9519,1,417,417,0.043807123,0.043807123
FALSE,Sevier County,2/1/16,Hide,Hide,2,2016,9076,9076,9505,9505,1,429,429,0.04513414,0.04513414
FALSE,Sevier County,2/1/17,Hide,Hide,2,2017,9314,9314,9707,9707,1,393,393,0.040486247,0.040486247
FALSE,Sevier County,2/1/18,Hide,Hide,2,2018,9482,9482,9839,9839,1,357,357,0.036284175,0.036284175
FALSE,Sevier County,2/1/19,Hide,Hide,2,2019,9435,9435,9762,9762,1,327,327,0.033497234,0.033497234
FALSE,Sevier County,2/1/20,Hide,Hide,2,2020,9396,9396,9740,9740,1,344,344,0.035318275,0.035318275
FALSE,State of Utah,2/1/93,Hide,Hide,2,1993,877686,877686,918630,918630,1,40944,40944,0.044570719,0.044570719
FALSE,State of Utah,2/1/94,Hide,Hide,2,1994,940576,940576,976422,976422,1,35846,35846,0.036711586,0.036711586
FALSE,State of Utah,2/1/95,Hide,Hide,2,1995,968511,968511,1005645,1005645,1,37134,37134,0.036925555,0.036925555
FALSE,State of Utah,2/1/96,Hide,Hide,2,1996,992261,992261,1027106,1027106,1,34845,34845,0.033925418,0.033925418
FALSE,State of Utah,2/1/97,Hide,Hide,2,1997,1025057,1025057,1059147,1059147,1,34090,34090,0.032186278,0.032186278
FALSE,State of Utah,2/1/98,Hide,Hide,2,1998,1050914,1050914,1089262,1089262,1,38348,38348,0.035205488,0.035205488
FALSE,State of Utah,2/1/99,Hide,Hide,2,1999,1074825,1074825,1115621,1115621,1,40796,40796,0.036567974,0.036567974
FALSE,State of Utah,2/1/00,Hide,Hide,2,2000,1095833,1095833,1130836,1130836,1,35003,35003,0.030953206,0.030953206
FALSE,State of Utah,2/1/01,Hide,Hide,2,2001,1113914,1113914,1159601,1159601,1,45687,45687,0.039398897,0.039398897
FALSE,State of Utah,2/1/02,Hide,Hide,2,2002,1113877,1113877,1179115,1179115,1,65238,65238,0.055327937,0.055327937
FALSE,State of Utah,2/1/03,Hide,Hide,2,2003,1122526,1122526,1192445,1192445,1,69919,69919,0.058634989,0.058634989
FALSE,State of Utah,2/1/04,Hide,Hide,2,2004,1153970,1153970,1218505,1218505,1,64535,64535,0.052962442,0.052962442
FALSE,State of Utah,2/1/05,Hide,Hide,2,2005,1198878,1198878,1253526,1253526,1,54648,54648,0.043595426,0.043595426
FALSE,State of Utah,2/1/06,Hide,Hide,2,2006,1256815,1256815,1301064,1301064,1,44249,44249,0.034009857,0.034009857
FALSE,State of Utah,2/1/07,Hide,Hide,2,2007,1314734,1314734,1346650,1346650,1,31916,31916,0.023700293,0.023700293
FALSE,State of Utah,2/1/08,Hide,Hide,2,2008,1330233,1330233,1371722,1371722,1,41489,41489,0.030245924,0.030245924
FALSE,State of Utah,2/1/09,Hide,Hide,2,2009,1287362,1287362,1379404,1379404,1,92042,92042,0.066725919,0.066725919
FALSE,State of Utah,2/1/10,Hide,Hide,2,2010,1248210,1248210,1355856,1355856,1,107646,107646,0.079393387,0.079393387
FALSE,State of Utah,2/1/11,Hide,Hide,2,2011,1252350,1252350,1351854,1351854,1,99504,99504,0.073605582,0.073605582
FALSE,State of Utah,2/1/12,Hide,Hide,2,2012,1281733,1281733,1360331,1360331,1,78598,78598,0.057778585,0.057778585
FALSE,State of Utah,2/1/13,Hide,Hide,2,2013,1325786,1325786,1394091,1394091,1,68305,68305,0.048996084,0.048996084
FALSE,State of Utah,2/1/14,Hide,Hide,2,2014,1363612,1363612,1419938,1419938,1,56326,56326,0.039667929,0.039667929
FALSE,State of Utah,2/1/15,Hide,Hide,2,2015,1394686,1394686,1446858,1446858,1,52172,52172,0.036058825,0.036058825
FALSE,State of Utah,2/1/16,Hide,Hide,2,2016,1433278,1433278,1486781,1486781,1,53503,53503,0.035985798,0.035985798
FALSE,State of Utah,2/1/17,Hide,Hide,2,2017,1484602,1484602,1535463,1535463,1,50861,50861,0.033124211,0.033124211
FALSE,State of Utah,2/1/18,Hide,Hide,2,2018,1516170,1516170,1564334,1564334,1,48164,48164,0.030788821,0.030788821
FALSE,State of Utah,2/1/19,Hide,Hide,2,2019,1535434,1535434,1583689,1583689,1,48255,48255,0.030469998,0.030469998
FALSE,State of Utah,2/1/20,Hide,Hide,2,2020,1590199,1590199,1630650,1630650,1,40451,40451,0.024806672,0.024806672
FALSE,Summit County,2/1/93,Hide,Hide,2,1993,9437,9437,10019,10019,1,582,582,0.05808963,0.05808963
FALSE,Summit County,2/1/94,Hide,Hide,2,1994,10503,10503,10998,10998,1,495,495,0.045008183,0.045008183
FALSE,Summit County,2/1/95,Hide,Hide,2,1995,11406,11406,11883,11883,1,477,477,0.040141378,0.040141378
FALSE,Summit County,2/1/96,Hide,Hide,2,1996,11941,11941,12410,12410,1,469,469,0.037792103,0.037792103
FALSE,Summit County,2/1/97,Hide,Hide,2,1997,12751,12751,13181,13181,1,430,430,0.032622715,0.032622715
FALSE,Summit County,2/1/98,Hide,Hide,2,1998,13490,13490,14092,14092,1,602,602,0.042719273,0.042719273
FALSE,Summit County,2/1/99,Hide,Hide,2,1999,14080,14080,14737,14737,1,657,657,0.044581665,0.044581665
FALSE,Summit County,2/1/00,Hide,Hide,2,2000,16351,16351,16955,16955,1,604,604,0.03562371,0.03562371
FALSE,Summit County,2/1/01,Hide,Hide,2,2001,17617,17617,18330,18330,1,713,713,0.038897981,0.038897981
FALSE,Summit County,2/1/02,Hide,Hide,2,2002,18028,18028,19290,19290,1,1262,1262,0.065422499,0.065422499
FALSE,Summit County,2/1/03,Hide,Hide,2,2003,18344,18344,19600,19600,1,1256,1256,0.064081633,0.064081633
FALSE,Summit County,2/1/04,Hide,Hide,2,2004,19063,19063,20206,20206,1,1143,1143,0.056567356,0.056567356
FALSE,Summit County,2/1/05,Hide,Hide,2,2005,20156,20156,21070,21070,1,914,914,0.043379212,0.043379212
FALSE,Summit County,2/1/06,Hide,Hide,2,2006,20811,20811,21522,21522,1,711,711,0.033035963,0.033035963
FALSE,Summit County,2/1/07,Hide,Hide,2,2007,21214,21214,21725,21725,1,511,511,0.023521289,0.023521289
FALSE,Summit County,2/1/08,Hide,Hide,2,2008,21208,21208,21826,21826,1,618,618,0.028314854,0.028314854
FALSE,Summit County,2/1/09,Hide,Hide,2,2009,20285,20285,21574,21574,1,1289,1289,0.059747845,0.059747845
FALSE,Summit County,2/1/10,Hide,Hide,2,2010,20186,20186,21732,21732,1,1546,1546,0.071139334,0.071139334
FALSE,Summit County,2/1/11,Hide,Hide,2,2011,20320,20320,21742,21742,1,1422,1422,0.065403367,0.065403367
FALSE,Summit County,2/1/12,Hide,Hide,2,2012,20372,20372,21481,21481,1,1109,1109,0.051627019,0.051627019
FALSE,Summit County,2/1/13,Hide,Hide,2,2013,20892,20892,21889,21889,1,997,997,0.045547992,0.045547992
FALSE,Summit County,2/1/14,Hide,Hide,2,2014,21589,21589,22410,22410,1,821,821,0.036635431,0.036635431
FALSE,Summit County,2/1/15,Hide,Hide,2,2015,22007,22007,22759,22759,1,752,752,0.033041874,0.033041874
FALSE,Summit County,2/1/16,Hide,Hide,2,2016,22793,22793,23555,23555,1,762,762,0.03234982,0.03234982
FALSE,Summit County,2/1/17,Hide,Hide,2,2017,23610,23610,24371,24371,1,761,761,0.031225637,0.031225637
FALSE,Summit County,2/1/18,Hide,Hide,2,2018,23559,23559,24288,24288,1,729,729,0.030014822,0.030014822
FALSE,Summit County,2/1/19,Hide,Hide,2,2019,24120,24120,24782,24782,1,662,662,0.026712937,0.026712937
FALSE,Summit County,2/1/20,Hide,Hide,2,2020,24633,24633,25333,25333,1,700,700,0.027631943,0.027631943
FALSE,Tooele County,2/1/93,Hide,Hide,2,1993,11553,11553,12350,12350,1,797,797,0.064534413,0.064534413
FALSE,Tooele County,2/1/94,Hide,Hide,2,1994,11026,11026,11670,11670,1,644,644,0.055184233,0.055184233
FALSE,Tooele County,2/1/95,Hide,Hide,2,1995,10904,10904,11559,11559,1,655,655,0.056665802,0.056665802
FALSE,Tooele County,2/1/96,Hide,Hide,2,1996,10935,10935,11545,11545,1,610,610,0.052836726,0.052836726
FALSE,Tooele County,2/1/97,Hide,Hide,2,1997,11158,11158,11720,11720,1,562,562,0.047952218,0.047952218
FALSE,Tooele County,2/1/98,Hide,Hide,2,1998,11118,11118,11669,11669,1,551,551,0.047219128,0.047219128
FALSE,Tooele County,2/1/99,Hide,Hide,2,1999,11235,11235,11872,11872,1,637,637,0.05365566,0.05365566
FALSE,Tooele County,2/1/00,Hide,Hide,2,2000,17344,17344,18020,18020,1,676,676,0.037513873,0.037513873
FALSE,Tooele County,2/1/01,Hide,Hide,2,2001,20126,20126,21026,21026,1,900,900,0.042804147,0.042804147
FALSE,Tooele County,2/1/02,Hide,Hide,2,2002,20666,20666,21973,21973,1,1307,1307,0.059482092,0.059482092
FALSE,Tooele County,2/1/03,Hide,Hide,2,2003,21303,21303,22799,22799,1,1496,1496,0.065616913,0.065616913
FALSE,Tooele County,2/1/04,Hide,Hide,2,2004,22214,22214,23570,23570,1,1356,1356,0.057530759,0.057530759
FALSE,Tooele County,2/1/05,Hide,Hide,2,2005,23488,23488,24630,24630,1,1142,1142,0.04636622,0.04636622
FALSE,Tooele County,2/1/06,Hide,Hide,2,2006,24925,24925,25896,25896,1,971,971,0.037496138,0.037496138
FALSE,Tooele County,2/1/07,Hide,Hide,2,2007,25894,25894,26565,26565,1,671,671,0.025258799,0.025258799
FALSE,Tooele County,2/1/08,Hide,Hide,2,2008,26930,26930,27815,27815,1,885,885,0.031817365,0.031817365
FALSE,Tooele County,2/1/09,Hide,Hide,2,2009,26391,26391,28341,28341,1,1950,1950,0.068804912,0.068804912
FALSE,Tooele County,2/1/10,Hide,Hide,2,2010,25182,25182,27532,27532,1,2350,2350,0.085355223,0.085355223
FALSE,Tooele County,2/1/11,Hide,Hide,2,2011,25192,25192,27306,27306,1,2114,2114,0.077418882,0.077418882
FALSE,Tooele County,2/1/12,Hide,Hide,2,2012,25699,25699,27413,27413,1,1714,1714,0.062525079,0.062525079
FALSE,Tooele County,2/1/13,Hide,Hide,2,2013,26616,26616,28190,28190,1,1574,1574,0.055835403,0.055835403
FALSE,Tooele County,2/1/14,Hide,Hide,2,2014,27325,27325,28783,28783,1,1458,1458,0.0506549,0.0506549
FALSE,Tooele County,2/1/15,Hide,Hide,2,2015,27945,27945,29196,29196,1,1251,1251,0.042848335,0.042848335
FALSE,Tooele County,2/1/16,Hide,Hide,2,2016,29024,29024,30241,30241,1,1217,1217,0.040243378,0.040243378
FALSE,Tooele County,2/1/17,Hide,Hide,2,2017,30599,30599,31758,31758,1,1159,1159,0.036494741,0.036494741
FALSE,Tooele County,2/1/18,Hide,Hide,2,2018,31660,31660,32760,32760,1,1100,1100,0.033577534,0.033577534
FALSE,Tooele County,2/1/19,Hide,Hide,2,2019,32391,32391,33462,33462,1,1071,1071,0.032006455,0.032006455
FALSE,Tooele County,2/1/20,Hide,Hide,2,2020,33417,33417,34507,34507,1,1090,1090,0.031587794,0.031587794
FALSE,Uintah County,2/1/93,Hide,Hide,2,1993,9058,9058,9817,9817,1,759,759,0.077314862,0.077314862
FALSE,Uintah County,2/1/94,Hide,Hide,2,1994,9450,9450,10204,10204,1,754,754,0.073892591,0.073892591
FALSE,Uintah County,2/1/95,Hide,Hide,2,1995,9723,9723,10433,10433,1,710,710,0.068053292,0.068053292
FALSE,Uintah County,2/1/96,Hide,Hide,2,1996,9387,9387,10134,10134,1,747,747,0.073712256,0.073712256
FALSE,Uintah County,2/1/97,Hide,Hide,2,1997,9850,9850,10482,10482,1,632,632,0.060293837,0.060293837
FALSE,Uintah County,2/1/98,Hide,Hide,2,1998,10268,10268,10821,10821,1,553,553,0.051104334,0.051104334
FALSE,Uintah County,2/1/99,Hide,Hide,2,1999,10173,10173,11042,11042,1,869,869,0.078699511,0.078699511
FALSE,Uintah County,2/1/00,Hide,Hide,2,2000,10773,10773,11248,11248,1,475,475,0.04222973,0.04222973
FALSE,Uintah County,2/1/01,Hide,Hide,2,2001,11445,11445,11953,11953,1,508,508,0.042499791,0.042499791
FALSE,Uintah County,2/1/02,Hide,Hide,2,2002,11793,11793,12498,12498,1,705,705,0.056409025,0.056409025
FALSE,Uintah County,2/1/03,Hide,Hide,2,2003,12186,12186,12975,12975,1,789,789,0.060809249,0.060809249
FALSE,Uintah County,2/1/04,Hide,Hide,2,2004,12741,12741,13473,13473,1,732,732,0.054330884,0.054330884
FALSE,Uintah County,2/1/05,Hide,Hide,2,2005,13619,13619,14215,14215,1,596,596,0.041927541,0.041927541
FALSE,Uintah County,2/1/06,Hide,Hide,2,2006,15279,15279,15732,15732,1,453,453,0.028794813,0.028794813
FALSE,Uintah County,2/1/07,Hide,Hide,2,2007,16828,16828,17152,17152,1,324,324,0.018889925,0.018889925
FALSE,Uintah County,2/1/08,Hide,Hide,2,2008,17246,17246,17643,17643,1,397,397,0.022501842,0.022501842
FALSE,Uintah County,2/1/09,Hide,Hide,2,2009,17735,17735,18745,18745,1,1010,1010,0.053881035,0.053881035
FALSE,Uintah County,2/1/10,Hide,Hide,2,2010,14044,14044,15470,15470,1,1426,1426,0.09217841,0.09217841
FALSE,Uintah County,2/1/11,Hide,Hide,2,2011,14381,14381,15439,15439,1,1058,1058,0.068527754,0.068527754
FALSE,Uintah County,2/1/12,Hide,Hide,2,2012,15248,15248,15989,15989,1,741,741,0.046344362,0.046344362
FALSE,Uintah County,2/1/13,Hide,Hide,2,2013,15081,15081,15807,15807,1,726,726,0.045929019,0.045929019
FALSE,Uintah County,2/1/14,Hide,Hide,2,2014,15250,15250,15826,15826,1,576,576,0.036395804,0.036395804
FALSE,Uintah County,2/1/15,Hide,Hide,2,2015,15157,15157,15970,15970,1,813,813,0.050907952,0.050907952
FALSE,Uintah County,2/1/16,Hide,Hide,2,2016,13051,13051,14434,14434,1,1383,1383,0.095815436,0.095815436
FALSE,Uintah County,2/1/17,Hide,Hide,2,2017,12695,12695,13652,13652,1,957,957,0.070099619,0.070099619
FALSE,Uintah County,2/1/18,Hide,Hide,2,2018,12991,12991,13643,13643,1,652,652,0.047790075,0.047790075
FALSE,Uintah County,2/1/19,Hide,Hide,2,2019,13042,13042,13613,13613,1,571,571,0.041945199,0.041945199
FALSE,Uintah County,2/1/20,Hide,Hide,2,2020,12917,12917,13699,13699,1,782,782,0.057084459,0.057084459
FALSE,United States,2/1/93,Hide,Hide,2,1993,119275,119275000,128458,128458000,1,9183,9183000,0.071,0.071
FALSE,United States,2/1/94,Hide,Hide,2,1994,122086,122086000,130669,130669000,1,8583,8583000,0.066,0.066
FALSE,United States,2/1/95,Hide,Hide,2,1995,124928,124928000,132115,132115000,1,7187,7187000,0.054,0.054
FALSE,United States,2/1/96,Hide,Hide,2,1996,125639,125639000,132952,132952000,1,7313,7313000,0.055,0.055
FALSE,United States,2/1/97,Hide,Hide,2,1997,128298,128298000,135400,135400000,1,7102,7102000,0.052,0.052
FALSE,United States,2/1/98,Hide,Hide,2,1998,130807,130807000,137112,137112000,1,6306,6306000,0.046,0.046
FALSE,United States,2/1/99,Hide,Hide,2,1999,132856,132856000,138967,138967000,1,6111,6111000,0.044,0.044
FALSE,United States,2/1/00,Hide,Hide,2,2000,136598,136598000,142456,142456000,1,5858,5858000,0.041,0.041
FALSE,United States,2/1/01,Hide,Hide,2,2001,137612,137612000,143701,143701000,1,6089,6089000,0.042,0.042
FALSE,United States,2/1/02,Hide,Hide,2,2002,136438,136438000,144653,144653000,1,8215,8215000,0.057,0.057
FALSE,United States,2/1/03,Hide,Hide,2,2003,137482,137482000,146100,146100000,1,8618,8618000,0.059,0.059
FALSE,United States,2/1/04,Hide,Hide,2,2004,138542,138542000,146709,146709000,1,8167,8167000,0.056,0.056
FALSE,United States,2/1/05,Hide,Hide,2,2005,140385,140385000,148364,148364000,1,7980,7980000,0.054,0.054
FALSE,United States,2/1/06,Hide,Hide,2,2006,143457,143457000,150641,150641000,1,7184,7184000,0.048,0.048
FALSE,United States,2/1/07,Hide,Hide,2,2007,146057,146057000,152983,152983000,1,6927,6927000,0.045,0.045
FALSE,United States,2/1/08,Hide,Hide,2,2008,146156,146156000,153653,153653000,1,7497,7497000,0.049,0.049
FALSE,United States,2/1/09,Hide,Hide,2,2009,141640,141640000,154538,154538000,1,12898,12898000,0.083,0.083
FALSE,United States,2/1/10,Hide,Hide,2,2010,138581,138581000,153694,153694000,1,15113,15113000,0.098,0.098
FALSE,United States,2/1/11,Hide,Hide,2,2011,139394,139394000,153214,153214000,1,13820,13820000,0.09,0.09
FALSE,United States,2/1/12,Hide,Hide,2,2012,141858,141858000,154671,154671000,1,12813,12813000,0.083,0.083
FALSE,United States,2/1/13,Hide,Hide,2,2013,143362,143362000,155312,155312000,1,11950,11950000,0.077,0.077
FALSE,United States,2/1/14,Hide,Hide,2,2014,145134,145134000,155483,155483000,1,10349,10349000,0.067,0.067
FALSE,United States,2/1/15,Hide,Hide,2,2015,148045,148045000,156644,156644000,1,8599,8599000,0.055,0.055
FALSE,United States,2/1/16,Hide,Hide,2,2016,150908,150908000,158653,158653000,1,7746,7746000,0.049,0.049
FALSE,United States,2/1/17,Hide,Hide,2,2017,152368,152368000,159767,159767000,1,7399,7399000,0.046,0.046
FALSE,United States,2/1/18,Hide,Hide,2,2018,155142,155142000,161783,161783000,1,6641,6641000,0.041,0.041
FALSE,United States,2/1/19,Hide,Hide,2,2019,156866,156866000,163047,163047000,1,6181,6181000,0.038,0.038
FALSE,United States,2/1/20,Hide,Hide,2,2020,158759,158759000,164546,164546000,1,5787,5787000,0.035169497,0.035169497
FALSE,Utah County,2/1/93,Hide,Hide,2,1993,127999,127999,133136,133136,1,5137,5137,0.038584605,0.038584605
FALSE,Utah County,2/1/94,Hide,Hide,2,1994,138787,138787,143208,143208,1,4421,4421,0.03087118,0.03087118
FALSE,Utah County,2/1/95,Hide,Hide,2,1995,142018,142018,146468,146468,1,4450,4450,0.030382063,0.030382063
FALSE,Utah County,2/1/96,Hide,Hide,2,1996,148294,148294,152506,152506,1,4212,4212,0.027618585,0.027618585
FALSE,Utah County,2/1/97,Hide,Hide,2,1997,152862,152862,157138,157138,1,4276,4276,0.02721175,0.02721175
FALSE,Utah County,2/1/98,Hide,Hide,2,1998,157191,157191,161928,161928,1,4737,4737,0.029253742,0.029253742
FALSE,Utah County,2/1/99,Hide,Hide,2,1999,163294,163294,168733,168733,1,5439,5439,0.032234358,0.032234358
FALSE,Utah County,2/1/00,Hide,Hide,2,2000,172917,172917,177602,177602,1,4685,4685,0.026379207,0.026379207
FALSE,Utah County,2/1/01,Hide,Hide,2,2001,177218,177218,183511,183511,1,6293,6293,0.034292222,0.034292222
FALSE,Utah County,2/1/02,Hide,Hide,2,2002,173980,173980,184551,184551,1,10571,10571,0.05727956,0.05727956
FALSE,Utah County,2/1/03,Hide,Hide,2,2003,176878,176878,187318,187318,1,10440,10440,0.055734099,0.055734099
FALSE,Utah County,2/1/04,Hide,Hide,2,2004,183937,183937,193624,193624,1,9687,9687,0.050029955,0.050029955
FALSE,Utah County,2/1/05,Hide,Hide,2,2005,193431,193431,201709,201709,1,8278,8278,0.041039319,0.041039319
FALSE,Utah County,2/1/06,Hide,Hide,2,2006,203852,203852,210656,210656,1,6804,6804,0.032299104,0.032299104
FALSE,Utah County,2/1/07,Hide,Hide,2,2007,215820,215820,220793,220793,1,4973,4973,0.022523359,0.022523359
FALSE,Utah County,2/1/08,Hide,Hide,2,2008,217198,217198,223906,223906,1,6708,6708,0.029959001,0.029959001
FALSE,Utah County,2/1/09,Hide,Hide,2,2009,209262,209262,223107,223107,1,13845,13845,0.062055426,0.062055426
FALSE,Utah County,2/1/10,Hide,Hide,2,2010,210786,210786,227863,227863,1,17077,17077,0.074944155,0.074944155
FALSE,Utah County,2/1/11,Hide,Hide,2,2011,213918,213918,229860,229860,1,15942,15942,0.06935526,0.06935526
FALSE,Utah County,2/1/12,Hide,Hide,2,2012,221722,221722,234158,234158,1,12436,12436,0.053109439,0.053109439
FALSE,Utah County,2/1/13,Hide,Hide,2,2013,233803,233803,244916,244916,1,11113,11113,0.045374741,0.045374741
FALSE,Utah County,2/1/14,Hide,Hide,2,2014,242981,242981,252376,252376,1,9395,9395,0.037226202,0.037226202
FALSE,Utah County,2/1/15,Hide,Hide,2,2015,252576,252576,261081,261081,1,8505,8505,0.032576097,0.032576097
FALSE,Utah County,2/1/16,Hide,Hide,2,2016,265009,265009,273706,273706,1,8697,8697,0.03177497,0.03177497
FALSE,Utah County,2/1/17,Hide,Hide,2,2017,277938,277938,286537,286537,1,8599,8599,0.030010086,0.030010086
FALSE,Utah County,2/1/18,Hide,Hide,2,2018,288746,288746,297020,297020,1,8274,8274,0.02785671,0.02785671
FALSE,Utah County,2/1/19,Hide,Hide,2,2019,296034,296034,303850,303850,1,7816,7816,0.025723219,0.025723219
FALSE,Utah County,2/1/20,Hide,Hide,2,2020,304135,304135,312454,312454,1,8319,8319,0.026624719,0.026624719
FALSE,Wasatch County,2/1/93,Hide,Hide,2,1993,4656,4656,4983,4983,1,327,327,0.065623119,0.065623119
FALSE,Wasatch County,2/1/94,Hide,Hide,2,1994,4958,4958,5244,5244,1,286,286,0.05453852,0.05453852
FALSE,Wasatch County,2/1/95,Hide,Hide,2,1995,5145,5145,5448,5448,1,303,303,0.05561674,0.05561674
FALSE,Wasatch County,2/1/96,Hide,Hide,2,1996,5276,5276,5524,5524,1,248,248,0.044895004,0.044895004
FALSE,Wasatch County,2/1/97,Hide,Hide,2,1997,5608,5608,5834,5834,1,226,226,0.03873843,0.03873843
FALSE,Wasatch County,2/1/98,Hide,Hide,2,1998,5897,5897,6201,6201,1,304,304,0.049024351,0.049024351
FALSE,Wasatch County,2/1/99,Hide,Hide,2,1999,6172,6172,6459,6459,1,287,287,0.044434123,0.044434123
FALSE,Wasatch County,2/1/00,Hide,Hide,2,2000,6984,6984,7224,7224,1,240,240,0.033222591,0.033222591
FALSE,Wasatch County,2/1/01,Hide,Hide,2,2001,7269,7269,7599,7599,1,330,330,0.043426767,0.043426767
FALSE,Wasatch County,2/1/02,Hide,Hide,2,2002,7607,7607,8110,8110,1,503,503,0.062022195,0.062022195
FALSE,Wasatch County,2/1/03,Hide,Hide,2,2003,7748,7748,8268,8268,1,520,520,0.062893082,0.062893082
FALSE,Wasatch County,2/1/04,Hide,Hide,2,2004,8109,8109,8616,8616,1,507,507,0.058844011,0.058844011
FALSE,Wasatch County,2/1/05,Hide,Hide,2,2005,8741,8741,9141,9141,1,400,400,0.043758889,0.043758889
FALSE,Wasatch County,2/1/06,Hide,Hide,2,2006,9399,9399,9741,9741,1,342,342,0.035109332,0.035109332
FALSE,Wasatch County,2/1/07,Hide,Hide,2,2007,10284,10284,10524,10524,1,240,240,0.022805017,0.022805017
FALSE,Wasatch County,2/1/08,Hide,Hide,2,2008,10150,10150,10469,10469,1,319,319,0.030470914,0.030470914
FALSE,Wasatch County,2/1/09,Hide,Hide,2,2009,9257,9257,9980,9980,1,723,723,0.07244489,0.07244489
FALSE,Wasatch County,2/1/10,Hide,Hide,2,2010,10156,10156,11104,11104,1,948,948,0.08537464,0.08537464
FALSE,Wasatch County,2/1/11,Hide,Hide,2,2011,10575,10575,11442,11442,1,867,867,0.075773466,0.075773466
FALSE,Wasatch County,2/1/12,Hide,Hide,2,2012,10799,10799,11501,11501,1,702,702,0.061038171,0.061038171
FALSE,Wasatch County,2/1/13,Hide,Hide,2,2013,11426,11426,12030,12030,1,604,604,0.050207814,0.050207814
FALSE,Wasatch County,2/1/14,Hide,Hide,2,2014,12115,12115,12629,12629,1,514,514,0.040699976,0.040699976
FALSE,Wasatch County,2/1/15,Hide,Hide,2,2015,12540,12540,12992,12992,1,452,452,0.03479064,0.03479064
FALSE,Wasatch County,2/1/16,Hide,Hide,2,2016,13179,13179,13670,13670,1,491,491,0.035918069,0.035918069
FALSE,Wasatch County,2/1/17,Hide,Hide,2,2017,13875,13875,14355,14355,1,480,480,0.033437827,0.033437827
FALSE,Wasatch County,2/1/18,Hide,Hide,2,2018,14370,14370,14832,14832,1,462,462,0.031148867,0.031148867
FALSE,Wasatch County,2/1/19,Hide,Hide,2,2019,15271,15271,15725,15725,1,454,454,0.028871224,0.028871224
FALSE,Wasatch County,2/1/20,Hide,Hide,2,2020,16091,16091,16595,16595,1,504,504,0.030370594,0.030370594
FALSE,Washington County,2/1/93,Hide,Hide,2,1993,23507,23507,24519,24519,1,1012,1012,0.041274114,0.041274114
FALSE,Washington County,2/1/94,Hide,Hide,2,1994,28343,28343,29178,29178,1,835,835,0.028617452,0.028617452
FALSE,Washington County,2/1/95,Hide,Hide,2,1995,30903,30903,31930,31930,1,1027,1027,0.032164109,0.032164109
FALSE,Washington County,2/1/96,Hide,Hide,2,1996,33029,33029,34198,34198,1,1169,1169,0.034183286,0.034183286
FALSE,Washington County,2/1/97,Hide,Hide,2,1997,33729,33729,34960,34960,1,1231,1231,0.03521167,0.03521167
FALSE,Washington County,2/1/98,Hide,Hide,2,1998,35265,35265,36514,36514,1,1249,1249,0.034206058,0.034206058
FALSE,Washington County,2/1/99,Hide,Hide,2,1999,37070,37070,38443,38443,1,1373,1373,0.035715215,0.035715215
FALSE,Washington County,2/1/00,Hide,Hide,2,2000,37539,37539,38842,38842,1,1303,1303,0.033546161,0.033546161
FALSE,Washington County,2/1/01,Hide,Hide,2,2001,39462,39462,41107,41107,1,1645,1645,0.040017515,0.040017515
FALSE,Washington County,2/1/02,Hide,Hide,2,2002,41447,41447,43567,43567,1,2120,2120,0.048660684,0.048660684
FALSE,Washington County,2/1/03,Hide,Hide,2,2003,43850,43850,46410,46410,1,2560,2560,0.055160526,0.055160526
FALSE,Washington County,2/1/04,Hide,Hide,2,2004,47645,47645,50198,50198,1,2553,2553,0.0508586,0.0508586
FALSE,Washington County,2/1/05,Hide,Hide,2,2005,52618,52618,54969,54969,1,2351,2351,0.042769561,0.042769561
FALSE,Washington County,2/1/06,Hide,Hide,2,2006,58365,58365,60341,60341,1,1976,1976,0.03274722,0.03274722
FALSE,Washington County,2/1/07,Hide,Hide,2,2007,61075,61075,62687,62687,1,1612,1612,0.025715061,0.025715061
FALSE,Washington County,2/1/08,Hide,Hide,2,2008,61113,61113,63334,63334,1,2221,2221,0.035068052,0.035068052
FALSE,Washington County,2/1/09,Hide,Hide,2,2009,55546,55546,60854,60854,1,5308,5308,0.087225162,0.087225162
FALSE,Washington County,2/1/10,Hide,Hide,2,2010,51291,51291,57278,57278,1,5987,5987,0.104525298,0.104525298
FALSE,Washington County,2/1/11,Hide,Hide,2,2011,50589,50589,56016,56016,1,5427,5427,0.096883033,0.096883033
FALSE,Washington County,2/1/12,Hide,Hide,2,2012,52322,52322,56545,56545,1,4223,4223,0.07468388,0.07468388
FALSE,Washington County,2/1/13,Hide,Hide,2,2013,54692,54692,58237,58237,1,3545,3545,0.060871954,0.060871954
FALSE,Washington County,2/1/14,Hide,Hide,2,2014,58200,58200,60990,60990,1,2790,2790,0.045745204,0.045745204
FALSE,Washington County,2/1/15,Hide,Hide,2,2015,60150,60150,62789,62789,1,2639,2639,0.042029655,0.042029655
FALSE,Washington County,2/1/16,Hide,Hide,2,2016,63084,63084,65685,65685,1,2601,2601,0.039598082,0.039598082
FALSE,Washington County,2/1/17,Hide,Hide,2,2017,67065,67065,69525,69525,1,2460,2460,0.035382956,0.035382956
FALSE,Washington County,2/1/18,Hide,Hide,2,2018,70640,70640,73100,73100,1,2460,2460,0.033652531,0.033652531
FALSE,Washington County,2/1/19,Hide,Hide,2,2019,72841,72841,75219,75219,1,2378,2378,0.031614353,0.031614353
FALSE,Washington County,2/1/20,Hide,Hide,2,2020,75186,75186,77800,77800,1,2614,2614,0.033598972,0.033598972
FALSE,Wayne County,2/1/93,Hide,Hide,2,1993,965,965,1050,1050,1,85,85,0.080952381,0.080952381
FALSE,Wayne County,2/1/94,Hide,Hide,2,1994,1049,1049,1139,1139,1,90,90,0.079016681,0.079016681
FALSE,Wayne County,2/1/95,Hide,Hide,2,1995,1171,1171,1248,1248,1,77,77,0.061698718,0.061698718
FALSE,Wayne County,2/1/96,Hide,Hide,2,1996,1261,1261,1336,1336,1,75,75,0.056137725,0.056137725
FALSE,Wayne County,2/1/97,Hide,Hide,2,1997,1286,1286,1359,1359,1,73,73,0.053715968,0.053715968
FALSE,Wayne County,2/1/98,Hide,Hide,2,1998,1432,1432,1513,1513,1,81,81,0.053536021,0.053536021
FALSE,Wayne County,2/1/99,Hide,Hide,2,1999,1366,1366,1458,1458,1,92,92,0.063100137,0.063100137
FALSE,Wayne County,2/1/00,Hide,Hide,2,2000,1298,1298,1356,1356,1,58,58,0.042772861,0.042772861
FALSE,Wayne County,2/1/01,Hide,Hide,2,2001,1292,1292,1366,1366,1,74,74,0.054172767,0.054172767
FALSE,Wayne County,2/1/02,Hide,Hide,2,2002,1417,1417,1498,1498,1,81,81,0.054072096,0.054072096
FALSE,Wayne County,2/1/03,Hide,Hide,2,2003,1278,1278,1364,1364,1,86,86,0.063049853,0.063049853
FALSE,Wayne County,2/1/04,Hide,Hide,2,2004,1274,1274,1363,1363,1,89,89,0.065297139,0.065297139
FALSE,Wayne County,2/1/05,Hide,Hide,2,2005,1226,1226,1299,1299,1,73,73,0.056197075,0.056197075
FALSE,Wayne County,2/1/06,Hide,Hide,2,2006,1308,1308,1375,1375,1,67,67,0.048727273,0.048727273
FALSE,Wayne County,2/1/07,Hide,Hide,2,2007,1354,1354,1408,1408,1,54,54,0.038352273,0.038352273
FALSE,Wayne County,2/1/08,Hide,Hide,2,2008,1297,1297,1361,1361,1,64,64,0.047024247,0.047024247
FALSE,Wayne County,2/1/09,Hide,Hide,2,2009,1352,1352,1466,1466,1,114,114,0.077762619,0.077762619
FALSE,Wayne County,2/1/10,Hide,Hide,2,2010,1426,1426,1558,1558,1,132,132,0.084724005,0.084724005
FALSE,Wayne County,2/1/11,Hide,Hide,2,2011,1366,1366,1500,1500,1,134,134,0.089333333,0.089333333
FALSE,Wayne County,2/1/12,Hide,Hide,2,2012,1194,1194,1338,1338,1,144,144,0.107623318,0.107623318
FALSE,Wayne County,2/1/13,Hide,Hide,2,2013,1189,1189,1342,1342,1,153,153,0.114008942,0.114008942
FALSE,Wayne County,2/1/14,Hide,Hide,2,2014,1265,1265,1398,1398,1,133,133,0.095135908,0.095135908
FALSE,Wayne County,2/1/15,Hide,Hide,2,2015,1272,1272,1402,1402,1,130,130,0.092724679,0.092724679
FALSE,Wayne County,2/1/16,Hide,Hide,2,2016,1330,1330,1447,1447,1,117,117,0.080856945,0.080856945
FALSE,Wayne County,2/1/17,Hide,Hide,2,2017,1331,1331,1444,1444,1,113,113,0.078254848,0.078254848
FALSE,Wayne County,2/1/18,Hide,Hide,2,2018,1355,1355,1445,1445,1,90,90,0.062283737,0.062283737
FALSE,Wayne County,2/1/19,Hide,Hide,2,2019,1338,1338,1418,1418,1,80,80,0.056417489,0.056417489
FALSE,Wayne County,2/1/20,Hide,Hide,2,2020,1363,1363,1457,1457,1,94,94,0.064516129,0.064516129
FALSE,Weber County,2/1/93,Hide,Hide,2,1993,81229,81229,86046,86046,1,4817,4817,0.055981684,0.055981684
FALSE,Weber County,2/1/94,Hide,Hide,2,1994,86824,86824,90885,90885,1,4061,4061,0.044682841,0.044682841
FALSE,Weber County,2/1/95,Hide,Hide,2,1995,87935,87935,92026,92026,1,4091,4091,0.044454828,0.044454828
FALSE,Weber County,2/1/96,Hide,Hide,2,1996,90715,90715,94617,94617,1,3902,3902,0.041239946,0.041239946
FALSE,Weber County,2/1/97,Hide,Hide,2,1997,94024,94024,97814,97814,1,3790,3790,0.03874701,0.03874701
FALSE,Weber County,2/1/98,Hide,Hide,2,1998,95948,95948,100496,100496,1,4548,4548,0.045255533,0.045255533
FALSE,Weber County,2/1/99,Hide,Hide,2,1999,98146,98146,102648,102648,1,4502,4502,0.043858624,0.043858624
FALSE,Weber County,2/1/00,Hide,Hide,2,2000,97039,97039,100978,100978,1,3939,3939,0.039008497,0.039008497
FALSE,Weber County,2/1/01,Hide,Hide,2,2001,96659,96659,101775,101775,1,5116,5116,0.050267747,0.050267747
FALSE,Weber County,2/1/02,Hide,Hide,2,2002,96898,96898,103242,103242,1,6344,6344,0.06144786,0.06144786
FALSE,Weber County,2/1/03,Hide,Hide,2,2003,98297,98297,105155,105155,1,6858,6858,0.065218012,0.065218012
FALSE,Weber County,2/1/04,Hide,Hide,2,2004,100220,100220,106505,106505,1,6285,6285,0.059011314,0.059011314
FALSE,Weber County,2/1/05,Hide,Hide,2,2005,102158,102158,107424,107424,1,5266,5266,0.049020703,0.049020703
FALSE,Weber County,2/1/06,Hide,Hide,2,2006,105009,105009,109271,109271,1,4262,4262,0.039003944,0.039003944
FALSE,Weber County,2/1/07,Hide,Hide,2,2007,108717,108717,111777,111777,1,3060,3060,0.027375936,0.027375936
FALSE,Weber County,2/1/08,Hide,Hide,2,2008,109635,109635,113679,113679,1,4044,4044,0.035573853,0.035573853
FALSE,Weber County,2/1/09,Hide,Hide,2,2009,106748,106748,115470,115470,1,8722,8722,0.075534771,0.075534771
FALSE,Weber County,2/1/10,Hide,Hide,2,2010,103225,103225,113032,113032,1,9807,9807,0.086763041,0.086763041
FALSE,Weber County,2/1/11,Hide,Hide,2,2011,102987,102987,112274,112274,1,9287,9287,0.082717281,0.082717281
FALSE,Weber County,2/1/12,Hide,Hide,2,2012,105243,105243,112867,112867,1,7624,7624,0.067548531,0.067548531
FALSE,Weber County,2/1/13,Hide,Hide,2,2013,107486,107486,114060,114060,1,6574,6574,0.057636332,0.057636332
FALSE,Weber County,2/1/14,Hide,Hide,2,2014,109188,109188,114490,114490,1,5302,5302,0.046309721,0.046309721
FALSE,Weber County,2/1/15,Hide,Hide,2,2015,111487,111487,116291,116291,1,4804,4804,0.041310162,0.041310162
FALSE,Weber County,2/1/16,Hide,Hide,2,2016,113943,113943,118766,118766,1,4823,4823,0.040609265,0.040609265
FALSE,Weber County,2/1/17,Hide,Hide,2,2017,117894,117894,122413,122413,1,4519,4519,0.036916014,0.036916014
FALSE,Weber County,2/1/18,Hide,Hide,2,2018,120156,120156,124481,124481,1,4325,4325,0.034744258,0.034744258
FALSE,Weber County,2/1/19,Hide,Hide,2,2019,122236,122236,126427,126427,1,4191,4191,0.033149565,0.033149565
FALSE,Weber County,2/1/20,Hide,Hide,2,2020,125114,125114,129116,129116,1,4002,4002,0.030995384,0.030995384
FALSE,Beaver County,3/1/93,Hide,Hide,3,1993,2005,2005,2102,2102,1,97,97,0.046146527,0.046146527
FALSE,Beaver County,3/1/94,Hide,Hide,3,1994,2048,2048,2138,2138,1,90,90,0.042095416,0.042095416
FALSE,Beaver County,3/1/95,Hide,Hide,3,1995,2216,2216,2292,2292,1,76,76,0.033158813,0.033158813
FALSE,Beaver County,3/1/96,Hide,Hide,3,1996,2351,2351,2474,2474,1,123,123,0.049717057,0.049717057
FALSE,Beaver County,3/1/97,Hide,Hide,3,1997,2441,2441,2576,2576,1,135,135,0.052406832,0.052406832
FALSE,Beaver County,3/1/98,Hide,Hide,3,1998,2400,2400,2525,2525,1,125,125,0.04950495,0.04950495
FALSE,Beaver County,3/1/99,Hide,Hide,3,1999,2391,2391,2480,2480,1,89,89,0.035887097,0.035887097
FALSE,Beaver County,3/1/00,Hide,Hide,3,2000,2600,2600,2687,2687,1,87,87,0.032378117,0.032378117
FALSE,Beaver County,3/1/01,Hide,Hide,3,2001,2661,2661,2767,2767,1,106,106,0.038308638,0.038308638
FALSE,Beaver County,3/1/02,Hide,Hide,3,2002,2967,2967,3102,3102,1,135,135,0.043520309,0.043520309
FALSE,Beaver County,3/1/03,Hide,Hide,3,2003,2831,2831,2988,2988,1,157,157,0.052543507,0.052543507
FALSE,Beaver County,3/1/04,Hide,Hide,3,2004,3016,3016,3156,3156,1,140,140,0.044359949,0.044359949
FALSE,Beaver County,3/1/05,Hide,Hide,3,2005,2893,2893,3019,3019,1,126,126,0.041735674,0.041735674
FALSE,Beaver County,3/1/06,Hide,Hide,3,2006,2963,2963,3068,3068,1,105,105,0.03422425,0.03422425
FALSE,Beaver County,3/1/07,Hide,Hide,3,2007,3164,3164,3237,3237,1,73,73,0.022551745,0.022551745
FALSE,Beaver County,3/1/08,Hide,Hide,3,2008,2948,2948,3032,3032,1,84,84,0.027704485,0.027704485
FALSE,Beaver County,3/1/09,Hide,Hide,3,2009,3249,3249,3451,3451,1,202,202,0.058533758,0.058533758
FALSE,Beaver County,3/1/10,Hide,Hide,3,2010,2790,2790,3104,3104,1,314,314,0.101159794,0.101159794
FALSE,Beaver County,3/1/11,Hide,Hide,3,2011,2819,2819,3083,3083,1,264,264,0.085630879,0.085630879
FALSE,Beaver County,3/1/12,Hide,Hide,3,2012,2721,2721,2912,2912,1,191,191,0.065590659,0.065590659
FALSE,Beaver County,3/1/13,Hide,Hide,3,2013,2879,2879,3029,3029,1,150,150,0.049521294,0.049521294
FALSE,Beaver County,3/1/14,Hide,Hide,3,2014,2905,2905,3031,3031,1,126,126,0.041570439,0.041570439
FALSE,Beaver County,3/1/15,Hide,Hide,3,2015,3067,3067,3183,3183,1,116,116,0.036443607,0.036443607
FALSE,Beaver County,3/1/16,Hide,Hide,3,2016,2978,2978,3107,3107,1,129,129,0.04151915,0.04151915
FALSE,Beaver County,3/1/17,Hide,Hide,3,2017,2910,2910,3050,3050,1,140,140,0.045901639,0.045901639
FALSE,Beaver County,3/1/18,Hide,Hide,3,2018,2903,2903,3014,3014,1,111,111,0.036828135,0.036828135
FALSE,Beaver County,3/1/19,Hide,Hide,3,2019,2813,2813,2904,2904,1,91,91,0.031336088,0.031336088
FALSE,Beaver County,3/1/20,Hide,Hide,3,2020,2703,2703,2793,2793,1,90,90,0.032223416,0.032223416
FALSE,Box Elder County,3/1/93,Hide,Hide,3,1993,16045,16045,16962,16962,1,917,917,0.054062021,0.054062021
FALSE,Box Elder County,3/1/94,Hide,Hide,3,1994,16906,16906,17798,17798,1,892,892,0.050117991,0.050117991
FALSE,Box Elder County,3/1/95,Hide,Hide,3,1995,17235,17235,18074,18074,1,839,839,0.046420272,0.046420272
FALSE,Box Elder County,3/1/96,Hide,Hide,3,1996,17015,17015,17806,17806,1,791,791,0.044423228,0.044423228
FALSE,Box Elder County,3/1/97,Hide,Hide,3,1997,17817,17817,18503,18503,1,686,686,0.037075069,0.037075069
FALSE,Box Elder County,3/1/98,Hide,Hide,3,1998,18293,18293,19147,19147,1,854,854,0.044602288,0.044602288
FALSE,Box Elder County,3/1/99,Hide,Hide,3,1999,17722,17722,18579,18579,1,857,857,0.046127348,0.046127348
FALSE,Box Elder County,3/1/00,Hide,Hide,3,2000,19031,19031,19748,19748,1,717,717,0.036307474,0.036307474
FALSE,Box Elder County,3/1/01,Hide,Hide,3,2001,19217,19217,20104,20104,1,887,887,0.044120573,0.044120573
FALSE,Box Elder County,3/1/02,Hide,Hide,3,2002,19918,19918,21081,21081,1,1163,1163,0.055168161,0.055168161
FALSE,Box Elder County,3/1/03,Hide,Hide,3,2003,19880,19880,21070,21070,1,1190,1190,0.056478405,0.056478405
FALSE,Box Elder County,3/1/04,Hide,Hide,3,2004,20981,20981,22114,22114,1,1133,1133,0.051234512,0.051234512
FALSE,Box Elder County,3/1/05,Hide,Hide,3,2005,21080,21080,22095,22095,1,1015,1015,0.045937995,0.045937995
FALSE,Box Elder County,3/1/06,Hide,Hide,3,2006,21911,21911,22711,22711,1,800,800,0.035225221,0.035225221
FALSE,Box Elder County,3/1/07,Hide,Hide,3,2007,22823,22823,23416,23416,1,593,593,0.025324564,0.025324564
FALSE,Box Elder County,3/1/08,Hide,Hide,3,2008,22954,22954,23686,23686,1,732,732,0.030904332,0.030904332
FALSE,Box Elder County,3/1/09,Hide,Hide,3,2009,21467,21467,23323,23323,1,1856,1856,0.079578099,0.079578099
FALSE,Box Elder County,3/1/10,Hide,Hide,3,2010,21525,21525,23487,23487,1,1962,1962,0.083535573,0.083535573
FALSE,Box Elder County,3/1/11,Hide,Hide,3,2011,21307,21307,23195,23195,1,1888,1888,0.081396853,0.081396853
FALSE,Box Elder County,3/1/12,Hide,Hide,3,2012,21546,21546,22928,22928,1,1382,1382,0.060275645,0.060275645
FALSE,Box Elder County,3/1/13,Hide,Hide,3,2013,22016,22016,23164,23164,1,1148,1148,0.049559662,0.049559662
FALSE,Box Elder County,3/1/14,Hide,Hide,3,2014,22467,22467,23386,23386,1,919,919,0.039297015,0.039297015
FALSE,Box Elder County,3/1/15,Hide,Hide,3,2015,23049,23049,23950,23950,1,901,901,0.037620042,0.037620042
FALSE,Box Elder County,3/1/16,Hide,Hide,3,2016,23542,23542,24429,24429,1,887,887,0.036309305,0.036309305
FALSE,Box Elder County,3/1/17,Hide,Hide,3,2017,24342,24342,25188,25188,1,846,846,0.033587423,0.033587423
FALSE,Box Elder County,3/1/18,Hide,Hide,3,2018,24656,24656,25406,25406,1,750,750,0.029520586,0.029520586
FALSE,Box Elder County,3/1/19,Hide,Hide,3,2019,25016,25016,25734,25734,1,718,718,0.027900832,0.027900832
FALSE,Box Elder County,3/1/20,Hide,Hide,3,2020,25451,25451,26238,26238,1,787,787,0.029994664,0.029994664
FALSE,Cache County,3/1/93,Hide,Hide,3,1993,36631,36631,37865,37865,1,1234,1234,0.032589463,0.032589463
FALSE,Cache County,3/1/94,Hide,Hide,3,1994,38872,38872,40006,40006,1,1134,1134,0.028345748,0.028345748
FALSE,Cache County,3/1/95,Hide,Hide,3,1995,40129,40129,41430,41430,1,1301,1301,0.031402365,0.031402365
FALSE,Cache County,3/1/96,Hide,Hide,3,1996,40670,40670,41906,41906,1,1236,1236,0.029494583,0.029494583
FALSE,Cache County,3/1/97,Hide,Hide,3,1997,41931,41931,43090,43090,1,1159,1159,0.026897192,0.026897192
FALSE,Cache County,3/1/98,Hide,Hide,3,1998,43087,43087,44392,44392,1,1305,1305,0.029397189,0.029397189
FALSE,Cache County,3/1/99,Hide,Hide,3,1999,43675,43675,44828,44828,1,1153,1153,0.025720532,0.025720532
FALSE,Cache County,3/1/00,Hide,Hide,3,2000,46282,46282,47551,47551,1,1269,1269,0.026687136,0.026687136
FALSE,Cache County,3/1/01,Hide,Hide,3,2001,47408,47408,49022,49022,1,1614,1614,0.032923993,0.032923993
FALSE,Cache County,3/1/02,Hide,Hide,3,2002,49939,49939,52031,52031,1,2092,2092,0.0402068,0.0402068
FALSE,Cache County,3/1/03,Hide,Hide,3,2003,50998,50998,53199,53199,1,2201,2201,0.041372958,0.041372958
FALSE,Cache County,3/1/04,Hide,Hide,3,2004,53733,53733,55780,55780,1,2047,2047,0.036697741,0.036697741
FALSE,Cache County,3/1/05,Hide,Hide,3,2005,55175,55175,57059,57059,1,1884,1884,0.033018455,0.033018455
FALSE,Cache County,3/1/06,Hide,Hide,3,2006,56242,56242,57724,57724,1,1482,1482,0.025673896,0.025673896
FALSE,Cache County,3/1/07,Hide,Hide,3,2007,59142,59142,60242,60242,1,1100,1100,0.018259686,0.018259686
FALSE,Cache County,3/1/08,Hide,Hide,3,2008,60088,60088,61546,61546,1,1458,1458,0.023689598,0.023689598
FALSE,Cache County,3/1/09,Hide,Hide,3,2009,58797,58797,62057,62057,1,3260,3260,0.052532349,0.052532349
FALSE,Cache County,3/1/10,Hide,Hide,3,2010,54200,54200,57660,57660,1,3460,3460,0.060006937,0.060006937
FALSE,Cache County,3/1/11,Hide,Hide,3,2011,53966,53966,57115,57115,1,3149,3149,0.055134378,0.055134378
FALSE,Cache County,3/1/12,Hide,Hide,3,2012,54266,54266,56909,56909,1,2643,2643,0.046442566,0.046442566
FALSE,Cache County,3/1/13,Hide,Hide,3,2013,55276,55276,57677,57677,1,2401,2401,0.041628379,0.041628379
FALSE,Cache County,3/1/14,Hide,Hide,3,2014,56700,56700,58600,58600,1,1900,1900,0.032423208,0.032423208
FALSE,Cache County,3/1/15,Hide,Hide,3,2015,57866,57866,59645,59645,1,1779,1779,0.029826473,0.029826473
FALSE,Cache County,3/1/16,Hide,Hide,3,2016,58912,58912,60854,60854,1,1942,1942,0.031912446,0.031912446
FALSE,Cache County,3/1/17,Hide,Hide,3,2017,60489,60489,62267,62267,1,1778,1778,0.028554451,0.028554451
FALSE,Cache County,3/1/18,Hide,Hide,3,2018,61262,61262,62916,62916,1,1654,1654,0.02628902,0.02628902
FALSE,Cache County,3/1/19,Hide,Hide,3,2019,62628,62628,64121,64121,1,1493,1493,0.023284103,0.023284103
FALSE,Cache County,3/1/20,Hide,Hide,3,2020,62693,62693,64285,64285,1,1592,1592,0.02476472,0.02476472
FALSE,Carbon County,3/1/93,Hide,Hide,3,1993,8165,8165,8890,8890,1,725,725,0.081552306,0.081552306
FALSE,Carbon County,3/1/94,Hide,Hide,3,1994,8684,8684,9397,9397,1,713,713,0.075875279,0.075875279
FALSE,Carbon County,3/1/95,Hide,Hide,3,1995,8549,8549,9150,9150,1,601,601,0.06568306,0.06568306
FALSE,Carbon County,3/1/96,Hide,Hide,3,1996,8729,8729,9300,9300,1,571,571,0.061397849,0.061397849
FALSE,Carbon County,3/1/97,Hide,Hide,3,1997,9152,9152,9646,9646,1,494,494,0.051212938,0.051212938
FALSE,Carbon County,3/1/98,Hide,Hide,3,1998,9247,9247,9781,9781,1,534,534,0.054595645,0.054595645
FALSE,Carbon County,3/1/99,Hide,Hide,3,1999,9222,9222,9954,9954,1,732,732,0.073538276,0.073538276
FALSE,Carbon County,3/1/00,Hide,Hide,3,2000,9044,9044,9504,9504,1,460,460,0.048400673,0.048400673
FALSE,Carbon County,3/1/01,Hide,Hide,3,2001,8355,8355,8959,8959,1,604,604,0.067418239,0.067418239
FALSE,Carbon County,3/1/02,Hide,Hide,3,2002,8774,8774,9391,9391,1,617,617,0.065701203,0.065701203
FALSE,Carbon County,3/1/03,Hide,Hide,3,2003,8716,8716,9445,9445,1,729,729,0.077183695,0.077183695
FALSE,Carbon County,3/1/04,Hide,Hide,3,2004,8606,8606,9260,9260,1,654,654,0.07062635,0.07062635
FALSE,Carbon County,3/1/05,Hide,Hide,3,2005,8900,8900,9396,9396,1,496,496,0.052788421,0.052788421
FALSE,Carbon County,3/1/06,Hide,Hide,3,2006,9392,9392,9771,9771,1,379,379,0.038788251,0.038788251
FALSE,Carbon County,3/1/07,Hide,Hide,3,2007,9431,9431,9738,9738,1,307,307,0.031525981,0.031525981
FALSE,Carbon County,3/1/08,Hide,Hide,3,2008,9469,9469,9873,9873,1,404,404,0.04091968,0.04091968
FALSE,Carbon County,3/1/09,Hide,Hide,3,2009,9882,9882,10616,10616,1,734,734,0.069140919,0.069140919
FALSE,Carbon County,3/1/10,Hide,Hide,3,2010,9064,9064,9936,9936,1,872,872,0.087761675,0.087761675
FALSE,Carbon County,3/1/11,Hide,Hide,3,2011,8874,8874,9632,9632,1,758,758,0.078696013,0.078696013
FALSE,Carbon County,3/1/12,Hide,Hide,3,2012,8757,8757,9416,9416,1,659,659,0.069987256,0.069987256
FALSE,Carbon County,3/1/13,Hide,Hide,3,2013,8444,8444,9046,9046,1,602,602,0.066548751,0.066548751
FALSE,Carbon County,3/1/14,Hide,Hide,3,2014,8247,8247,8699,8699,1,452,452,0.051959995,0.051959995
FALSE,Carbon County,3/1/15,Hide,Hide,3,2015,8288,8288,8749,8749,1,461,461,0.052691736,0.052691736
FALSE,Carbon County,3/1/16,Hide,Hide,3,2016,7941,7941,8461,8461,1,520,520,0.061458456,0.061458456
FALSE,Carbon County,3/1/17,Hide,Hide,3,2017,7846,7846,8283,8283,1,437,437,0.052758662,0.052758662
FALSE,Carbon County,3/1/18,Hide,Hide,3,2018,8037,8037,8426,8426,1,389,389,0.046166627,0.046166627
FALSE,Carbon County,3/1/19,Hide,Hide,3,2019,8112,8112,8446,8446,1,334,334,0.039545347,0.039545347
FALSE,Carbon County,3/1/20,Hide,Hide,3,2020,8202,8202,8576,8576,1,374,374,0.043610075,0.043610075
FALSE,Daggett County,3/1/93,Hide,Hide,3,1993,383,383,400,400,1,17,17,0.0425,0.0425
FALSE,Daggett County,3/1/94,Hide,Hide,3,1994,445,445,460,460,1,15,15,0.032608696,0.032608696
FALSE,Daggett County,3/1/95,Hide,Hide,3,1995,419,419,456,456,1,37,37,0.081140351,0.081140351
FALSE,Daggett County,3/1/96,Hide,Hide,3,1996,396,396,411,411,1,15,15,0.03649635,0.03649635
FALSE,Daggett County,3/1/97,Hide,Hide,3,1997,395,395,411,411,1,16,16,0.03892944,0.03892944
FALSE,Daggett County,3/1/98,Hide,Hide,3,1998,409,409,427,427,1,18,18,0.042154567,0.042154567
FALSE,Daggett County,3/1/99,Hide,Hide,3,1999,415,415,431,431,1,16,16,0.03712297,0.03712297
FALSE,Daggett County,3/1/00,Hide,Hide,3,2000,441,441,455,455,1,14,14,0.030769231,0.030769231
FALSE,Daggett County,3/1/01,Hide,Hide,3,2001,418,418,441,441,1,23,23,0.052154195,0.052154195
FALSE,Daggett County,3/1/02,Hide,Hide,3,2002,494,494,517,517,1,23,23,0.044487427,0.044487427
FALSE,Daggett County,3/1/03,Hide,Hide,3,2003,457,457,483,483,1,26,26,0.053830228,0.053830228
FALSE,Daggett County,3/1/04,Hide,Hide,3,2004,495,495,522,522,1,27,27,0.051724138,0.051724138
FALSE,Daggett County,3/1/05,Hide,Hide,3,2005,458,458,481,481,1,23,23,0.047817048,0.047817048
FALSE,Daggett County,3/1/06,Hide,Hide,3,2006,485,485,513,513,1,28,28,0.054580897,0.054580897
FALSE,Daggett County,3/1/07,Hide,Hide,3,2007,500,500,518,518,1,18,18,0.034749035,0.034749035
FALSE,Daggett County,3/1/08,Hide,Hide,3,2008,454,454,471,471,1,17,17,0.036093418,0.036093418
FALSE,Daggett County,3/1/09,Hide,Hide,3,2009,432,432,458,458,1,26,26,0.056768559,0.056768559
FALSE,Daggett County,3/1/10,Hide,Hide,3,2010,458,458,493,493,1,35,35,0.070993915,0.070993915
FALSE,Daggett County,3/1/11,Hide,Hide,3,2011,438,438,469,469,1,31,31,0.066098081,0.066098081
FALSE,Daggett County,3/1/12,Hide,Hide,3,2012,418,418,439,439,1,21,21,0.047835991,0.047835991
FALSE,Daggett County,3/1/13,Hide,Hide,3,2013,415,415,437,437,1,22,22,0.050343249,0.050343249
FALSE,Daggett County,3/1/14,Hide,Hide,3,2014,417,417,434,434,1,17,17,0.039170507,0.039170507
FALSE,Daggett County,3/1/15,Hide,Hide,3,2015,450,450,471,471,1,21,21,0.044585987,0.044585987
FALSE,Daggett County,3/1/16,Hide,Hide,3,2016,452,452,477,477,1,25,25,0.052410901,0.052410901
FALSE,Daggett County,3/1/17,Hide,Hide,3,2017,416,416,435,435,1,19,19,0.043678161,0.043678161
FALSE,Daggett County,3/1/18,Hide,Hide,3,2018,384,384,401,401,1,17,17,0.042394015,0.042394015
FALSE,Daggett County,3/1/19,Hide,Hide,3,2019,375,375,392,392,1,17,17,0.043367347,0.043367347
FALSE,Daggett County,3/1/20,Hide,Hide,3,2020,372,372,386,386,1,14,14,0.03626943,0.03626943
FALSE,Davis County,3/1/93,Hide,Hide,3,1993,94480,94480,98328,98328,1,3848,3848,0.039134326,0.039134326
FALSE,Davis County,3/1/94,Hide,Hide,3,1994,101244,101244,104747,104747,1,3503,3503,0.033442485,0.033442485
FALSE,Davis County,3/1/95,Hide,Hide,3,1995,101666,101666,105422,105422,1,3756,3756,0.035628237,0.035628237
FALSE,Davis County,3/1/96,Hide,Hide,3,1996,106455,106455,109916,109916,1,3461,3461,0.031487682,0.031487682
FALSE,Davis County,3/1/97,Hide,Hide,3,1997,111152,111152,114579,114579,1,3427,3427,0.029909495,0.029909495
FALSE,Davis County,3/1/98,Hide,Hide,3,1998,115586,115586,119546,119546,1,3960,3960,0.033125324,0.033125324
FALSE,Davis County,3/1/99,Hide,Hide,3,1999,119992,119992,124003,124003,1,4011,4011,0.032345992,0.032345992
FALSE,Davis County,3/1/00,Hide,Hide,3,2000,117111,117111,120605,120605,1,3494,3494,0.028970607,0.028970607
FALSE,Davis County,3/1/01,Hide,Hide,3,2001,117045,117045,121758,121758,1,4713,4713,0.038707929,0.038707929
FALSE,Davis County,3/1/02,Hide,Hide,3,2002,117801,117801,123857,123857,1,6056,6056,0.048895097,0.048895097
FALSE,Davis County,3/1/03,Hide,Hide,3,2003,121001,121001,127598,127598,1,6597,6597,0.051701437,0.051701437
FALSE,Davis County,3/1/04,Hide,Hide,3,2004,124822,124822,131287,131287,1,6465,6465,0.049243261,0.049243261
FALSE,Davis County,3/1/05,Hide,Hide,3,2005,128907,128907,134418,134418,1,5511,5511,0.040998973,0.040998973
FALSE,Davis County,3/1/06,Hide,Hide,3,2006,135190,135190,139651,139651,1,4461,4461,0.031943917,0.031943917
FALSE,Davis County,3/1/07,Hide,Hide,3,2007,140148,140148,143425,143425,1,3277,3277,0.022848178,0.022848178
FALSE,Davis County,3/1/08,Hide,Hide,3,2008,141265,141265,145529,145529,1,4264,4264,0.029300002,0.029300002
FALSE,Davis County,3/1/09,Hide,Hide,3,2009,136399,136399,145167,145167,1,8768,8768,0.060399402,0.060399402
FALSE,Davis County,3/1/10,Hide,Hide,3,2010,136567,136567,146885,146885,1,10318,10318,0.07024543,0.07024543
FALSE,Davis County,3/1/11,Hide,Hide,3,2011,136926,136926,146295,146295,1,9369,9369,0.064041833,0.064041833
FALSE,Davis County,3/1/12,Hide,Hide,3,2012,139991,139991,147577,147577,1,7586,7586,0.051403674,0.051403674
FALSE,Davis County,3/1/13,Hide,Hide,3,2013,144751,144751,151485,151485,1,6734,6734,0.044453246,0.044453246
FALSE,Davis County,3/1/14,Hide,Hide,3,2014,149158,149158,154856,154856,1,5698,5698,0.036795475,0.036795475
FALSE,Davis County,3/1/15,Hide,Hide,3,2015,153279,153279,158615,158615,1,5336,5336,0.033641207,0.033641207
FALSE,Davis County,3/1/16,Hide,Hide,3,2016,157150,157150,162523,162523,1,5373,5373,0.033059936,0.033059936
FALSE,Davis County,3/1/17,Hide,Hide,3,2017,162645,162645,167830,167830,1,5185,5185,0.030894357,0.030894357
FALSE,Davis County,3/1/18,Hide,Hide,3,2018,164711,164711,169625,169625,1,4914,4914,0.028969786,0.028969786
FALSE,Davis County,3/1/19,Hide,Hide,3,2019,167960,167960,172413,172413,1,4453,4453,0.025827519,0.025827519
FALSE,Davis County,3/1/20,Hide,Hide,3,2020,170922,170922,176250,176250,1,5328,5328,0.030229787,0.030229787
FALSE,Duchesne County,3/1/93,Hide,Hide,3,1993,5083,5083,5585,5585,1,502,502,0.089883617,0.089883617
FALSE,Duchesne County,3/1/94,Hide,Hide,3,1994,5164,5164,5763,5763,1,599,599,0.103938921,0.103938921
FALSE,Duchesne County,3/1/95,Hide,Hide,3,1995,5332,5332,5849,5849,1,517,517,0.088391178,0.088391178
FALSE,Duchesne County,3/1/96,Hide,Hide,3,1996,5288,5288,5788,5788,1,500,500,0.086385625,0.086385625
FALSE,Duchesne County,3/1/97,Hide,Hide,3,1997,5452,5452,5853,5853,1,401,401,0.068511874,0.068511874
FALSE,Duchesne County,3/1/98,Hide,Hide,3,1998,5755,5755,6141,6141,1,386,386,0.062856212,0.062856212
FALSE,Duchesne County,3/1/99,Hide,Hide,3,1999,5509,5509,6140,6140,1,631,631,0.10276873,0.10276873
FALSE,Duchesne County,3/1/00,Hide,Hide,3,2000,5706,5706,5991,5991,1,285,285,0.047571357,0.047571357
FALSE,Duchesne County,3/1/01,Hide,Hide,3,2001,6142,6142,6473,6473,1,331,331,0.051135486,0.051135486
FALSE,Duchesne County,3/1/02,Hide,Hide,3,2002,6514,6514,6969,6969,1,455,455,0.065289138,0.065289138
FALSE,Duchesne County,3/1/03,Hide,Hide,3,2003,6442,6442,6914,6914,1,472,472,0.068267284,0.068267284
FALSE,Duchesne County,3/1/04,Hide,Hide,3,2004,6798,6798,7225,7225,1,427,427,0.059100346,0.059100346
FALSE,Duchesne County,3/1/05,Hide,Hide,3,2005,7147,7147,7490,7490,1,343,343,0.045794393,0.045794393
FALSE,Duchesne County,3/1/06,Hide,Hide,3,2006,7889,7889,8155,8155,1,266,266,0.032618026,0.032618026
FALSE,Duchesne County,3/1/07,Hide,Hide,3,2007,8974,8974,9162,9162,1,188,188,0.020519537,0.020519537
FALSE,Duchesne County,3/1/08,Hide,Hide,3,2008,9577,9577,9831,9831,1,254,254,0.025836639,0.025836639
FALSE,Duchesne County,3/1/09,Hide,Hide,3,2009,9989,9989,10742,10742,1,753,753,0.070098678,0.070098678
FALSE,Duchesne County,3/1/10,Hide,Hide,3,2010,7515,7515,8334,8334,1,819,819,0.098272138,0.098272138
FALSE,Duchesne County,3/1/11,Hide,Hide,3,2011,7689,7689,8291,8291,1,602,602,0.072608853,0.072608853
FALSE,Duchesne County,3/1/12,Hide,Hide,3,2012,8625,8625,9056,9056,1,431,431,0.047592756,0.047592756
FALSE,Duchesne County,3/1/13,Hide,Hide,3,2013,8842,8842,9251,9251,1,409,409,0.044211437,0.044211437
FALSE,Duchesne County,3/1/14,Hide,Hide,3,2014,9256,9256,9595,9595,1,339,339,0.035330902,0.035330902
FALSE,Duchesne County,3/1/15,Hide,Hide,3,2015,8601,8601,9189,9189,1,588,588,0.063989553,0.063989553
FALSE,Duchesne County,3/1/16,Hide,Hide,3,2016,7432,7432,8235,8235,1,803,803,0.097510625,0.097510625
FALSE,Duchesne County,3/1/17,Hide,Hide,3,2017,7502,7502,8008,8008,1,506,506,0.063186813,0.063186813
FALSE,Duchesne County,3/1/18,Hide,Hide,3,2018,7433,7433,7774,7774,1,341,341,0.043864163,0.043864163
FALSE,Duchesne County,3/1/19,Hide,Hide,3,2019,7413,7413,7721,7721,1,308,308,0.039891206,0.039891206
FALSE,Duchesne County,3/1/20,Hide,Hide,3,2020,7405,7405,7839,7839,1,434,434,0.055364205,0.055364205
FALSE,Emery County,3/1/93,Hide,Hide,3,1993,3760,3760,4114,4114,1,354,354,0.086047642,0.086047642
FALSE,Emery County,3/1/94,Hide,Hide,3,1994,3867,3867,4206,4206,1,339,339,0.080599144,0.080599144
FALSE,Emery County,3/1/95,Hide,Hide,3,1995,3918,3918,4255,4255,1,337,337,0.07920094,0.07920094
FALSE,Emery County,3/1/96,Hide,Hide,3,1996,3921,3921,4238,4238,1,317,317,0.074799434,0.074799434
FALSE,Emery County,3/1/97,Hide,Hide,3,1997,3885,3885,4180,4180,1,295,295,0.070574163,0.070574163
FALSE,Emery County,3/1/98,Hide,Hide,3,1998,3885,3885,4202,4202,1,317,317,0.075440267,0.075440267
FALSE,Emery County,3/1/99,Hide,Hide,3,1999,3772,3772,4064,4064,1,292,292,0.071850394,0.071850394
FALSE,Emery County,3/1/00,Hide,Hide,3,2000,4450,4450,4657,4657,1,207,207,0.044449216,0.044449216
FALSE,Emery County,3/1/01,Hide,Hide,3,2001,4352,4352,4650,4650,1,298,298,0.064086022,0.064086022
FALSE,Emery County,3/1/02,Hide,Hide,3,2002,4405,4405,4730,4730,1,325,325,0.068710359,0.068710359
FALSE,Emery County,3/1/03,Hide,Hide,3,2003,4529,4529,4919,4919,1,390,390,0.079284407,0.079284407
FALSE,Emery County,3/1/04,Hide,Hide,3,2004,4733,4733,5115,5115,1,382,382,0.074682307,0.074682307
FALSE,Emery County,3/1/05,Hide,Hide,3,2005,4745,4745,5024,5024,1,279,279,0.055533439,0.055533439
FALSE,Emery County,3/1/06,Hide,Hide,3,2006,5015,5015,5212,5212,1,197,197,0.037797391,0.037797391
FALSE,Emery County,3/1/07,Hide,Hide,3,2007,5011,5011,5176,5176,1,165,165,0.031877898,0.031877898
FALSE,Emery County,3/1/08,Hide,Hide,3,2008,4938,4938,5119,5119,1,181,181,0.035358468,0.035358468
FALSE,Emery County,3/1/09,Hide,Hide,3,2009,4824,4824,5135,5135,1,311,311,0.060564752,0.060564752
FALSE,Emery County,3/1/10,Hide,Hide,3,2010,4875,4875,5271,5271,1,396,396,0.075128059,0.075128059
FALSE,Emery County,3/1/11,Hide,Hide,3,2011,4728,4728,5107,5107,1,379,379,0.074211866,0.074211866
FALSE,Emery County,3/1/12,Hide,Hide,3,2012,4408,4408,4755,4755,1,347,347,0.072975815,0.072975815
FALSE,Emery County,3/1/13,Hide,Hide,3,2013,4453,4453,4763,4763,1,310,310,0.06508503,0.06508503
FALSE,Emery County,3/1/14,Hide,Hide,3,2014,4421,4421,4676,4676,1,255,255,0.05453379,0.05453379
FALSE,Emery County,3/1/15,Hide,Hide,3,2015,4188,4188,4422,4422,1,234,234,0.052917232,0.052917232
FALSE,Emery County,3/1/16,Hide,Hide,3,2016,4009,4009,4302,4302,1,293,293,0.068107857,0.068107857
FALSE,Emery County,3/1/17,Hide,Hide,3,2017,3940,3940,4166,4166,1,226,226,0.05424868,0.05424868
FALSE,Emery County,3/1/18,Hide,Hide,3,2018,4085,4085,4289,4289,1,204,204,0.047563535,0.047563535
FALSE,Emery County,3/1/19,Hide,Hide,3,2019,4157,4157,4339,4339,1,182,182,0.041945149,0.041945149
FALSE,Emery County,3/1/20,Hide,Hide,3,2020,4121,4121,4330,4330,1,209,209,0.048267898,0.048267898
FALSE,Garfield County,3/1/93,Hide,Hide,3,1993,2077,2077,2320,2320,1,243,243,0.104741379,0.104741379
FALSE,Garfield County,3/1/94,Hide,Hide,3,1994,2261,2261,2510,2510,1,249,249,0.099203187,0.099203187
FALSE,Garfield County,3/1/95,Hide,Hide,3,1995,2250,2250,2591,2591,1,341,341,0.131609417,0.131609417
FALSE,Garfield County,3/1/96,Hide,Hide,3,1996,2388,2388,2640,2640,1,252,252,0.095454545,0.095454545
FALSE,Garfield County,3/1/97,Hide,Hide,3,1997,2499,2499,2738,2738,1,239,239,0.087289993,0.087289993
FALSE,Garfield County,3/1/98,Hide,Hide,3,1998,2531,2531,2769,2769,1,238,238,0.085951607,0.085951607
FALSE,Garfield County,3/1/99,Hide,Hide,3,1999,2624,2624,2862,2862,1,238,238,0.08315863,0.08315863
FALSE,Garfield County,3/1/00,Hide,Hide,3,2000,2387,2387,2550,2550,1,163,163,0.063921569,0.063921569
FALSE,Garfield County,3/1/01,Hide,Hide,3,2001,2370,2370,2569,2569,1,199,199,0.077462047,0.077462047
FALSE,Garfield County,3/1/02,Hide,Hide,3,2002,2343,2343,2597,2597,1,254,254,0.09780516,0.09780516
FALSE,Garfield County,3/1/03,Hide,Hide,3,2003,2321,2321,2552,2552,1,231,231,0.090517241,0.090517241
FALSE,Garfield County,3/1/04,Hide,Hide,3,2004,2442,2442,2645,2645,1,203,203,0.076748582,0.076748582
FALSE,Garfield County,3/1/05,Hide,Hide,3,2005,2476,2476,2674,2674,1,198,198,0.074046372,0.074046372
FALSE,Garfield County,3/1/06,Hide,Hide,3,2006,2526,2526,2672,2672,1,146,146,0.054640719,0.054640719
FALSE,Garfield County,3/1/07,Hide,Hide,3,2007,2619,2619,2730,2730,1,111,111,0.040659341,0.040659341
FALSE,Garfield County,3/1/08,Hide,Hide,3,2008,2594,2594,2752,2752,1,158,158,0.057412791,0.057412791
FALSE,Garfield County,3/1/09,Hide,Hide,3,2009,2597,2597,2883,2883,1,286,286,0.09920222,0.09920222
FALSE,Garfield County,3/1/10,Hide,Hide,3,2010,2735,2735,3051,3051,1,316,316,0.103572599,0.103572599
FALSE,Garfield County,3/1/11,Hide,Hide,3,2011,2676,2676,2997,2997,1,321,321,0.107107107,0.107107107
FALSE,Garfield County,3/1/12,Hide,Hide,3,2012,2575,2575,2843,2843,1,268,268,0.09426662,0.09426662
FALSE,Garfield County,3/1/13,Hide,Hide,3,2013,2558,2558,2811,2811,1,253,253,0.090003557,0.090003557
FALSE,Garfield County,3/1/14,Hide,Hide,3,2014,2472,2472,2708,2708,1,236,236,0.087149188,0.087149188
FALSE,Garfield County,3/1/15,Hide,Hide,3,2015,2551,2551,2796,2796,1,245,245,0.087625179,0.087625179
FALSE,Garfield County,3/1/16,Hide,Hide,3,2016,2526,2526,2768,2768,1,242,242,0.087427746,0.087427746
FALSE,Garfield County,3/1/17,Hide,Hide,3,2017,2650,2650,2866,2866,1,216,216,0.075366364,0.075366364
FALSE,Garfield County,3/1/18,Hide,Hide,3,2018,2587,2587,2811,2811,1,224,224,0.079686944,0.079686944
FALSE,Garfield County,3/1/19,Hide,Hide,3,2019,2602,2602,2779,2779,1,177,177,0.063691976,0.063691976
FALSE,Garfield County,3/1/20,Hide,Hide,3,2020,2606,2606,2814,2814,1,208,208,0.073916134,0.073916134
FALSE,Grand County,3/1/93,Hide,Hide,3,1993,4189,4189,4468,4468,1,279,279,0.062444047,0.062444047
FALSE,Grand County,3/1/94,Hide,Hide,3,1994,4540,4540,4865,4865,1,325,325,0.0668037,0.0668037
FALSE,Grand County,3/1/95,Hide,Hide,3,1995,4540,4540,4868,4868,1,328,328,0.0673788,0.0673788
FALSE,Grand County,3/1/96,Hide,Hide,3,1996,4800,4800,5141,5141,1,341,341,0.066329508,0.066329508
FALSE,Grand County,3/1/97,Hide,Hide,3,1997,4820,4820,5147,5147,1,327,327,0.063532155,0.063532155
FALSE,Grand County,3/1/98,Hide,Hide,3,1998,4863,4863,5237,5237,1,374,374,0.071414932,0.071414932
FALSE,Grand County,3/1/99,Hide,Hide,3,1999,5248,5248,5621,5621,1,373,373,0.066358299,0.066358299
FALSE,Grand County,3/1/00,Hide,Hide,3,2000,4430,4430,4731,4731,1,301,301,0.063622913,0.063622913
FALSE,Grand County,3/1/01,Hide,Hide,3,2001,4353,4353,4669,4669,1,316,316,0.067680445,0.067680445
FALSE,Grand County,3/1/02,Hide,Hide,3,2002,4477,4477,4838,4838,1,361,361,0.074617611,0.074617611
FALSE,Grand County,3/1/03,Hide,Hide,3,2003,4565,4565,4926,4926,1,361,361,0.073284612,0.073284612
FALSE,Grand County,3/1/04,Hide,Hide,3,2004,4460,4460,4820,4820,1,360,360,0.074688797,0.074688797
FALSE,Grand County,3/1/05,Hide,Hide,3,2005,4585,4585,4901,4901,1,316,316,0.064476637,0.064476637
FALSE,Grand County,3/1/06,Hide,Hide,3,2006,4736,4736,5002,5002,1,266,266,0.053178729,0.053178729
FALSE,Grand County,3/1/07,Hide,Hide,3,2007,4989,4989,5210,5210,1,221,221,0.042418426,0.042418426
FALSE,Grand County,3/1/08,Hide,Hide,3,2008,4941,4941,5212,5212,1,271,271,0.051995395,0.051995395
FALSE,Grand County,3/1/09,Hide,Hide,3,2009,4849,4849,5364,5364,1,515,515,0.09601044,0.09601044
FALSE,Grand County,3/1/10,Hide,Hide,3,2010,4810,4810,5356,5356,1,546,546,0.101941748,0.101941748
FALSE,Grand County,3/1/11,Hide,Hide,3,2011,4770,4770,5307,5307,1,537,537,0.101187111,0.101187111
FALSE,Grand County,3/1/12,Hide,Hide,3,2012,4932,4932,5386,5386,1,454,454,0.08429261,0.08429261
FALSE,Grand County,3/1/13,Hide,Hide,3,2013,5004,5004,5434,5434,1,430,430,0.079131395,0.079131395
FALSE,Grand County,3/1/14,Hide,Hide,3,2014,5132,5132,5498,5498,1,366,366,0.066569662,0.066569662
FALSE,Grand County,3/1/15,Hide,Hide,3,2015,5239,5239,5581,5581,1,342,342,0.061279341,0.061279341
FALSE,Grand County,3/1/16,Hide,Hide,3,2016,5360,5360,5696,5696,1,336,336,0.058988764,0.058988764
FALSE,Grand County,3/1/17,Hide,Hide,3,2017,5530,5530,5855,5855,1,325,325,0.055508113,0.055508113
FALSE,Grand County,3/1/18,Hide,Hide,3,2018,5773,5773,6062,6062,1,289,289,0.047674035,0.047674035
FALSE,Grand County,3/1/19,Hide,Hide,3,2019,5856,5856,6107,6107,1,251,251,0.041100377,0.041100377
FALSE,Grand County,3/1/20,Hide,Hide,3,2020,6097,6097,6408,6408,1,311,311,0.048533084,0.048533084
FALSE,Iron County,3/1/93,Hide,Hide,3,1993,10512,10512,10934,10934,1,422,422,0.038595208,0.038595208
FALSE,Iron County,3/1/94,Hide,Hide,3,1994,11447,11447,11876,11876,1,429,429,0.036123274,0.036123274
FALSE,Iron County,3/1/95,Hide,Hide,3,1995,12477,12477,12891,12891,1,414,414,0.032115429,0.032115429
FALSE,Iron County,3/1/96,Hide,Hide,3,1996,12570,12570,13097,13097,1,527,527,0.040238222,0.040238222
FALSE,Iron County,3/1/97,Hide,Hide,3,1997,13658,13658,14110,14110,1,452,452,0.032034018,0.032034018
FALSE,Iron County,3/1/98,Hide,Hide,3,1998,14165,14165,14723,14723,1,558,558,0.037899885,0.037899885
FALSE,Iron County,3/1/99,Hide,Hide,3,1999,14394,14394,14949,14949,1,555,555,0.037126229,0.037126229
FALSE,Iron County,3/1/00,Hide,Hide,3,2000,16069,16069,16569,16569,1,500,500,0.030176836,0.030176836
FALSE,Iron County,3/1/01,Hide,Hide,3,2001,16071,16071,16798,16798,1,727,727,0.043278962,0.043278962
FALSE,Iron County,3/1/02,Hide,Hide,3,2002,16873,16873,17774,17774,1,901,901,0.050692022,0.050692022
FALSE,Iron County,3/1/03,Hide,Hide,3,2003,16739,16739,17703,17703,1,964,964,0.054454047,0.054454047
FALSE,Iron County,3/1/04,Hide,Hide,3,2004,17666,17666,18539,18539,1,873,873,0.047089919,0.047089919
FALSE,Iron County,3/1/05,Hide,Hide,3,2005,18817,18817,19610,19610,1,793,793,0.040438552,0.040438552
FALSE,Iron County,3/1/06,Hide,Hide,3,2006,19895,19895,20536,20536,1,641,641,0.031213479,0.031213479
FALSE,Iron County,3/1/07,Hide,Hide,3,2007,20624,20624,21156,21156,1,532,532,0.025146531,0.025146531
FALSE,Iron County,3/1/08,Hide,Hide,3,2008,20114,20114,20862,20862,1,748,748,0.035854664,0.035854664
FALSE,Iron County,3/1/09,Hide,Hide,3,2009,19288,19288,21052,21052,1,1764,1764,0.083792514,0.083792514
FALSE,Iron County,3/1/10,Hide,Hide,3,2010,18513,18513,20493,20493,1,1980,1980,0.096618357,0.096618357
FALSE,Iron County,3/1/11,Hide,Hide,3,2011,18234,18234,19985,19985,1,1751,1751,0.087615712,0.087615712
FALSE,Iron County,3/1/12,Hide,Hide,3,2012,18176,18176,19553,19553,1,1377,1377,0.070423976,0.070423976
FALSE,Iron County,3/1/13,Hide,Hide,3,2013,18194,18194,19337,19337,1,1143,1143,0.059109479,0.059109479
FALSE,Iron County,3/1/14,Hide,Hide,3,2014,19002,19002,19898,19898,1,896,896,0.045029651,0.045029651
FALSE,Iron County,3/1/15,Hide,Hide,3,2015,19289,19289,20207,20207,1,918,918,0.045429802,0.045429802
FALSE,Iron County,3/1/16,Hide,Hide,3,2016,20163,20163,21078,21078,1,915,915,0.043410191,0.043410191
FALSE,Iron County,3/1/17,Hide,Hide,3,2017,21142,21142,22118,22118,1,976,976,0.044126955,0.044126955
FALSE,Iron County,3/1/18,Hide,Hide,3,2018,21779,21779,22575,22575,1,796,796,0.035260244,0.035260244
FALSE,Iron County,3/1/19,Hide,Hide,3,2019,22925,22925,23670,23670,1,745,745,0.03147444,0.03147444
FALSE,Iron County,3/1/20,Hide,Hide,3,2020,24035,24035,24881,24881,1,846,846,0.034001849,0.034001849
FALSE,Juab County,3/1/93,Hide,Hide,3,1993,2957,2957,3170,3170,1,213,213,0.067192429,0.067192429
FALSE,Juab County,3/1/94,Hide,Hide,3,1994,3157,3157,3302,3302,1,145,145,0.04391278,0.04391278
FALSE,Juab County,3/1/95,Hide,Hide,3,1995,3211,3211,3383,3383,1,172,172,0.050842448,0.050842448
FALSE,Juab County,3/1/96,Hide,Hide,3,1996,3228,3228,3365,3365,1,137,137,0.040713224,0.040713224
FALSE,Juab County,3/1/97,Hide,Hide,3,1997,3324,3324,3459,3459,1,135,135,0.039028621,0.039028621
FALSE,Juab County,3/1/98,Hide,Hide,3,1998,3383,3383,3537,3537,1,154,154,0.043539723,0.043539723
FALSE,Juab County,3/1/99,Hide,Hide,3,1999,3446,3446,3632,3632,1,186,186,0.051211454,0.051211454
FALSE,Juab County,3/1/00,Hide,Hide,3,2000,3570,3570,3697,3697,1,127,127,0.034352177,0.034352177
FALSE,Juab County,3/1/01,Hide,Hide,3,2001,3619,3619,3783,3783,1,164,164,0.043351837,0.043351837
FALSE,Juab County,3/1/02,Hide,Hide,3,2002,3407,3407,3673,3673,1,266,266,0.072420365,0.072420365
FALSE,Juab County,3/1/03,Hide,Hide,3,2003,3402,3402,3669,3669,1,267,267,0.072771872,0.072771872
FALSE,Juab County,3/1/04,Hide,Hide,3,2004,3541,3541,3800,3800,1,259,259,0.068157895,0.068157895
FALSE,Juab County,3/1/05,Hide,Hide,3,2005,3694,3694,3882,3882,1,188,188,0.048428645,0.048428645
FALSE,Juab County,3/1/06,Hide,Hide,3,2006,3835,3835,3990,3990,1,155,155,0.038847118,0.038847118
FALSE,Juab County,3/1/07,Hide,Hide,3,2007,3966,3966,4086,4086,1,120,120,0.029368576,0.029368576
FALSE,Juab County,3/1/08,Hide,Hide,3,2008,3765,3765,3941,3941,1,176,176,0.044658716,0.044658716
FALSE,Juab County,3/1/09,Hide,Hide,3,2009,3609,3609,3992,3992,1,383,383,0.095941884,0.095941884
FALSE,Juab County,3/1/10,Hide,Hide,3,2010,4129,4129,4549,4549,1,420,420,0.092327984,0.092327984
FALSE,Juab County,3/1/11,Hide,Hide,3,2011,4167,4167,4564,4564,1,397,397,0.086985101,0.086985101
FALSE,Juab County,3/1/12,Hide,Hide,3,2012,4268,4268,4561,4561,1,293,293,0.064240298,0.064240298
FALSE,Juab County,3/1/13,Hide,Hide,3,2013,4412,4412,4659,4659,1,247,247,0.053015669,0.053015669
FALSE,Juab County,3/1/14,Hide,Hide,3,2014,4557,4557,4757,4757,1,200,200,0.042043305,0.042043305
FALSE,Juab County,3/1/15,Hide,Hide,3,2015,4680,4680,4876,4876,1,196,196,0.040196883,0.040196883
FALSE,Juab County,3/1/16,Hide,Hide,3,2016,4957,4957,5156,5156,1,199,199,0.038595811,0.038595811
FALSE,Juab County,3/1/17,Hide,Hide,3,2017,5180,5180,5361,5361,1,181,181,0.033762358,0.033762358
FALSE,Juab County,3/1/18,Hide,Hide,3,2018,5379,5379,5543,5543,1,164,164,0.029586866,0.029586866
FALSE,Juab County,3/1/19,Hide,Hide,3,2019,5518,5518,5673,5673,1,155,155,0.027322404,0.027322404
FALSE,Juab County,3/1/20,Hide,Hide,3,2020,5650,5650,5804,5804,1,154,154,0.026533425,0.026533425
FALSE,Kane County,3/1/93,Hide,Hide,3,1993,2395,2395,2574,2574,1,179,179,0.06954157,0.06954157
FALSE,Kane County,3/1/94,Hide,Hide,3,1994,2532,2532,2740,2740,1,208,208,0.075912409,0.075912409
FALSE,Kane County,3/1/95,Hide,Hide,3,1995,2490,2490,2741,2741,1,251,251,0.091572419,0.091572419
FALSE,Kane County,3/1/96,Hide,Hide,3,1996,2371,2371,2547,2547,1,176,176,0.069100903,0.069100903
FALSE,Kane County,3/1/97,Hide,Hide,3,1997,2466,2466,2600,2600,1,134,134,0.051538462,0.051538462
FALSE,Kane County,3/1/98,Hide,Hide,3,1998,2631,2631,2731,2731,1,100,100,0.036616624,0.036616624
FALSE,Kane County,3/1/99,Hide,Hide,3,1999,2686,2686,2800,2800,1,114,114,0.040714286,0.040714286
FALSE,Kane County,3/1/00,Hide,Hide,3,2000,2885,2885,2991,2991,1,106,106,0.035439652,0.035439652
FALSE,Kane County,3/1/01,Hide,Hide,3,2001,2979,2979,3114,3114,1,135,135,0.043352601,0.043352601
FALSE,Kane County,3/1/02,Hide,Hide,3,2002,2849,2849,2998,2998,1,149,149,0.0496998,0.0496998
FALSE,Kane County,3/1/03,Hide,Hide,3,2003,2918,2918,3086,3086,1,168,168,0.054439404,0.054439404
FALSE,Kane County,3/1/04,Hide,Hide,3,2004,3069,3069,3253,3253,1,184,184,0.056563172,0.056563172
FALSE,Kane County,3/1/05,Hide,Hide,3,2005,3023,3023,3191,3191,1,168,168,0.052648073,0.052648073
FALSE,Kane County,3/1/06,Hide,Hide,3,2006,3269,3269,3399,3399,1,130,130,0.038246543,0.038246543
FALSE,Kane County,3/1/07,Hide,Hide,3,2007,3423,3423,3527,3527,1,104,104,0.029486816,0.029486816
FALSE,Kane County,3/1/08,Hide,Hide,3,2008,3303,3303,3422,3422,1,119,119,0.034774985,0.034774985
FALSE,Kane County,3/1/09,Hide,Hide,3,2009,3232,3232,3486,3486,1,254,254,0.07286288,0.07286288
FALSE,Kane County,3/1/10,Hide,Hide,3,2010,3303,3303,3588,3588,1,285,285,0.079431438,0.079431438
FALSE,Kane County,3/1/11,Hide,Hide,3,2011,3244,3244,3512,3512,1,268,268,0.076309795,0.076309795
FALSE,Kane County,3/1/12,Hide,Hide,3,2012,3229,3229,3470,3470,1,241,241,0.06945245,0.06945245
FALSE,Kane County,3/1/13,Hide,Hide,3,2013,3280,3280,3470,3470,1,190,190,0.054755043,0.054755043
FALSE,Kane County,3/1/14,Hide,Hide,3,2014,3363,3363,3538,3538,1,175,175,0.049462973,0.049462973
FALSE,Kane County,3/1/15,Hide,Hide,3,2015,3422,3422,3584,3584,1,162,162,0.045200893,0.045200893
FALSE,Kane County,3/1/16,Hide,Hide,3,2016,3539,3539,3689,3689,1,150,150,0.040661426,0.040661426
FALSE,Kane County,3/1/17,Hide,Hide,3,2017,3600,3600,3728,3728,1,128,128,0.034334764,0.034334764
FALSE,Kane County,3/1/18,Hide,Hide,3,2018,3676,3676,3796,3796,1,120,120,0.031612223,0.031612223
FALSE,Kane County,3/1/19,Hide,Hide,3,2019,3679,3679,3796,3796,1,117,117,0.030821918,0.030821918
FALSE,Kane County,3/1/20,Hide,Hide,3,2020,3723,3723,3848,3848,1,125,125,0.032484407,0.032484407
FALSE,Millard County,3/1/93,Hide,Hide,3,1993,4431,4431,4698,4698,1,267,267,0.056832695,0.056832695
FALSE,Millard County,3/1/94,Hide,Hide,3,1994,4451,4451,4669,4669,1,218,218,0.04669094,0.04669094
FALSE,Millard County,3/1/95,Hide,Hide,3,1995,4568,4568,4811,4811,1,243,243,0.05050925,0.05050925
FALSE,Millard County,3/1/96,Hide,Hide,3,1996,4522,4522,4723,4723,1,201,201,0.042557696,0.042557696
FALSE,Millard County,3/1/97,Hide,Hide,3,1997,4565,4565,4745,4745,1,180,180,0.037934668,0.037934668
FALSE,Millard County,3/1/98,Hide,Hide,3,1998,4542,4542,4760,4760,1,218,218,0.045798319,0.045798319
FALSE,Millard County,3/1/99,Hide,Hide,3,1999,4531,4531,4729,4729,1,198,198,0.041869317,0.041869317
FALSE,Millard County,3/1/00,Hide,Hide,3,2000,5024,5024,5191,5191,1,167,167,0.032171065,0.032171065
FALSE,Millard County,3/1/01,Hide,Hide,3,2001,5082,5082,5287,5287,1,205,205,0.038774352,0.038774352
FALSE,Millard County,3/1/02,Hide,Hide,3,2002,5666,5666,5946,5946,1,280,280,0.047090481,0.047090481
FALSE,Millard County,3/1/03,Hide,Hide,3,2003,5673,5673,5967,5967,1,294,294,0.04927099,0.04927099
FALSE,Millard County,3/1/04,Hide,Hide,3,2004,5987,5987,6302,6302,1,315,315,0.049984132,0.049984132
FALSE,Millard County,3/1/05,Hide,Hide,3,2005,5785,5785,6034,6034,1,249,249,0.041266158,0.041266158
FALSE,Millard County,3/1/06,Hide,Hide,3,2006,5944,5944,6146,6146,1,202,202,0.032866905,0.032866905
FALSE,Millard County,3/1/07,Hide,Hide,3,2007,6173,6173,6315,6315,1,142,142,0.022486144,0.022486144
FALSE,Millard County,3/1/08,Hide,Hide,3,2008,5725,5725,5905,5905,1,180,180,0.030482642,0.030482642
FALSE,Millard County,3/1/09,Hide,Hide,3,2009,6084,6084,6416,6416,1,332,332,0.051745636,0.051745636
FALSE,Millard County,3/1/10,Hide,Hide,3,2010,5859,5859,6263,6263,1,404,404,0.064505828,0.064505828
FALSE,Millard County,3/1/11,Hide,Hide,3,2011,5860,5860,6198,6198,1,338,338,0.054533721,0.054533721
FALSE,Millard County,3/1/12,Hide,Hide,3,2012,5684,5684,5972,5972,1,288,288,0.04822505,0.04822505
FALSE,Millard County,3/1/13,Hide,Hide,3,2013,5742,5742,5999,5999,1,257,257,0.042840473,0.042840473
FALSE,Millard County,3/1/14,Hide,Hide,3,2014,5844,5844,6048,6048,1,204,204,0.033730159,0.033730159
FALSE,Millard County,3/1/15,Hide,Hide,3,2015,6014,6014,6229,6229,1,215,215,0.034515974,0.034515974
FALSE,Millard County,3/1/16,Hide,Hide,3,2016,5922,5922,6130,6130,1,208,208,0.033931485,0.033931485
FALSE,Millard County,3/1/17,Hide,Hide,3,2017,6193,6193,6412,6412,1,219,219,0.03415471,0.03415471
FALSE,Millard County,3/1/18,Hide,Hide,3,2018,6094,6094,6293,6293,1,199,199,0.031622438,0.031622438
FALSE,Millard County,3/1/19,Hide,Hide,3,2019,5819,5819,5995,5995,1,176,176,0.029357798,0.029357798
FALSE,Millard County,3/1/20,Hide,Hide,3,2020,5824,5824,6005,6005,1,181,181,0.030141549,0.030141549
FALSE,Morgan County,3/1/93,Hide,Hide,3,1993,2781,2781,2955,2955,1,174,174,0.058883249,0.058883249
FALSE,Morgan County,3/1/94,Hide,Hide,3,1994,2808,2808,2940,2940,1,132,132,0.044897959,0.044897959
FALSE,Morgan County,3/1/95,Hide,Hide,3,1995,3170,3170,3335,3335,1,165,165,0.049475262,0.049475262
FALSE,Morgan County,3/1/96,Hide,Hide,3,1996,3299,3299,3451,3451,1,152,152,0.044045204,0.044045204
FALSE,Morgan County,3/1/97,Hide,Hide,3,1997,3434,3434,3572,3572,1,138,138,0.038633819,0.038633819
FALSE,Morgan County,3/1/98,Hide,Hide,3,1998,3560,3560,3700,3700,1,140,140,0.037837838,0.037837838
FALSE,Morgan County,3/1/99,Hide,Hide,3,1999,3425,3425,3567,3567,1,142,142,0.039809364,0.039809364
FALSE,Morgan County,3/1/00,Hide,Hide,3,2000,3335,3335,3449,3449,1,114,114,0.033053059,0.033053059
FALSE,Morgan County,3/1/01,Hide,Hide,3,2001,3343,3343,3469,3469,1,126,126,0.036321707,0.036321707
FALSE,Morgan County,3/1/02,Hide,Hide,3,2002,3343,3343,3527,3527,1,184,184,0.052168982,0.052168982
FALSE,Morgan County,3/1/03,Hide,Hide,3,2003,3383,3383,3573,3573,1,190,190,0.053176602,0.053176602
FALSE,Morgan County,3/1/04,Hide,Hide,3,2004,3468,3468,3651,3651,1,183,183,0.050123254,0.050123254
FALSE,Morgan County,3/1/05,Hide,Hide,3,2005,3618,3618,3782,3782,1,164,164,0.0433633,0.0433633
FALSE,Morgan County,3/1/06,Hide,Hide,3,2006,3785,3785,3913,3913,1,128,128,0.032711475,0.032711475
FALSE,Morgan County,3/1/07,Hide,Hide,3,2007,3865,3865,3960,3960,1,95,95,0.023989899,0.023989899
FALSE,Morgan County,3/1/08,Hide,Hide,3,2008,3937,3937,4060,4060,1,123,123,0.030295567,0.030295567
FALSE,Morgan County,3/1/09,Hide,Hide,3,2009,3837,3837,4078,4078,1,241,241,0.059097597,0.059097597
FALSE,Morgan County,3/1/10,Hide,Hide,3,2010,3944,3944,4236,4236,1,292,292,0.068932956,0.068932956
FALSE,Morgan County,3/1/11,Hide,Hide,3,2011,3959,3959,4214,4214,1,255,255,0.060512577,0.060512577
FALSE,Morgan County,3/1/12,Hide,Hide,3,2012,4071,4071,4290,4290,1,219,219,0.051048951,0.051048951
FALSE,Morgan County,3/1/13,Hide,Hide,3,2013,4273,4273,4465,4465,1,192,192,0.04300112,0.04300112
FALSE,Morgan County,3/1/14,Hide,Hide,3,2014,4482,4482,4645,4645,1,163,163,0.035091496,0.035091496
FALSE,Morgan County,3/1/15,Hide,Hide,3,2015,4715,4715,4866,4866,1,151,151,0.031031648,0.031031648
FALSE,Morgan County,3/1/16,Hide,Hide,3,2016,4908,4908,5065,5065,1,157,157,0.030997038,0.030997038
FALSE,Morgan County,3/1/17,Hide,Hide,3,2017,5194,5194,5351,5351,1,157,157,0.02934031,0.02934031
FALSE,Morgan County,3/1/18,Hide,Hide,3,2018,5266,5266,5411,5411,1,145,145,0.026797265,0.026797265
FALSE,Morgan County,3/1/19,Hide,Hide,3,2019,5370,5370,5512,5512,1,142,142,0.025761974,0.025761974
FALSE,Morgan County,3/1/20,Hide,Hide,3,2020,5456,5456,5604,5604,1,148,148,0.026409707,0.026409707
FALSE,Piute County,3/1/93,Hide,Hide,3,1993,418,418,442,442,1,24,24,0.054298643,0.054298643
FALSE,Piute County,3/1/94,Hide,Hide,3,1994,440,440,480,480,1,40,40,0.083333333,0.083333333
FALSE,Piute County,3/1/95,Hide,Hide,3,1995,461,461,490,490,1,29,29,0.059183673,0.059183673
FALSE,Piute County,3/1/96,Hide,Hide,3,1996,483,483,505,505,1,22,22,0.043564356,0.043564356
FALSE,Piute County,3/1/97,Hide,Hide,3,1997,497,497,525,525,1,28,28,0.053333333,0.053333333
FALSE,Piute County,3/1/98,Hide,Hide,3,1998,504,504,527,527,1,23,23,0.043643264,0.043643264
FALSE,Piute County,3/1/99,Hide,Hide,3,1999,515,515,550,550,1,35,35,0.063636364,0.063636364
FALSE,Piute County,3/1/00,Hide,Hide,3,2000,575,575,598,598,1,23,23,0.038461538,0.038461538
FALSE,Piute County,3/1/01,Hide,Hide,3,2001,695,695,738,738,1,43,43,0.058265583,0.058265583
FALSE,Piute County,3/1/02,Hide,Hide,3,2002,683,683,728,728,1,45,45,0.061813187,0.061813187
FALSE,Piute County,3/1/03,Hide,Hide,3,2003,741,741,787,787,1,46,46,0.058449809,0.058449809
FALSE,Piute County,3/1/04,Hide,Hide,3,2004,825,825,862,862,1,37,37,0.042923434,0.042923434
FALSE,Piute County,3/1/05,Hide,Hide,3,2005,830,830,867,867,1,37,37,0.042675894,0.042675894
FALSE,Piute County,3/1/06,Hide,Hide,3,2006,840,840,870,870,1,30,30,0.034482759,0.034482759
FALSE,Piute County,3/1/07,Hide,Hide,3,2007,912,912,929,929,1,17,17,0.018299247,0.018299247
FALSE,Piute County,3/1/08,Hide,Hide,3,2008,868,868,892,892,1,24,24,0.02690583,0.02690583
FALSE,Piute County,3/1/09,Hide,Hide,3,2009,841,841,896,896,1,55,55,0.061383929,0.061383929
FALSE,Piute County,3/1/10,Hide,Hide,3,2010,558,558,616,616,1,58,58,0.094155844,0.094155844
FALSE,Piute County,3/1/11,Hide,Hide,3,2011,498,498,554,554,1,56,56,0.101083032,0.101083032
FALSE,Piute County,3/1/12,Hide,Hide,3,2012,463,463,507,507,1,44,44,0.08678501,0.08678501
FALSE,Piute County,3/1/13,Hide,Hide,3,2013,456,456,493,493,1,37,37,0.07505071,0.07505071
FALSE,Piute County,3/1/14,Hide,Hide,3,2014,428,428,460,460,1,32,32,0.069565217,0.069565217
FALSE,Piute County,3/1/15,Hide,Hide,3,2015,451,451,483,483,1,32,32,0.066252588,0.066252588
FALSE,Piute County,3/1/16,Hide,Hide,3,2016,420,420,449,449,1,29,29,0.064587973,0.064587973
FALSE,Piute County,3/1/17,Hide,Hide,3,2017,451,451,476,476,1,25,25,0.052521008,0.052521008
FALSE,Piute County,3/1/18,Hide,Hide,3,2018,460,460,483,483,1,23,23,0.047619048,0.047619048
FALSE,Piute County,3/1/19,Hide,Hide,3,2019,459,459,481,481,1,22,22,0.045738046,0.045738046
FALSE,Piute County,3/1/20,Hide,Hide,3,2020,452,452,479,479,1,27,27,0.056367432,0.056367432
FALSE,Rich County,3/1/93,Hide,Hide,3,1993,746,746,772,772,1,26,26,0.033678756,0.033678756
FALSE,Rich County,3/1/94,Hide,Hide,3,1994,749,749,779,779,1,30,30,0.038510911,0.038510911
FALSE,Rich County,3/1/95,Hide,Hide,3,1995,820,820,855,855,1,35,35,0.040935673,0.040935673
FALSE,Rich County,3/1/96,Hide,Hide,3,1996,943,943,978,978,1,35,35,0.035787321,0.035787321
FALSE,Rich County,3/1/97,Hide,Hide,3,1997,890,890,917,917,1,27,27,0.029443839,0.029443839
FALSE,Rich County,3/1/98,Hide,Hide,3,1998,970,970,1003,1003,1,33,33,0.032901296,0.032901296
FALSE,Rich County,3/1/99,Hide,Hide,3,1999,971,971,1003,1003,1,32,32,0.031904287,0.031904287
FALSE,Rich County,3/1/00,Hide,Hide,3,2000,971,971,1001,1001,1,30,30,0.02997003,0.02997003
FALSE,Rich County,3/1/01,Hide,Hide,3,2001,1056,1056,1097,1097,1,41,41,0.037374658,0.037374658
FALSE,Rich County,3/1/02,Hide,Hide,3,2002,1206,1206,1252,1252,1,46,46,0.036741214,0.036741214
FALSE,Rich County,3/1/03,Hide,Hide,3,2003,1201,1201,1251,1251,1,50,50,0.039968026,0.039968026
FALSE,Rich County,3/1/04,Hide,Hide,3,2004,1322,1322,1366,1366,1,44,44,0.032210835,0.032210835
FALSE,Rich County,3/1/05,Hide,Hide,3,2005,1247,1247,1290,1290,1,43,43,0.033333333,0.033333333
FALSE,Rich County,3/1/06,Hide,Hide,3,2006,1348,1348,1384,1384,1,36,36,0.026011561,0.026011561
FALSE,Rich County,3/1/07,Hide,Hide,3,2007,1447,1447,1470,1470,1,23,23,0.015646259,0.015646259
FALSE,Rich County,3/1/08,Hide,Hide,3,2008,1363,1363,1393,1393,1,30,30,0.021536253,0.021536253
FALSE,Rich County,3/1/09,Hide,Hide,3,2009,1422,1422,1495,1495,1,73,73,0.048829431,0.048829431
FALSE,Rich County,3/1/10,Hide,Hide,3,2010,1012,1012,1090,1090,1,78,78,0.071559633,0.071559633
FALSE,Rich County,3/1/11,Hide,Hide,3,2011,912,912,988,988,1,76,76,0.076923077,0.076923077
FALSE,Rich County,3/1/12,Hide,Hide,3,2012,900,900,950,950,1,50,50,0.052631579,0.052631579
FALSE,Rich County,3/1/13,Hide,Hide,3,2013,933,933,981,981,1,48,48,0.048929664,0.048929664
FALSE,Rich County,3/1/14,Hide,Hide,3,2014,997,997,1036,1036,1,39,39,0.037644788,0.037644788
FALSE,Rich County,3/1/15,Hide,Hide,3,2015,1027,1027,1064,1064,1,37,37,0.034774436,0.034774436
FALSE,Rich County,3/1/16,Hide,Hide,3,2016,1041,1041,1073,1073,1,32,32,0.029822926,0.029822926
FALSE,Rich County,3/1/17,Hide,Hide,3,2017,1090,1090,1128,1128,1,38,38,0.033687943,0.033687943
FALSE,Rich County,3/1/18,Hide,Hide,3,2018,1120,1120,1157,1157,1,37,37,0.031979257,0.031979257
FALSE,Rich County,3/1/19,Hide,Hide,3,2019,1141,1141,1179,1179,1,38,38,0.032230704,0.032230704
FALSE,Rich County,3/1/20,Hide,Hide,3,2020,1137,1137,1180,1180,1,43,43,0.036440678,0.036440678
FALSE,Salt Lake County,3/1/93,Hide,Hide,3,1993,397646,397646,413759,413759,1,16113,16113,0.03894296,0.03894296
FALSE,Salt Lake County,3/1/94,Hide,Hide,3,1994,423568,423568,437824,437824,1,14256,14256,0.032561029,0.032561029
FALSE,Salt Lake County,3/1/95,Hide,Hide,3,1995,438058,438058,452277,452277,1,14219,14219,0.031438698,0.031438698
FALSE,Salt Lake County,3/1/96,Hide,Hide,3,1996,443592,443592,457112,457112,1,13520,13520,0.029576996,0.029576996
FALSE,Salt Lake County,3/1/97,Hide,Hide,3,1997,457675,457675,470499,470499,1,12824,12824,0.027256168,0.027256168
FALSE,Salt Lake County,3/1/98,Hide,Hide,3,1998,465013,465013,480670,480670,1,15657,15657,0.032573283,0.032573283
FALSE,Salt Lake County,3/1/99,Hide,Hide,3,1999,472858,472858,489051,489051,1,16193,16193,0.033111066,0.033111066
FALSE,Salt Lake County,3/1/00,Hide,Hide,3,2000,468961,468961,483105,483105,1,14144,14144,0.029277279,0.029277279
FALSE,Salt Lake County,3/1/01,Hide,Hide,3,2001,475246,475246,494510,494510,1,19264,19264,0.038955734,0.038955734
FALSE,Salt Lake County,3/1/02,Hide,Hide,3,2002,467197,467197,495541,495541,1,28344,28344,0.057198093,0.057198093
FALSE,Salt Lake County,3/1/03,Hide,Hide,3,2003,465586,465586,494925,494925,1,29339,29339,0.059279689,0.059279689
FALSE,Salt Lake County,3/1/04,Hide,Hide,3,2004,471160,471160,497539,497539,1,26379,26379,0.053018959,0.053018959
FALSE,Salt Lake County,3/1/05,Hide,Hide,3,2005,489718,489718,511377,511377,1,21659,21659,0.042354271,0.042354271
FALSE,Salt Lake County,3/1/06,Hide,Hide,3,2006,512867,512867,529920,529920,1,17053,17053,0.032180329,0.032180329
FALSE,Salt Lake County,3/1/07,Hide,Hide,3,2007,533992,533992,546292,546292,1,12300,12300,0.022515431,0.022515431
FALSE,Salt Lake County,3/1/08,Hide,Hide,3,2008,542667,542667,558558,558558,1,15891,15891,0.028450045,0.028450045
FALSE,Salt Lake County,3/1/09,Hide,Hide,3,2009,521322,521322,557624,557624,1,36302,36302,0.065101215,0.065101215
FALSE,Salt Lake County,3/1/10,Hide,Hide,3,2010,506088,506088,547996,547996,1,41908,41908,0.076475011,0.076475011
FALSE,Salt Lake County,3/1/11,Hide,Hide,3,2011,507941,507941,546417,546417,1,38476,38476,0.070415086,0.070415086
FALSE,Salt Lake County,3/1/12,Hide,Hide,3,2012,521441,521441,552092,552092,1,30651,30651,0.055517921,0.055517921
FALSE,Salt Lake County,3/1/13,Hide,Hide,3,2013,539907,539907,565894,565894,1,25987,25987,0.045922028,0.045922028
FALSE,Salt Lake County,3/1/14,Hide,Hide,3,2014,551953,551953,573905,573905,1,21952,21952,0.038250233,0.038250233
FALSE,Salt Lake County,3/1/15,Hide,Hide,3,2015,561219,561219,581029,581029,1,19810,19810,0.034094684,0.034094684
FALSE,Salt Lake County,3/1/16,Hide,Hide,3,2016,576903,576903,596452,596452,1,19549,19549,0.032775479,0.032775479
FALSE,Salt Lake County,3/1/17,Hide,Hide,3,2017,593364,593364,612634,612634,1,19270,19270,0.031454343,0.031454343
FALSE,Salt Lake County,3/1/18,Hide,Hide,3,2018,598848,598848,617115,617115,1,18267,18267,0.029600642,0.029600642
FALSE,Salt Lake County,3/1/19,Hide,Hide,3,2019,611464,611464,628332,628332,1,16868,16868,0.02684568,0.02684568
FALSE,Salt Lake County,3/1/20,Hide,Hide,3,2020,624970,624970,645913,645913,1,20943,20943,0.032423871,0.032423871
FALSE,San Juan County,3/1/93,Hide,Hide,3,1993,4648,4648,5005,5005,1,357,357,0.071328671,0.071328671
FALSE,San Juan County,3/1/94,Hide,Hide,3,1994,4614,4614,5046,5046,1,432,432,0.085612366,0.085612366
FALSE,San Juan County,3/1/95,Hide,Hide,3,1995,4712,4712,5153,5153,1,441,441,0.085581215,0.085581215
FALSE,San Juan County,3/1/96,Hide,Hide,3,1996,4710,4710,5185,5185,1,475,475,0.091610415,0.091610415
FALSE,San Juan County,3/1/97,Hide,Hide,3,1997,4473,4473,4943,4943,1,470,470,0.095083957,0.095083957
FALSE,San Juan County,3/1/98,Hide,Hide,3,1998,4547,4547,4931,4931,1,384,384,0.07787467,0.07787467
FALSE,San Juan County,3/1/99,Hide,Hide,3,1999,4712,4712,5114,5114,1,402,402,0.078607743,0.078607743
FALSE,San Juan County,3/1/00,Hide,Hide,3,2000,4464,4464,4814,4814,1,350,350,0.072704612,0.072704612
FALSE,San Juan County,3/1/01,Hide,Hide,3,2001,4164,4164,4545,4545,1,381,381,0.083828383,0.083828383
FALSE,San Juan County,3/1/02,Hide,Hide,3,2002,4329,4329,4728,4728,1,399,399,0.084390863,0.084390863
FALSE,San Juan County,3/1/03,Hide,Hide,3,2003,4336,4336,4767,4767,1,431,431,0.090413258,0.090413258
FALSE,San Juan County,3/1/04,Hide,Hide,3,2004,4428,4428,4880,4880,1,452,452,0.092622951,0.092622951
FALSE,San Juan County,3/1/05,Hide,Hide,3,2005,4351,4351,4745,4745,1,394,394,0.083034773,0.083034773
FALSE,San Juan County,3/1/06,Hide,Hide,3,2006,4550,4550,4864,4864,1,314,314,0.064555921,0.064555921
FALSE,San Juan County,3/1/07,Hide,Hide,3,2007,4715,4715,4947,4947,1,232,232,0.046897109,0.046897109
FALSE,San Juan County,3/1/08,Hide,Hide,3,2008,4632,4632,4923,4923,1,291,291,0.059110299,0.059110299
FALSE,San Juan County,3/1/09,Hide,Hide,3,2009,4640,4640,5188,5188,1,548,548,0.105628373,0.105628373
FALSE,San Juan County,3/1/10,Hide,Hide,3,2010,5307,5307,5979,5979,1,672,672,0.112393377,0.112393377
FALSE,San Juan County,3/1/11,Hide,Hide,3,2011,5372,5372,5998,5998,1,626,626,0.104368123,0.104368123
FALSE,San Juan County,3/1/12,Hide,Hide,3,2012,5236,5236,5761,5761,1,525,525,0.091130012,0.091130012
FALSE,San Juan County,3/1/13,Hide,Hide,3,2013,5164,5164,5618,5618,1,454,454,0.080811677,0.080811677
FALSE,San Juan County,3/1/14,Hide,Hide,3,2014,5220,5220,5644,5644,1,424,424,0.075124026,0.075124026
FALSE,San Juan County,3/1/15,Hide,Hide,3,2015,5275,5275,5723,5723,1,448,448,0.078280622,0.078280622
FALSE,San Juan County,3/1/16,Hide,Hide,3,2016,5256,5256,5747,5747,1,491,491,0.08543588,0.08543588
FALSE,San Juan County,3/1/17,Hide,Hide,3,2017,5283,5283,5699,5699,1,416,416,0.072995262,0.072995262
FALSE,San Juan County,3/1/18,Hide,Hide,3,2018,5319,5319,5673,5673,1,354,354,0.062400846,0.062400846
FALSE,San Juan County,3/1/19,Hide,Hide,3,2019,5431,5431,5730,5730,1,299,299,0.052181501,0.052181501
FALSE,San Juan County,3/1/20,Hide,Hide,3,2020,5399,5399,5784,5784,1,385,385,0.066562932,0.066562932
FALSE,Sanpete County,3/1/93,Hide,Hide,3,1993,6546,6546,7036,7036,1,490,490,0.069641842,0.069641842
FALSE,Sanpete County,3/1/94,Hide,Hide,3,1994,6852,6852,7343,7343,1,491,491,0.066866403,0.066866403
FALSE,Sanpete County,3/1/95,Hide,Hide,3,1995,7196,7196,7684,7684,1,488,488,0.063508589,0.063508589
FALSE,Sanpete County,3/1/96,Hide,Hide,3,1996,7632,7632,8122,8122,1,490,490,0.060329968,0.060329968
FALSE,Sanpete County,3/1/97,Hide,Hide,3,1997,8066,8066,8538,8538,1,472,472,0.055282268,0.055282268
FALSE,Sanpete County,3/1/98,Hide,Hide,3,1998,8379,8379,8903,8903,1,524,524,0.058856565,0.058856565
FALSE,Sanpete County,3/1/99,Hide,Hide,3,1999,8518,8518,9002,9002,1,484,484,0.05376583,0.05376583
FALSE,Sanpete County,3/1/00,Hide,Hide,3,2000,9057,9057,9446,9446,1,389,389,0.041181452,0.041181452
FALSE,Sanpete County,3/1/01,Hide,Hide,3,2001,9289,9289,9809,9809,1,520,520,0.05301254,0.05301254
FALSE,Sanpete County,3/1/02,Hide,Hide,3,2002,9506,9506,10151,10151,1,645,645,0.063540538,0.063540538
FALSE,Sanpete County,3/1/03,Hide,Hide,3,2003,9617,9617,10318,10318,1,701,701,0.067939523,0.067939523
FALSE,Sanpete County,3/1/04,Hide,Hide,3,2004,9928,9928,10590,10590,1,662,662,0.062511804,0.062511804
FALSE,Sanpete County,3/1/05,Hide,Hide,3,2005,9863,9863,10446,10446,1,583,583,0.055810837,0.055810837
FALSE,Sanpete County,3/1/06,Hide,Hide,3,2006,10149,10149,10587,10587,1,438,438,0.041371493,0.041371493
FALSE,Sanpete County,3/1/07,Hide,Hide,3,2007,10662,10662,10970,10970,1,308,308,0.028076572,0.028076572
FALSE,Sanpete County,3/1/08,Hide,Hide,3,2008,10464,10464,10873,10873,1,409,409,0.037616113,0.037616113
FALSE,Sanpete County,3/1/09,Hide,Hide,3,2009,10433,10433,11347,11347,1,914,914,0.080549925,0.080549925
FALSE,Sanpete County,3/1/10,Hide,Hide,3,2010,10470,10470,11459,11459,1,989,989,0.086307706,0.086307706
FALSE,Sanpete County,3/1/11,Hide,Hide,3,2011,10104,10104,11030,11030,1,926,926,0.083952856,0.083952856
FALSE,Sanpete County,3/1/12,Hide,Hide,3,2012,10501,10501,11255,11255,1,754,754,0.066992448,0.066992448
FALSE,Sanpete County,3/1/13,Hide,Hide,3,2013,10570,10570,11235,11235,1,665,665,0.059190031,0.059190031
FALSE,Sanpete County,3/1/14,Hide,Hide,3,2014,10523,10523,11038,11038,1,515,515,0.046657003,0.046657003
FALSE,Sanpete County,3/1/15,Hide,Hide,3,2015,10960,10960,11437,11437,1,477,477,0.041706741,0.041706741
FALSE,Sanpete County,3/1/16,Hide,Hide,3,2016,11214,11214,11695,11695,1,481,481,0.041128687,0.041128687
FALSE,Sanpete County,3/1/17,Hide,Hide,3,2017,11421,11421,11893,11893,1,472,472,0.039687211,0.039687211
FALSE,Sanpete County,3/1/18,Hide,Hide,3,2018,11876,11876,12331,12331,1,455,455,0.036898873,0.036898873
FALSE,Sanpete County,3/1/19,Hide,Hide,3,2019,12047,12047,12467,12467,1,420,420,0.033688939,0.033688939
FALSE,Sanpete County,3/1/20,Hide,Hide,3,2020,12160,12160,12550,12550,1,390,390,0.031075697,0.031075697
FALSE,Sevier County,3/1/93,Hide,Hide,3,1993,6554,6554,6978,6978,1,424,424,0.060762396,0.060762396
FALSE,Sevier County,3/1/94,Hide,Hide,3,1994,6975,6975,7317,7317,1,342,342,0.046740467,0.046740467
FALSE,Sevier County,3/1/95,Hide,Hide,3,1995,7235,7235,7631,7631,1,396,396,0.051893592,0.051893592
FALSE,Sevier County,3/1/96,Hide,Hide,3,1996,7462,7462,7818,7818,1,356,356,0.045535943,0.045535943
FALSE,Sevier County,3/1/97,Hide,Hide,3,1997,7704,7704,8037,8037,1,333,333,0.041433371,0.041433371
FALSE,Sevier County,3/1/98,Hide,Hide,3,1998,7927,7927,8302,8302,1,375,375,0.045169839,0.045169839
FALSE,Sevier County,3/1/99,Hide,Hide,3,1999,8038,8038,8401,8401,1,363,363,0.043209142,0.043209142
FALSE,Sevier County,3/1/00,Hide,Hide,3,2000,8051,8051,8339,8339,1,288,288,0.034536515,0.034536515
FALSE,Sevier County,3/1/01,Hide,Hide,3,2001,8014,8014,8393,8393,1,379,379,0.045156678,0.045156678
FALSE,Sevier County,3/1/02,Hide,Hide,3,2002,8333,8333,8831,8831,1,498,498,0.056392255,0.056392255
FALSE,Sevier County,3/1/03,Hide,Hide,3,2003,8220,8220,8731,8731,1,511,511,0.058527087,0.058527087
FALSE,Sevier County,3/1/04,Hide,Hide,3,2004,8765,8765,9251,9251,1,486,486,0.052534861,0.052534861
FALSE,Sevier County,3/1/05,Hide,Hide,3,2005,8646,8646,9073,9073,1,427,427,0.047062714,0.047062714
FALSE,Sevier County,3/1/06,Hide,Hide,3,2006,8966,8966,9294,9294,1,328,328,0.035291586,0.035291586
FALSE,Sevier County,3/1/07,Hide,Hide,3,2007,9295,9295,9517,9517,1,222,222,0.023326679,0.023326679
FALSE,Sevier County,3/1/08,Hide,Hide,3,2008,9252,9252,9559,9559,1,307,307,0.03211633,0.03211633
FALSE,Sevier County,3/1/09,Hide,Hide,3,2009,9082,9082,9809,9809,1,727,727,0.074115608,0.074115608
FALSE,Sevier County,3/1/10,Hide,Hide,3,2010,8843,8843,9673,9673,1,830,830,0.085805851,0.085805851
FALSE,Sevier County,3/1/11,Hide,Hide,3,2011,8744,8744,9503,9503,1,759,759,0.079869515,0.079869515
FALSE,Sevier County,3/1/12,Hide,Hide,3,2012,8848,8848,9451,9451,1,603,603,0.063802772,0.063802772
FALSE,Sevier County,3/1/13,Hide,Hide,3,2013,8792,8792,9324,9324,1,532,532,0.057057057,0.057057057
FALSE,Sevier County,3/1/14,Hide,Hide,3,2014,8874,8874,9293,9293,1,419,419,0.0450877,0.0450877
FALSE,Sevier County,3/1/15,Hide,Hide,3,2015,9141,9141,9561,9561,1,420,420,0.043928459,0.043928459
FALSE,Sevier County,3/1/16,Hide,Hide,3,2016,9091,9091,9519,9519,1,428,428,0.044962706,0.044962706
FALSE,Sevier County,3/1/17,Hide,Hide,3,2017,9343,9343,9734,9734,1,391,391,0.040168482,0.040168482
FALSE,Sevier County,3/1/18,Hide,Hide,3,2018,9480,9480,9833,9833,1,353,353,0.035899522,0.035899522
FALSE,Sevier County,3/1/19,Hide,Hide,3,2019,9420,9420,9743,9743,1,323,323,0.033152007,0.033152007
FALSE,Sevier County,3/1/20,Hide,Hide,3,2020,9363,9363,9728,9728,1,365,365,0.037520559,0.037520559
FALSE,State of Utah,3/1/93,Hide,Hide,3,1993,883224,883224,923497,923497,1,40273,40273,0.043609237,0.043609237
FALSE,State of Utah,3/1/94,Hide,Hide,3,1994,944369,944369,980604,980604,1,36235,36235,0.036951715,0.036951715
FALSE,State of Utah,3/1/95,Hide,Hide,3,1995,970025,970025,1006574,1006574,1,36549,36549,0.036310296,0.036310296
FALSE,State of Utah,3/1/96,Hide,Hide,3,1996,994351,994351,1029468,1029468,1,35117,35117,0.034111794,0.034111794
FALSE,State of Utah,3/1/97,Hide,Hide,3,1997,1028232,1028232,1061777,1061777,1,33545,33545,0.031593263,0.031593263
FALSE,State of Utah,3/1/98,Hide,Hide,3,1998,1052633,1052633,1091772,1091772,1,39139,39139,0.03584906,0.03584906
FALSE,State of Utah,3/1/99,Hide,Hide,3,1999,1076168,1076168,1116995,1116995,1,40827,40827,0.036550746,0.036550746
FALSE,State of Utah,3/1/00,Hide,Hide,3,2000,1098193,1098193,1133369,1133369,1,35176,35176,0.03103667,0.03103667
FALSE,State of Utah,3/1/01,Hide,Hide,3,2001,1113744,1113744,1160545,1160545,1,46801,46801,0.040326743,0.040326743
FALSE,State of Utah,3/1/02,Hide,Hide,3,2002,1114024,1114024,1180850,1180850,1,66826,66826,0.056591438,0.056591438
FALSE,State of Utah,3/1/03,Hide,Hide,3,2003,1123989,1123989,1193437,1193437,1,69448,69448,0.058191593,0.058191593
FALSE,State of Utah,3/1/04,Hide,Hide,3,2004,1157443,1157443,1221480,1221480,1,64037,64037,0.052425746,0.052425746
FALSE,State of Utah,3/1/05,Hide,Hide,3,2005,1203574,1203574,1257385,1257385,1,53811,53811,0.042795961,0.042795961
FALSE,State of Utah,3/1/06,Hide,Hide,3,2006,1262412,1262412,1305187,1305187,1,42775,42775,0.032773082,0.032773082
FALSE,State of Utah,3/1/07,Hide,Hide,3,2007,1318217,1318217,1350184,1350184,1,31967,31967,0.023676032,0.023676032
FALSE,State of Utah,3/1/08,Hide,Hide,3,2008,1329084,1329084,1371484,1371484,1,42400,42400,0.030915417,0.030915417
FALSE,State of Utah,3/1/09,Hide,Hide,3,2009,1280436,1280436,1376406,1376406,1,95970,95970,0.069725067,0.069725067
FALSE,State of Utah,3/1/10,Hide,Hide,3,2010,1248856,1248856,1356837,1356837,1,107981,107981,0.079582883,0.079582883
FALSE,State of Utah,3/1/11,Hide,Hide,3,2011,1252983,1252983,1350661,1350661,1,97678,97678,0.072318665,0.072318665
FALSE,State of Utah,3/1/12,Hide,Hide,3,2012,1286115,1286115,1363728,1363728,1,77613,77613,0.056912375,0.056912375
FALSE,State of Utah,3/1/13,Hide,Hide,3,2013,1329253,1329253,1396655,1396655,1,67402,67402,0.048259592,0.048259592
FALSE,State of Utah,3/1/14,Hide,Hide,3,2014,1365208,1365208,1420471,1420471,1,55263,55263,0.038904701,0.038904701
FALSE,State of Utah,3/1/15,Hide,Hide,3,2015,1397758,1397758,1450127,1450127,1,52369,52369,0.036113389,0.036113389
FALSE,State of Utah,3/1/16,Hide,Hide,3,2016,1437811,1437811,1491206,1491206,1,53395,53395,0.035806589,0.035806589
FALSE,State of Utah,3/1/17,Hide,Hide,3,2017,1487898,1487898,1538861,1538861,1,50963,50963,0.033117351,0.033117351
FALSE,State of Utah,3/1/18,Hide,Hide,3,2018,1517578,1517578,1565654,1565654,1,48076,48076,0.030706657,0.030706657
FALSE,State of Utah,3/1/19,Hide,Hide,3,2019,1538066,1538066,1585267,1585267,1,47201,47201,0.029774795,0.029774795
FALSE,State of Utah,3/1/20,Hide,Hide,3,2020,1565274,1565274,1623114,1623114,1,57840,57840,0.035635205,0.035635205
FALSE,Summit County,3/1/93,Hide,Hide,3,1993,9542,9542,10114,10114,1,572,572,0.05655527,0.05655527
FALSE,Summit County,3/1/94,Hide,Hide,3,1994,10579,10579,11077,11077,1,498,498,0.044958021,0.044958021
FALSE,Summit County,3/1/95,Hide,Hide,3,1995,11455,11455,11920,11920,1,465,465,0.039010067,0.039010067
FALSE,Summit County,3/1/96,Hide,Hide,3,1996,12027,12027,12494,12494,1,467,467,0.037377941,0.037377941
FALSE,Summit County,3/1/97,Hide,Hide,3,1997,12762,12762,13195,13195,1,433,433,0.03281546,0.03281546
FALSE,Summit County,3/1/98,Hide,Hide,3,1998,13444,13444,14059,14059,1,615,615,0.043744221,0.043744221
FALSE,Summit County,3/1/99,Hide,Hide,3,1999,14032,14032,14703,14703,1,671,671,0.045636945,0.045636945
FALSE,Summit County,3/1/00,Hide,Hide,3,2000,16893,16893,17499,17499,1,606,606,0.03463055,0.03463055
FALSE,Summit County,3/1/01,Hide,Hide,3,2001,17710,17710,18441,18441,1,731,731,0.039639933,0.039639933
FALSE,Summit County,3/1/02,Hide,Hide,3,2002,18045,18045,19317,19317,1,1272,1272,0.065848734,0.065848734
FALSE,Summit County,3/1/03,Hide,Hide,3,2003,18436,18436,19683,19683,1,1247,1247,0.063354163,0.063354163
FALSE,Summit County,3/1/04,Hide,Hide,3,2004,19142,19142,20275,20275,1,1133,1133,0.055881628,0.055881628
FALSE,Summit County,3/1/05,Hide,Hide,3,2005,20284,20284,21181,21181,1,897,897,0.042349275,0.042349275
FALSE,Summit County,3/1/06,Hide,Hide,3,2006,20859,20859,21550,21550,1,691,691,0.032064965,0.032064965
FALSE,Summit County,3/1/07,Hide,Hide,3,2007,21145,21145,21657,21657,1,512,512,0.023641317,0.023641317
FALSE,Summit County,3/1/08,Hide,Hide,3,2008,21296,21296,21923,21923,1,627,627,0.0286001,0.0286001
FALSE,Summit County,3/1/09,Hide,Hide,3,2009,20334,20334,21720,21720,1,1386,1386,0.063812155,0.063812155
FALSE,Summit County,3/1/10,Hide,Hide,3,2010,19889,19889,21423,21423,1,1534,1534,0.071605284,0.071605284
FALSE,Summit County,3/1/11,Hide,Hide,3,2011,20265,20265,21649,21649,1,1384,1384,0.06392905,0.06392905
FALSE,Summit County,3/1/12,Hide,Hide,3,2012,20308,20308,21407,21407,1,1099,1099,0.051338347,0.051338347
FALSE,Summit County,3/1/13,Hide,Hide,3,2013,20875,20875,21848,21848,1,973,973,0.044534969,0.044534969
FALSE,Summit County,3/1/14,Hide,Hide,3,2014,21664,21664,22469,22469,1,805,805,0.03582714,0.03582714
FALSE,Summit County,3/1/15,Hide,Hide,3,2015,22103,22103,22859,22859,1,756,756,0.033072313,0.033072313
FALSE,Summit County,3/1/16,Hide,Hide,3,2016,22866,22866,23621,23621,1,755,755,0.031963084,0.031963084
FALSE,Summit County,3/1/17,Hide,Hide,3,2017,23628,23628,24391,24391,1,763,763,0.03128203,0.03128203
FALSE,Summit County,3/1/18,Hide,Hide,3,2018,23590,23590,24318,24318,1,728,728,0.029936672,0.029936672
FALSE,Summit County,3/1/19,Hide,Hide,3,2019,24187,24187,24838,24838,1,651,651,0.02620984,0.02620984
FALSE,Summit County,3/1/20,Hide,Hide,3,2020,24519,24519,25254,25254,1,735,735,0.0291043,0.0291043
FALSE,Tooele County,3/1/93,Hide,Hide,3,1993,11501,11501,12254,12254,1,753,753,0.061449323,0.061449323
FALSE,Tooele County,3/1/94,Hide,Hide,3,1994,10947,10947,11612,11612,1,665,665,0.057268343,0.057268343
FALSE,Tooele County,3/1/95,Hide,Hide,3,1995,10906,10906,11556,11556,1,650,650,0.056247837,0.056247837
FALSE,Tooele County,3/1/96,Hide,Hide,3,1996,10969,10969,11589,11589,1,620,620,0.053499008,0.053499008
FALSE,Tooele County,3/1/97,Hide,Hide,3,1997,11139,11139,11690,11690,1,551,551,0.047134303,0.047134303
FALSE,Tooele County,3/1/98,Hide,Hide,3,1998,11062,11062,11621,11621,1,559,559,0.048102573,0.048102573
FALSE,Tooele County,3/1/99,Hide,Hide,3,1999,11182,11182,11820,11820,1,638,638,0.053976311,0.053976311
FALSE,Tooele County,3/1/00,Hide,Hide,3,2000,18284,18284,18969,18969,1,685,685,0.03611155,0.03611155
FALSE,Tooele County,3/1/01,Hide,Hide,3,2001,20085,20085,21016,21016,1,931,931,0.044299581,0.044299581
FALSE,Tooele County,3/1/02,Hide,Hide,3,2002,20658,20658,22005,22005,1,1347,1347,0.061213361,0.061213361
FALSE,Tooele County,3/1/03,Hide,Hide,3,2003,21430,21430,22903,22903,1,1473,1473,0.064314719,0.064314719
FALSE,Tooele County,3/1/04,Hide,Hide,3,2004,22270,22270,23626,23626,1,1356,1356,0.057394396,0.057394396
FALSE,Tooele County,3/1/05,Hide,Hide,3,2005,23609,23609,24732,24732,1,1123,1123,0.04540676,0.04540676
FALSE,Tooele County,3/1/06,Hide,Hide,3,2006,25036,25036,25970,25970,1,934,934,0.035964575,0.035964575
FALSE,Tooele County,3/1/07,Hide,Hide,3,2007,25931,25931,26602,26602,1,671,671,0.025223667,0.025223667
FALSE,Tooele County,3/1/08,Hide,Hide,3,2008,27013,27013,27912,27912,1,899,899,0.032208369,0.032208369
FALSE,Tooele County,3/1/09,Hide,Hide,3,2009,26286,26286,28372,28372,1,2086,2086,0.073523192,0.073523192
FALSE,Tooele County,3/1/10,Hide,Hide,3,2010,25146,25146,27474,27474,1,2328,2328,0.084734658,0.084734658
FALSE,Tooele County,3/1/11,Hide,Hide,3,2011,25198,25198,27273,27273,1,2075,2075,0.076082573,0.076082573
FALSE,Tooele County,3/1/12,Hide,Hide,3,2012,25799,25799,27510,27510,1,1711,1711,0.062195565,0.062195565
FALSE,Tooele County,3/1/13,Hide,Hide,3,2013,26684,26684,28245,28245,1,1561,1561,0.055266419,0.055266419
FALSE,Tooele County,3/1/14,Hide,Hide,3,2014,27346,27346,28775,28775,1,1429,1429,0.049661164,0.049661164
FALSE,Tooele County,3/1/15,Hide,Hide,3,2015,28007,28007,29251,29251,1,1244,1244,0.042528461,0.042528461
FALSE,Tooele County,3/1/16,Hide,Hide,3,2016,29160,29160,30371,30371,1,1211,1211,0.039873564,0.039873564
FALSE,Tooele County,3/1/17,Hide,Hide,3,2017,30750,30750,31924,31924,1,1174,1174,0.03677484,0.03677484
FALSE,Tooele County,3/1/18,Hide,Hide,3,2018,31776,31776,32875,32875,1,1099,1099,0.033429658,0.033429658
FALSE,Tooele County,3/1/19,Hide,Hide,3,2019,32440,32440,33485,33485,1,1045,1045,0.031208004,0.031208004
FALSE,Tooele County,3/1/20,Hide,Hide,3,2020,33320,33320,34496,34496,1,1176,1176,0.034090909,0.034090909
FALSE,Uintah County,3/1/93,Hide,Hide,3,1993,9040,9040,9811,9811,1,771,771,0.078585261,0.078585261
FALSE,Uintah County,3/1/94,Hide,Hide,3,1994,9465,9465,10230,10230,1,765,765,0.074780059,0.074780059
FALSE,Uintah County,3/1/95,Hide,Hide,3,1995,9744,9744,10448,10448,1,704,704,0.067381317,0.067381317
FALSE,Uintah County,3/1/96,Hide,Hide,3,1996,9363,9363,10107,10107,1,744,744,0.073612348,0.073612348
FALSE,Uintah County,3/1/97,Hide,Hide,3,1997,9954,9954,10568,10568,1,614,614,0.058099924,0.058099924
FALSE,Uintah County,3/1/98,Hide,Hide,3,1998,10255,10255,10832,10832,1,577,577,0.053268095,0.053268095
FALSE,Uintah County,3/1/99,Hide,Hide,3,1999,10175,10175,11034,11034,1,859,859,0.077850281,0.077850281
FALSE,Uintah County,3/1/00,Hide,Hide,3,2000,10831,10831,11294,11294,1,463,463,0.040995219,0.040995219
FALSE,Uintah County,3/1/01,Hide,Hide,3,2001,11494,11494,12001,12001,1,507,507,0.042246479,0.042246479
FALSE,Uintah County,3/1/02,Hide,Hide,3,2002,11778,11778,12511,12511,1,733,733,0.058588442,0.058588442
FALSE,Uintah County,3/1/03,Hide,Hide,3,2003,12208,12208,12980,12980,1,772,772,0.059476117,0.059476117
FALSE,Uintah County,3/1/04,Hide,Hide,3,2004,12846,12846,13574,13574,1,728,728,0.053631943,0.053631943
FALSE,Uintah County,3/1/05,Hide,Hide,3,2005,13734,13734,14323,14323,1,589,589,0.04112267,0.04112267
FALSE,Uintah County,3/1/06,Hide,Hide,3,2006,15405,15405,15842,15842,1,437,437,0.027584901,0.027584901
FALSE,Uintah County,3/1/07,Hide,Hide,3,2007,16947,16947,17271,17271,1,324,324,0.018759771,0.018759771
FALSE,Uintah County,3/1/08,Hide,Hide,3,2008,17459,17459,17847,17847,1,388,388,0.021740349,0.021740349
FALSE,Uintah County,3/1/09,Hide,Hide,3,2009,17291,17291,18483,18483,1,1192,1192,0.064491695,0.064491695
FALSE,Uintah County,3/1/10,Hide,Hide,3,2010,13912,13912,15270,15270,1,1358,1358,0.088932547,0.088932547
FALSE,Uintah County,3/1/11,Hide,Hide,3,2011,14436,14436,15456,15456,1,1020,1020,0.065993789,0.065993789
FALSE,Uintah County,3/1/12,Hide,Hide,3,2012,15337,15337,16058,16058,1,721,721,0.044899738,0.044899738
FALSE,Uintah County,3/1/13,Hide,Hide,3,2013,15087,15087,15799,15799,1,712,712,0.045066143,0.045066143
FALSE,Uintah County,3/1/14,Hide,Hide,3,2014,15338,15338,15892,15892,1,554,554,0.034860307,0.034860307
FALSE,Uintah County,3/1/15,Hide,Hide,3,2015,14888,14888,15783,15783,1,895,895,0.056706583,0.056706583
FALSE,Uintah County,3/1/16,Hide,Hide,3,2016,12967,12967,14373,14373,1,1406,1406,0.097822306,0.097822306
FALSE,Uintah County,3/1/17,Hide,Hide,3,2017,12769,12769,13665,13665,1,896,896,0.065568972,0.065568972
FALSE,Uintah County,3/1/18,Hide,Hide,3,2018,12971,12971,13607,13607,1,636,636,0.046740648,0.046740648
FALSE,Uintah County,3/1/19,Hide,Hide,3,2019,13065,13065,13627,13627,1,562,562,0.041241653,0.041241653
FALSE,Uintah County,3/1/20,Hide,Hide,3,2020,12819,12819,13683,13683,1,864,864,0.063144047,0.063144047
FALSE,United States,3/1/93,Hide,Hide,3,1993,119542,119542000,128598,128598000,1,9056,9056000,0.07,0.07
FALSE,United States,3/1/94,Hide,Hide,3,1994,121930,121930000,130400,130400000,1,8470,8470000,0.065,0.065
FALSE,United States,3/1/95,Hide,Hide,3,1995,124955,124955000,132108,132108000,1,7153,7153000,0.054,0.054
FALSE,United States,3/1/96,Hide,Hide,3,1996,125862,125862000,133180,133180000,1,7318,7318000,0.055,0.055
FALSE,United States,3/1/97,Hide,Hide,3,1997,128891,128891000,135891,135891000,1,7000,7000000,0.052,0.052
FALSE,United States,3/1/98,Hide,Hide,3,1998,130814,130814000,137236,137236000,1,6422,6422000,0.047,0.047
FALSE,United States,3/1/99,Hide,Hide,3,1999,132947,132947000,138730,138730000,1,5783,5783000,0.042,0.042
FALSE,United States,3/1/00,Hide,Hide,3,2000,136701,136701000,142434,142434000,1,5733,5733000,0.04,0.04
FALSE,United States,3/1/01,Hide,Hide,3,2001,137783,137783000,143924,143924000,1,6141,6141000,0.043,0.043
FALSE,United States,3/1/02,Hide,Hide,3,2002,136177,136177000,144481,144481000,1,8304,8304000,0.057,0.057
FALSE,United States,3/1/03,Hide,Hide,3,2003,137434,137434000,146022,146022000,1,8588,8588000,0.059,0.059
FALSE,United States,3/1/04,Hide,Hide,3,2004,138453,138453000,146944,146944000,1,8491,8491000,0.058,0.058
FALSE,United States,3/1/05,Hide,Hide,3,2005,140654,140654000,148391,148391000,1,7737,7737000,0.052,0.052
FALSE,United States,3/1/06,Hide,Hide,3,2006,143741,143741000,150813,150813000,1,7072,7072000,0.047,0.047
FALSE,United States,3/1/07,Hide,Hide,3,2007,146320,146320000,153051,153051000,1,6731,6731000,0.044,0.044
FALSE,United States,3/1/08,Hide,Hide,3,2008,146086,146086000,153908,153908000,1,7822,7822000,0.051,0.051
FALSE,United States,3/1/09,Hide,Hide,3,2009,140707,140707000,154133,154133000,1,13426,13426000,0.087,0.087
FALSE,United States,3/1/10,Hide,Hide,3,2010,138751,138751000,153954,153954000,1,15202,15202000,0.099,0.099
FALSE,United States,3/1/11,Hide,Hide,3,2011,139639,139639000,153376,153376000,1,13737,13737000,0.09,0.09
FALSE,United States,3/1/12,Hide,Hide,3,2012,142036,142036000,154749,154749000,1,12713,12713000,0.082,0.082
FALSE,United States,3/1/13,Hide,Hide,3,2013,143316,143316000,155005,155005000,1,11689,11689000,0.075,0.075
FALSE,United States,3/1/14,Hide,Hide,3,2014,145648,145648000,156028,156028000,1,10380,10380000,0.067,0.067
FALSE,United States,3/1/15,Hide,Hide,3,2015,148128,148128000,156643,156643000,1,8515,8515000,0.054,0.054
FALSE,United States,3/1/16,Hide,Hide,3,2016,151157,151157000,159103,159103000,1,7945,7945000,0.05,0.05
FALSE,United States,3/1/17,Hide,Hide,3,2017,152978,152978000,160066,160066000,1,7088,7088000,0.044,0.044
FALSE,United States,3/1/18,Hide,Hide,3,2018,155191,155191000,161684,161684000,1,6493,6493000,0.04,0.04
FALSE,United States,3/1/19,Hide,Hide,3,2019,156741,156741000,162935,162935000,1,6194,6194000,0.038,0.038
FALSE,United States,3/1/20,Hide,Hide,3,2020,155772,155772000,162913,162913000,1,7140,7140000,0.044,0.044
FALSE,Utah County,3/1/93,Hide,Hide,3,1993,128862,128862,133901,133901,1,5039,5039,0.037632281,0.037632281
FALSE,Utah County,3/1/94,Hide,Hide,3,1994,139638,139638,144108,144108,1,4470,4470,0.031018403,0.031018403
FALSE,Utah County,3/1/95,Hide,Hide,3,1995,142407,142407,146814,146814,1,4407,4407,0.030017573,0.030017573
FALSE,Utah County,3/1/96,Hide,Hide,3,1996,148073,148073,152367,152367,1,4294,4294,0.028181955,0.028181955
FALSE,Utah County,3/1/97,Hide,Hide,3,1997,153362,153362,157547,157547,1,4185,4185,0.026563502,0.026563502
FALSE,Utah County,3/1/98,Hide,Hide,3,1998,157914,157914,162753,162753,1,4839,4839,0.029732171,0.029732171
FALSE,Utah County,3/1/99,Hide,Hide,3,1999,163581,163581,168984,168984,1,5403,5403,0.031973441,0.031973441
FALSE,Utah County,3/1/00,Hide,Hide,3,2000,173820,173820,178597,178597,1,4777,4777,0.02674737,0.02674737
FALSE,Utah County,3/1/01,Hide,Hide,3,2001,176906,176906,183445,183445,1,6539,6539,0.035645561,0.035645561
FALSE,Utah County,3/1/02,Hide,Hide,3,2002,174283,174283,185089,185089,1,10806,10806,0.058382724,0.058382724
FALSE,Utah County,3/1/03,Hide,Hide,3,2003,177239,177239,187495,187495,1,10256,10256,0.054700125,0.054700125
FALSE,Utah County,3/1/04,Hide,Hide,3,2004,184669,184669,194310,194310,1,9641,9641,0.049616592,0.049616592
FALSE,Utah County,3/1/05,Hide,Hide,3,2005,194412,194412,202660,202660,1,8248,8248,0.040698707,0.040698707
FALSE,Utah County,3/1/06,Hide,Hide,3,2006,204552,204552,211134,211134,1,6582,6582,0.031174515,0.031174515
FALSE,Utah County,3/1/07,Hide,Hide,3,2007,216274,216274,221232,221232,1,4958,4958,0.022410863,0.022410863
FALSE,Utah County,3/1/08,Hide,Hide,3,2008,216872,216872,223686,223686,1,6814,6814,0.030462345,0.030462345
FALSE,Utah County,3/1/09,Hide,Hide,3,2009,208158,208158,222768,222768,1,14610,14610,0.065583926,0.065583926
FALSE,Utah County,3/1/10,Hide,Hide,3,2010,212060,212060,229247,229247,1,17187,17187,0.074971537,0.074971537
FALSE,Utah County,3/1/11,Hide,Hide,3,2011,214278,214278,229857,229857,1,15579,15579,0.067776922,0.067776922
FALSE,Utah County,3/1/12,Hide,Hide,3,2012,222931,222931,235250,235250,1,12319,12319,0.052365569,0.052365569
FALSE,Utah County,3/1/13,Hide,Hide,3,2013,234666,234666,245683,245683,1,11017,11017,0.044842337,0.044842337
FALSE,Utah County,3/1/14,Hide,Hide,3,2014,243469,243469,252653,252653,1,9184,9184,0.036350251,0.036350251
FALSE,Utah County,3/1/15,Hide,Hide,3,2015,253548,253548,262103,262103,1,8555,8555,0.03263984,0.03263984
FALSE,Utah County,3/1/16,Hide,Hide,3,2016,266176,266176,274914,274914,1,8738,8738,0.031784485,0.031784485
FALSE,Utah County,3/1/17,Hide,Hide,3,2017,278840,278840,287418,287418,1,8578,8578,0.029845034,0.029845034
FALSE,Utah County,3/1/18,Hide,Hide,3,2018,289287,289287,297538,297538,1,8251,8251,0.027730912,0.027730912
FALSE,Utah County,3/1/19,Hide,Hide,3,2019,296881,296881,304567,304567,1,7686,7686,0.025235827,0.025235827
FALSE,Utah County,3/1/20,Hide,Hide,3,2020,303865,303865,312681,312681,1,8816,8816,0.02819487,0.02819487
FALSE,Wasatch County,3/1/93,Hide,Hide,3,1993,4697,4697,5020,5020,1,323,323,0.064342629,0.064342629
FALSE,Wasatch County,3/1/94,Hide,Hide,3,1994,4985,4985,5276,5276,1,291,291,0.055155421,0.055155421
FALSE,Wasatch County,3/1/95,Hide,Hide,3,1995,5146,5146,5438,5438,1,292,292,0.053696212,0.053696212
FALSE,Wasatch County,3/1/96,Hide,Hide,3,1996,5317,5317,5566,5566,1,249,249,0.044735897,0.044735897
FALSE,Wasatch County,3/1/97,Hide,Hide,3,1997,5628,5628,5850,5850,1,222,222,0.037948718,0.037948718
FALSE,Wasatch County,3/1/98,Hide,Hide,3,1998,5897,5897,6205,6205,1,308,308,0.049637389,0.049637389
FALSE,Wasatch County,3/1/99,Hide,Hide,3,1999,6137,6137,6434,6434,1,297,297,0.04616102,0.04616102
FALSE,Wasatch County,3/1/00,Hide,Hide,3,2000,7221,7221,7463,7463,1,242,242,0.032426638,0.032426638
FALSE,Wasatch County,3/1/01,Hide,Hide,3,2001,7339,7339,7669,7669,1,330,330,0.043030382,0.043030382
FALSE,Wasatch County,3/1/02,Hide,Hide,3,2002,7605,7605,8119,8119,1,514,514,0.063308289,0.063308289
FALSE,Wasatch County,3/1/03,Hide,Hide,3,2003,7799,7799,8320,8320,1,521,521,0.062620192,0.062620192
FALSE,Wasatch County,3/1/04,Hide,Hide,3,2004,8156,8156,8656,8656,1,500,500,0.057763401,0.057763401
FALSE,Wasatch County,3/1/05,Hide,Hide,3,2005,8807,8807,9199,9199,1,392,392,0.042613328,0.042613328
FALSE,Wasatch County,3/1/06,Hide,Hide,3,2006,9466,9466,9806,9806,1,340,340,0.034672649,0.034672649
FALSE,Wasatch County,3/1/07,Hide,Hide,3,2007,10337,10337,10567,10567,1,230,230,0.021765875,0.021765875
FALSE,Wasatch County,3/1/08,Hide,Hide,3,2008,10035,10035,10352,10352,1,317,317,0.030622102,0.030622102
FALSE,Wasatch County,3/1/09,Hide,Hide,3,2009,9230,9230,10005,10005,1,775,775,0.077461269,0.077461269
FALSE,Wasatch County,3/1/10,Hide,Hide,3,2010,10313,10313,11273,11273,1,960,960,0.08515923,0.08515923
FALSE,Wasatch County,3/1/11,Hide,Hide,3,2011,10495,10495,11345,11345,1,850,850,0.074922874,0.074922874
FALSE,Wasatch County,3/1/12,Hide,Hide,3,2012,10827,10827,11519,11519,1,692,692,0.060074659,0.060074659
FALSE,Wasatch County,3/1/13,Hide,Hide,3,2013,11473,11473,12066,12066,1,593,593,0.049146362,0.049146362
FALSE,Wasatch County,3/1/14,Hide,Hide,3,2014,12143,12143,12643,12643,1,500,500,0.039547576,0.039547576
FALSE,Wasatch County,3/1/15,Hide,Hide,3,2015,12639,12639,13098,13098,1,459,459,0.035043518,0.035043518
FALSE,Wasatch County,3/1/16,Hide,Hide,3,2016,13247,13247,13739,13739,1,492,492,0.035810467,0.035810467
FALSE,Wasatch County,3/1/17,Hide,Hide,3,2017,13935,13935,14419,14419,1,484,484,0.033566822,0.033566822
FALSE,Wasatch County,3/1/18,Hide,Hide,3,2018,14403,14403,14869,14869,1,466,466,0.031340373,0.031340373
FALSE,Wasatch County,3/1/19,Hide,Hide,3,2019,15374,15374,15820,15820,1,446,446,0.028192162,0.028192162
FALSE,Wasatch County,3/1/20,Hide,Hide,3,2020,16050,16050,16585,16585,1,535,535,0.032258065,0.032258065
FALSE,Washington County,3/1/93,Hide,Hide,3,1993,23873,23873,24884,24884,1,1011,1011,0.040628516,0.040628516
FALSE,Washington County,3/1/94,Hide,Hide,3,1994,28682,28682,29521,29521,1,839,839,0.028420446,0.028420446
FALSE,Washington County,3/1/95,Hide,Hide,3,1995,31054,31054,32090,32090,1,1036,1036,0.032284201,0.032284201
FALSE,Washington County,3/1/96,Hide,Hide,3,1996,33103,33103,34296,34296,1,1193,1193,0.034785398,0.034785398
FALSE,Washington County,3/1/97,Hide,Hide,3,1997,33835,33835,35034,35034,1,1199,1199,0.034223897,0.034223897
FALSE,Washington County,3/1/98,Hide,Hide,3,1998,35413,35413,36712,36712,1,1299,1299,0.035383526,0.035383526
FALSE,Washington County,3/1/99,Hide,Hide,3,1999,37059,37059,38423,38423,1,1364,1364,0.035499571,0.035499571
FALSE,Washington County,3/1/00,Hide,Hide,3,2000,37611,37611,38912,38912,1,1301,1301,0.033434416,0.033434416
FALSE,Washington County,3/1/01,Hide,Hide,3,2001,39650,39650,41320,41320,1,1670,1670,0.040416263,0.040416263
FALSE,Washington County,3/1/02,Hide,Hide,3,2002,41750,41750,43928,43928,1,2178,2178,0.049581133,0.049581133
FALSE,Washington County,3/1/03,Hide,Hide,3,2003,44025,44025,46579,46579,1,2554,2554,0.054831576,0.054831576
FALSE,Washington County,3/1/04,Hide,Hide,3,2004,47977,47977,50535,50535,1,2558,2558,0.050618383,0.050618383
FALSE,Washington County,3/1/05,Hide,Hide,3,2005,53098,53098,55459,55459,1,2361,2361,0.04257199,0.04257199
FALSE,Washington County,3/1/06,Hide,Hide,3,2006,58860,58860,60786,60786,1,1926,1926,0.031684927,0.031684927
FALSE,Washington County,3/1/07,Hide,Hide,3,2007,61216,61216,62805,62805,1,1589,1589,0.025300533,0.025300533
FALSE,Washington County,3/1/08,Hide,Hide,3,2008,60499,60499,62808,62808,1,2309,2309,0.036762833,0.036762833
FALSE,Washington County,3/1/09,Hide,Hide,3,2009,55285,55285,60885,60885,1,5600,5600,0.091976677,0.091976677
FALSE,Washington County,3/1/10,Hide,Hide,3,2010,51087,51087,57070,57070,1,5983,5983,0.104836166,0.104836166
FALSE,Washington County,3/1/11,Hide,Hide,3,2011,50673,50673,55972,55972,1,5299,5299,0.094672336,0.094672336
FALSE,Washington County,3/1/12,Hide,Hide,3,2012,52495,52495,56630,56630,1,4135,4135,0.073017835,0.073017835
FALSE,Washington County,3/1/13,Hide,Hide,3,2013,54985,54985,58474,58474,1,3489,3489,0.059667545,0.059667545
FALSE,Washington County,3/1/14,Hide,Hide,3,2014,58313,58313,61059,61059,1,2746,2746,0.044972895,0.044972895
FALSE,Washington County,3/1/15,Hide,Hide,3,2015,60332,60332,62965,62965,1,2633,2633,0.041816882,0.041816882
FALSE,Washington County,3/1/16,Hide,Hide,3,2016,63469,63469,66056,66056,1,2587,2587,0.03916374,0.03916374
FALSE,Washington County,3/1/17,Hide,Hide,3,2017,67358,67358,69832,69832,1,2474,2474,0.035427884,0.035427884
FALSE,Washington County,3/1/18,Hide,Hide,3,2018,70913,70913,73383,73383,1,2470,2470,0.033659022,0.033659022
FALSE,Washington County,3/1/19,Hide,Hide,3,2019,72971,72971,75305,75305,1,2334,2334,0.030993958,0.030993958
FALSE,Washington County,3/1/20,Hide,Hide,3,2020,75161,75161,77937,77937,1,2776,2776,0.035618512,0.035618512
FALSE,Wayne County,3/1/93,Hide,Hide,3,1993,962,962,1044,1044,1,82,82,0.078544061,0.078544061
FALSE,Wayne County,3/1/94,Hide,Hide,3,1994,1055,1055,1147,1147,1,92,92,0.080209241,0.080209241
FALSE,Wayne County,3/1/95,Hide,Hide,3,1995,1199,1199,1277,1277,1,78,78,0.061080658,0.061080658
FALSE,Wayne County,3/1/96,Hide,Hide,3,1996,1267,1267,1343,1343,1,76,76,0.056589724,0.056589724
FALSE,Wayne County,3/1/97,Hide,Hide,3,1997,1288,1288,1359,1359,1,71,71,0.052244297,0.052244297
FALSE,Wayne County,3/1/98,Hide,Hide,3,1998,1429,1429,1512,1512,1,83,83,0.05489418,0.05489418
FALSE,Wayne County,3/1/99,Hide,Hide,3,1999,1379,1379,1470,1470,1,91,91,0.061904762,0.061904762
FALSE,Wayne County,3/1/00,Hide,Hide,3,2000,1267,1267,1324,1324,1,57,57,0.04305136,0.04305136
FALSE,Wayne County,3/1/01,Hide,Hide,3,2001,1311,1311,1385,1385,1,74,74,0.053429603,0.053429603
FALSE,Wayne County,3/1/02,Hide,Hide,3,2002,1396,1396,1479,1479,1,83,83,0.056118999,0.056118999
FALSE,Wayne County,3/1/03,Hide,Hide,3,2003,1261,1261,1348,1348,1,87,87,0.064540059,0.064540059
FALSE,Wayne County,3/1/04,Hide,Hide,3,2004,1302,1302,1391,1391,1,89,89,0.063982746,0.063982746
FALSE,Wayne County,3/1/05,Hide,Hide,3,2005,1230,1230,1302,1302,1,72,72,0.055299539,0.055299539
FALSE,Wayne County,3/1/06,Hide,Hide,3,2006,1315,1315,1381,1381,1,66,66,0.047791455,0.047791455
FALSE,Wayne County,3/1/07,Hide,Hide,3,2007,1358,1358,1412,1412,1,54,54,0.038243626,0.038243626
FALSE,Wayne County,3/1/08,Hide,Hide,3,2008,1276,1276,1341,1341,1,65,65,0.04847129,0.04847129
FALSE,Wayne County,3/1/09,Hide,Hide,3,2009,1345,1345,1460,1460,1,115,115,0.078767123,0.078767123
FALSE,Wayne County,3/1/10,Hide,Hide,3,2010,1438,1438,1570,1570,1,132,132,0.084076433,0.084076433
FALSE,Wayne County,3/1/11,Hide,Hide,3,2011,1353,1353,1490,1490,1,137,137,0.091946309,0.091946309
FALSE,Wayne County,3/1/12,Hide,Hide,3,2012,1201,1201,1346,1346,1,145,145,0.107726597,0.107726597
FALSE,Wayne County,3/1/13,Hide,Hide,3,2013,1194,1194,1347,1347,1,153,153,0.113585746,0.113585746
FALSE,Wayne County,3/1/14,Hide,Hide,3,2014,1260,1260,1390,1390,1,130,130,0.09352518,0.09352518
FALSE,Wayne County,3/1/15,Hide,Hide,3,2015,1271,1271,1401,1401,1,130,130,0.092790864,0.092790864
FALSE,Wayne County,3/1/16,Hide,Hide,3,2016,1332,1332,1447,1447,1,115,115,0.079474775,0.079474775
FALSE,Wayne County,3/1/17,Hide,Hide,3,2017,1338,1338,1451,1451,1,113,113,0.077877326,0.077877326
FALSE,Wayne County,3/1/18,Hide,Hide,3,2018,1356,1356,1444,1444,1,88,88,0.060941828,0.060941828
FALSE,Wayne County,3/1/19,Hide,Hide,3,2019,1338,1338,1417,1417,1,79,79,0.055751588,0.055751588
FALSE,Wayne County,3/1/20,Hide,Hide,3,2020,1365,1365,1464,1464,1,99,99,0.067622951,0.067622951
FALSE,Weber County,3/1/93,Hide,Hide,3,1993,81665,81665,86440,86440,1,4775,4775,0.055240629,0.055240629
FALSE,Weber County,3/1/94,Hide,Hide,3,1994,87198,87198,91252,91252,1,4054,4054,0.044426424,0.044426424
FALSE,Weber County,3/1/95,Hide,Hide,3,1995,87868,87868,91887,91887,1,4019,4019,0.043738505,0.043738505
FALSE,Weber County,3/1/96,Hide,Hide,3,1996,91128,91128,95032,95032,1,3904,3904,0.041080899,0.041080899
FALSE,Weber County,3/1/97,Hide,Hide,3,1997,94313,94313,98040,98040,1,3727,3727,0.038015096,0.038015096
FALSE,Weber County,3/1/98,Hide,Hide,3,1998,95988,95988,100667,100667,1,4679,4679,0.046479979,0.046479979
FALSE,Weber County,3/1/99,Hide,Hide,3,1999,98193,98193,102643,102643,1,4450,4450,0.04335415,0.04335415
FALSE,Weber County,3/1/00,Hide,Hide,3,2000,96808,96808,100753,100753,1,3945,3945,0.039155162,0.039155162
FALSE,Weber County,3/1/01,Hide,Hide,3,2001,96794,96794,101959,101959,1,5165,5165,0.050657617,0.050657617
FALSE,Weber County,3/1/02,Hide,Hide,3,2002,96987,96987,103426,103426,1,6439,6439,0.062257073,0.062257073
FALSE,Weber County,3/1/03,Hide,Hide,3,2003,98444,98444,105304,105304,1,6860,6860,0.065144724,0.065144724
FALSE,Weber County,3/1/04,Hide,Hide,3,2004,100404,100404,106609,106609,1,6205,6205,0.058203341,0.058203341
FALSE,Weber County,3/1/05,Hide,Hide,3,2005,102319,102319,107521,107521,1,5202,5202,0.048381246,0.048381246
FALSE,Weber County,3/1/06,Hide,Hide,3,2006,105321,105321,109433,109433,1,4112,4112,0.037575503,0.037575503
FALSE,Weber County,3/1/07,Hide,Hide,3,2007,108936,108936,112002,112002,1,3066,3066,0.027374511,0.027374511
FALSE,Weber County,3/1/08,Hide,Hide,3,2008,109622,109622,113697,113697,1,4075,4075,0.035840875,0.035840875
FALSE,Weber County,3/1/09,Hide,Hide,3,2009,106280,106280,115507,115507,1,9227,9227,0.079882605,0.079882605
FALSE,Weber County,3/1/10,Hide,Hide,3,2010,103298,103298,113178,113178,1,9880,9880,0.087296118,0.087296118
FALSE,Weber County,3/1/11,Hide,Hide,3,2011,103058,103058,112283,112283,1,9225,9225,0.082158475,0.082158475
FALSE,Weber County,3/1/12,Hide,Hide,3,2012,105461,105461,112989,112989,1,7528,7528,0.066625955,0.066625955
FALSE,Weber County,3/1/13,Hide,Hide,3,2013,107584,107584,114041,114041,1,6457,6457,0.056619988,0.056619988
FALSE,Weber County,3/1/14,Hide,Hide,3,2014,109259,109259,114435,114435,1,5176,5176,0.045230917,0.045230917
FALSE,Weber County,3/1/15,Hide,Hide,3,2015,111694,111694,116515,116515,1,4821,4821,0.041376647,0.041376647
FALSE,Weber County,3/1/16,Hide,Hide,3,2016,114162,114162,118961,118961,1,4799,4799,0.040340952,0.040340952
FALSE,Weber County,3/1/17,Hide,Hide,3,2017,118216,118216,122736,122736,1,4520,4520,0.036827011,0.036827011
FALSE,Weber County,3/1/18,Hide,Hide,3,2018,120273,120273,124600,124600,1,4327,4327,0.034727127,0.034727127
FALSE,Weber County,3/1/19,Hide,Hide,3,2019,122560,122560,126619,126619,1,4059,4059,0.0320568,0.0320568
FALSE,Weber County,3/1/20,Hide,Hide,3,2020,124851,124851,129196,129196,1,4345,4345,0.033631072,0.033631072
FALSE,Beaver County,4/1/93,Hide,Hide,4,1993,2021,2021,2122,2122,1,101,101,0.047596607,0.047596607
FALSE,Beaver County,4/1/94,Hide,Hide,4,1994,2056,2056,2144,2144,1,88,88,0.041044776,0.041044776
FALSE,Beaver County,4/1/95,Hide,Hide,4,1995,2233,2233,2311,2311,1,78,78,0.033751623,0.033751623
FALSE,Beaver County,4/1/96,Hide,Hide,4,1996,2341,2341,2462,2462,1,121,121,0.049147035,0.049147035
FALSE,Beaver County,4/1/97,Hide,Hide,4,1997,2443,2443,2570,2570,1,127,127,0.049416342,0.049416342
FALSE,Beaver County,4/1/98,Hide,Hide,4,1998,2396,2396,2530,2530,1,134,134,0.052964427,0.052964427
FALSE,Beaver County,4/1/99,Hide,Hide,4,1999,2387,2387,2474,2474,1,87,87,0.035165724,0.035165724
FALSE,Beaver County,4/1/00,Hide,Hide,4,2000,2624,2624,2713,2713,1,89,89,0.032805013,0.032805013
FALSE,Beaver County,4/1/01,Hide,Hide,4,2001,2719,2719,2828,2828,1,109,109,0.03854314,0.03854314
FALSE,Beaver County,4/1/02,Hide,Hide,4,2002,2918,2918,3057,3057,1,139,139,0.045469414,0.045469414
FALSE,Beaver County,4/1/03,Hide,Hide,4,2003,2806,2806,2961,2961,1,155,155,0.05234718,0.05234718
FALSE,Beaver County,4/1/04,Hide,Hide,4,2004,3067,3067,3204,3204,1,137,137,0.042759051,0.042759051
FALSE,Beaver County,4/1/05,Hide,Hide,4,2005,2912,2912,3037,3037,1,125,125,0.041159039,0.041159039
FALSE,Beaver County,4/1/06,Hide,Hide,4,2006,2986,2986,3088,3088,1,102,102,0.033031088,0.033031088
FALSE,Beaver County,4/1/07,Hide,Hide,4,2007,3149,3149,3224,3224,1,75,75,0.023263027,0.023263027
FALSE,Beaver County,4/1/08,Hide,Hide,4,2008,2931,2931,3018,3018,1,87,87,0.028827038,0.028827038
FALSE,Beaver County,4/1/09,Hide,Hide,4,2009,3277,3277,3480,3480,1,203,203,0.058333333,0.058333333
FALSE,Beaver County,4/1/10,Hide,Hide,4,2010,2759,2759,3083,3083,1,324,324,0.105092442,0.105092442
FALSE,Beaver County,4/1/11,Hide,Hide,4,2011,2827,2827,3084,3084,1,257,257,0.083333333,0.083333333
FALSE,Beaver County,4/1/12,Hide,Hide,4,2012,2719,2719,2904,2904,1,185,185,0.063705234,0.063705234
FALSE,Beaver County,4/1/13,Hide,Hide,4,2013,2875,2875,3024,3024,1,149,149,0.049272487,0.049272487
FALSE,Beaver County,4/1/14,Hide,Hide,4,2014,2883,2883,3005,3005,1,122,122,0.040599002,0.040599002
FALSE,Beaver County,4/1/15,Hide,Hide,4,2015,3079,3079,3197,3197,1,118,118,0.036909603,0.036909603
FALSE,Beaver County,4/1/16,Hide,Hide,4,2016,2969,2969,3107,3107,1,138,138,0.044415835,0.044415835
FALSE,Beaver County,4/1/17,Hide,Hide,4,2017,2904,2904,3035,3035,1,131,131,0.043163097,0.043163097
FALSE,Beaver County,4/1/18,Hide,Hide,4,2018,2894,2894,3002,3002,1,108,108,0.035976016,0.035976016
FALSE,Beaver County,4/1/19,Hide,Hide,4,2019,2805,2805,2897,2897,1,92,92,0.03175699,0.03175699
FALSE,Beaver County,4/1/20,Show,Hide,4,2020,2627,2627,2811,2811,1,184,184,0.065457133,0.065457133
FALSE,Box Elder County,4/1/93,Hide,Hide,4,1993,16237,16237,17149,17149,1,912,912,0.053180943,0.053180943
FALSE,Box Elder County,4/1/94,Hide,Hide,4,1994,16950,16950,17832,17832,1,882,882,0.049461642,0.049461642
FALSE,Box Elder County,4/1/95,Hide,Hide,4,1995,17181,17181,18019,18019,1,838,838,0.046506465,0.046506465
FALSE,Box Elder County,4/1/96,Hide,Hide,4,1996,16996,16996,17771,17771,1,775,775,0.043610376,0.043610376
FALSE,Box Elder County,4/1/97,Hide,Hide,4,1997,17906,17906,18585,18585,1,679,679,0.03653484,0.03653484
FALSE,Box Elder County,4/1/98,Hide,Hide,4,1998,18293,18293,19173,19173,1,880,880,0.045897877,0.045897877
FALSE,Box Elder County,4/1/99,Hide,Hide,4,1999,17667,17667,18534,18534,1,867,867,0.046778893,0.046778893
FALSE,Box Elder County,4/1/00,Hide,Hide,4,2000,19218,19218,19934,19934,1,716,716,0.035918531,0.035918531
FALSE,Box Elder County,4/1/01,Hide,Hide,4,2001,19233,19233,20121,20121,1,888,888,0.044132995,0.044132995
FALSE,Box Elder County,4/1/02,Hide,Hide,4,2002,19928,19928,21105,21105,1,1177,1177,0.055768775,0.055768775
FALSE,Box Elder County,4/1/03,Hide,Hide,4,2003,19886,19886,21067,21067,1,1181,1181,0.05605924,0.05605924
FALSE,Box Elder County,4/1/04,Hide,Hide,4,2004,21026,21026,22158,22158,1,1132,1132,0.051087643,0.051087643
FALSE,Box Elder County,4/1/05,Hide,Hide,4,2005,21195,21195,22196,22196,1,1001,1001,0.045098216,0.045098216
FALSE,Box Elder County,4/1/06,Hide,Hide,4,2006,21979,21979,22762,22762,1,783,783,0.034399438,0.034399438
FALSE,Box Elder County,4/1/07,Hide,Hide,4,2007,22855,22855,23454,23454,1,599,599,0.025539354,0.025539354
FALSE,Box Elder County,4/1/08,Hide,Hide,4,2008,22898,22898,23663,23663,1,765,765,0.032328952,0.032328952
FALSE,Box Elder County,4/1/09,Hide,Hide,4,2009,21343,21343,23224,23224,1,1881,1881,0.0809938,0.0809938
FALSE,Box Elder County,4/1/10,Hide,Hide,4,2010,21591,21591,23572,23572,1,1981,1981,0.084040387,0.084040387
FALSE,Box Elder County,4/1/11,Hide,Hide,4,2011,21332,21332,23180,23180,1,1848,1848,0.0797239,0.0797239
FALSE,Box Elder County,4/1/12,Hide,Hide,4,2012,21559,21559,22927,22927,1,1368,1368,0.059667641,0.059667641
FALSE,Box Elder County,4/1/13,Hide,Hide,4,2013,22029,22029,23157,23157,1,1128,1128,0.048710973,0.048710973
FALSE,Box Elder County,4/1/14,Hide,Hide,4,2014,22465,22465,23373,23373,1,908,908,0.038848244,0.038848244
FALSE,Box Elder County,4/1/15,Hide,Hide,4,2015,23098,23098,24000,24000,1,902,902,0.037583333,0.037583333
FALSE,Box Elder County,4/1/16,Hide,Hide,4,2016,23626,23626,24504,24504,1,878,878,0.035830885,0.035830885
FALSE,Box Elder County,4/1/17,Hide,Hide,4,2017,24375,24375,25218,25218,1,843,843,0.033428503,0.033428503
FALSE,Box Elder County,4/1/18,Hide,Hide,4,2018,24631,24631,25381,25381,1,750,750,0.029549663,0.029549663
FALSE,Box Elder County,4/1/19,Hide,Hide,4,2019,25087,25087,25793,25793,1,706,706,0.027371768,0.027371768
FALSE,Box Elder County,4/1/20,Show,Hide,4,2020,23669,23669,26428,26428,1,2759,2759,0.104396852,0.104396852
FALSE,Cache County,4/1/93,Hide,Hide,4,1993,36882,36882,38089,38089,1,1207,1207,0.031688939,0.031688939
FALSE,Cache County,4/1/94,Hide,Hide,4,1994,38931,38931,40055,40055,1,1124,1124,0.028061416,0.028061416
FALSE,Cache County,4/1/95,Hide,Hide,4,1995,40292,40292,41597,41597,1,1305,1305,0.031372455,0.031372455
FALSE,Cache County,4/1/96,Hide,Hide,4,1996,40635,40635,41871,41871,1,1236,1236,0.029519238,0.029519238
FALSE,Cache County,4/1/97,Hide,Hide,4,1997,42145,42145,43266,43266,1,1121,1121,0.02590949,0.02590949
FALSE,Cache County,4/1/98,Hide,Hide,4,1998,43039,43039,44388,44388,1,1349,1349,0.030391097,0.030391097
FALSE,Cache County,4/1/99,Hide,Hide,4,1999,43880,43880,45027,45027,1,1147,1147,0.025473605,0.025473605
FALSE,Cache County,4/1/00,Hide,Hide,4,2000,46502,46502,47790,47790,1,1288,1288,0.026951245,0.026951245
FALSE,Cache County,4/1/01,Hide,Hide,4,2001,47623,47623,49279,49279,1,1656,1656,0.033604578,0.033604578
FALSE,Cache County,4/1/02,Hide,Hide,4,2002,50157,50157,52277,52277,1,2120,2120,0.040553207,0.040553207
FALSE,Cache County,4/1/03,Hide,Hide,4,2003,50996,50996,53170,53170,1,2174,2174,0.040887719,0.040887719
FALSE,Cache County,4/1/04,Hide,Hide,4,2004,53975,53975,56030,56030,1,2055,2055,0.03667678,0.03667678
FALSE,Cache County,4/1/05,Hide,Hide,4,2005,55175,55175,57056,57056,1,1881,1881,0.032967611,0.032967611
FALSE,Cache County,4/1/06,Hide,Hide,4,2006,56601,56601,58027,58027,1,1426,1426,0.024574767,0.024574767
FALSE,Cache County,4/1/07,Hide,Hide,4,2007,59403,59403,60523,60523,1,1120,1120,0.018505362,0.018505362
FALSE,Cache County,4/1/08,Hide,Hide,4,2008,59974,59974,61449,61449,1,1475,1475,0.024003645,0.024003645
FALSE,Cache County,4/1/09,Hide,Hide,4,2009,58638,58638,62014,62014,1,3376,3376,0.05443932,0.05443932
FALSE,Cache County,4/1/10,Hide,Hide,4,2010,53818,53818,57289,57289,1,3471,3471,0.060587547,0.060587547
FALSE,Cache County,4/1/11,Hide,Hide,4,2011,53931,53931,56998,56998,1,3067,3067,0.053808906,0.053808906
FALSE,Cache County,4/1/12,Hide,Hide,4,2012,54321,54321,56934,56934,1,2613,2613,0.045895247,0.045895247
FALSE,Cache County,4/1/13,Hide,Hide,4,2013,55301,55301,57691,57691,1,2390,2390,0.041427606,0.041427606
FALSE,Cache County,4/1/14,Hide,Hide,4,2014,56803,56803,58664,58664,1,1861,1861,0.031723033,0.031723033
FALSE,Cache County,4/1/15,Hide,Hide,4,2015,58062,58062,59862,59862,1,1800,1800,0.030069159,0.030069159
FALSE,Cache County,4/1/16,Hide,Hide,4,2016,59004,59004,60948,60948,1,1944,1944,0.031896043,0.031896043
FALSE,Cache County,4/1/17,Hide,Hide,4,2017,60569,60569,62331,62331,1,1762,1762,0.028268438,0.028268438
FALSE,Cache County,4/1/18,Hide,Hide,4,2018,61313,61313,62980,62980,1,1667,1667,0.02646872,0.02646872
FALSE,Cache County,4/1/19,Hide,Hide,4,2019,62711,62711,64171,64171,1,1460,1460,0.02275171,0.02275171
FALSE,Cache County,4/1/20,Show,Hide,4,2020,58272,58272,62058,62058,1,3786,3786,0.061007445,0.061007445
FALSE,Carbon County,4/1/93,Hide,Hide,4,1993,8196,8196,8898,8898,1,702,702,0.078894134,0.078894134
FALSE,Carbon County,4/1/94,Hide,Hide,4,1994,8678,8678,9411,9411,1,733,733,0.077887578,0.077887578
FALSE,Carbon County,4/1/95,Hide,Hide,4,1995,8522,8522,9114,9114,1,592,592,0.064955014,0.064955014
FALSE,Carbon County,4/1/96,Hide,Hide,4,1996,8774,8774,9348,9348,1,574,574,0.061403509,0.061403509
FALSE,Carbon County,4/1/97,Hide,Hide,4,1997,9186,9186,9665,9665,1,479,479,0.049560269,0.049560269
FALSE,Carbon County,4/1/98,Hide,Hide,4,1998,9255,9255,9805,9805,1,550,550,0.05609383,0.05609383
FALSE,Carbon County,4/1/99,Hide,Hide,4,1999,9216,9216,9938,9938,1,722,722,0.072650433,0.072650433
FALSE,Carbon County,4/1/00,Hide,Hide,4,2000,8983,8983,9448,9448,1,465,465,0.049216765,0.049216765
FALSE,Carbon County,4/1/01,Hide,Hide,4,2001,8347,8347,8951,8951,1,604,604,0.067478494,0.067478494
FALSE,Carbon County,4/1/02,Hide,Hide,4,2002,8807,8807,9436,9436,1,629,629,0.066659602,0.066659602
FALSE,Carbon County,4/1/03,Hide,Hide,4,2003,8697,8697,9422,9422,1,725,725,0.07694757,0.07694757
FALSE,Carbon County,4/1/04,Hide,Hide,4,2004,8617,8617,9254,9254,1,637,637,0.068835098,0.068835098
FALSE,Carbon County,4/1/05,Hide,Hide,4,2005,8950,8950,9433,9433,1,483,483,0.051203223,0.051203223
FALSE,Carbon County,4/1/06,Hide,Hide,4,2006,9437,9437,9807,9807,1,370,370,0.037728153,0.037728153
FALSE,Carbon County,4/1/07,Hide,Hide,4,2007,9409,9409,9719,9719,1,310,310,0.031896286,0.031896286
FALSE,Carbon County,4/1/08,Hide,Hide,4,2008,9502,9502,9919,9919,1,417,417,0.042040528,0.042040528
FALSE,Carbon County,4/1/09,Hide,Hide,4,2009,9814,9814,10595,10595,1,781,781,0.073714016,0.073714016
FALSE,Carbon County,4/1/10,Hide,Hide,4,2010,9055,9055,9913,9913,1,858,858,0.086553011,0.086553011
FALSE,Carbon County,4/1/11,Hide,Hide,4,2011,8836,8836,9575,9575,1,739,739,0.077180157,0.077180157
FALSE,Carbon County,4/1/12,Hide,Hide,4,2012,8731,8731,9386,9386,1,655,655,0.069784786,0.069784786
FALSE,Carbon County,4/1/13,Hide,Hide,4,2013,8455,8455,9047,9047,1,592,592,0.065436056,0.065436056
FALSE,Carbon County,4/1/14,Hide,Hide,4,2014,8225,8225,8669,8669,1,444,444,0.05121698,0.05121698
FALSE,Carbon County,4/1/15,Hide,Hide,4,2015,8264,8264,8739,8739,1,475,475,0.054354045,0.054354045
FALSE,Carbon County,4/1/16,Hide,Hide,4,2016,7918,7918,8426,8426,1,508,508,0.06028958,0.06028958
FALSE,Carbon County,4/1/17,Hide,Hide,4,2017,7857,7857,8284,8284,1,427,427,0.051545147,0.051545147
FALSE,Carbon County,4/1/18,Hide,Hide,4,2018,8052,8052,8439,8439,1,387,387,0.045858514,0.045858514
FALSE,Carbon County,4/1/19,Hide,Hide,4,2019,8136,8136,8466,8466,1,330,330,0.038979447,0.038979447
FALSE,Carbon County,4/1/20,Show,Hide,4,2020,7553,7553,8363,8363,1,810,810,0.096855196,0.096855196
FALSE,Daggett County,4/1/93,Hide,Hide,4,1993,384,384,400,400,1,16,16,0.04,0.04
FALSE,Daggett County,4/1/94,Hide,Hide,4,1994,454,454,471,471,1,17,17,0.036093418,0.036093418
FALSE,Daggett County,4/1/95,Hide,Hide,4,1995,419,419,453,453,1,34,34,0.075055188,0.075055188
FALSE,Daggett County,4/1/96,Hide,Hide,4,1996,393,393,409,409,1,16,16,0.039119804,0.039119804
FALSE,Daggett County,4/1/97,Hide,Hide,4,1997,395,395,412,412,1,17,17,0.041262136,0.041262136
FALSE,Daggett County,4/1/98,Hide,Hide,4,1998,410,410,428,428,1,18,18,0.042056075,0.042056075
FALSE,Daggett County,4/1/99,Hide,Hide,4,1999,420,420,437,437,1,17,17,0.038901602,0.038901602
FALSE,Daggett County,4/1/00,Hide,Hide,4,2000,445,445,459,459,1,14,14,0.030501089,0.030501089
FALSE,Daggett County,4/1/01,Hide,Hide,4,2001,423,423,445,445,1,22,22,0.049438202,0.049438202
FALSE,Daggett County,4/1/02,Hide,Hide,4,2002,488,488,512,512,1,24,24,0.046875,0.046875
FALSE,Daggett County,4/1/03,Hide,Hide,4,2003,451,451,477,477,1,26,26,0.054507338,0.054507338
FALSE,Daggett County,4/1/04,Hide,Hide,4,2004,500,500,527,527,1,27,27,0.051233397,0.051233397
FALSE,Daggett County,4/1/05,Hide,Hide,4,2005,461,461,484,484,1,23,23,0.047520661,0.047520661
FALSE,Daggett County,4/1/06,Hide,Hide,4,2006,484,484,511,511,1,27,27,0.052837573,0.052837573
FALSE,Daggett County,4/1/07,Hide,Hide,4,2007,511,511,529,529,1,18,18,0.034026465,0.034026465
FALSE,Daggett County,4/1/08,Hide,Hide,4,2008,434,434,451,451,1,17,17,0.037694013,0.037694013
FALSE,Daggett County,4/1/09,Hide,Hide,4,2009,432,432,458,458,1,26,26,0.056768559,0.056768559
FALSE,Daggett County,4/1/10,Hide,Hide,4,2010,457,457,492,492,1,35,35,0.071138211,0.071138211
FALSE,Daggett County,4/1/11,Hide,Hide,4,2011,440,440,470,470,1,30,30,0.063829787,0.063829787
FALSE,Daggett County,4/1/12,Hide,Hide,4,2012,416,416,437,437,1,21,21,0.04805492,0.04805492
FALSE,Daggett County,4/1/13,Hide,Hide,4,2013,416,416,438,438,1,22,22,0.050228311,0.050228311
FALSE,Daggett County,4/1/14,Hide,Hide,4,2014,412,412,428,428,1,16,16,0.037383178,0.037383178
FALSE,Daggett County,4/1/15,Hide,Hide,4,2015,449,449,470,470,1,21,21,0.044680851,0.044680851
FALSE,Daggett County,4/1/16,Hide,Hide,4,2016,451,451,476,476,1,25,25,0.052521008,0.052521008
FALSE,Daggett County,4/1/17,Hide,Hide,4,2017,412,412,432,432,1,20,20,0.046296296,0.046296296
FALSE,Daggett County,4/1/18,Hide,Hide,4,2018,383,383,400,400,1,17,17,0.0425,0.0425
FALSE,Daggett County,4/1/19,Hide,Hide,4,2019,376,376,393,393,1,17,17,0.043256997,0.043256997
FALSE,Daggett County,4/1/20,Show,Hide,4,2020,335,335,368,368,1,33,33,0.089673913,0.089673913
FALSE,Davis County,4/1/93,Hide,Hide,4,1993,95068,95068,98882,98882,1,3814,3814,0.038571226,0.038571226
FALSE,Davis County,4/1/94,Hide,Hide,4,1994,101633,101633,105164,105164,1,3531,3531,0.033576129,0.033576129
FALSE,Davis County,4/1/95,Hide,Hide,4,1995,101686,101686,105365,105365,1,3679,3679,0.034916718,0.034916718
FALSE,Davis County,4/1/96,Hide,Hide,4,1996,106915,106915,110404,110404,1,3489,3489,0.031602116,0.031602116
FALSE,Davis County,4/1/97,Hide,Hide,4,1997,111555,111555,114959,114959,1,3404,3404,0.029610557,0.029610557
FALSE,Davis County,4/1/98,Hide,Hide,4,1998,115864,115864,119873,119873,1,4009,4009,0.033443728,0.033443728
FALSE,Davis County,4/1/99,Hide,Hide,4,1999,120092,120092,124129,124129,1,4037,4037,0.032522618,0.032522618
FALSE,Davis County,4/1/00,Hide,Hide,4,2000,116860,116860,120342,120342,1,3482,3482,0.028934204,0.028934204
FALSE,Davis County,4/1/01,Hide,Hide,4,2001,117196,117196,121962,121962,1,4766,4766,0.039077746,0.039077746
FALSE,Davis County,4/1/02,Hide,Hide,4,2002,117970,117970,124159,124159,1,6189,6189,0.049847373,0.049847373
FALSE,Davis County,4/1/03,Hide,Hide,4,2003,121126,121126,127702,127702,1,6576,6576,0.051494887,0.051494887
FALSE,Davis County,4/1/04,Hide,Hide,4,2004,125204,125204,131599,131599,1,6395,6395,0.048594594,0.048594594
FALSE,Davis County,4/1/05,Hide,Hide,4,2005,129340,129340,134821,134821,1,5481,5481,0.040653904,0.040653904
FALSE,Davis County,4/1/06,Hide,Hide,4,2006,135706,135706,140030,140030,1,4324,4324,0.030879097,0.030879097
FALSE,Davis County,4/1/07,Hide,Hide,4,2007,140468,140468,143797,143797,1,3329,3329,0.023150692,0.023150692
FALSE,Davis County,4/1/08,Hide,Hide,4,2008,141190,141190,145526,145526,1,4336,4336,0.029795363,0.029795363
FALSE,Davis County,4/1/09,Hide,Hide,4,2009,135941,135941,145064,145064,1,9123,9123,0.062889483,0.062889483
FALSE,Davis County,4/1/10,Hide,Hide,4,2010,136959,136959,147300,147300,1,10341,10341,0.070203666,0.070203666
FALSE,Davis County,4/1/11,Hide,Hide,4,2011,137018,137018,146221,146221,1,9203,9203,0.062938976,0.062938976
FALSE,Davis County,4/1/12,Hide,Hide,4,2012,140308,140308,147780,147780,1,7472,7472,0.050561646,0.050561646
FALSE,Davis County,4/1/13,Hide,Hide,4,2013,145045,145045,151724,151724,1,6679,6679,0.044020722,0.044020722
FALSE,Davis County,4/1/14,Hide,Hide,4,2014,149446,149446,155051,155051,1,5605,5605,0.036149396,0.036149396
FALSE,Davis County,4/1/15,Hide,Hide,4,2015,153634,153634,159020,159020,1,5386,5386,0.033869953,0.033869953
FALSE,Davis County,4/1/16,Hide,Hide,4,2016,157620,157620,162953,162953,1,5333,5333,0.032727228,0.032727228
FALSE,Davis County,4/1/17,Hide,Hide,4,2017,163025,163025,168240,168240,1,5215,5215,0.030997385,0.030997385
FALSE,Davis County,4/1/18,Hide,Hide,4,2018,164804,164804,169673,169673,1,4869,4869,0.028696375,0.028696375
FALSE,Davis County,4/1/19,Hide,Hide,4,2019,168403,168403,172783,172783,1,4380,4380,0.025349716,0.025349716
FALSE,Davis County,4/1/20,Show,Hide,4,2020,158303,158303,173873,173873,1,15570,15570,0.089548118,0.089548118
FALSE,Duchesne County,4/1/93,Hide,Hide,4,1993,5133,5133,5633,5633,1,500,500,0.088762649,0.088762649
FALSE,Duchesne County,4/1/94,Hide,Hide,4,1994,5172,5172,5782,5782,1,610,610,0.105499827,0.105499827
FALSE,Duchesne County,4/1/95,Hide,Hide,4,1995,5293,5293,5807,5807,1,514,514,0.088513863,0.088513863
FALSE,Duchesne County,4/1/96,Hide,Hide,4,1996,5302,5302,5806,5806,1,504,504,0.086806752,0.086806752
FALSE,Duchesne County,4/1/97,Hide,Hide,4,1997,5484,5484,5876,5876,1,392,392,0.066712049,0.066712049
FALSE,Duchesne County,4/1/98,Hide,Hide,4,1998,5712,5712,6108,6108,1,396,396,0.064833006,0.064833006
FALSE,Duchesne County,4/1/99,Hide,Hide,4,1999,5528,5528,6151,6151,1,623,623,0.101284344,0.101284344
FALSE,Duchesne County,4/1/00,Hide,Hide,4,2000,5758,5758,6044,6044,1,286,286,0.047319656,0.047319656
FALSE,Duchesne County,4/1/01,Hide,Hide,4,2001,6176,6176,6506,6506,1,330,330,0.05072241,0.05072241
FALSE,Duchesne County,4/1/02,Hide,Hide,4,2002,6509,6509,6969,6969,1,460,460,0.066006601,0.066006601
FALSE,Duchesne County,4/1/03,Hide,Hide,4,2003,6408,6408,6869,6869,1,461,461,0.067113117,0.067113117
FALSE,Duchesne County,4/1/04,Hide,Hide,4,2004,6891,6891,7313,7313,1,422,422,0.057705456,0.057705456
FALSE,Duchesne County,4/1/05,Hide,Hide,4,2005,7202,7202,7545,7545,1,343,343,0.04546057,0.04546057
FALSE,Duchesne County,4/1/06,Hide,Hide,4,2006,8001,8001,8258,8258,1,257,257,0.031121337,0.031121337
FALSE,Duchesne County,4/1/07,Hide,Hide,4,2007,9003,9003,9191,9191,1,188,188,0.020454793,0.020454793
FALSE,Duchesne County,4/1/08,Hide,Hide,4,2008,9696,9696,9951,9951,1,255,255,0.025625565,0.025625565
FALSE,Duchesne County,4/1/09,Hide,Hide,4,2009,9743,9743,10580,10580,1,837,837,0.079111531,0.079111531
FALSE,Duchesne County,4/1/10,Hide,Hide,4,2010,7445,7445,8249,8249,1,804,804,0.09746636,0.09746636
FALSE,Duchesne County,4/1/11,Hide,Hide,4,2011,7757,7757,8339,8339,1,582,582,0.069792541,0.069792541
FALSE,Duchesne County,4/1/12,Hide,Hide,4,2012,8680,8680,9103,9103,1,423,423,0.046468197,0.046468197
FALSE,Duchesne County,4/1/13,Hide,Hide,4,2013,8868,8868,9272,9272,1,404,404,0.043572045,0.043572045
FALSE,Duchesne County,4/1/14,Hide,Hide,4,2014,9271,9271,9601,9601,1,330,330,0.03437142,0.03437142
FALSE,Duchesne County,4/1/15,Hide,Hide,4,2015,8428,8428,9062,9062,1,634,634,0.069962481,0.069962481
FALSE,Duchesne County,4/1/16,Hide,Hide,4,2016,7386,7386,8174,8174,1,788,788,0.09640323,0.09640323
FALSE,Duchesne County,4/1/17,Hide,Hide,4,2017,7537,7537,8014,8014,1,477,477,0.059520839,0.059520839
FALSE,Duchesne County,4/1/18,Hide,Hide,4,2018,7427,7427,7763,7763,1,336,336,0.043282236,0.043282236
FALSE,Duchesne County,4/1/19,Hide,Hide,4,2019,7415,7415,7725,7725,1,310,310,0.04012945,0.04012945
FALSE,Duchesne County,4/1/20,Show,Hide,4,2020,6897,6897,7898,7898,1,1001,1001,0.126740947,0.126740947
FALSE,Emery County,4/1/93,Hide,Hide,4,1993,3728,3728,4084,4084,1,356,356,0.087169442,0.087169442
FALSE,Emery County,4/1/94,Hide,Hide,4,1994,3850,3850,4189,4189,1,339,339,0.080926235,0.080926235
FALSE,Emery County,4/1/95,Hide,Hide,4,1995,3917,3917,4248,4248,1,331,331,0.077919021,0.077919021
FALSE,Emery County,4/1/96,Hide,Hide,4,1996,3901,3901,4221,4221,1,320,320,0.075811419,0.075811419
FALSE,Emery County,4/1/97,Hide,Hide,4,1997,3891,3891,4180,4180,1,289,289,0.069138756,0.069138756
FALSE,Emery County,4/1/98,Hide,Hide,4,1998,3889,3889,4220,4220,1,331,331,0.078436019,0.078436019
FALSE,Emery County,4/1/99,Hide,Hide,4,1999,3761,3761,4049,4049,1,288,288,0.071128674,0.071128674
FALSE,Emery County,4/1/00,Hide,Hide,4,2000,4508,4508,4715,4715,1,207,207,0.043902439,0.043902439
FALSE,Emery County,4/1/01,Hide,Hide,4,2001,4349,4349,4657,4657,1,308,308,0.066136998,0.066136998
FALSE,Emery County,4/1/02,Hide,Hide,4,2002,4411,4411,4732,4732,1,321,321,0.06783601,0.06783601
FALSE,Emery County,4/1/03,Hide,Hide,4,2003,4515,4515,4906,4906,1,391,391,0.079698329,0.079698329
FALSE,Emery County,4/1/04,Hide,Hide,4,2004,4761,4761,5133,5133,1,372,372,0.072472238,0.072472238
FALSE,Emery County,4/1/05,Hide,Hide,4,2005,4777,4777,5051,5051,1,274,274,0.054246684,0.054246684
FALSE,Emery County,4/1/06,Hide,Hide,4,2006,5045,5045,5237,5237,1,192,192,0.036662211,0.036662211
FALSE,Emery County,4/1/07,Hide,Hide,4,2007,4980,4980,5144,5144,1,164,164,0.031881804,0.031881804
FALSE,Emery County,4/1/08,Hide,Hide,4,2008,4931,4931,5114,5114,1,183,183,0.035784122,0.035784122
FALSE,Emery County,4/1/09,Hide,Hide,4,2009,4828,4828,5159,5159,1,331,331,0.064159721,0.064159721
FALSE,Emery County,4/1/10,Hide,Hide,4,2010,4883,4883,5276,5276,1,393,393,0.074488249,0.074488249
FALSE,Emery County,4/1/11,Hide,Hide,4,2011,4686,4686,5064,5064,1,378,378,0.07464455,0.07464455
FALSE,Emery County,4/1/12,Hide,Hide,4,2012,4386,4386,4734,4734,1,348,348,0.073510773,0.073510773
FALSE,Emery County,4/1/13,Hide,Hide,4,2013,4453,4453,4755,4755,1,302,302,0.063512093,0.063512093
FALSE,Emery County,4/1/14,Hide,Hide,4,2014,4420,4420,4669,4669,1,249,249,0.053330478,0.053330478
FALSE,Emery County,4/1/15,Hide,Hide,4,2015,4168,4168,4412,4412,1,244,244,0.055303717,0.055303717
FALSE,Emery County,4/1/16,Hide,Hide,4,2016,4005,4005,4289,4289,1,284,284,0.066215901,0.066215901
FALSE,Emery County,4/1/17,Hide,Hide,4,2017,3942,3942,4165,4165,1,223,223,0.053541417,0.053541417
FALSE,Emery County,4/1/18,Hide,Hide,4,2018,4094,4094,4299,4299,1,205,205,0.047685508,0.047685508
FALSE,Emery County,4/1/19,Hide,Hide,4,2019,4157,4157,4335,4335,1,178,178,0.04106113,0.04106113
FALSE,Emery County,4/1/20,Show,Hide,4,2020,3868,3868,4228,4228,1,360,360,0.085146641,0.085146641
FALSE,Garfield County,4/1/93,Hide,Hide,4,1993,2088,2088,2321,2321,1,233,233,0.100387764,0.100387764
FALSE,Garfield County,4/1/94,Hide,Hide,4,1994,2292,2292,2541,2541,1,249,249,0.097992916,0.097992916
FALSE,Garfield County,4/1/95,Hide,Hide,4,1995,2256,2256,2598,2598,1,342,342,0.131639723,0.131639723
FALSE,Garfield County,4/1/96,Hide,Hide,4,1996,2386,2386,2639,2639,1,253,253,0.095869648,0.095869648
FALSE,Garfield County,4/1/97,Hide,Hide,4,1997,2514,2514,2747,2747,1,233,233,0.084819803,0.084819803
FALSE,Garfield County,4/1/98,Hide,Hide,4,1998,2518,2518,2762,2762,1,244,244,0.088341781,0.088341781
FALSE,Garfield County,4/1/99,Hide,Hide,4,1999,2670,2670,2904,2904,1,234,234,0.080578512,0.080578512
FALSE,Garfield County,4/1/00,Hide,Hide,4,2000,2352,2352,2511,2511,1,159,159,0.063321386,0.063321386
FALSE,Garfield County,4/1/01,Hide,Hide,4,2001,2379,2379,2577,2577,1,198,198,0.076833527,0.076833527
FALSE,Garfield County,4/1/02,Hide,Hide,4,2002,2321,2321,2586,2586,1,265,265,0.102474865,0.102474865
FALSE,Garfield County,4/1/03,Hide,Hide,4,2003,2315,2315,2548,2548,1,233,233,0.09144427,0.09144427
FALSE,Garfield County,4/1/04,Hide,Hide,4,2004,2451,2451,2655,2655,1,204,204,0.076836158,0.076836158
FALSE,Garfield County,4/1/05,Hide,Hide,4,2005,2484,2484,2683,2683,1,199,199,0.074170704,0.074170704
FALSE,Garfield County,4/1/06,Hide,Hide,4,2006,2532,2532,2674,2674,1,142,142,0.053103964,0.053103964
FALSE,Garfield County,4/1/07,Hide,Hide,4,2007,2610,2610,2721,2721,1,111,111,0.040793826,0.040793826
FALSE,Garfield County,4/1/08,Hide,Hide,4,2008,2606,2606,2761,2761,1,155,155,0.05613908,0.05613908
FALSE,Garfield County,4/1/09,Hide,Hide,4,2009,2576,2576,2871,2871,1,295,295,0.102751654,0.102751654
FALSE,Garfield County,4/1/10,Hide,Hide,4,2010,2762,2762,3080,3080,1,318,318,0.103246753,0.103246753
FALSE,Garfield County,4/1/11,Hide,Hide,4,2011,2667,2667,2995,2995,1,328,328,0.10951586,0.10951586
FALSE,Garfield County,4/1/12,Hide,Hide,4,2012,2583,2583,2855,2855,1,272,272,0.095271454,0.095271454
FALSE,Garfield County,4/1/13,Hide,Hide,4,2013,2543,2543,2795,2795,1,252,252,0.090161002,0.090161002
FALSE,Garfield County,4/1/14,Hide,Hide,4,2014,2459,2459,2691,2691,1,232,232,0.086213304,0.086213304
FALSE,Garfield County,4/1/15,Hide,Hide,4,2015,2541,2541,2788,2788,1,247,247,0.088593974,0.088593974
FALSE,Garfield County,4/1/16,Hide,Hide,4,2016,2535,2535,2774,2774,1,239,239,0.086157174,0.086157174
FALSE,Garfield County,4/1/17,Hide,Hide,4,2017,2660,2660,2876,2876,1,216,216,0.075104312,0.075104312
FALSE,Garfield County,4/1/18,Hide,Hide,4,2018,2578,2578,2797,2797,1,219,219,0.078298177,0.078298177
FALSE,Garfield County,4/1/19,Hide,Hide,4,2019,2614,2614,2785,2785,1,171,171,0.061400359,0.061400359
FALSE,Garfield County,4/1/20,Show,Hide,4,2020,2177,2177,2869,2869,1,692,692,0.241199024,0.241199024
FALSE,Grand County,4/1/93,Hide,Hide,4,1993,4257,4257,4532,4532,1,275,275,0.060679612,0.060679612
FALSE,Grand County,4/1/94,Hide,Hide,4,1994,4556,4556,4883,4883,1,327,327,0.066967028,0.066967028
FALSE,Grand County,4/1/95,Hide,Hide,4,1995,4582,4582,4907,4907,1,325,325,0.066231914,0.066231914
FALSE,Grand County,4/1/96,Hide,Hide,4,1996,4785,4785,5130,5130,1,345,345,0.067251462,0.067251462
FALSE,Grand County,4/1/97,Hide,Hide,4,1997,4860,4860,5184,5184,1,324,324,0.0625,0.0625
FALSE,Grand County,4/1/98,Hide,Hide,4,1998,4862,4862,5238,5238,1,376,376,0.071783123,0.071783123
FALSE,Grand County,4/1/99,Hide,Hide,4,1999,5254,5254,5618,5618,1,364,364,0.064791741,0.064791741
FALSE,Grand County,4/1/00,Hide,Hide,4,2000,4366,4366,4670,4670,1,304,304,0.06509636,0.06509636
FALSE,Grand County,4/1/01,Hide,Hide,4,2001,4353,4353,4671,4671,1,318,318,0.06807964,0.06807964
FALSE,Grand County,4/1/02,Hide,Hide,4,2002,4472,4472,4835,4835,1,363,363,0.075077559,0.075077559
FALSE,Grand County,4/1/03,Hide,Hide,4,2003,4559,4559,4927,4927,1,368,368,0.074690481,0.074690481
FALSE,Grand County,4/1/04,Hide,Hide,4,2004,4478,4478,4841,4841,1,363,363,0.074984507,0.074984507
FALSE,Grand County,4/1/05,Hide,Hide,4,2005,4607,4607,4918,4918,1,311,311,0.063237088,0.063237088
FALSE,Grand County,4/1/06,Hide,Hide,4,2006,4748,4748,5007,5007,1,259,259,0.051727581,0.051727581
FALSE,Grand County,4/1/07,Hide,Hide,4,2007,4975,4975,5201,5201,1,226,226,0.043453182,0.043453182
FALSE,Grand County,4/1/08,Hide,Hide,4,2008,4945,4945,5216,5216,1,271,271,0.051955521,0.051955521
FALSE,Grand County,4/1/09,Hide,Hide,4,2009,4855,4855,5382,5382,1,527,527,0.097918989,0.097918989
FALSE,Grand County,4/1/10,Hide,Hide,4,2010,4793,4793,5348,5348,1,555,555,0.103777113,0.103777113
FALSE,Grand County,4/1/11,Hide,Hide,4,2011,4769,4769,5309,5309,1,540,540,0.10171407,0.10171407
FALSE,Grand County,4/1/12,Hide,Hide,4,2012,4948,4948,5404,5404,1,456,456,0.084381939,0.084381939
FALSE,Grand County,4/1/13,Hide,Hide,4,2013,5011,5011,5439,5439,1,428,428,0.078690936,0.078690936
FALSE,Grand County,4/1/14,Hide,Hide,4,2014,5139,5139,5495,5495,1,356,356,0.064786169,0.064786169
FALSE,Grand County,4/1/15,Hide,Hide,4,2015,5235,5235,5576,5576,1,341,341,0.06115495,0.06115495
FALSE,Grand County,4/1/16,Hide,Hide,4,2016,5371,5371,5705,5705,1,334,334,0.058545136,0.058545136
FALSE,Grand County,4/1/17,Hide,Hide,4,2017,5550,5550,5870,5870,1,320,320,0.05451448,0.05451448
FALSE,Grand County,4/1/18,Hide,Hide,4,2018,5791,5791,6074,6074,1,283,283,0.046592032,0.046592032
FALSE,Grand County,4/1/19,Hide,Hide,4,2019,5879,5879,6127,6127,1,248,248,0.040476579,0.040476579
FALSE,Grand County,4/1/20,Show,Hide,4,2020,4959,4959,6796,6796,1,1837,1837,0.270306062,0.270306062
FALSE,Iron County,4/1/93,Hide,Hide,4,1993,10569,10569,10993,10993,1,424,424,0.038569999,0.038569999
FALSE,Iron County,4/1/94,Hide,Hide,4,1994,11556,11556,11981,11981,1,425,425,0.035472832,0.035472832
FALSE,Iron County,4/1/95,Hide,Hide,4,1995,12494,12494,12911,12911,1,417,417,0.03229804,0.03229804
FALSE,Iron County,4/1/96,Hide,Hide,4,1996,12658,12658,13184,13184,1,526,526,0.039896845,0.039896845
FALSE,Iron County,4/1/97,Hide,Hide,4,1997,13709,13709,14157,14157,1,448,448,0.031645123,0.031645123
FALSE,Iron County,4/1/98,Hide,Hide,4,1998,14183,14183,14746,14746,1,563,563,0.038179845,0.038179845
FALSE,Iron County,4/1/99,Hide,Hide,4,1999,14443,14443,15001,15001,1,558,558,0.03719752,0.03719752
FALSE,Iron County,4/1/00,Hide,Hide,4,2000,16260,16260,16767,16767,1,507,507,0.030237967,0.030237967
FALSE,Iron County,4/1/01,Hide,Hide,4,2001,16068,16068,16818,16818,1,750,750,0.044595077,0.044595077
FALSE,Iron County,4/1/02,Hide,Hide,4,2002,16848,16848,17765,17765,1,917,917,0.051618351,0.051618351
FALSE,Iron County,4/1/03,Hide,Hide,4,2003,16749,16749,17701,17701,1,952,952,0.053782272,0.053782272
FALSE,Iron County,4/1/04,Hide,Hide,4,2004,17758,17758,18628,18628,1,870,870,0.046703887,0.046703887
FALSE,Iron County,4/1/05,Hide,Hide,4,2005,18894,18894,19677,19677,1,783,783,0.039792651,0.039792651
FALSE,Iron County,4/1/06,Hide,Hide,4,2006,20052,20052,20677,20677,1,625,625,0.030226822,0.030226822
FALSE,Iron County,4/1/07,Hide,Hide,4,2007,20621,20621,21165,21165,1,544,544,0.025702811,0.025702811
FALSE,Iron County,4/1/08,Hide,Hide,4,2008,20117,20117,20885,20885,1,768,768,0.036772803,0.036772803
FALSE,Iron County,4/1/09,Hide,Hide,4,2009,19133,19133,20949,20949,1,1816,1816,0.086686715,0.086686715
FALSE,Iron County,4/1/10,Hide,Hide,4,2010,18459,18459,20460,20460,1,2001,2001,0.097800587,0.097800587
FALSE,Iron County,4/1/11,Hide,Hide,4,2011,18228,18228,19936,19936,1,1708,1708,0.085674157,0.085674157
FALSE,Iron County,4/1/12,Hide,Hide,4,2012,18190,18190,19554,19554,1,1364,1364,0.069755549,0.069755549
FALSE,Iron County,4/1/13,Hide,Hide,4,2013,18260,18260,19379,19379,1,1119,1119,0.057742918,0.057742918
FALSE,Iron County,4/1/14,Hide,Hide,4,2014,18955,18955,19839,19839,1,884,884,0.044558698,0.044558698
FALSE,Iron County,4/1/15,Hide,Hide,4,2015,19333,19333,20243,20243,1,910,910,0.044953811,0.044953811
FALSE,Iron County,4/1/16,Hide,Hide,4,2016,20296,20296,21221,21221,1,925,925,0.043588898,0.043588898
FALSE,Iron County,4/1/17,Hide,Hide,4,2017,21155,21155,22127,22127,1,972,972,0.043928232,0.043928232
FALSE,Iron County,4/1/18,Hide,Hide,4,2018,21879,21879,22680,22680,1,801,801,0.03531746,0.03531746
FALSE,Iron County,4/1/19,Hide,Hide,4,2019,23040,23040,23773,23773,1,733,733,0.030833298,0.030833298
FALSE,Iron County,4/1/20,Show,Hide,4,2020,21166,21166,23346,23346,1,2180,2180,0.093377881,0.093377881
FALSE,Juab County,4/1/93,Hide,Hide,4,1993,2971,2971,3186,3186,1,215,215,0.067482737,0.067482737
FALSE,Juab County,4/1/94,Hide,Hide,4,1994,3176,3176,3322,3322,1,146,146,0.043949428,0.043949428
FALSE,Juab County,4/1/95,Hide,Hide,4,1995,3180,3180,3352,3352,1,172,172,0.051312649,0.051312649
FALSE,Juab County,4/1/96,Hide,Hide,4,1996,3260,3260,3396,3396,1,136,136,0.040047114,0.040047114
FALSE,Juab County,4/1/97,Hide,Hide,4,1997,3306,3306,3436,3436,1,130,130,0.037834692,0.037834692
FALSE,Juab County,4/1/98,Hide,Hide,4,1998,3407,3407,3562,3562,1,155,155,0.043514879,0.043514879
FALSE,Juab County,4/1/99,Hide,Hide,4,1999,3458,3458,3644,3644,1,186,186,0.05104281,0.05104281
FALSE,Juab County,4/1/00,Hide,Hide,4,2000,3585,3585,3711,3711,1,126,126,0.033953112,0.033953112
FALSE,Juab County,4/1/01,Hide,Hide,4,2001,3600,3600,3774,3774,1,174,174,0.046104928,0.046104928
FALSE,Juab County,4/1/02,Hide,Hide,4,2002,3402,3402,3672,3672,1,270,270,0.073529412,0.073529412
FALSE,Juab County,4/1/03,Hide,Hide,4,2003,3404,3404,3668,3668,1,264,264,0.071973828,0.071973828
FALSE,Juab County,4/1/04,Hide,Hide,4,2004,3552,3552,3809,3809,1,257,257,0.067471777,0.067471777
FALSE,Juab County,4/1/05,Hide,Hide,4,2005,3703,3703,3887,3887,1,184,184,0.047337278,0.047337278
FALSE,Juab County,4/1/06,Hide,Hide,4,2006,3842,3842,3997,3997,1,155,155,0.038779084,0.038779084
FALSE,Juab County,4/1/07,Hide,Hide,4,2007,3971,3971,4093,4093,1,122,122,0.029806988,0.029806988
FALSE,Juab County,4/1/08,Hide,Hide,4,2008,3753,3753,3933,3933,1,180,180,0.04576659,0.04576659
FALSE,Juab County,4/1/09,Hide,Hide,4,2009,3586,3586,3970,3970,1,384,384,0.096725441,0.096725441
FALSE,Juab County,4/1/10,Hide,Hide,4,2010,4177,4177,4603,4603,1,426,426,0.092548338,0.092548338
FALSE,Juab County,4/1/11,Hide,Hide,4,2011,4175,4175,4572,4572,1,397,397,0.086832896,0.086832896
FALSE,Juab County,4/1/12,Hide,Hide,4,2012,4295,4295,4586,4586,1,291,291,0.06345399,0.06345399
FALSE,Juab County,4/1/13,Hide,Hide,4,2013,4421,4421,4665,4665,1,244,244,0.052304394,0.052304394
FALSE,Juab County,4/1/14,Hide,Hide,4,2014,4564,4564,4759,4759,1,195,195,0.040974995,0.040974995
FALSE,Juab County,4/1/15,Hide,Hide,4,2015,4696,4696,4893,4893,1,197,197,0.040261598,0.040261598
FALSE,Juab County,4/1/16,Hide,Hide,4,2016,4983,4983,5182,5182,1,199,199,0.038402161,0.038402161
FALSE,Juab County,4/1/17,Hide,Hide,4,2017,5194,5194,5375,5375,1,181,181,0.033674419,0.033674419
FALSE,Juab County,4/1/18,Hide,Hide,4,2018,5382,5382,5543,5543,1,161,161,0.029045643,0.029045643
FALSE,Juab County,4/1/19,Hide,Hide,4,2019,5530,5530,5684,5684,1,154,154,0.027093596,0.027093596
FALSE,Juab County,4/1/20,Show,Hide,4,2020,5131,5131,5442,5442,1,311,311,0.057148107,0.057148107
FALSE,Kane County,4/1/93,Hide,Hide,4,1993,2325,2325,2494,2494,1,169,169,0.06776263,0.06776263
FALSE,Kane County,4/1/94,Hide,Hide,4,1994,2509,2509,2728,2728,1,219,219,0.080278592,0.080278592
FALSE,Kane County,4/1/95,Hide,Hide,4,1995,2471,2471,2721,2721,1,250,250,0.091877986,0.091877986
FALSE,Kane County,4/1/96,Hide,Hide,4,1996,2356,2356,2540,2540,1,184,184,0.072440945,0.072440945
FALSE,Kane County,4/1/97,Hide,Hide,4,1997,2470,2470,2597,2597,1,127,127,0.04890258,0.04890258
FALSE,Kane County,4/1/98,Hide,Hide,4,1998,2618,2618,2713,2713,1,95,95,0.035016587,0.035016587
FALSE,Kane County,4/1/99,Hide,Hide,4,1999,2664,2664,2772,2772,1,108,108,0.038961039,0.038961039
FALSE,Kane County,4/1/00,Hide,Hide,4,2000,2946,2946,3056,3056,1,110,110,0.035994764,0.035994764
FALSE,Kane County,4/1/01,Hide,Hide,4,2001,3008,3008,3145,3145,1,137,137,0.043561208,0.043561208
FALSE,Kane County,4/1/02,Hide,Hide,4,2002,2820,2820,2976,2976,1,156,156,0.052419355,0.052419355
FALSE,Kane County,4/1/03,Hide,Hide,4,2003,2936,2936,3107,3107,1,171,171,0.055037013,0.055037013
FALSE,Kane County,4/1/04,Hide,Hide,4,2004,3099,3099,3285,3285,1,186,186,0.056621005,0.056621005
FALSE,Kane County,4/1/05,Hide,Hide,4,2005,3036,3036,3204,3204,1,168,168,0.052434457,0.052434457
FALSE,Kane County,4/1/06,Hide,Hide,4,2006,3290,3290,3418,3418,1,128,128,0.0374488,0.0374488
FALSE,Kane County,4/1/07,Hide,Hide,4,2007,3412,3412,3516,3516,1,104,104,0.029579067,0.029579067
FALSE,Kane County,4/1/08,Hide,Hide,4,2008,3306,3306,3428,3428,1,122,122,0.035589265,0.035589265
FALSE,Kane County,4/1/09,Hide,Hide,4,2009,3217,3217,3477,3477,1,260,260,0.074777107,0.074777107
FALSE,Kane County,4/1/10,Hide,Hide,4,2010,3295,3295,3576,3576,1,281,281,0.078579418,0.078579418
FALSE,Kane County,4/1/11,Hide,Hide,4,2011,3244,3244,3510,3510,1,266,266,0.075783476,0.075783476
FALSE,Kane County,4/1/12,Hide,Hide,4,2012,3232,3232,3476,3476,1,244,244,0.070195627,0.070195627
FALSE,Kane County,4/1/13,Hide,Hide,4,2013,3283,3283,3470,3470,1,187,187,0.05389049,0.05389049
FALSE,Kane County,4/1/14,Hide,Hide,4,2014,3378,3378,3550,3550,1,172,172,0.048450704,0.048450704
FALSE,Kane County,4/1/15,Hide,Hide,4,2015,3437,3437,3598,3598,1,161,161,0.044747082,0.044747082
FALSE,Kane County,4/1/16,Hide,Hide,4,2016,3541,3541,3688,3688,1,147,147,0.039859002,0.039859002
FALSE,Kane County,4/1/17,Hide,Hide,4,2017,3600,3600,3729,3729,1,129,129,0.034593725,0.034593725
FALSE,Kane County,4/1/18,Hide,Hide,4,2018,3672,3672,3791,3791,1,119,119,0.031390135,0.031390135
FALSE,Kane County,4/1/19,Hide,Hide,4,2019,3686,3686,3802,3802,1,116,116,0.030510258,0.030510258
FALSE,Kane County,4/1/20,Show,Hide,4,2020,3022,3022,3568,3568,1,546,546,0.153026906,0.153026906
FALSE,Millard County,4/1/93,Hide,Hide,4,1993,4421,4421,4687,4687,1,266,266,0.05675272,0.05675272
FALSE,Millard County,4/1/94,Hide,Hide,4,1994,4446,4446,4669,4669,1,223,223,0.047761833,0.047761833
FALSE,Millard County,4/1/95,Hide,Hide,4,1995,4543,4543,4782,4782,1,239,239,0.049979088,0.049979088
FALSE,Millard County,4/1/96,Hide,Hide,4,1996,4540,4540,4740,4740,1,200,200,0.042194093,0.042194093
FALSE,Millard County,4/1/97,Hide,Hide,4,1997,4556,4556,4734,4734,1,178,178,0.037600338,0.037600338
FALSE,Millard County,4/1/98,Hide,Hide,4,1998,4511,4511,4728,4728,1,217,217,0.045896785,0.045896785
FALSE,Millard County,4/1/99,Hide,Hide,4,1999,4552,4552,4754,4754,1,202,202,0.042490534,0.042490534
FALSE,Millard County,4/1/00,Hide,Hide,4,2000,5074,5074,5243,5243,1,169,169,0.032233454,0.032233454
FALSE,Millard County,4/1/01,Hide,Hide,4,2001,5169,5169,5379,5379,1,210,210,0.039040714,0.039040714
FALSE,Millard County,4/1/02,Hide,Hide,4,2002,5607,5607,5890,5890,1,283,283,0.048047538,0.048047538
FALSE,Millard County,4/1/03,Hide,Hide,4,2003,5617,5617,5910,5910,1,293,293,0.049576988,0.049576988
FALSE,Millard County,4/1/04,Hide,Hide,4,2004,6043,6043,6352,6352,1,309,309,0.048646096,0.048646096
FALSE,Millard County,4/1/05,Hide,Hide,4,2005,5833,5833,6083,6083,1,250,250,0.041098142,0.041098142
FALSE,Millard County,4/1/06,Hide,Hide,4,2006,5985,5985,6181,6181,1,196,196,0.031710079,0.031710079
FALSE,Millard County,4/1/07,Hide,Hide,4,2007,6149,6149,6292,6292,1,143,143,0.022727273,0.022727273
FALSE,Millard County,4/1/08,Hide,Hide,4,2008,5707,5707,5889,5889,1,182,182,0.030905077,0.030905077
FALSE,Millard County,4/1/09,Hide,Hide,4,2009,6081,6081,6427,6427,1,346,346,0.053835382,0.053835382
FALSE,Millard County,4/1/10,Hide,Hide,4,2010,5845,5845,6245,6245,1,400,400,0.064051241,0.064051241
FALSE,Millard County,4/1/11,Hide,Hide,4,2011,5865,5865,6197,6197,1,332,332,0.05357431,0.05357431
FALSE,Millard County,4/1/12,Hide,Hide,4,2012,5685,5685,5972,5972,1,287,287,0.048057602,0.048057602
FALSE,Millard County,4/1/13,Hide,Hide,4,2013,5738,5738,5992,5992,1,254,254,0.042389853,0.042389853
FALSE,Millard County,4/1/14,Hide,Hide,4,2014,5819,5819,6021,6021,1,202,202,0.033549244,0.033549244
FALSE,Millard County,4/1/15,Hide,Hide,4,2015,6017,6017,6231,6231,1,214,214,0.034344407,0.034344407
FALSE,Millard County,4/1/16,Hide,Hide,4,2016,5955,5955,6161,6161,1,206,206,0.03343613,0.03343613
FALSE,Millard County,4/1/17,Hide,Hide,4,2017,6195,6195,6413,6413,1,218,218,0.033993451,0.033993451
FALSE,Millard County,4/1/18,Hide,Hide,4,2018,6043,6043,6242,6242,1,199,199,0.031880807,0.031880807
FALSE,Millard County,4/1/19,Hide,Hide,4,2019,5831,5831,6005,6005,1,174,174,0.028975853,0.028975853
FALSE,Millard County,4/1/20,Show,Hide,4,2020,5473,5473,5806,5806,1,333,333,0.057354461,0.057354461
FALSE,Morgan County,4/1/93,Hide,Hide,4,1993,2782,2782,2956,2956,1,174,174,0.058863329,0.058863329
FALSE,Morgan County,4/1/94,Hide,Hide,4,1994,2809,2809,2943,2943,1,134,134,0.04553177,0.04553177
FALSE,Morgan County,4/1/95,Hide,Hide,4,1995,3209,3209,3369,3369,1,160,160,0.047491837,0.047491837
FALSE,Morgan County,4/1/96,Hide,Hide,4,1996,3341,3341,3490,3490,1,149,149,0.04269341,0.04269341
FALSE,Morgan County,4/1/97,Hide,Hide,4,1997,3434,3434,3572,3572,1,138,138,0.038633819,0.038633819
FALSE,Morgan County,4/1/98,Hide,Hide,4,1998,3549,3549,3691,3691,1,142,142,0.038471959,0.038471959
FALSE,Morgan County,4/1/99,Hide,Hide,4,1999,3421,3421,3564,3564,1,143,143,0.040123457,0.040123457
FALSE,Morgan County,4/1/00,Hide,Hide,4,2000,3316,3316,3432,3432,1,116,116,0.033799534,0.033799534
FALSE,Morgan County,4/1/01,Hide,Hide,4,2001,3338,3338,3465,3465,1,127,127,0.036652237,0.036652237
FALSE,Morgan County,4/1/02,Hide,Hide,4,2002,3343,3343,3529,3529,1,186,186,0.052706149,0.052706149
FALSE,Morgan County,4/1/03,Hide,Hide,4,2003,3382,3382,3569,3569,1,187,187,0.052395629,0.052395629
FALSE,Morgan County,4/1/04,Hide,Hide,4,2004,3478,3478,3660,3660,1,182,182,0.049726776,0.049726776
FALSE,Morgan County,4/1/05,Hide,Hide,4,2005,3629,3629,3792,3792,1,163,163,0.042985232,0.042985232
FALSE,Morgan County,4/1/06,Hide,Hide,4,2006,3799,3799,3923,3923,1,124,124,0.031608463,0.031608463
FALSE,Morgan County,4/1/07,Hide,Hide,4,2007,3872,3872,3970,3970,1,98,98,0.024685139,0.024685139
FALSE,Morgan County,4/1/08,Hide,Hide,4,2008,3939,3939,4062,4062,1,123,123,0.03028065,0.03028065
FALSE,Morgan County,4/1/09,Hide,Hide,4,2009,3824,3824,4071,4071,1,247,247,0.060673053,0.060673053
FALSE,Morgan County,4/1/10,Hide,Hide,4,2010,3964,3964,4259,4259,1,295,295,0.069265086,0.069265086
FALSE,Morgan County,4/1/11,Hide,Hide,4,2011,3965,3965,4214,4214,1,249,249,0.059088752,0.059088752
FALSE,Morgan County,4/1/12,Hide,Hide,4,2012,4082,4082,4300,4300,1,218,218,0.050697674,0.050697674
FALSE,Morgan County,4/1/13,Hide,Hide,4,2013,4284,4284,4473,4473,1,189,189,0.042253521,0.042253521
FALSE,Morgan County,4/1/14,Hide,Hide,4,2014,4495,4495,4656,4656,1,161,161,0.034579038,0.034579038
FALSE,Morgan County,4/1/15,Hide,Hide,4,2015,4738,4738,4891,4891,1,153,153,0.031281946,0.031281946
FALSE,Morgan County,4/1/16,Hide,Hide,4,2016,4927,4927,5082,5082,1,155,155,0.030499803,0.030499803
FALSE,Morgan County,4/1/17,Hide,Hide,4,2017,5211,5211,5368,5368,1,157,157,0.029247392,0.029247392
FALSE,Morgan County,4/1/18,Hide,Hide,4,2018,5269,5269,5415,5415,1,146,146,0.026962142,0.026962142
FALSE,Morgan County,4/1/19,Hide,Hide,4,2019,5390,5390,5532,5532,1,142,142,0.025668836,0.025668836
FALSE,Morgan County,4/1/20,Show,Hide,4,2020,5072,5072,5502,5502,1,430,430,0.078153399,0.078153399
FALSE,Piute County,4/1/93,Hide,Hide,4,1993,423,423,447,447,1,24,24,0.053691275,0.053691275
FALSE,Piute County,4/1/94,Hide,Hide,4,1994,440,440,482,482,1,42,42,0.087136929,0.087136929
FALSE,Piute County,4/1/95,Hide,Hide,4,1995,462,462,490,490,1,28,28,0.057142857,0.057142857
FALSE,Piute County,4/1/96,Hide,Hide,4,1996,484,484,507,507,1,23,23,0.045364892,0.045364892
FALSE,Piute County,4/1/97,Hide,Hide,4,1997,492,492,519,519,1,27,27,0.052023121,0.052023121
FALSE,Piute County,4/1/98,Hide,Hide,4,1998,494,494,516,516,1,22,22,0.042635659,0.042635659
FALSE,Piute County,4/1/99,Hide,Hide,4,1999,523,523,559,559,1,36,36,0.064400716,0.064400716
FALSE,Piute County,4/1/00,Hide,Hide,4,2000,588,588,612,612,1,24,24,0.039215686,0.039215686
FALSE,Piute County,4/1/01,Hide,Hide,4,2001,708,708,752,752,1,44,44,0.058510638,0.058510638
FALSE,Piute County,4/1/02,Hide,Hide,4,2002,676,676,722,722,1,46,46,0.063711911,0.063711911
FALSE,Piute County,4/1/03,Hide,Hide,4,2003,743,743,788,788,1,45,45,0.057106599,0.057106599
FALSE,Piute County,4/1/04,Hide,Hide,4,2004,838,838,874,874,1,36,36,0.041189931,0.041189931
FALSE,Piute County,4/1/05,Hide,Hide,4,2005,823,823,859,859,1,36,36,0.041909197,0.041909197
FALSE,Piute County,4/1/06,Hide,Hide,4,2006,855,855,884,884,1,29,29,0.03280543,0.03280543
FALSE,Piute County,4/1/07,Hide,Hide,4,2007,923,923,940,940,1,17,17,0.018085106,0.018085106
FALSE,Piute County,4/1/08,Hide,Hide,4,2008,866,866,890,890,1,24,24,0.026966292,0.026966292
FALSE,Piute County,4/1/09,Hide,Hide,4,2009,831,831,889,889,1,58,58,0.065241845,0.065241845
FALSE,Piute County,4/1/10,Hide,Hide,4,2010,529,529,586,586,1,57,57,0.097269625,0.097269625
FALSE,Piute County,4/1/11,Hide,Hide,4,2011,491,491,547,547,1,56,56,0.1023766,0.1023766
FALSE,Piute County,4/1/12,Hide,Hide,4,2012,462,462,506,506,1,44,44,0.086956522,0.086956522
FALSE,Piute County,4/1/13,Hide,Hide,4,2013,456,456,494,494,1,38,38,0.076923077,0.076923077
FALSE,Piute County,4/1/14,Hide,Hide,4,2014,426,426,457,457,1,31,31,0.067833698,0.067833698
FALSE,Piute County,4/1/15,Hide,Hide,4,2015,452,452,483,483,1,31,31,0.064182195,0.064182195
FALSE,Piute County,4/1/16,Hide,Hide,4,2016,422,422,450,450,1,28,28,0.062222222,0.062222222
FALSE,Piute County,4/1/17,Hide,Hide,4,2017,453,453,477,477,1,24,24,0.050314465,0.050314465
FALSE,Piute County,4/1/18,Hide,Hide,4,2018,458,458,481,481,1,23,23,0.047817048,0.047817048
FALSE,Piute County,4/1/19,Hide,Hide,4,2019,460,460,482,482,1,22,22,0.045643154,0.045643154
FALSE,Piute County,4/1/20,Show,Hide,4,2020,431,431,483,483,1,52,52,0.107660455,0.107660455
FALSE,Rich County,4/1/93,Hide,Hide,4,1993,750,750,774,774,1,24,24,0.031007752,0.031007752
FALSE,Rich County,4/1/94,Hide,Hide,4,1994,759,759,789,789,1,30,30,0.038022814,0.038022814
FALSE,Rich County,4/1/95,Hide,Hide,4,1995,827,827,864,864,1,37,37,0.042824074,0.042824074
FALSE,Rich County,4/1/96,Hide,Hide,4,1996,948,948,984,984,1,36,36,0.036585366,0.036585366
FALSE,Rich County,4/1/97,Hide,Hide,4,1997,888,888,915,915,1,27,27,0.029508197,0.029508197
FALSE,Rich County,4/1/98,Hide,Hide,4,1998,962,962,994,994,1,32,32,0.032193159,0.032193159
FALSE,Rich County,4/1/99,Hide,Hide,4,1999,978,978,1011,1011,1,33,33,0.03264095,0.03264095
FALSE,Rich County,4/1/00,Hide,Hide,4,2000,1000,1000,1029,1029,1,29,29,0.028182702,0.028182702
FALSE,Rich County,4/1/01,Hide,Hide,4,2001,1072,1072,1111,1111,1,39,39,0.03510351,0.03510351
FALSE,Rich County,4/1/02,Hide,Hide,4,2002,1188,1188,1236,1236,1,48,48,0.038834951,0.038834951
FALSE,Rich County,4/1/03,Hide,Hide,4,2003,1197,1197,1247,1247,1,50,50,0.040096231,0.040096231
FALSE,Rich County,4/1/04,Hide,Hide,4,2004,1337,1337,1381,1381,1,44,44,0.03186097,0.03186097
FALSE,Rich County,4/1/05,Hide,Hide,4,2005,1243,1243,1285,1285,1,42,42,0.032684825,0.032684825
FALSE,Rich County,4/1/06,Hide,Hide,4,2006,1374,1374,1409,1409,1,35,35,0.024840312,0.024840312
FALSE,Rich County,4/1/07,Hide,Hide,4,2007,1442,1442,1466,1466,1,24,24,0.016371078,0.016371078
FALSE,Rich County,4/1/08,Hide,Hide,4,2008,1352,1352,1383,1383,1,31,31,0.02241504,0.02241504
FALSE,Rich County,4/1/09,Hide,Hide,4,2009,1405,1405,1481,1481,1,76,76,0.051316678,0.051316678
FALSE,Rich County,4/1/10,Hide,Hide,4,2010,980,980,1057,1057,1,77,77,0.072847682,0.072847682
FALSE,Rich County,4/1/11,Hide,Hide,4,2011,911,911,986,986,1,75,75,0.076064909,0.076064909
FALSE,Rich County,4/1/12,Hide,Hide,4,2012,907,907,956,956,1,49,49,0.05125523,0.05125523
FALSE,Rich County,4/1/13,Hide,Hide,4,2013,937,937,984,984,1,47,47,0.047764228,0.047764228
FALSE,Rich County,4/1/14,Hide,Hide,4,2014,981,981,1020,1020,1,39,39,0.038235294,0.038235294
FALSE,Rich County,4/1/15,Hide,Hide,4,2015,1031,1031,1069,1069,1,38,38,0.03554724,0.03554724
FALSE,Rich County,4/1/16,Hide,Hide,4,2016,1053,1053,1085,1085,1,32,32,0.029493088,0.029493088
FALSE,Rich County,4/1/17,Hide,Hide,4,2017,1091,1091,1129,1129,1,38,38,0.033658105,0.033658105
FALSE,Rich County,4/1/18,Hide,Hide,4,2018,1120,1120,1156,1156,1,36,36,0.031141869,0.031141869
FALSE,Rich County,4/1/19,Hide,Hide,4,2019,1150,1150,1187,1187,1,37,37,0.031171019,0.031171019
FALSE,Rich County,4/1/20,Show,Hide,4,2020,918,918,992,992,1,74,74,0.074596774,0.074596774
FALSE,Salt Lake County,4/1/93,Hide,Hide,4,1993,400008,400008,415822,415822,1,15814,15814,0.038030696,0.038030696
FALSE,Salt Lake County,4/1/94,Hide,Hide,4,1994,424933,424933,439353,439353,1,14420,14420,0.032820989,0.032820989
FALSE,Salt Lake County,4/1/95,Hide,Hide,4,1995,438627,438627,452650,452650,1,14023,14023,0.030979786,0.030979786
FALSE,Salt Lake County,4/1/96,Hide,Hide,4,1996,444760,444760,458366,458366,1,13606,13606,0.029683703,0.029683703
FALSE,Salt Lake County,4/1/97,Hide,Hide,4,1997,459024,459024,471864,471864,1,12840,12840,0.02721123,0.02721123
FALSE,Salt Lake County,4/1/98,Hide,Hide,4,1998,465646,465646,481456,481456,1,15810,15810,0.032837892,0.032837892
FALSE,Salt Lake County,4/1/99,Hide,Hide,4,1999,473251,473251,489518,489518,1,16267,16267,0.033230647,0.033230647
FALSE,Salt Lake County,4/1/00,Hide,Hide,4,2000,469060,469060,483366,483366,1,14306,14306,0.02959662,0.02959662
FALSE,Salt Lake County,4/1/01,Hide,Hide,4,2001,474192,474192,493962,493962,1,19770,19770,0.040023322,0.040023322
FALSE,Salt Lake County,4/1/02,Hide,Hide,4,2002,465905,465905,494888,494888,1,28983,28983,0.058564766,0.058564766
FALSE,Salt Lake County,4/1/03,Hide,Hide,4,2003,466630,466630,495708,495708,1,29078,29078,0.058659533,0.058659533
FALSE,Salt Lake County,4/1/04,Hide,Hide,4,2004,471689,471689,497729,497729,1,26040,26040,0.052317627,0.052317627
FALSE,Salt Lake County,4/1/05,Hide,Hide,4,2005,491740,491740,512991,512991,1,21251,21251,0.041425678,0.041425678
FALSE,Salt Lake County,4/1/06,Hide,Hide,4,2006,514678,514678,531208,531208,1,16530,16530,0.031117754,0.031117754
FALSE,Salt Lake County,4/1/07,Hide,Hide,4,2007,535007,535007,547475,547475,1,12468,12468,0.022773643,0.022773643
FALSE,Salt Lake County,4/1/08,Hide,Hide,4,2008,542058,542058,558300,558300,1,16242,16242,0.029091886,0.029091886
FALSE,Salt Lake County,4/1/09,Hide,Hide,4,2009,518992,518992,556844,556844,1,37852,37852,0.06797595,0.06797595
FALSE,Salt Lake County,4/1/10,Hide,Hide,4,2010,506692,506692,548856,548856,1,42164,42164,0.076821607,0.076821607
FALSE,Salt Lake County,4/1/11,Hide,Hide,4,2011,507882,507882,545615,545615,1,37733,37733,0.069156823,0.069156823
FALSE,Salt Lake County,4/1/12,Hide,Hide,4,2012,523418,523418,553520,553520,1,30102,30102,0.054382859,0.054382859
FALSE,Salt Lake County,4/1/13,Hide,Hide,4,2013,541380,541380,567123,567123,1,25743,25743,0.045392269,0.045392269
FALSE,Salt Lake County,4/1/14,Hide,Hide,4,2014,552496,552496,574023,574023,1,21527,21527,0.037501982,0.037501982
FALSE,Salt Lake County,4/1/15,Hide,Hide,4,2015,562239,562239,582075,582075,1,19836,19836,0.034078083,0.034078083
FALSE,Salt Lake County,4/1/16,Hide,Hide,4,2016,578621,578621,598045,598045,1,19424,19424,0.032479161,0.032479161
FALSE,Salt Lake County,4/1/17,Hide,Hide,4,2017,594158,594158,613569,613569,1,19411,19411,0.031636214,0.031636214
FALSE,Salt Lake County,4/1/18,Hide,Hide,4,2018,599287,599287,617483,617483,1,18196,18196,0.029468018,0.029468018
FALSE,Salt Lake County,4/1/19,Hide,Hide,4,2019,613616,613616,630221,630221,1,16605,16605,0.0263479,0.0263479
FALSE,Salt Lake County,4/1/20,Show,Hide,4,2020,560482,560482,631486,631486,1,71004,71004,0.112439547,0.112439547
FALSE,San Juan County,4/1/93,Hide,Hide,4,1993,4708,4708,5055,5055,1,347,347,0.068644906,0.068644906
FALSE,San Juan County,4/1/94,Hide,Hide,4,1994,4630,4630,5068,5068,1,438,438,0.086424625,0.086424625
FALSE,San Juan County,4/1/95,Hide,Hide,4,1995,4726,4726,5172,5172,1,446,446,0.086233565,0.086233565
FALSE,San Juan County,4/1/96,Hide,Hide,4,1996,4680,4680,5154,5154,1,474,474,0.091967404,0.091967404
FALSE,San Juan County,4/1/97,Hide,Hide,4,1997,4472,4472,4928,4928,1,456,456,0.092532468,0.092532468
FALSE,San Juan County,4/1/98,Hide,Hide,4,1998,4562,4562,4947,4947,1,385,385,0.077824944,0.077824944
FALSE,San Juan County,4/1/99,Hide,Hide,4,1999,4717,4717,5117,5117,1,400,400,0.078170803,0.078170803
FALSE,San Juan County,4/1/00,Hide,Hide,4,2000,4425,4425,4782,4782,1,357,357,0.074654956,0.074654956
FALSE,San Juan County,4/1/01,Hide,Hide,4,2001,4158,4158,4535,4535,1,377,377,0.083131202,0.083131202
FALSE,San Juan County,4/1/02,Hide,Hide,4,2002,4332,4332,4733,4733,1,401,401,0.084724276,0.084724276
FALSE,San Juan County,4/1/03,Hide,Hide,4,2003,4317,4317,4747,4747,1,430,430,0.090583526,0.090583526
FALSE,San Juan County,4/1/04,Hide,Hide,4,2004,4450,4450,4906,4906,1,456,456,0.092947411,0.092947411
FALSE,San Juan County,4/1/05,Hide,Hide,4,2005,4361,4361,4750,4750,1,389,389,0.081894737,0.081894737
FALSE,San Juan County,4/1/06,Hide,Hide,4,2006,4569,4569,4878,4878,1,309,309,0.063345633,0.063345633
FALSE,San Juan County,4/1/07,Hide,Hide,4,2007,4721,4721,4958,4958,1,237,237,0.047801533,0.047801533
FALSE,San Juan County,4/1/08,Hide,Hide,4,2008,4626,4626,4926,4926,1,300,300,0.06090134,0.06090134
FALSE,San Juan County,4/1/09,Hide,Hide,4,2009,4631,4631,5205,5205,1,574,574,0.110278578,0.110278578
FALSE,San Juan County,4/1/10,Hide,Hide,4,2010,5377,5377,6043,6043,1,666,666,0.110210161,0.110210161
FALSE,San Juan County,4/1/11,Hide,Hide,4,2011,5369,5369,5982,5982,1,613,613,0.102474089,0.102474089
FALSE,San Juan County,4/1/12,Hide,Hide,4,2012,5227,5227,5749,5749,1,522,522,0.0907984,0.0907984
FALSE,San Juan County,4/1/13,Hide,Hide,4,2013,5162,5162,5616,5616,1,454,454,0.080840456,0.080840456
FALSE,San Juan County,4/1/14,Hide,Hide,4,2014,5195,5195,5616,5616,1,421,421,0.074964387,0.074964387
FALSE,San Juan County,4/1/15,Hide,Hide,4,2015,5289,5289,5740,5740,1,451,451,0.078571429,0.078571429
FALSE,San Juan County,4/1/16,Hide,Hide,4,2016,5267,5267,5755,5755,1,488,488,0.08479583,0.08479583
FALSE,San Juan County,4/1/17,Hide,Hide,4,2017,5274,5274,5683,5683,1,409,409,0.07196903,0.07196903
FALSE,San Juan County,4/1/18,Hide,Hide,4,2018,5325,5325,5677,5677,1,352,352,0.06200458,0.06200458
FALSE,San Juan County,4/1/19,Hide,Hide,4,2019,5445,5445,5738,5738,1,293,293,0.051063088,0.051063088
FALSE,San Juan County,4/1/20,Show,Hide,4,2020,4899,4899,5873,5873,1,974,974,0.165843691,0.165843691
FALSE,Sanpete County,4/1/93,Hide,Hide,4,1993,6611,6611,7090,7090,1,479,479,0.067559944,0.067559944
FALSE,Sanpete County,4/1/94,Hide,Hide,4,1994,6883,6883,7380,7380,1,497,497,0.067344173,0.067344173
FALSE,Sanpete County,4/1/95,Hide,Hide,4,1995,7212,7212,7692,7692,1,480,480,0.062402496,0.062402496
FALSE,Sanpete County,4/1/96,Hide,Hide,4,1996,7670,7670,8158,8158,1,488,488,0.059818583,0.059818583
FALSE,Sanpete County,4/1/97,Hide,Hide,4,1997,8078,8078,8546,8546,1,468,468,0.054762462,0.054762462
FALSE,Sanpete County,4/1/98,Hide,Hide,4,1998,8396,8396,8926,8926,1,530,530,0.059377101,0.059377101
FALSE,Sanpete County,4/1/99,Hide,Hide,4,1999,8549,8549,9040,9040,1,491,491,0.054314159,0.054314159
FALSE,Sanpete County,4/1/00,Hide,Hide,4,2000,9137,9137,9536,9536,1,399,399,0.041841443,0.041841443
FALSE,Sanpete County,4/1/01,Hide,Hide,4,2001,9323,9323,9852,9852,1,529,529,0.053694681,0.053694681
FALSE,Sanpete County,4/1/02,Hide,Hide,4,2002,9467,9467,10118,10118,1,651,651,0.064340779,0.064340779
FALSE,Sanpete County,4/1/03,Hide,Hide,4,2003,9565,9565,10264,10264,1,699,699,0.068102104,0.068102104
FALSE,Sanpete County,4/1/04,Hide,Hide,4,2004,9982,9982,10645,10645,1,663,663,0.062282762,0.062282762
FALSE,Sanpete County,4/1/05,Hide,Hide,4,2005,9892,9892,10469,10469,1,577,577,0.055115102,0.055115102
FALSE,Sanpete County,4/1/06,Hide,Hide,4,2006,10177,10177,10604,10604,1,427,427,0.040267823,0.040267823
FALSE,Sanpete County,4/1/07,Hide,Hide,4,2007,10655,10655,10968,10968,1,313,313,0.028537564,0.028537564
FALSE,Sanpete County,4/1/08,Hide,Hide,4,2008,10493,10493,10909,10909,1,416,416,0.038133651,0.038133651
FALSE,Sanpete County,4/1/09,Hide,Hide,4,2009,10380,10380,11314,11314,1,934,934,0.08255259,0.08255259
FALSE,Sanpete County,4/1/10,Hide,Hide,4,2010,10443,10443,11453,11453,1,1010,1010,0.088186501,0.088186501
FALSE,Sanpete County,4/1/11,Hide,Hide,4,2011,10113,10113,11022,11022,1,909,909,0.082471421,0.082471421
FALSE,Sanpete County,4/1/12,Hide,Hide,4,2012,10510,10510,11255,11255,1,745,745,0.066192803,0.066192803
FALSE,Sanpete County,4/1/13,Hide,Hide,4,2013,10552,10552,11206,11206,1,654,654,0.058361592,0.058361592
FALSE,Sanpete County,4/1/14,Hide,Hide,4,2014,10535,10535,11042,11042,1,507,507,0.045915595,0.045915595
FALSE,Sanpete County,4/1/15,Hide,Hide,4,2015,11003,11003,11481,11481,1,478,478,0.041634004,0.041634004
FALSE,Sanpete County,4/1/16,Hide,Hide,4,2016,11274,11274,11754,11754,1,480,480,0.040837162,0.040837162
FALSE,Sanpete County,4/1/17,Hide,Hide,4,2017,11410,11410,11882,11882,1,472,472,0.039723952,0.039723952
FALSE,Sanpete County,4/1/18,Hide,Hide,4,2018,11898,11898,12353,12353,1,455,455,0.036833158,0.036833158
FALSE,Sanpete County,4/1/19,Hide,Hide,4,2019,12063,12063,12477,12477,1,414,414,0.033181053,0.033181053
FALSE,Sanpete County,4/1/20,Show,Hide,4,2020,11478,11478,12208,12208,1,730,730,0.059796855,0.059796855
FALSE,Sevier County,4/1/93,Hide,Hide,4,1993,6606,6606,7018,7018,1,412,412,0.058706184,0.058706184
FALSE,Sevier County,4/1/94,Hide,Hide,4,1994,7009,7009,7361,7361,1,352,352,0.04781959,0.04781959
FALSE,Sevier County,4/1/95,Hide,Hide,4,1995,7235,7235,7629,7629,1,394,394,0.051645039,0.051645039
FALSE,Sevier County,4/1/96,Hide,Hide,4,1996,7474,7474,7829,7829,1,355,355,0.045344233,0.045344233
FALSE,Sevier County,4/1/97,Hide,Hide,4,1997,7719,7719,8036,8036,1,317,317,0.039447486,0.039447486
FALSE,Sevier County,4/1/98,Hide,Hide,4,1998,7931,7931,8322,8322,1,391,391,0.046983898,0.046983898
FALSE,Sevier County,4/1/99,Hide,Hide,4,1999,8074,8074,8434,8434,1,360,360,0.042684373,0.042684373
FALSE,Sevier County,4/1/00,Hide,Hide,4,2000,8058,8058,8352,8352,1,294,294,0.035201149,0.035201149
FALSE,Sevier County,4/1/01,Hide,Hide,4,2001,8040,8040,8424,8424,1,384,384,0.045584046,0.045584046
FALSE,Sevier County,4/1/02,Hide,Hide,4,2002,8316,8316,8819,8819,1,503,503,0.057035945,0.057035945
FALSE,Sevier County,4/1/03,Hide,Hide,4,2003,8191,8191,8700,8700,1,509,509,0.058505747,0.058505747
FALSE,Sevier County,4/1/04,Hide,Hide,4,2004,8824,8824,9310,9310,1,486,486,0.052201933,0.052201933
FALSE,Sevier County,4/1/05,Hide,Hide,4,2005,8664,8664,9085,9085,1,421,421,0.046340121,0.046340121
FALSE,Sevier County,4/1/06,Hide,Hide,4,2006,9004,9004,9324,9324,1,320,320,0.034320034,0.034320034
FALSE,Sevier County,4/1/07,Hide,Hide,4,2007,9270,9270,9501,9501,1,231,231,0.02431323,0.02431323
FALSE,Sevier County,4/1/08,Hide,Hide,4,2008,9249,9249,9571,9571,1,322,322,0.033643297,0.033643297
FALSE,Sevier County,4/1/09,Hide,Hide,4,2009,9063,9063,9808,9808,1,745,745,0.075958401,0.075958401
FALSE,Sevier County,4/1/10,Hide,Hide,4,2010,8836,8836,9657,9657,1,821,821,0.085016051,0.085016051
FALSE,Sevier County,4/1/11,Hide,Hide,4,2011,8751,8751,9495,9495,1,744,744,0.07835703,0.07835703
FALSE,Sevier County,4/1/12,Hide,Hide,4,2012,8842,8842,9441,9441,1,599,599,0.063446669,0.063446669
FALSE,Sevier County,4/1/13,Hide,Hide,4,2013,8782,8782,9306,9306,1,524,524,0.056307758,0.056307758
FALSE,Sevier County,4/1/14,Hide,Hide,4,2014,8868,8868,9285,9285,1,417,417,0.044911147,0.044911147
FALSE,Sevier County,4/1/15,Hide,Hide,4,2015,9161,9161,9584,9584,1,423,423,0.04413606,0.04413606
FALSE,Sevier County,4/1/16,Hide,Hide,4,2016,9110,9110,9537,9537,1,427,427,0.044772989,0.044772989
FALSE,Sevier County,4/1/17,Hide,Hide,4,2017,9355,9355,9744,9744,1,389,389,0.039922003,0.039922003
FALSE,Sevier County,4/1/18,Hide,Hide,4,2018,9478,9478,9827,9827,1,349,349,0.035514399,0.035514399
FALSE,Sevier County,4/1/19,Hide,Hide,4,2019,9416,9416,9734,9734,1,318,318,0.032668995,0.032668995
FALSE,Sevier County,4/1/20,Show,Hide,4,2020,8727,8727,9506,9506,1,779,779,0.081948243,0.081948243
FALSE,State of Utah,4/1/93,Hide,Hide,4,1993,888907,888907,928547,928547,1,39640,39640,0.042690354,0.042690354
FALSE,State of Utah,4/1/94,Hide,Hide,4,1994,947815,947815,984472,984472,1,36657,36657,0.037235188,0.037235188
FALSE,State of Utah,4/1/95,Hide,Hide,4,1995,971593,971593,1007653,1007653,1,36060,36060,0.035786129,0.035786129
FALSE,State of Utah,4/1/96,Hide,Hide,4,1996,996755,996755,1031988,1031988,1,35233,35233,0.034140901,0.034140901
FALSE,State of Utah,4/1/97,Hide,Hide,4,1997,1031264,1031264,1064392,1064392,1,33128,33128,0.031123872,0.031123872
FALSE,State of Utah,4/1/98,Hide,Hide,4,1998,1054557,1054557,1094367,1094367,1,39810,39810,0.036377193,0.036377193
FALSE,State of Utah,4/1/99,Hide,Hide,4,1999,1077585,1077585,1118500,1118500,1,40915,40915,0.036580241,0.036580241
FALSE,State of Utah,4/1/00,Hide,Hide,4,2000,1100234,1100234,1135920,1135920,1,35686,35686,0.031415945,0.031415945
FALSE,State of Utah,4/1/01,Hide,Hide,4,2001,1113420,1113420,1161319,1161319,1,47899,47899,0.041245343,0.041245343
FALSE,State of Utah,4/1/02,Hide,Hide,4,2002,1113903,1113903,1181898,1181898,1,67995,67995,0.057530345,0.057530345
FALSE,State of Utah,4/1/03,Hide,Hide,4,2003,1125743,1125743,1194659,1194659,1,68916,68916,0.057686754,0.057686754
FALSE,State of Utah,4/1/04,Hide,Hide,4,2004,1161029,1161029,1224487,1224487,1,63458,63458,0.051824152,0.051824152
FALSE,State of Utah,4/1/05,Hide,Hide,4,2005,1208488,1208488,1261428,1261428,1,52940,52940,0.041968309,0.041968309
FALSE,State of Utah,4/1/06,Hide,Hide,4,2006,1267867,1267867,1309543,1309543,1,41676,41676,0.031824843,0.031824843
FALSE,State of Utah,4/1/07,Hide,Hide,4,2007,1320951,1320951,1353375,1353375,1,32424,32424,0.023957883,0.023957883
FALSE,State of Utah,4/1/08,Hide,Hide,4,2008,1327878,1327878,1371280,1371280,1,43402,43402,0.03165072,0.03165072
FALSE,State of Utah,4/1/09,Hide,Hide,4,2009,1274429,1274429,1372900,1372900,1,98471,98471,0.071724816,0.071724816
FALSE,State of Utah,4/1/10,Hide,Hide,4,2010,1249619,1249619,1357702,1357702,1,108083,108083,0.079607307,0.079607307
FALSE,State of Utah,4/1/11,Hide,Hide,4,2011,1253673,1253673,1349388,1349388,1,95715,95715,0.070932156,0.070932156
FALSE,State of Utah,4/1/12,Hide,Hide,4,2012,1290232,1290232,1366813,1366813,1,76581,76581,0.056028879,0.056028879
FALSE,State of Utah,4/1/13,Hide,Hide,4,2013,1332981,1332981,1399488,1399488,1,66507,66507,0.04752238,0.04752238
FALSE,State of Utah,4/1/14,Hide,Hide,4,2014,1366570,1366570,1421071,1421071,1,54501,54501,0.03835206,0.03835206
FALSE,State of Utah,4/1/15,Hide,Hide,4,2015,1400754,1400754,1453434,1453434,1,52680,52680,0.036245196,0.036245196
FALSE,State of Utah,4/1/16,Hide,Hide,4,2016,1442627,1442627,1495667,1495667,1,53040,53040,0.035462439,0.035462439
FALSE,State of Utah,4/1/17,Hide,Hide,4,2017,1490961,1490961,1542019,1542019,1,51058,51058,0.033111135,0.033111135
FALSE,State of Utah,4/1/18,Hide,Hide,4,2018,1518540,1518540,1566708,1566708,1,48168,48168,0.030744721,0.030744721
FALSE,State of Utah,4/1/19,Hide,Hide,4,2019,1540433,1540433,1586487,1586487,1,46054,46054,0.029028917,0.029028917
FALSE,State of Utah,4/1/20,Show,Hide,4,2020,1434307,1434307,1600601,1600601,1,166294,166294,0.103894725,0.103894725
FALSE,Summit County,4/1/93,Hide,Hide,4,1993,9639,9639,10203,10203,1,564,564,0.055277859,0.055277859
FALSE,Summit County,4/1/94,Hide,Hide,4,1994,10655,10655,11150,11150,1,495,495,0.044394619,0.044394619
FALSE,Summit County,4/1/95,Hide,Hide,4,1995,11493,11493,11951,11951,1,458,458,0.038323153,0.038323153
FALSE,Summit County,4/1/96,Hide,Hide,4,1996,12120,12120,12583,12583,1,463,463,0.036795677,0.036795677
FALSE,Summit County,4/1/97,Hide,Hide,4,1997,12773,12773,13211,13211,1,438,438,0.03315419,0.03315419
FALSE,Summit County,4/1/98,Hide,Hide,4,1998,13366,13366,13989,13989,1,623,623,0.044534992,0.044534992
FALSE,Summit County,4/1/99,Hide,Hide,4,1999,13921,13921,14608,14608,1,687,687,0.047029025,0.047029025
FALSE,Summit County,4/1/00,Hide,Hide,4,2000,17336,17336,17948,17948,1,612,612,0.034098507,0.034098507
FALSE,Summit County,4/1/01,Hide,Hide,4,2001,17920,17920,18669,18669,1,749,749,0.040119985,0.040119985
FALSE,Summit County,4/1/02,Hide,Hide,4,2002,18073,18073,19350,19350,1,1277,1277,0.065994832,0.065994832
FALSE,Summit County,4/1/03,Hide,Hide,4,2003,18536,18536,19776,19776,1,1240,1240,0.062702265,0.062702265
FALSE,Summit County,4/1/04,Hide,Hide,4,2004,19223,19223,20343,20343,1,1120,1120,0.055055793,0.055055793
FALSE,Summit County,4/1/05,Hide,Hide,4,2005,20396,20396,21274,21274,1,878,878,0.041271035,0.041271035
FALSE,Summit County,4/1/06,Hide,Hide,4,2006,20954,20954,21631,21631,1,677,677,0.031297675,0.031297675
FALSE,Summit County,4/1/07,Hide,Hide,4,2007,21151,21151,21664,21664,1,513,513,0.023679838,0.023679838
FALSE,Summit County,4/1/08,Hide,Hide,4,2008,21422,21422,22062,22062,1,640,640,0.029009156,0.029009156
FALSE,Summit County,4/1/09,Hide,Hide,4,2009,20557,20557,22024,22024,1,1467,1467,0.066609154,0.066609154
FALSE,Summit County,4/1/10,Hide,Hide,4,2010,19521,19521,21057,21057,1,1536,1536,0.072944864,0.072944864
FALSE,Summit County,4/1/11,Hide,Hide,4,2011,20010,20010,21362,21362,1,1352,1352,0.063289954,0.063289954
FALSE,Summit County,4/1/12,Hide,Hide,4,2012,20207,20207,21294,21294,1,1087,1087,0.051047243,0.051047243
FALSE,Summit County,4/1/13,Hide,Hide,4,2013,20924,20924,21876,21876,1,952,952,0.043518011,0.043518011
FALSE,Summit County,4/1/14,Hide,Hide,4,2014,21738,21738,22527,22527,1,789,789,0.035024637,0.035024637
FALSE,Summit County,4/1/15,Hide,Hide,4,2015,22172,22172,22933,22933,1,761,761,0.033183622,0.033183622
FALSE,Summit County,4/1/16,Hide,Hide,4,2016,22946,22946,23693,23693,1,747,747,0.031528299,0.031528299
FALSE,Summit County,4/1/17,Hide,Hide,4,2017,23603,23603,24368,24368,1,765,765,0.031393631,0.031393631
FALSE,Summit County,4/1/18,Hide,Hide,4,2018,23618,23618,24345,24345,1,727,727,0.029862395,0.029862395
FALSE,Summit County,4/1/19,Hide,Hide,4,2019,24285,24285,24926,24926,1,641,641,0.02571612,0.02571612
FALSE,Summit County,4/1/20,Show,Hide,4,2020,19237,19237,24160,24160,1,4923,4923,0.203766556,0.203766556
FALSE,Tooele County,4/1/93,Hide,Hide,4,1993,11450,11450,12160,12160,1,710,710,0.058388158,0.058388158
FALSE,Tooele County,4/1/94,Hide,Hide,4,1994,10924,10924,11600,11600,1,676,676,0.058275862,0.058275862
FALSE,Tooele County,4/1/95,Hide,Hide,4,1995,10886,10886,11538,11538,1,652,652,0.056508927,0.056508927
FALSE,Tooele County,4/1/96,Hide,Hide,4,1996,11012,11012,11635,11635,1,623,623,0.053545337,0.053545337
FALSE,Tooele County,4/1/97,Hide,Hide,4,1997,11121,11121,11660,11660,1,539,539,0.046226415,0.046226415
FALSE,Tooele County,4/1/98,Hide,Hide,4,1998,11092,11092,11658,11658,1,566,566,0.048550352,0.048550352
FALSE,Tooele County,4/1/99,Hide,Hide,4,1999,11231,11231,11875,11875,1,644,644,0.054231579,0.054231579
FALSE,Tooele County,4/1/00,Hide,Hide,4,2000,18893,18893,19586,19586,1,693,693,0.035382416,0.035382416
FALSE,Tooele County,4/1/01,Hide,Hide,4,2001,20120,20120,21080,21080,1,960,960,0.045540797,0.045540797
FALSE,Tooele County,4/1/02,Hide,Hide,4,2002,20653,20653,22038,22038,1,1385,1385,0.062845993,0.062845993
FALSE,Tooele County,4/1/03,Hide,Hide,4,2003,21557,21557,23008,23008,1,1451,1451,0.063065021,0.063065021
FALSE,Tooele County,4/1/04,Hide,Hide,4,2004,22364,22364,23713,23713,1,1349,1349,0.056888626,0.056888626
FALSE,Tooele County,4/1/05,Hide,Hide,4,2005,23743,23743,24852,24852,1,1109,1109,0.044624175,0.044624175
FALSE,Tooele County,4/1/06,Hide,Hide,4,2006,25151,25151,26052,26052,1,901,901,0.034584677,0.034584677
FALSE,Tooele County,4/1/07,Hide,Hide,4,2007,26000,26000,26687,26687,1,687,687,0.025742871,0.025742871
FALSE,Tooele County,4/1/08,Hide,Hide,4,2008,27019,27019,27936,27936,1,917,917,0.032825029,0.032825029
FALSE,Tooele County,4/1/09,Hide,Hide,4,2009,26185,26185,28363,28363,1,2178,2178,0.076790184,0.076790184
FALSE,Tooele County,4/1/10,Hide,Hide,4,2010,25152,25152,27472,27472,1,2320,2320,0.084449621,0.084449621
FALSE,Tooele County,4/1/11,Hide,Hide,4,2011,25204,25204,27236,27236,1,2032,2032,0.074607138,0.074607138
FALSE,Tooele County,4/1/12,Hide,Hide,4,2012,25903,25903,27606,27606,1,1703,1703,0.061689488,0.061689488
FALSE,Tooele County,4/1/13,Hide,Hide,4,2013,26754,26754,28312,28312,1,1558,1558,0.055029669,0.055029669
FALSE,Tooele County,4/1/14,Hide,Hide,4,2014,27381,27381,28783,28783,1,1402,1402,0.048709308,0.048709308
FALSE,Tooele County,4/1/15,Hide,Hide,4,2015,28073,28073,29312,29312,1,1239,1239,0.042269378,0.042269378
FALSE,Tooele County,4/1/16,Hide,Hide,4,2016,29274,29274,30476,30476,1,1202,1202,0.039440872,0.039440872
FALSE,Tooele County,4/1/17,Hide,Hide,4,2017,30882,30882,32070,32070,1,1188,1188,0.037043966,0.037043966
FALSE,Tooele County,4/1/18,Hide,Hide,4,2018,31859,31859,32962,32962,1,1103,1103,0.033462775,0.033462775
FALSE,Tooele County,4/1/19,Hide,Hide,4,2019,32541,32541,33560,33560,1,1019,1019,0.030363528,0.030363528
FALSE,Tooele County,4/1/20,Show,Hide,4,2020,29949,29949,33477,33477,1,3528,3528,0.105385787,0.105385787
FALSE,Uintah County,4/1/93,Hide,Hide,4,1993,9090,9090,9866,9866,1,776,776,0.078653963,0.078653963
FALSE,Uintah County,4/1/94,Hide,Hide,4,1994,9458,9458,10224,10224,1,766,766,0.074921753,0.074921753
FALSE,Uintah County,4/1/95,Hide,Hide,4,1995,9722,9722,10423,10423,1,701,701,0.067255109,0.067255109
FALSE,Uintah County,4/1/96,Hide,Hide,4,1996,9369,9369,10107,10107,1,738,738,0.0730187,0.0730187
FALSE,Uintah County,4/1/97,Hide,Hide,4,1997,10039,10039,10649,10649,1,610,610,0.057282374,0.057282374
FALSE,Uintah County,4/1/98,Hide,Hide,4,1998,10216,10216,10820,10820,1,604,604,0.055822551,0.055822551
FALSE,Uintah County,4/1/99,Hide,Hide,4,1999,10235,10235,11070,11070,1,835,835,0.075429088,0.075429088
FALSE,Uintah County,4/1/00,Hide,Hide,4,2000,10861,10861,11321,11321,1,460,460,0.040632453,0.040632453
FALSE,Uintah County,4/1/01,Hide,Hide,4,2001,11516,11516,12023,12023,1,507,507,0.042169176,0.042169176
FALSE,Uintah County,4/1/02,Hide,Hide,4,2002,11806,11806,12561,12561,1,755,755,0.060106679,0.060106679
FALSE,Uintah County,4/1/03,Hide,Hide,4,2003,12219,12219,12975,12975,1,756,756,0.058265896,0.058265896
FALSE,Uintah County,4/1/04,Hide,Hide,4,2004,12953,12953,13679,13679,1,726,726,0.053074055,0.053074055
FALSE,Uintah County,4/1/05,Hide,Hide,4,2005,13844,13844,14422,14422,1,578,578,0.040077659,0.040077659
FALSE,Uintah County,4/1/06,Hide,Hide,4,2006,15507,15507,15930,15930,1,423,423,0.026553672,0.026553672
FALSE,Uintah County,4/1/07,Hide,Hide,4,2007,17044,17044,17372,17372,1,328,328,0.018880958,0.018880958
FALSE,Uintah County,4/1/08,Hide,Hide,4,2008,17696,17696,18080,18080,1,384,384,0.021238938,0.021238938
FALSE,Uintah County,4/1/09,Hide,Hide,4,2009,16831,16831,18173,18173,1,1342,1342,0.073845815,0.073845815
FALSE,Uintah County,4/1/10,Hide,Hide,4,2010,13878,13878,15193,15193,1,1315,1315,0.086553018,0.086553018
FALSE,Uintah County,4/1/11,Hide,Hide,4,2011,14457,14457,15448,15448,1,991,991,0.064150699,0.064150699
FALSE,Uintah County,4/1/12,Hide,Hide,4,2012,15392,15392,16096,16096,1,704,704,0.043737575,0.043737575
FALSE,Uintah County,4/1/13,Hide,Hide,4,2013,15090,15090,15788,15788,1,698,698,0.044210793,0.044210793
FALSE,Uintah County,4/1/14,Hide,Hide,4,2014,15397,15397,15941,15941,1,544,544,0.034125839,0.034125839
FALSE,Uintah County,4/1/15,Hide,Hide,4,2015,14615,14615,15575,15575,1,960,960,0.061637239,0.061637239
FALSE,Uintah County,4/1/16,Hide,Hide,4,2016,12924,12924,14327,14327,1,1403,1403,0.097926991,0.097926991
FALSE,Uintah County,4/1/17,Hide,Hide,4,2017,12823,12823,13680,13680,1,857,857,0.062646199,0.062646199
FALSE,Uintah County,4/1/18,Hide,Hide,4,2018,12947,12947,13573,13573,1,626,626,0.046120975,0.046120975
FALSE,Uintah County,4/1/19,Hide,Hide,4,2019,13079,13079,13634,13634,1,555,555,0.040707056,0.040707056
FALSE,Uintah County,4/1/20,Show,Hide,4,2020,11838,11838,14082,14082,1,2244,2244,0.159352365,0.159352365
FALSE,United States,4/1/93,Hide,Hide,4,1993,119474,119474000,128584,128584000,1,9110,9110000,0.071,0.071
FALSE,United States,4/1/94,Hide,Hide,4,1994,122290,122290000,130621,130621000,1,8331,8331000,0.064,0.064
FALSE,United States,4/1/95,Hide,Hide,4,1995,124945,124945000,132590,132590000,1,7645,7645000,0.058,0.058
FALSE,United States,4/1/96,Hide,Hide,4,1996,125994,125994000,133409,133409000,1,7415,7415000,0.056,0.056
FALSE,United States,4/1/97,Hide,Hide,4,1997,129143,129143000,136016,136016000,1,6873,6873000,0.051,0.051
FALSE,United States,4/1/98,Hide,Hide,4,1998,131209,131209000,137150,137150000,1,5941,5941000,0.043,0.043
FALSE,United States,4/1/99,Hide,Hide,4,1999,132955,132955000,138959,138959000,1,6004,6004000,0.043,0.043
FALSE,United States,4/1/00,Hide,Hide,4,2000,137270,137270000,142751,142751000,1,5481,5481000,0.038,0.038
FALSE,United States,4/1/01,Hide,Hide,4,2001,137299,137299000,143569,143569000,1,6271,6271000,0.044,0.044
FALSE,United States,4/1/02,Hide,Hide,4,2002,136126,136126000,144725,144725000,1,8599,8599000,0.059,0.059
FALSE,United States,4/1/03,Hide,Hide,4,2003,137633,137633000,146474,146474000,1,8842,8842000,0.06,0.06
FALSE,United States,4/1/04,Hide,Hide,4,2004,138680,138680000,146850,146850000,1,8170,8170000,0.056,0.056
FALSE,United States,4/1/05,Hide,Hide,4,2005,141254,141254000,148926,148926000,1,7672,7672000,0.052,0.052
FALSE,United States,4/1/06,Hide,Hide,4,2006,143761,143761000,150881,150881000,1,7120,7120000,0.047,0.047
FALSE,United States,4/1/07,Hide,Hide,4,2007,145586,145586000,152435,152435000,1,6850,6850000,0.045,0.045
FALSE,United States,4/1/08,Hide,Hide,4,2008,146132,146132000,153769,153769000,1,7637,7637000,0.05,0.05
FALSE,United States,4/1/09,Hide,Hide,4,2009,140656,140656000,154509,154509000,1,13853,13853000,0.09,0.09
FALSE,United States,4/1/10,Hide,Hide,4,2010,139297,139297000,154622,154622000,1,15325,15325000,0.099,0.099
FALSE,United States,4/1/11,Hide,Hide,4,2011,139586,139586000,153543,153543000,1,13957,13957000,0.091,0.091
FALSE,United States,4/1/12,Hide,Hide,4,2012,141899,141899000,154545,154545000,1,12646,12646000,0.082,0.082
FALSE,United States,4/1/13,Hide,Hide,4,2013,143635,143635000,155394,155394000,1,11760,11760000,0.076,0.076
FALSE,United States,4/1/14,Hide,Hide,4,2014,145667,145667000,155369,155369000,1,9702,9702000,0.062,0.062
FALSE,United States,4/1/15,Hide,Hide,4,2015,148511,148511000,157060,157060000,1,8550,8550000,0.054,0.054
FALSE,United States,4/1/16,Hide,Hide,4,2016,151006,151006000,158981,158981000,1,7975,7975000,0.05,0.05
FALSE,United States,4/1/17,Hide,Hide,4,2017,153224,153224000,160309,160309000,1,7085,7085000,0.044,0.044
FALSE,United States,4/1/18,Hide,Hide,4,2018,155324,155324000,161742,161742000,1,6418,6418000,0.04,0.04
FALSE,United States,4/1/19,Hide,Hide,4,2019,156696,156696000,162546,162546000,1,5850,5850000,0.036,0.036
FALSE,United States,4/1/20,Show,Hide,4,2020,133403,133403000,156481,156481000,1,23078,23078000,0.147481164,0.147481164
FALSE,Utah County,4/1/93,Hide,Hide,4,1993,129872,129872,134858,134858,1,4986,4986,0.036972223,0.036972223
FALSE,Utah County,4/1/94,Hide,Hide,4,1994,140332,140332,144866,144866,1,4534,4534,0.031297889,0.031297889
FALSE,Utah County,4/1/95,Hide,Hide,4,1995,142708,142708,147089,147089,1,4381,4381,0.029784688,0.029784688
FALSE,Utah County,4/1/96,Hide,Hide,4,1996,148047,148047,152394,152394,1,4347,4347,0.028524745,0.028524745
FALSE,Utah County,4/1/97,Hide,Hide,4,1997,153688,153688,157797,157797,1,4109,4109,0.026039785,0.026039785
FALSE,Utah County,4/1/98,Hide,Hide,4,1998,158601,158601,163483,163483,1,4882,4882,0.029862432,0.029862432
FALSE,Utah County,4/1/99,Hide,Hide,4,1999,163982,163982,169364,169364,1,5382,5382,0.03177771,0.03177771
FALSE,Utah County,4/1/00,Hide,Hide,4,2000,174487,174487,179400,179400,1,4913,4913,0.02738573,0.02738573
FALSE,Utah County,4/1/01,Hide,Hide,4,2001,176639,176639,183428,183428,1,6789,6789,0.037011798,0.037011798
FALSE,Utah County,4/1/02,Hide,Hide,4,2002,174628,174628,185504,185504,1,10876,10876,0.058629464,0.058629464
FALSE,Utah County,4/1/03,Hide,Hide,4,2003,177691,177691,187817,187817,1,10126,10126,0.053914182,0.053914182
FALSE,Utah County,4/1/04,Hide,Hide,4,2004,185523,185523,195107,195107,1,9584,9584,0.049121764,0.049121764
FALSE,Utah County,4/1/05,Hide,Hide,4,2005,195321,195321,203562,203562,1,8241,8241,0.04048398,0.04048398
FALSE,Utah County,4/1/06,Hide,Hide,4,2006,205202,205202,211629,211629,1,6427,6427,0.030369184,0.030369184
FALSE,Utah County,4/1/07,Hide,Hide,4,2007,216746,216746,221763,221763,1,5017,5017,0.022623251,0.022623251
FALSE,Utah County,4/1/08,Hide,Hide,4,2008,216647,216647,223580,223580,1,6933,6933,0.031009035,0.031009035
FALSE,Utah County,4/1/09,Hide,Hide,4,2009,207215,207215,222247,222247,1,15032,15032,0.067636459,0.067636459
FALSE,Utah County,4/1/10,Hide,Hide,4,2010,212688,212688,229943,229943,1,17255,17255,0.075040336,0.075040336
FALSE,Utah County,4/1/11,Hide,Hide,4,2011,214753,214753,229994,229994,1,15241,15241,0.066266946,0.066266946
FALSE,Utah County,4/1/12,Hide,Hide,4,2012,224332,224332,236509,236509,1,12177,12177,0.051486413,0.051486413
FALSE,Utah County,4/1/13,Hide,Hide,4,2013,235692,235692,246616,246616,1,10924,10924,0.044295585,0.044295585
FALSE,Utah County,4/1/14,Hide,Hide,4,2014,244027,244027,253035,253035,1,9008,9008,0.035599818,0.035599818
FALSE,Utah County,4/1/15,Hide,Hide,4,2015,254578,254578,263219,263219,1,8641,8641,0.032828177,0.032828177
FALSE,Utah County,4/1/16,Hide,Hide,4,2016,267406,267406,276166,276166,1,8760,8760,0.031720052,0.031720052
FALSE,Utah County,4/1/17,Hide,Hide,4,2017,279706,279706,288264,288264,1,8558,8558,0.029688064,0.029688064
FALSE,Utah County,4/1/18,Hide,Hide,4,2018,289626,289626,297885,297885,1,8259,8259,0.027725465,0.027725465
FALSE,Utah County,4/1/19,Hide,Hide,4,2019,297628,297628,305191,305191,1,7563,7563,0.024781203,0.024781203
FALSE,Utah County,4/1/20,Show,Hide,4,2020,275992,275992,299698,299698,1,23706,23706,0.079099627,0.079099627
FALSE,Wasatch County,4/1/93,Hide,Hide,4,1993,4732,4732,5050,5050,1,318,318,0.062970297,0.062970297
FALSE,Wasatch County,4/1/94,Hide,Hide,4,1994,5013,5013,5313,5313,1,300,300,0.056465274,0.056465274
FALSE,Wasatch County,4/1/95,Hide,Hide,4,1995,5152,5152,5435,5435,1,283,283,0.052069917,0.052069917
FALSE,Wasatch County,4/1/96,Hide,Hide,4,1996,5356,5356,5603,5603,1,247,247,0.044083527,0.044083527
FALSE,Wasatch County,4/1/97,Hide,Hide,4,1997,5636,5636,5857,5857,1,221,221,0.037732628,0.037732628
FALSE,Wasatch County,4/1/98,Hide,Hide,4,1998,5870,5870,6174,6174,1,304,304,0.049238743,0.049238743
FALSE,Wasatch County,4/1/99,Hide,Hide,4,1999,6068,6068,6381,6381,1,313,313,0.049051873,0.049051873
FALSE,Wasatch County,4/1/00,Hide,Hide,4,2000,7432,7432,7681,7681,1,249,249,0.032417654,0.032417654
FALSE,Wasatch County,4/1/01,Hide,Hide,4,2001,7474,7474,7803,7803,1,329,329,0.042163271,0.042163271
FALSE,Wasatch County,4/1/02,Hide,Hide,4,2002,7637,7637,8155,8155,1,518,518,0.063519313,0.063519313
FALSE,Wasatch County,4/1/03,Hide,Hide,4,2003,7860,7860,8385,8385,1,525,525,0.062611807,0.062611807
FALSE,Wasatch County,4/1/04,Hide,Hide,4,2004,8203,8203,8697,8697,1,494,494,0.056801196,0.056801196
FALSE,Wasatch County,4/1/05,Hide,Hide,4,2005,8846,8846,9231,9231,1,385,385,0.041707291,0.041707291
FALSE,Wasatch County,4/1/06,Hide,Hide,4,2006,9564,9564,9902,9902,1,338,338,0.034134518,0.034134518
FALSE,Wasatch County,4/1/07,Hide,Hide,4,2007,10395,10395,10626,10626,1,231,231,0.02173913,0.02173913
FALSE,Wasatch County,4/1/08,Hide,Hide,4,2008,9989,9989,10307,10307,1,318,318,0.030852818,0.030852818
FALSE,Wasatch County,4/1/09,Hide,Hide,4,2009,9240,9240,10051,10051,1,811,811,0.080688489,0.080688489
FALSE,Wasatch County,4/1/10,Hide,Hide,4,2010,10353,10353,11323,11323,1,970,970,0.085666343,0.085666343
FALSE,Wasatch County,4/1/11,Hide,Hide,4,2011,10418,10418,11253,11253,1,835,835,0.074202435,0.074202435
FALSE,Wasatch County,4/1/12,Hide,Hide,4,2012,10862,10862,11546,11546,1,684,684,0.059241296,0.059241296
FALSE,Wasatch County,4/1/13,Hide,Hide,4,2013,11528,11528,12113,12113,1,585,585,0.04829522,0.04829522
FALSE,Wasatch County,4/1/14,Hide,Hide,4,2014,12155,12155,12642,12642,1,487,487,0.038522386,0.038522386
FALSE,Wasatch County,4/1/15,Hide,Hide,4,2015,12723,12723,13188,13188,1,465,465,0.035259327,0.035259327
FALSE,Wasatch County,4/1/16,Hide,Hide,4,2016,13299,13299,13789,13789,1,490,490,0.035535572,0.035535572
FALSE,Wasatch County,4/1/17,Hide,Hide,4,2017,13971,13971,14459,14459,1,488,488,0.033750605,0.033750605
FALSE,Wasatch County,4/1/18,Hide,Hide,4,2018,14468,14468,14938,14938,1,470,470,0.031463382,0.031463382
FALSE,Wasatch County,4/1/19,Hide,Hide,4,2019,15482,15482,15922,15922,1,440,440,0.027634719,0.027634719
FALSE,Wasatch County,4/1/20,Show,Hide,4,2020,13283,13283,16109,16109,1,2826,2826,0.175429884,0.175429884
FALSE,Washington County,4/1/93,Hide,Hide,4,1993,24240,24240,25241,25241,1,1001,1001,0.0396577,0.0396577
FALSE,Washington County,4/1/94,Hide,Hide,4,1994,28966,28966,29817,29817,1,851,851,0.028540765,0.028540765
FALSE,Washington County,4/1/95,Hide,Hide,4,1995,31222,31222,32270,32270,1,1048,1048,0.032475984,0.032475984
FALSE,Washington County,4/1/96,Hide,Hide,4,1996,33189,33189,34396,34396,1,1207,1207,0.03509129,0.03509129
FALSE,Washington County,4/1/97,Hide,Hide,4,1997,33981,33981,35158,35158,1,1177,1177,0.033477445,0.033477445
FALSE,Washington County,4/1/98,Hide,Hide,4,1998,35519,35519,36857,36857,1,1338,1338,0.036302466,0.036302466
FALSE,Washington County,4/1/99,Hide,Hide,4,1999,37069,37069,38430,38430,1,1361,1361,0.03541504,0.03541504
FALSE,Washington County,4/1/00,Hide,Hide,4,2000,37751,37751,39058,39058,1,1307,1307,0.033463055,0.033463055
FALSE,Washington County,4/1/01,Hide,Hide,4,2001,39860,39860,41541,41541,1,1681,1681,0.040466046,0.040466046
FALSE,Washington County,4/1/02,Hide,Hide,4,2002,41931,41931,44159,44159,1,2228,2228,0.050454041,0.050454041
FALSE,Washington County,4/1/03,Hide,Hide,4,2003,44193,44193,46741,46741,1,2548,2548,0.054513168,0.054513168
FALSE,Washington County,4/1/04,Hide,Hide,4,2004,48394,48394,50960,50960,1,2566,2566,0.050353218,0.050353218
FALSE,Washington County,4/1/05,Hide,Hide,4,2005,53637,53637,56004,56004,1,2367,2367,0.042264838,0.042264838
FALSE,Washington County,4/1/06,Hide,Hide,4,2006,59177,59177,61070,61070,1,1893,1893,0.030997216,0.030997216
FALSE,Washington County,4/1/07,Hide,Hide,4,2007,61290,61290,62879,62879,1,1589,1589,0.025270758,0.025270758
FALSE,Washington County,4/1/08,Hide,Hide,4,2008,59934,59934,62333,62333,1,2399,2399,0.038486837,0.038486837
FALSE,Washington County,4/1/09,Hide,Hide,4,2009,55075,55075,60851,60851,1,5776,5776,0.094920379,0.094920379
FALSE,Washington County,4/1/10,Hide,Hide,4,2010,51013,51013,57022,57022,1,6009,6009,0.10538038,0.10538038
FALSE,Washington County,4/1/11,Hide,Hide,4,2011,50739,50739,55922,55922,1,5183,5183,0.092682665,0.092682665
FALSE,Washington County,4/1/12,Hide,Hide,4,2012,52656,52656,56711,56711,1,4055,4055,0.071502883,0.071502883
FALSE,Washington County,4/1/13,Hide,Hide,4,2013,55391,55391,58828,58828,1,3437,3437,0.05842456,0.05842456
FALSE,Washington County,4/1/14,Hide,Hide,4,2014,58339,58339,61046,61046,1,2707,2707,0.04434361,0.04434361
FALSE,Washington County,4/1/15,Hide,Hide,4,2015,60487,60487,63111,63111,1,2624,2624,0.041577538,0.041577538
FALSE,Washington County,4/1/16,Hide,Hide,4,2016,63897,63897,66466,66466,1,2569,2569,0.038651341,0.038651341
FALSE,Washington County,4/1/17,Hide,Hide,4,2017,67639,67639,70127,70127,1,2488,2488,0.035478489,0.035478489
FALSE,Washington County,4/1/18,Hide,Hide,4,2018,71105,71105,73584,73584,1,2479,2479,0.033689389,0.033689389
FALSE,Washington County,4/1/19,Hide,Hide,4,2019,73100,73100,75401,75401,1,2301,2301,0.030516837,0.030516837
FALSE,Washington County,4/1/20,Show,Hide,4,2020,65989,65989,75371,75371,1,9382,9382,0.124477584,0.124477584
FALSE,Wayne County,4/1/93,Hide,Hide,4,1993,966,966,1044,1044,1,78,78,0.074712644,0.074712644
FALSE,Wayne County,4/1/94,Hide,Hide,4,1994,1065,1065,1158,1158,1,93,93,0.080310881,0.080310881
FALSE,Wayne County,4/1/95,Hide,Hide,4,1995,1228,1228,1309,1309,1,81,81,0.061879297,0.061879297
FALSE,Wayne County,4/1/96,Hide,Hide,4,1996,1271,1271,1347,1347,1,76,76,0.056421678,0.056421678
FALSE,Wayne County,4/1/97,Hide,Hide,4,1997,1290,1290,1358,1358,1,68,68,0.050073638,0.050073638
FALSE,Wayne County,4/1/98,Hide,Hide,4,1998,1423,1423,1509,1509,1,86,86,0.056991385,0.056991385
FALSE,Wayne County,4/1/99,Hide,Hide,4,1999,1386,1386,1475,1475,1,89,89,0.060338983,0.060338983
FALSE,Wayne County,4/1/00,Hide,Hide,4,2000,1252,1252,1310,1310,1,58,58,0.044274809,0.044274809
FALSE,Wayne County,4/1/01,Hide,Hide,4,2001,1329,1329,1402,1402,1,73,73,0.052068474,0.052068474
FALSE,Wayne County,4/1/02,Hide,Hide,4,2002,1375,1375,1461,1461,1,86,86,0.058863792,0.058863792
FALSE,Wayne County,4/1/03,Hide,Hide,4,2003,1244,1244,1333,1333,1,89,89,0.066766692,0.066766692
FALSE,Wayne County,4/1/04,Hide,Hide,4,2004,1322,1322,1411,1411,1,89,89,0.063075833,0.063075833
FALSE,Wayne County,4/1/05,Hide,Hide,4,2005,1234,1234,1305,1305,1,71,71,0.05440613,0.05440613
FALSE,Wayne County,4/1/06,Hide,Hide,4,2006,1324,1324,1389,1389,1,65,65,0.046796256,0.046796256
FALSE,Wayne County,4/1/07,Hide,Hide,4,2007,1353,1353,1408,1408,1,55,55,0.0390625,0.0390625
FALSE,Wayne County,4/1/08,Hide,Hide,4,2008,1266,1266,1332,1332,1,66,66,0.04954955,0.04954955
FALSE,Wayne County,4/1/09,Hide,Hide,4,2009,1337,1337,1452,1452,1,115,115,0.079201102,0.079201102
FALSE,Wayne County,4/1/10,Hide,Hide,4,2010,1449,1449,1581,1581,1,132,132,0.083491461,0.083491461
FALSE,Wayne County,4/1/11,Hide,Hide,4,2011,1340,1340,1481,1481,1,141,141,0.095205942,0.095205942
FALSE,Wayne County,4/1/12,Hide,Hide,4,2012,1208,1208,1355,1355,1,147,147,0.108487085,0.108487085
FALSE,Wayne County,4/1/13,Hide,Hide,4,2013,1204,1204,1356,1356,1,152,152,0.112094395,0.112094395
FALSE,Wayne County,4/1/14,Hide,Hide,4,2014,1251,1251,1380,1380,1,129,129,0.093478261,0.093478261
FALSE,Wayne County,4/1/15,Hide,Hide,4,2015,1275,1275,1405,1405,1,130,130,0.09252669,0.09252669
FALSE,Wayne County,4/1/16,Hide,Hide,4,2016,1328,1328,1441,1441,1,113,113,0.078417765,0.078417765
FALSE,Wayne County,4/1/17,Hide,Hide,4,2017,1344,1344,1457,1457,1,113,113,0.077556623,0.077556623
FALSE,Wayne County,4/1/18,Hide,Hide,4,2018,1357,1357,1443,1443,1,86,86,0.05959806,0.05959806
FALSE,Wayne County,4/1/19,Hide,Hide,4,2019,1337,1337,1414,1414,1,77,77,0.054455446,0.054455446
FALSE,Wayne County,4/1/20,Show,Hide,4,2020,1191,1191,1420,1420,1,229,229,0.161267606,0.161267606
FALSE,Weber County,4/1/93,Hide,Hide,4,1993,82127,82127,86879,86879,1,4752,4752,0.054696762,0.054696762
FALSE,Weber County,4/1/94,Hide,Hide,4,1994,87517,87517,91555,91555,1,4038,4038,0.044104637,0.044104637
FALSE,Weber County,4/1/95,Hide,Hide,4,1995,87883,87883,91847,91847,1,3964,3964,0.043158731,0.043158731
FALSE,Weber County,4/1/96,Hide,Hide,4,1996,91447,91447,95333,95333,1,3886,3886,0.04076238,0.04076238
FALSE,Weber County,4/1/97,Hide,Hide,4,1997,94581,94581,98291,98291,1,3710,3710,0.037745063,0.037745063
FALSE,Weber County,4/1/98,Hide,Hide,4,1998,96136,96136,100899,100899,1,4763,4763,0.047205621,0.047205621
FALSE,Weber County,4/1/99,Hide,Hide,4,1999,98133,98133,102562,102562,1,4429,4429,0.043183635,0.043183635
FALSE,Weber County,4/1/00,Hide,Hide,4,2000,96677,96677,100655,100655,1,3978,3978,0.039521137,0.039521137
FALSE,Weber County,4/1/01,Hide,Hide,4,2001,96862,96862,102016,102016,1,5154,5154,0.050521487,0.050521487
FALSE,Weber County,4/1/02,Hide,Hide,4,2002,97082,97082,103579,103579,1,6497,6497,0.06272507,0.06272507
FALSE,Weber County,4/1/03,Hide,Hide,4,2003,98459,98459,105338,105338,1,6879,6879,0.065304069,0.065304069
FALSE,Weber County,4/1/04,Hide,Hide,4,2004,100642,100642,106763,106763,1,6121,6121,0.057332596,0.057332596
FALSE,Weber County,4/1/05,Hide,Hide,4,2005,102559,102559,107679,107679,1,5120,5120,0.047548733,0.047548733
FALSE,Weber County,4/1/06,Hide,Hide,4,2006,105624,105624,109625,109625,1,4001,4001,0.036497149,0.036497149
FALSE,Weber County,4/1/07,Hide,Hide,4,2007,109084,109084,112195,112195,1,3111,3111,0.027728508,0.027728508
FALSE,Weber County,4/1/08,Hide,Hide,4,2008,109599,109599,113697,113697,1,4098,4098,0.036043167,0.036043167
FALSE,Weber County,4/1/09,Hide,Hide,4,2009,105815,105815,115377,115377,1,9562,9562,0.082876136,0.082876136
FALSE,Weber County,4/1/10,Hide,Hide,4,2010,103469,103469,113493,113493,1,10024,10024,0.088322628,0.088322628
FALSE,Weber County,4/1/11,Hide,Hide,4,2011,103124,103124,112318,112318,1,9194,9194,0.081856871,0.081856871
FALSE,Weber County,4/1/12,Hide,Hide,4,2012,105629,105629,113092,113092,1,7463,7463,0.065990521,0.065990521
FALSE,Weber County,4/1/13,Hide,Hide,4,2013,107713,107713,114033,114033,1,6320,6320,0.055422553,0.055422553
FALSE,Weber County,4/1/14,Hide,Hide,4,2014,109381,109381,114459,114459,1,5078,5078,0.044365231,0.044365231
FALSE,Weber County,4/1/15,Hide,Hide,4,2015,111879,111879,116721,116721,1,4842,4842,0.041483538,0.041483538
FALSE,Weber County,4/1/16,Hide,Hide,4,2016,114421,114421,119181,119181,1,4760,4760,0.039939252,0.039939252
FALSE,Weber County,4/1/17,Hide,Hide,4,2017,118489,118489,123002,123002,1,4513,4513,0.03669046,0.03669046
FALSE,Weber County,4/1/18,Hide,Hide,4,2018,120302,120302,124635,124635,1,4333,4333,0.034765515,0.034765515
FALSE,Weber County,4/1/19,Hide,Hide,4,2019,122913,122913,126837,126837,1,3924,3924,0.030937345,0.030937345
FALSE,Weber County,4/1/20,Show,Hide,4,2020,115749,115749,129680,129680,1,13931,13931,0.107425972,0.107425972
FALSE,Beaver County,5/1/93,Hide,Hide,5,1993,2036,2036,2141,2141,1,105,105,0.049042504,0.049042504
FALSE,Beaver County,5/1/94,Hide,Hide,5,1994,2070,2070,2157,2157,1,87,87,0.040333797,0.040333797
FALSE,Beaver County,5/1/95,Hide,Hide,5,1995,2250,2250,2331,2331,1,81,81,0.034749035,0.034749035
FALSE,Beaver County,5/1/96,Hide,Hide,5,1996,2328,2328,2449,2449,1,121,121,0.049407922,0.049407922
FALSE,Beaver County,5/1/97,Hide,Hide,5,1997,2446,2446,2567,2567,1,121,121,0.047136735,0.047136735
FALSE,Beaver County,5/1/98,Hide,Hide,5,1998,2394,2394,2532,2532,1,138,138,0.05450237,0.05450237
FALSE,Beaver County,5/1/99,Hide,Hide,5,1999,2373,2373,2460,2460,1,87,87,0.035365854,0.035365854
FALSE,Beaver County,5/1/00,Hide,Hide,5,2000,2638,2638,2729,2729,1,91,91,0.033345548,0.033345548
FALSE,Beaver County,5/1/01,Hide,Hide,5,2001,2784,2784,2895,2895,1,111,111,0.038341969,0.038341969
FALSE,Beaver County,5/1/02,Hide,Hide,5,2002,2890,2890,3032,3032,1,142,142,0.046833773,0.046833773
FALSE,Beaver County,5/1/03,Hide,Hide,5,2003,2797,2797,2952,2952,1,155,155,0.052506775,0.052506775
FALSE,Beaver County,5/1/04,Hide,Hide,5,2004,3074,3074,3209,3209,1,135,135,0.04206918,0.04206918
FALSE,Beaver County,5/1/05,Hide,Hide,5,2005,2922,2922,3047,3047,1,125,125,0.041023958,0.041023958
FALSE,Beaver County,5/1/06,Hide,Hide,5,2006,3014,3014,3113,3113,1,99,99,0.03180212,0.03180212
FALSE,Beaver County,5/1/07,Hide,Hide,5,2007,3109,3109,3186,3186,1,77,77,0.024168236,0.024168236
FALSE,Beaver County,5/1/08,Hide,Hide,5,2008,2942,2942,3032,3032,1,90,90,0.029683377,0.029683377
FALSE,Beaver County,5/1/09,Hide,Hide,5,2009,3317,3317,3520,3520,1,203,203,0.057670455,0.057670455
FALSE,Beaver County,5/1/10,Hide,Hide,5,2010,2770,2770,3100,3100,1,330,330,0.106451613,0.106451613
FALSE,Beaver County,5/1/11,Hide,Hide,5,2011,2829,2829,3080,3080,1,251,251,0.081493506,0.081493506
FALSE,Beaver County,5/1/12,Hide,Hide,5,2012,2717,2717,2898,2898,1,181,181,0.062456867,0.062456867
FALSE,Beaver County,5/1/13,Hide,Hide,5,2013,2868,2868,3015,3015,1,147,147,0.048756219,0.048756219
FALSE,Beaver County,5/1/14,Hide,Hide,5,2014,2851,2851,2969,2969,1,118,118,0.039744022,0.039744022
FALSE,Beaver County,5/1/15,Hide,Hide,5,2015,3078,3078,3199,3199,1,121,121,0.03782432,0.03782432
FALSE,Beaver County,5/1/16,Hide,Hide,5,2016,2960,2960,3107,3107,1,147,147,0.04731252,0.04731252
FALSE,Beaver County,5/1/17,Hide,Hide,5,2017,2897,2897,3020,3020,1,123,123,0.040728477,0.040728477
FALSE,Beaver County,5/1/18,Hide,Hide,5,2018,2889,2889,2995,2995,1,106,106,0.035392321,0.035392321
FALSE,Beaver County,5/1/19,Show,Show,5,2019,2792,2792,2884,2884,1,92,92,0.031900139,0.031900139
TRUE,Beaver County,5/1/20,Show,Show,5,2020,2656,2656,2818,2818,1,162,162,0.05748758,0.05748758
FALSE,Box Elder County,5/1/93,Hide,Hide,5,1993,16398,16398,17310,17310,1,912,912,0.052686308,0.052686308
FALSE,Box Elder County,5/1/94,Hide,Hide,5,1994,17022,17022,17889,17889,1,867,867,0.048465537,0.048465537
FALSE,Box Elder County,5/1/95,Hide,Hide,5,1995,17112,17112,17949,17949,1,837,837,0.046632124,0.046632124
FALSE,Box Elder County,5/1/96,Hide,Hide,5,1996,17008,17008,17767,17767,1,759,759,0.042719649,0.042719649
FALSE,Box Elder County,5/1/97,Hide,Hide,5,1997,17970,17970,18652,18652,1,682,682,0.036564443,0.036564443
FALSE,Box Elder County,5/1/98,Hide,Hide,5,1998,18303,18303,19208,19208,1,905,905,0.047115785,0.047115785
FALSE,Box Elder County,5/1/99,Hide,Hide,5,1999,17635,17635,18506,18506,1,871,871,0.047065816,0.047065816
FALSE,Box Elder County,5/1/00,Hide,Hide,5,2000,19318,19318,20034,20034,1,716,716,0.035739243,0.035739243
FALSE,Box Elder County,5/1/01,Hide,Hide,5,2001,19297,19297,20190,20190,1,893,893,0.044229817,0.044229817
FALSE,Box Elder County,5/1/02,Hide,Hide,5,2002,19936,19936,21120,21120,1,1184,1184,0.056060606,0.056060606
FALSE,Box Elder County,5/1/03,Hide,Hide,5,2003,19934,19934,21110,21110,1,1176,1176,0.055708195,0.055708195
FALSE,Box Elder County,5/1/04,Hide,Hide,5,2004,21031,21031,22160,22160,1,1129,1129,0.050947653,0.050947653
FALSE,Box Elder County,5/1/05,Hide,Hide,5,2005,21303,21303,22288,22288,1,985,985,0.044194185,0.044194185
FALSE,Box Elder County,5/1/06,Hide,Hide,5,2006,22051,22051,22819,22819,1,768,768,0.033656164,0.033656164
FALSE,Box Elder County,5/1/07,Hide,Hide,5,2007,22849,22849,23461,23461,1,612,612,0.026085845,0.026085845
FALSE,Box Elder County,5/1/08,Hide,Hide,5,2008,22855,22855,23664,23664,1,809,809,0.034186951,0.034186951
FALSE,Box Elder County,5/1/09,Hide,Hide,5,2009,21268,21268,23143,23143,1,1875,1875,0.081018018,0.081018018
FALSE,Box Elder County,5/1/10,Hide,Hide,5,2010,21659,21659,23659,23659,1,2000,2000,0.084534427,0.084534427
FALSE,Box Elder County,5/1/11,Hide,Hide,5,2011,21377,21377,23186,23186,1,1809,1809,0.07802122,0.07802122
FALSE,Box Elder County,5/1/12,Hide,Hide,5,2012,21580,21580,22934,22934,1,1354,1354,0.059038981,0.059038981
FALSE,Box Elder County,5/1/13,Hide,Hide,5,2013,22027,22027,23138,23138,1,1111,1111,0.04801625,0.04801625
FALSE,Box Elder County,5/1/14,Hide,Hide,5,2014,22456,22456,23360,23360,1,904,904,0.03869863,0.03869863
FALSE,Box Elder County,5/1/15,Hide,Hide,5,2015,23130,23130,24031,24031,1,901,901,0.037493238,0.037493238
FALSE,Box Elder County,5/1/16,Hide,Hide,5,2016,23719,23719,24585,24585,1,866,866,0.035224731,0.035224731
FALSE,Box Elder County,5/1/17,Hide,Hide,5,2017,24402,24402,25240,25240,1,838,838,0.033201268,0.033201268
FALSE,Box Elder County,5/1/18,Hide,Hide,5,2018,24607,24607,25360,25360,1,753,753,0.029692429,0.029692429
FALSE,Box Elder County,5/1/19,Show,Show,5,2019,25147,25147,25838,25838,1,691,691,0.026743556,0.026743556
TRUE,Box Elder County,5/1/20,Show,Show,5,2020,24353,24353,27157,27157,1,2804,2804,0.103251464,0.103251464
FALSE,Cache County,5/1/93,Hide,Hide,5,1993,37160,37160,38345,38345,1,1185,1185,0.030903638,0.030903638
FALSE,Cache County,5/1/94,Hide,Hide,5,1994,38971,38971,40099,40099,1,1128,1128,0.028130377,0.028130377
FALSE,Cache County,5/1/95,Hide,Hide,5,1995,40446,40446,41755,41755,1,1309,1309,0.031349539,0.031349539
FALSE,Cache County,5/1/96,Hide,Hide,5,1996,40678,40678,41917,41917,1,1239,1239,0.029558413,0.029558413
FALSE,Cache County,5/1/97,Hide,Hide,5,1997,42276,42276,43357,43357,1,1081,1081,0.024932537,0.024932537
FALSE,Cache County,5/1/98,Hide,Hide,5,1998,43010,43010,44397,44397,1,1387,1387,0.03124085,0.03124085
FALSE,Cache County,5/1/99,Hide,Hide,5,1999,44024,44024,45184,45184,1,1160,1160,0.025672805,0.025672805
FALSE,Cache County,5/1/00,Hide,Hide,5,2000,46728,46728,48036,48036,1,1308,1308,0.027229578,0.027229578
FALSE,Cache County,5/1/01,Hide,Hide,5,2001,47875,47875,49567,49567,1,1692,1692,0.034135614,0.034135614
FALSE,Cache County,5/1/02,Hide,Hide,5,2002,50267,50267,52426,52426,1,2159,2159,0.041181856,0.041181856
FALSE,Cache County,5/1/03,Hide,Hide,5,2003,51193,51193,53328,53328,1,2135,2135,0.040035254,0.040035254
FALSE,Cache County,5/1/04,Hide,Hide,5,2004,54136,54136,56202,56202,1,2066,2066,0.036760258,0.036760258
FALSE,Cache County,5/1/05,Hide,Hide,5,2005,55165,55165,57034,57034,1,1869,1869,0.032769927,0.032769927
FALSE,Cache County,5/1/06,Hide,Hide,5,2006,56910,56910,58294,58294,1,1384,1384,0.023741723,0.023741723
FALSE,Cache County,5/1/07,Hide,Hide,5,2007,59506,59506,60663,60663,1,1157,1157,0.019072581,0.019072581
FALSE,Cache County,5/1/08,Hide,Hide,5,2008,59969,59969,61468,61468,1,1499,1499,0.024386673,0.024386673
FALSE,Cache County,5/1/09,Hide,Hide,5,2009,58558,58558,62008,62008,1,3450,3450,0.055637982,0.055637982
FALSE,Cache County,5/1/10,Hide,Hide,5,2010,53588,53588,57073,57073,1,3485,3485,0.061062148,0.061062148
FALSE,Cache County,5/1/11,Hide,Hide,5,2011,53850,53850,56848,56848,1,2998,2998,0.052737124,0.052737124
FALSE,Cache County,5/1/12,Hide,Hide,5,2012,54388,54388,56965,56965,1,2577,2577,0.045238304,0.045238304
FALSE,Cache County,5/1/13,Hide,Hide,5,2013,55310,55310,57686,57686,1,2376,2376,0.041188503,0.041188503
FALSE,Cache County,5/1/14,Hide,Hide,5,2014,56864,56864,58710,58710,1,1846,1846,0.031442684,0.031442684
FALSE,Cache County,5/1/15,Hide,Hide,5,2015,58263,58263,60086,60086,1,1823,1823,0.030339846,0.030339846
FALSE,Cache County,5/1/16,Hide,Hide,5,2016,59128,59128,61054,61054,1,1926,1926,0.031545845,0.031545845
FALSE,Cache County,5/1/17,Hide,Hide,5,2017,60623,60623,62374,62374,1,1751,1751,0.028072594,0.028072594
FALSE,Cache County,5/1/18,Hide,Hide,5,2018,61412,61412,63090,63090,1,1678,1678,0.026596925,0.026596925
FALSE,Cache County,5/1/19,Show,Show,5,2019,62717,62717,64139,64139,1,1422,1422,0.022170598,0.022170598
TRUE,Cache County,5/1/20,Show,Show,5,2020,59163,59163,62137,62137,1,2974,2974,0.047861982,0.047861982
FALSE,Carbon County,5/1/93,Hide,Hide,5,1993,8247,8247,8932,8932,1,685,685,0.076690551,0.076690551
FALSE,Carbon County,5/1/94,Hide,Hide,5,1994,8665,8665,9405,9405,1,740,740,0.078681552,0.078681552
FALSE,Carbon County,5/1/95,Hide,Hide,5,1995,8503,8503,9090,9090,1,587,587,0.064576458,0.064576458
FALSE,Carbon County,5/1/96,Hide,Hide,5,1996,8817,8817,9390,9390,1,573,573,0.061022364,0.061022364
FALSE,Carbon County,5/1/97,Hide,Hide,5,1997,9212,9212,9683,9683,1,471,471,0.04864195,0.04864195
FALSE,Carbon County,5/1/98,Hide,Hide,5,1998,9258,9258,9825,9825,1,567,567,0.057709924,0.057709924
FALSE,Carbon County,5/1/99,Hide,Hide,5,1999,9220,9220,9929,9929,1,709,709,0.07140699,0.07140699
FALSE,Carbon County,5/1/00,Hide,Hide,5,2000,8901,8901,9380,9380,1,479,479,0.051066098,0.051066098
FALSE,Carbon County,5/1/01,Hide,Hide,5,2001,8363,8363,8960,8960,1,597,597,0.066629464,0.066629464
FALSE,Carbon County,5/1/02,Hide,Hide,5,2002,8830,8830,9470,9470,1,640,640,0.067581837,0.067581837
FALSE,Carbon County,5/1/03,Hide,Hide,5,2003,8673,8673,9395,9395,1,722,722,0.076849388,0.076849388
FALSE,Carbon County,5/1/04,Hide,Hide,5,2004,8636,8636,9259,9259,1,623,623,0.067285884,0.067285884
FALSE,Carbon County,5/1/05,Hide,Hide,5,2005,8994,8994,9465,9465,1,471,471,0.049762282,0.049762282
FALSE,Carbon County,5/1/06,Hide,Hide,5,2006,9485,9485,9847,9847,1,362,362,0.036762466,0.036762466
FALSE,Carbon County,5/1/07,Hide,Hide,5,2007,9391,9391,9707,9707,1,316,316,0.032553827,0.032553827
FALSE,Carbon County,5/1/08,Hide,Hide,5,2008,9525,9525,9955,9955,1,430,430,0.043194375,0.043194375
FALSE,Carbon County,5/1/09,Hide,Hide,5,2009,9747,9747,10563,10563,1,816,816,0.077250781,0.077250781
FALSE,Carbon County,5/1/10,Hide,Hide,5,2010,9057,9057,9905,9905,1,848,848,0.085613327,0.085613327
FALSE,Carbon County,5/1/11,Hide,Hide,5,2011,8819,8819,9544,9544,1,725,725,0.075963956,0.075963956
FALSE,Carbon County,5/1/12,Hide,Hide,5,2012,8692,8692,9342,9342,1,650,650,0.069578249,0.069578249
FALSE,Carbon County,5/1/13,Hide,Hide,5,2013,8452,8452,9034,9034,1,582,582,0.06442329,0.06442329
FALSE,Carbon County,5/1/14,Hide,Hide,5,2014,8211,8211,8650,8650,1,439,439,0.050751445,0.050751445
FALSE,Carbon County,5/1/15,Hide,Hide,5,2015,8241,8241,8730,8730,1,489,489,0.056013746,0.056013746
FALSE,Carbon County,5/1/16,Hide,Hide,5,2016,7895,7895,8393,8393,1,498,498,0.05933516,0.05933516
FALSE,Carbon County,5/1/17,Hide,Hide,5,2017,7856,7856,8276,8276,1,420,420,0.050749154,0.050749154
FALSE,Carbon County,5/1/18,Hide,Hide,5,2018,8070,8070,8453,8453,1,383,383,0.045309358,0.045309358
FALSE,Carbon County,5/1/19,Show,Show,5,2019,8161,8161,8486,8486,1,325,325,0.038298374,0.038298374
TRUE,Carbon County,5/1/20,Show,Show,5,2020,7889,7889,8498,8498,1,609,609,0.071663921,0.071663921
FALSE,Daggett County,5/1/93,Hide,Hide,5,1993,386,386,402,402,1,16,16,0.039800995,0.039800995
FALSE,Daggett County,5/1/94,Hide,Hide,5,1994,459,459,478,478,1,19,19,0.039748954,0.039748954
FALSE,Daggett County,5/1/95,Hide,Hide,5,1995,419,419,450,450,1,31,31,0.068888889,0.068888889
FALSE,Daggett County,5/1/96,Hide,Hide,5,1996,392,392,409,409,1,17,17,0.041564792,0.041564792
FALSE,Daggett County,5/1/97,Hide,Hide,5,1997,394,394,411,411,1,17,17,0.04136253,0.04136253
FALSE,Daggett County,5/1/98,Hide,Hide,5,1998,409,409,427,427,1,18,18,0.042154567,0.042154567
FALSE,Daggett County,5/1/99,Hide,Hide,5,1999,425,425,442,442,1,17,17,0.038461538,0.038461538
FALSE,Daggett County,5/1/00,Hide,Hide,5,2000,451,451,466,466,1,15,15,0.032188841,0.032188841
FALSE,Daggett County,5/1/01,Hide,Hide,5,2001,430,430,452,452,1,22,22,0.048672566,0.048672566
FALSE,Daggett County,5/1/02,Hide,Hide,5,2002,480,480,504,504,1,24,24,0.047619048,0.047619048
FALSE,Daggett County,5/1/03,Hide,Hide,5,2003,450,450,476,476,1,26,26,0.054621849,0.054621849
FALSE,Daggett County,5/1/04,Hide,Hide,5,2004,499,499,527,527,1,28,28,0.05313093,0.05313093
FALSE,Daggett County,5/1/05,Hide,Hide,5,2005,464,464,486,486,1,22,22,0.04526749,0.04526749
FALSE,Daggett County,5/1/06,Hide,Hide,5,2006,486,486,512,512,1,26,26,0.05078125,0.05078125
FALSE,Daggett County,5/1/07,Hide,Hide,5,2007,516,516,535,535,1,19,19,0.035514019,0.035514019
FALSE,Daggett County,5/1/08,Hide,Hide,5,2008,421,421,439,439,1,18,18,0.041002278,0.041002278
FALSE,Daggett County,5/1/09,Hide,Hide,5,2009,436,436,462,462,1,26,26,0.056277056,0.056277056
FALSE,Daggett County,5/1/10,Hide,Hide,5,2010,458,458,494,494,1,36,36,0.072874494,0.072874494
FALSE,Daggett County,5/1/11,Hide,Hide,5,2011,444,444,474,474,1,30,30,0.063291139,0.063291139
FALSE,Daggett County,5/1/12,Hide,Hide,5,2012,415,415,437,437,1,22,22,0.050343249,0.050343249
FALSE,Daggett County,5/1/13,Hide,Hide,5,2013,416,416,438,438,1,22,22,0.050228311,0.050228311
FALSE,Daggett County,5/1/14,Hide,Hide,5,2014,407,407,423,423,1,16,16,0.037825059,0.037825059
FALSE,Daggett County,5/1/15,Hide,Hide,5,2015,446,446,467,467,1,21,21,0.04496788,0.04496788
FALSE,Daggett County,5/1/16,Hide,Hide,5,2016,452,452,477,477,1,25,25,0.052410901,0.052410901
FALSE,Daggett County,5/1/17,Hide,Hide,5,2017,406,406,427,427,1,21,21,0.049180328,0.049180328
FALSE,Daggett County,5/1/18,Hide,Hide,5,2018,385,385,403,403,1,18,18,0.044665012,0.044665012
FALSE,Daggett County,5/1/19,Show,Show,5,2019,376,376,392,392,1,16,16,0.040816327,0.040816327
TRUE,Daggett County,5/1/20,Show,Show,5,2020,358,358,377,377,1,19,19,0.050397878,0.050397878
FALSE,Davis County,5/1/93,Hide,Hide,5,1993,95708,95708,99500,99500,1,3792,3792,0.038110553,0.038110553
FALSE,Davis County,5/1/94,Hide,Hide,5,1994,101957,101957,105527,105527,1,3570,3570,0.033830205,0.033830205
FALSE,Davis County,5/1/95,Hide,Hide,5,1995,101825,101825,105429,105429,1,3604,3604,0.034184143,0.034184143
FALSE,Davis County,5/1/96,Hide,Hide,5,1996,107309,107309,110798,110798,1,3489,3489,0.031489738,0.031489738
FALSE,Davis County,5/1/97,Hide,Hide,5,1997,111943,111943,115348,115348,1,3405,3405,0.029519367,0.029519367
FALSE,Davis County,5/1/98,Hide,Hide,5,1998,116129,116129,120157,120157,1,4028,4028,0.033522808,0.033522808
FALSE,Davis County,5/1/99,Hide,Hide,5,1999,120126,120126,124203,124203,1,4077,4077,0.032825294,0.032825294
FALSE,Davis County,5/1/00,Hide,Hide,5,2000,116674,116674,120186,120186,1,3512,3512,0.029221374,0.029221374
FALSE,Davis County,5/1/01,Hide,Hide,5,2001,117299,117299,122094,122094,1,4795,4795,0.039273019,0.039273019
FALSE,Davis County,5/1/02,Hide,Hide,5,2002,118228,118228,124518,124518,1,6290,6290,0.050514785,0.050514785
FALSE,Davis County,5/1/03,Hide,Hide,5,2003,121198,121198,127767,127767,1,6569,6569,0.051413902,0.051413902
FALSE,Davis County,5/1/04,Hide,Hide,5,2004,125600,125600,131920,131920,1,6320,6320,0.047907823,0.047907823
FALSE,Davis County,5/1/05,Hide,Hide,5,2005,129779,129779,135212,135212,1,5433,5433,0.040181345,0.040181345
FALSE,Davis County,5/1/06,Hide,Hide,5,2006,136128,136128,140335,140335,1,4207,4207,0.029978266,0.029978266
FALSE,Davis County,5/1/07,Hide,Hide,5,2007,140799,140799,144218,144218,1,3419,3419,0.023707166,0.023707166
FALSE,Davis County,5/1/08,Hide,Hide,5,2008,141088,141088,145525,145525,1,4437,4437,0.030489607,0.030489607
FALSE,Davis County,5/1/09,Hide,Hide,5,2009,135634,135634,145039,145039,1,9405,9405,0.064844628,0.064844628
FALSE,Davis County,5/1/10,Hide,Hide,5,2010,137155,137155,147508,147508,1,10353,10353,0.070186024,0.070186024
FALSE,Davis County,5/1/11,Hide,Hide,5,2011,137135,137135,146203,146203,1,9068,9068,0.062023351,0.062023351
FALSE,Davis County,5/1/12,Hide,Hide,5,2012,140687,140687,148035,148035,1,7348,7348,0.04963691,0.04963691
FALSE,Davis County,5/1/13,Hide,Hide,5,2013,145370,145370,151987,151987,1,6617,6617,0.043536618,0.043536618
FALSE,Davis County,5/1/14,Hide,Hide,5,2014,149724,149724,155272,155272,1,5548,5548,0.035730847,0.035730847
FALSE,Davis County,5/1/15,Hide,Hide,5,2015,153992,153992,159440,159440,1,5448,5448,0.034169594,0.034169594
FALSE,Davis County,5/1/16,Hide,Hide,5,2016,158118,158118,163373,163373,1,5255,5255,0.032165658,0.032165658
FALSE,Davis County,5/1/17,Hide,Hide,5,2017,163375,163375,168607,168607,1,5232,5232,0.03103074,0.03103074
FALSE,Davis County,5/1/18,Hide,Hide,5,2018,164847,164847,169693,169693,1,4846,4846,0.028557454,0.028557454
FALSE,Davis County,5/1/19,Show,Show,5,2019,168885,168885,173189,173189,1,4304,4304,0.024851463,0.024851463
TRUE,Davis County,5/1/20,Show,Show,5,2020,164087,164087,176609,176609,1,12522,12522,0.070902389,0.070902389
FALSE,Duchesne County,5/1/93,Hide,Hide,5,1993,5204,5204,5702,5702,1,498,498,0.087337776,0.087337776
FALSE,Duchesne County,5/1/94,Hide,Hide,5,1994,5211,5211,5818,5818,1,607,607,0.104331385,0.104331385
FALSE,Duchesne County,5/1/95,Hide,Hide,5,1995,5257,5257,5772,5772,1,515,515,0.089223839,0.089223839
FALSE,Duchesne County,5/1/96,Hide,Hide,5,1996,5298,5298,5800,5800,1,502,502,0.086551724,0.086551724
FALSE,Duchesne County,5/1/97,Hide,Hide,5,1997,5499,5499,5890,5890,1,391,391,0.066383701,0.066383701
FALSE,Duchesne County,5/1/98,Hide,Hide,5,1998,5682,5682,6092,6092,1,410,410,0.067301379,0.067301379
FALSE,Duchesne County,5/1/99,Hide,Hide,5,1999,5519,5519,6118,6118,1,599,599,0.097907813,0.097907813
FALSE,Duchesne County,5/1/00,Hide,Hide,5,2000,5793,5793,6088,6088,1,295,295,0.048455979,0.048455979
FALSE,Duchesne County,5/1/01,Hide,Hide,5,2001,6231,6231,6560,6560,1,329,329,0.050152439,0.050152439
FALSE,Duchesne County,5/1/02,Hide,Hide,5,2002,6521,6521,6987,6987,1,466,466,0.066695291,0.066695291
FALSE,Duchesne County,5/1/03,Hide,Hide,5,2003,6407,6407,6857,6857,1,450,450,0.065626367,0.065626367
FALSE,Duchesne County,5/1/04,Hide,Hide,5,2004,6954,6954,7372,7372,1,418,418,0.056701031,0.056701031
FALSE,Duchesne County,5/1/05,Hide,Hide,5,2005,7251,7251,7589,7589,1,338,338,0.044538147,0.044538147
FALSE,Duchesne County,5/1/06,Hide,Hide,5,2006,8103,8103,8354,8354,1,251,251,0.030045487,0.030045487
FALSE,Duchesne County,5/1/07,Hide,Hide,5,2007,9002,9002,9197,9197,1,195,195,0.021202566,0.021202566
FALSE,Duchesne County,5/1/08,Hide,Hide,5,2008,9838,9838,10094,10094,1,256,256,0.025361601,0.025361601
FALSE,Duchesne County,5/1/09,Hide,Hide,5,2009,9540,9540,10434,10434,1,894,894,0.085681426,0.085681426
FALSE,Duchesne County,5/1/10,Hide,Hide,5,2010,7411,7411,8202,8202,1,791,791,0.096439893,0.096439893
FALSE,Duchesne County,5/1/11,Hide,Hide,5,2011,7817,7817,8380,8380,1,563,563,0.067183771,0.067183771
FALSE,Duchesne County,5/1/12,Hide,Hide,5,2012,8718,8718,9139,9139,1,421,421,0.046066309,0.046066309
FALSE,Duchesne County,5/1/13,Hide,Hide,5,2013,8893,8893,9296,9296,1,403,403,0.043351979,0.043351979
FALSE,Duchesne County,5/1/14,Hide,Hide,5,2014,9269,9269,9597,9597,1,328,328,0.034177347,0.034177347
FALSE,Duchesne County,5/1/15,Hide,Hide,5,2015,8273,8273,8938,8938,1,665,665,0.074401432,0.074401432
FALSE,Duchesne County,5/1/16,Hide,Hide,5,2016,7362,7362,8119,8119,1,757,757,0.093238084,0.093238084
FALSE,Duchesne County,5/1/17,Hide,Hide,5,2017,7550,7550,8003,8003,1,453,453,0.056603774,0.056603774
FALSE,Duchesne County,5/1/18,Hide,Hide,5,2018,7410,7410,7749,7749,1,339,339,0.04374758,0.04374758
FALSE,Duchesne County,5/1/19,Show,Show,5,2019,7417,7417,7729,7729,1,312,312,0.040367447,0.040367447
TRUE,Duchesne County,5/1/20,Show,Show,5,2020,7064,7064,8014,8014,1,950,950,0.118542551,0.118542551
FALSE,Emery County,5/1/93,Hide,Hide,5,1993,3725,3725,4085,4085,1,360,360,0.088127295,0.088127295
FALSE,Emery County,5/1/94,Hide,Hide,5,1994,3834,3834,4168,4168,1,334,334,0.080134357,0.080134357
FALSE,Emery County,5/1/95,Hide,Hide,5,1995,3911,3911,4240,4240,1,329,329,0.07759434,0.07759434
FALSE,Emery County,5/1/96,Hide,Hide,5,1996,3875,3875,4196,4196,1,321,321,0.07650143,0.07650143
FALSE,Emery County,5/1/97,Hide,Hide,5,1997,3903,3903,4184,4184,1,281,281,0.067160612,0.067160612
FALSE,Emery County,5/1/98,Hide,Hide,5,1998,3897,3897,4237,4237,1,340,340,0.080245457,0.080245457
FALSE,Emery County,5/1/99,Hide,Hide,5,1999,3747,3747,4031,4031,1,284,284,0.070453982,0.070453982
FALSE,Emery County,5/1/00,Hide,Hide,5,2000,4531,4531,4741,4741,1,210,210,0.044294453,0.044294453
FALSE,Emery County,5/1/01,Hide,Hide,5,2001,4360,4360,4676,4676,1,316,316,0.067579127,0.067579127
FALSE,Emery County,5/1/02,Hide,Hide,5,2002,4431,4431,4753,4753,1,322,322,0.067746686,0.067746686
FALSE,Emery County,5/1/03,Hide,Hide,5,2003,4496,4496,4886,4886,1,390,390,0.079819894,0.079819894
FALSE,Emery County,5/1/04,Hide,Hide,5,2004,4780,4780,5142,5142,1,362,362,0.070400622,0.070400622
FALSE,Emery County,5/1/05,Hide,Hide,5,2005,4816,4816,5087,5087,1,271,271,0.053273049,0.053273049
FALSE,Emery County,5/1/06,Hide,Hide,5,2006,5073,5073,5261,5261,1,188,188,0.035734651,0.035734651
FALSE,Emery County,5/1/07,Hide,Hide,5,2007,4952,4952,5117,5117,1,165,165,0.032245456,0.032245456
FALSE,Emery County,5/1/08,Hide,Hide,5,2008,4921,4921,5106,5106,1,185,185,0.036231884,0.036231884
FALSE,Emery County,5/1/09,Hide,Hide,5,2009,4841,4841,5190,5190,1,349,349,0.067244701,0.067244701
FALSE,Emery County,5/1/10,Hide,Hide,5,2010,4877,4877,5270,5270,1,393,393,0.074573055,0.074573055
FALSE,Emery County,5/1/11,Hide,Hide,5,2011,4644,4644,5021,5021,1,377,377,0.075084644,0.075084644
FALSE,Emery County,5/1/12,Hide,Hide,5,2012,4383,4383,4730,4730,1,347,347,0.073361522,0.073361522
FALSE,Emery County,5/1/13,Hide,Hide,5,2013,4451,4451,4745,4745,1,294,294,0.061959958,0.061959958
FALSE,Emery County,5/1/14,Hide,Hide,5,2014,4401,4401,4644,4644,1,243,243,0.052325581,0.052325581
FALSE,Emery County,5/1/15,Hide,Hide,5,2015,4152,4152,4408,4408,1,256,256,0.058076225,0.058076225
FALSE,Emery County,5/1/16,Hide,Hide,5,2016,4001,4001,4275,4275,1,274,274,0.064093567,0.064093567
FALSE,Emery County,5/1/17,Hide,Hide,5,2017,3950,3950,4170,4170,1,220,220,0.052757794,0.052757794
FALSE,Emery County,5/1/18,Hide,Hide,5,2018,4104,4104,4309,4309,1,205,205,0.047574843,0.047574843
FALSE,Emery County,5/1/19,Show,Show,5,2019,4148,4148,4321,4321,1,173,173,0.040037028,0.040037028
TRUE,Emery County,5/1/20,Show,Show,5,2020,4181,4181,4448,4448,1,267,267,0.060026978,0.060026978
FALSE,Garfield County,5/1/93,Hide,Hide,5,1993,2099,2099,2317,2317,1,218,218,0.094087182,0.094087182
FALSE,Garfield County,5/1/94,Hide,Hide,5,1994,2311,2311,2562,2562,1,251,251,0.097970336,0.097970336
FALSE,Garfield County,5/1/95,Hide,Hide,5,1995,2269,2269,2611,2611,1,342,342,0.130984297,0.130984297
FALSE,Garfield County,5/1/96,Hide,Hide,5,1996,2387,2387,2644,2644,1,257,257,0.09720121,0.09720121
FALSE,Garfield County,5/1/97,Hide,Hide,5,1997,2523,2523,2753,2753,1,230,230,0.083545223,0.083545223
FALSE,Garfield County,5/1/98,Hide,Hide,5,1998,2505,2505,2749,2749,1,244,244,0.088759549,0.088759549
FALSE,Garfield County,5/1/99,Hide,Hide,5,1999,2709,2709,2939,2939,1,230,230,0.078257911,0.078257911
FALSE,Garfield County,5/1/00,Hide,Hide,5,2000,2329,2329,2486,2486,1,157,157,0.06315366,0.06315366
FALSE,Garfield County,5/1/01,Hide,Hide,5,2001,2386,2386,2581,2581,1,195,195,0.075552112,0.075552112
FALSE,Garfield County,5/1/02,Hide,Hide,5,2002,2306,2306,2578,2578,1,272,272,0.105508146,0.105508146
FALSE,Garfield County,5/1/03,Hide,Hide,5,2003,2313,2313,2548,2548,1,235,235,0.092229199,0.092229199
FALSE,Garfield County,5/1/04,Hide,Hide,5,2004,2451,2451,2656,2656,1,205,205,0.077183735,0.077183735
FALSE,Garfield County,5/1/05,Hide,Hide,5,2005,2496,2496,2695,2695,1,199,199,0.073840445,0.073840445
FALSE,Garfield County,5/1/06,Hide,Hide,5,2006,2535,2535,2675,2675,1,140,140,0.052336449,0.052336449
FALSE,Garfield County,5/1/07,Hide,Hide,5,2007,2591,2591,2702,2702,1,111,111,0.041080681,0.041080681
FALSE,Garfield County,5/1/08,Hide,Hide,5,2008,2628,2628,2783,2783,1,155,155,0.055695293,0.055695293
FALSE,Garfield County,5/1/09,Hide,Hide,5,2009,2563,2563,2863,2863,1,300,300,0.10478519,0.10478519
FALSE,Garfield County,5/1/10,Hide,Hide,5,2010,2776,2776,3096,3096,1,320,320,0.103359173,0.103359173
FALSE,Garfield County,5/1/11,Hide,Hide,5,2011,2664,2664,2998,2998,1,334,334,0.111407605,0.111407605
FALSE,Garfield County,5/1/12,Hide,Hide,5,2012,2594,2594,2872,2872,1,278,278,0.096796657,0.096796657
FALSE,Garfield County,5/1/13,Hide,Hide,5,2013,2526,2526,2779,2779,1,253,253,0.091039942,0.091039942
FALSE,Garfield County,5/1/14,Hide,Hide,5,2014,2448,2448,2678,2678,1,230,230,0.085884989,0.085884989
FALSE,Garfield County,5/1/15,Hide,Hide,5,2015,2528,2528,2777,2777,1,249,249,0.089665106,0.089665106
FALSE,Garfield County,5/1/16,Hide,Hide,5,2016,2539,2539,2776,2776,1,237,237,0.08537464,0.08537464
FALSE,Garfield County,5/1/17,Hide,Hide,5,2017,2673,2673,2888,2888,1,215,215,0.074445983,0.074445983
FALSE,Garfield County,5/1/18,Hide,Hide,5,2018,2572,2572,2785,2785,1,213,213,0.076481149,0.076481149
FALSE,Garfield County,5/1/19,Show,Show,5,2019,2618,2618,2785,2785,1,167,167,0.059964093,0.059964093
TRUE,Garfield County,5/1/20,Show,Show,5,2020,2576,2576,3024,3024,1,448,448,0.148148148,0.148148148
FALSE,Grand County,5/1/93,Hide,Hide,5,1993,4326,4326,4601,4601,1,275,275,0.059769615,0.059769615
FALSE,Grand County,5/1/94,Hide,Hide,5,1994,4568,4568,4895,4895,1,327,327,0.06680286,0.06680286
FALSE,Grand County,5/1/95,Hide,Hide,5,1995,4626,4626,4949,4949,1,323,323,0.06526571,0.06526571
FALSE,Grand County,5/1/96,Hide,Hide,5,1996,4748,4748,5096,5096,1,348,348,0.068288854,0.068288854
FALSE,Grand County,5/1/97,Hide,Hide,5,1997,4900,4900,5222,5222,1,322,322,0.061662198,0.061662198
FALSE,Grand County,5/1/98,Hide,Hide,5,1998,4857,4857,5233,5233,1,376,376,0.07185171,0.07185171
FALSE,Grand County,5/1/99,Hide,Hide,5,1999,5252,5252,5605,5605,1,353,353,0.062979483,0.062979483
FALSE,Grand County,5/1/00,Hide,Hide,5,2000,4335,4335,4644,4644,1,309,309,0.066537468,0.066537468
FALSE,Grand County,5/1/01,Hide,Hide,5,2001,4357,4357,4676,4676,1,319,319,0.068220701,0.068220701
FALSE,Grand County,5/1/02,Hide,Hide,5,2002,4463,4463,4827,4827,1,364,364,0.075409157,0.075409157
FALSE,Grand County,5/1/03,Hide,Hide,5,2003,4545,4545,4919,4919,1,374,374,0.076031714,0.076031714
FALSE,Grand County,5/1/04,Hide,Hide,5,2004,4492,4492,4856,4856,1,364,364,0.074958814,0.074958814
FALSE,Grand County,5/1/05,Hide,Hide,5,2005,4634,4634,4942,4942,1,308,308,0.062322946,0.062322946
FALSE,Grand County,5/1/06,Hide,Hide,5,2006,4768,4768,5021,5021,1,253,253,0.050388369,0.050388369
FALSE,Grand County,5/1/07,Hide,Hide,5,2007,4941,4941,5172,5172,1,231,231,0.044663573,0.044663573
FALSE,Grand County,5/1/08,Hide,Hide,5,2008,4959,4959,5233,5233,1,274,274,0.052360023,0.052360023
FALSE,Grand County,5/1/09,Hide,Hide,5,2009,4875,4875,5407,5407,1,532,532,0.098390975,0.098390975
FALSE,Grand County,5/1/10,Hide,Hide,5,2010,4770,4770,5336,5336,1,566,566,0.106071964,0.106071964
FALSE,Grand County,5/1/11,Hide,Hide,5,2011,4771,4771,5312,5312,1,541,541,0.10184488,0.10184488
FALSE,Grand County,5/1/12,Hide,Hide,5,2012,4958,4958,5418,5418,1,460,460,0.084902178,0.084902178
FALSE,Grand County,5/1/13,Hide,Hide,5,2013,5020,5020,5446,5446,1,426,426,0.078222549,0.078222549
FALSE,Grand County,5/1/14,Hide,Hide,5,2014,5145,5145,5493,5493,1,348,348,0.063353359,0.063353359
FALSE,Grand County,5/1/15,Hide,Hide,5,2015,5233,5233,5574,5574,1,341,341,0.061176893,0.061176893
FALSE,Grand County,5/1/16,Hide,Hide,5,2016,5381,5381,5713,5713,1,332,332,0.058113075,0.058113075
FALSE,Grand County,5/1/17,Hide,Hide,5,2017,5569,5569,5886,5886,1,317,317,0.053856609,0.053856609
FALSE,Grand County,5/1/18,Hide,Hide,5,2018,5800,5800,6078,6078,1,278,278,0.04573873,0.04573873
FALSE,Grand County,5/1/19,Show,Show,5,2019,5909,5909,6153,6153,1,244,244,0.039655453,0.039655453
TRUE,Grand County,5/1/20,Show,Show,5,2020,5602,5602,6713,6713,1,1111,1111,0.165499777,0.165499777
FALSE,Iron County,5/1/93,Hide,Hide,5,1993,10615,10615,11041,11041,1,426,426,0.038583462,0.038583462
FALSE,Iron County,5/1/94,Hide,Hide,5,1994,11680,11680,12102,12102,1,422,422,0.034870269,0.034870269
FALSE,Iron County,5/1/95,Hide,Hide,5,1995,12518,12518,12940,12940,1,422,422,0.032612056,0.032612056
FALSE,Iron County,5/1/96,Hide,Hide,5,1996,12748,12748,13264,13264,1,516,516,0.038902292,0.038902292
FALSE,Iron County,5/1/97,Hide,Hide,5,1997,13748,13748,14201,14201,1,453,453,0.031899162,0.031899162
FALSE,Iron County,5/1/98,Hide,Hide,5,1998,14209,14209,14775,14775,1,566,566,0.038307953,0.038307953
FALSE,Iron County,5/1/99,Hide,Hide,5,1999,14507,14507,15063,15063,1,556,556,0.036911638,0.036911638
FALSE,Iron County,5/1/00,Hide,Hide,5,2000,16399,16399,16919,16919,1,520,520,0.030734677,0.030734677
FALSE,Iron County,5/1/01,Hide,Hide,5,2001,16150,16150,16917,16917,1,767,767,0.045339008,0.045339008
FALSE,Iron County,5/1/02,Hide,Hide,5,2002,16785,16785,17716,17716,1,931,931,0.052551366,0.052551366
FALSE,Iron County,5/1/03,Hide,Hide,5,2003,16800,16800,17737,17737,1,937,937,0.052827423,0.052827423
FALSE,Iron County,5/1/04,Hide,Hide,5,2004,17851,17851,18722,18722,1,871,871,0.046522807,0.046522807
FALSE,Iron County,5/1/05,Hide,Hide,5,2005,18949,18949,19721,19721,1,772,772,0.039146088,0.039146088
FALSE,Iron County,5/1/06,Hide,Hide,5,2006,20207,20207,20818,20818,1,611,611,0.029349601,0.029349601
FALSE,Iron County,5/1/07,Hide,Hide,5,2007,20590,20590,21156,21156,1,566,566,0.02675364,0.02675364
FALSE,Iron County,5/1/08,Hide,Hide,5,2008,20102,20102,20903,20903,1,801,801,0.038319858,0.038319858
FALSE,Iron County,5/1/09,Hide,Hide,5,2009,19007,19007,20849,20849,1,1842,1842,0.088349561,0.088349561
FALSE,Iron County,5/1/10,Hide,Hide,5,2010,18451,18451,20467,20467,1,2016,2016,0.098500024,0.098500024
FALSE,Iron County,5/1/11,Hide,Hide,5,2011,18209,18209,19879,19879,1,1670,1670,0.08400825,0.08400825
FALSE,Iron County,5/1/12,Hide,Hide,5,2012,18175,18175,19528,19528,1,1353,1353,0.069285129,0.069285129
FALSE,Iron County,5/1/13,Hide,Hide,5,2013,18305,18305,19405,19405,1,1100,1100,0.056686421,0.056686421
FALSE,Iron County,5/1/14,Hide,Hide,5,2014,18924,18924,19800,19800,1,876,876,0.044242424,0.044242424
FALSE,Iron County,5/1/15,Hide,Hide,5,2015,19382,19382,20285,20285,1,903,903,0.044515652,0.044515652
FALSE,Iron County,5/1/16,Hide,Hide,5,2016,20453,20453,21386,21386,1,933,933,0.043626672,0.043626672
FALSE,Iron County,5/1/17,Hide,Hide,5,2017,21165,21165,22128,22128,1,963,963,0.043519523,0.043519523
FALSE,Iron County,5/1/18,Hide,Hide,5,2018,21971,21971,22780,22780,1,809,809,0.035513608,0.035513608
FALSE,Iron County,5/1/19,Show,Show,5,2019,23150,23150,23871,23871,1,721,721,0.030204013,0.030204013
TRUE,Iron County,5/1/20,Show,Show,5,2020,21675,21675,23487,23487,1,1812,1812,0.077149061,0.077149061
FALSE,Juab County,5/1/93,Hide,Hide,5,1993,3001,3001,3217,3217,1,216,216,0.067143301,0.067143301
FALSE,Juab County,5/1/94,Hide,Hide,5,1994,3184,3184,3335,3335,1,151,151,0.045277361,0.045277361
FALSE,Juab County,5/1/95,Hide,Hide,5,1995,3162,3162,3332,3332,1,170,170,0.051020408,0.051020408
FALSE,Juab County,5/1/96,Hide,Hide,5,1996,3285,3285,3420,3420,1,135,135,0.039473684,0.039473684
FALSE,Juab County,5/1/97,Hide,Hide,5,1997,3282,3282,3408,3408,1,126,126,0.036971831,0.036971831
FALSE,Juab County,5/1/98,Hide,Hide,5,1998,3445,3445,3599,3599,1,154,154,0.042789664,0.042789664
FALSE,Juab County,5/1/99,Hide,Hide,5,1999,3481,3481,3667,3667,1,186,186,0.050722662,0.050722662
FALSE,Juab County,5/1/00,Hide,Hide,5,2000,3583,3583,3709,3709,1,126,126,0.033971421,0.033971421
FALSE,Juab County,5/1/01,Hide,Hide,5,2001,3583,3583,3763,3763,1,180,180,0.047834175,0.047834175
FALSE,Juab County,5/1/02,Hide,Hide,5,2002,3399,3399,3672,3672,1,273,273,0.074346405,0.074346405
FALSE,Juab County,5/1/03,Hide,Hide,5,2003,3407,3407,3668,3668,1,261,261,0.071155943,0.071155943
FALSE,Juab County,5/1/04,Hide,Hide,5,2004,3564,3564,3816,3816,1,252,252,0.066037736,0.066037736
FALSE,Juab County,5/1/05,Hide,Hide,5,2005,3711,3711,3892,3892,1,181,181,0.046505653,0.046505653
FALSE,Juab County,5/1/06,Hide,Hide,5,2006,3853,3853,4009,4009,1,156,156,0.038912447,0.038912447
FALSE,Juab County,5/1/07,Hide,Hide,5,2007,3979,3979,4103,4103,1,124,124,0.030221789,0.030221789
FALSE,Juab County,5/1/08,Hide,Hide,5,2008,3746,3746,3930,3930,1,184,184,0.046819338,0.046819338
FALSE,Juab County,5/1/09,Hide,Hide,5,2009,3570,3570,3952,3952,1,382,382,0.096659919,0.096659919
FALSE,Juab County,5/1/10,Hide,Hide,5,2010,4193,4193,4625,4625,1,432,432,0.093405405,0.093405405
FALSE,Juab County,5/1/11,Hide,Hide,5,2011,4188,4188,4584,4584,1,396,396,0.086387435,0.086387435
FALSE,Juab County,5/1/12,Hide,Hide,5,2012,4321,4321,4609,4609,1,288,288,0.06248644,0.06248644
FALSE,Juab County,5/1/13,Hide,Hide,5,2013,4439,4439,4680,4680,1,241,241,0.051495726,0.051495726
FALSE,Juab County,5/1/14,Hide,Hide,5,2014,4572,4572,4765,4765,1,193,193,0.040503673,0.040503673
FALSE,Juab County,5/1/15,Hide,Hide,5,2015,4718,4718,4915,4915,1,197,197,0.040081384,0.040081384
FALSE,Juab County,5/1/16,Hide,Hide,5,2016,5007,5007,5204,5204,1,197,197,0.037855496,0.037855496
FALSE,Juab County,5/1/17,Hide,Hide,5,2017,5207,5207,5387,5387,1,180,180,0.033413774,0.033413774
FALSE,Juab County,5/1/18,Hide,Hide,5,2018,5381,5381,5541,5541,1,160,160,0.028875654,0.028875654
FALSE,Juab County,5/1/19,Show,Show,5,2019,5541,5541,5693,5693,1,152,152,0.026699455,0.026699455
TRUE,Juab County,5/1/20,Show,Show,5,2020,5283,5283,5502,5502,1,219,219,0.039803708,0.039803708
FALSE,Kane County,5/1/93,Hide,Hide,5,1993,2263,2263,2419,2419,1,156,156,0.064489458,0.064489458
FALSE,Kane County,5/1/94,Hide,Hide,5,1994,2480,2480,2713,2713,1,233,233,0.085882787,0.085882787
FALSE,Kane County,5/1/95,Hide,Hide,5,1995,2457,2457,2708,2708,1,251,251,0.092688331,0.092688331
FALSE,Kane County,5/1/96,Hide,Hide,5,1996,2357,2357,2549,2549,1,192,192,0.075323656,0.075323656
FALSE,Kane County,5/1/97,Hide,Hide,5,1997,2466,2466,2586,2586,1,120,120,0.046403712,0.046403712
FALSE,Kane County,5/1/98,Hide,Hide,5,1998,2593,2593,2683,2683,1,90,90,0.03354454,0.03354454
FALSE,Kane County,5/1/99,Hide,Hide,5,1999,2633,2633,2735,2735,1,102,102,0.037294333,0.037294333
FALSE,Kane County,5/1/00,Hide,Hide,5,2000,3002,3002,3116,3116,1,114,114,0.036585366,0.036585366
FALSE,Kane County,5/1/01,Hide,Hide,5,2001,3028,3028,3165,3165,1,137,137,0.04328594,0.04328594
FALSE,Kane County,5/1/02,Hide,Hide,5,2002,2809,2809,2972,2972,1,163,163,0.054845222,0.054845222
FALSE,Kane County,5/1/03,Hide,Hide,5,2003,2947,2947,3121,3121,1,174,174,0.055751362,0.055751362
FALSE,Kane County,5/1/04,Hide,Hide,5,2004,3116,3116,3304,3304,1,188,188,0.056900726,0.056900726
FALSE,Kane County,5/1/05,Hide,Hide,5,2005,3059,3059,3225,3225,1,166,166,0.051472868,0.051472868
FALSE,Kane County,5/1/06,Hide,Hide,5,2006,3303,3303,3430,3430,1,127,127,0.037026239,0.037026239
FALSE,Kane County,5/1/07,Hide,Hide,5,2007,3393,3393,3499,3499,1,106,106,0.03029437,0.03029437
FALSE,Kane County,5/1/08,Hide,Hide,5,2008,3319,3319,3446,3446,1,127,127,0.036854324,0.036854324
FALSE,Kane County,5/1/09,Hide,Hide,5,2009,3210,3210,3473,3473,1,263,263,0.075727037,0.075727037
FALSE,Kane County,5/1/10,Hide,Hide,5,2010,3286,3286,3565,3565,1,279,279,0.07826087,0.07826087
FALSE,Kane County,5/1/11,Hide,Hide,5,2011,3239,3239,3503,3503,1,264,264,0.075363974,0.075363974
FALSE,Kane County,5/1/12,Hide,Hide,5,2012,3233,3233,3477,3477,1,244,244,0.070175439,0.070175439
FALSE,Kane County,5/1/13,Hide,Hide,5,2013,3284,3284,3469,3469,1,185,185,0.05332949,0.05332949
FALSE,Kane County,5/1/14,Hide,Hide,5,2014,3396,3396,3565,3565,1,169,169,0.04740533,0.04740533
FALSE,Kane County,5/1/15,Hide,Hide,5,2015,3452,3452,3613,3613,1,161,161,0.044561306,0.044561306
FALSE,Kane County,5/1/16,Hide,Hide,5,2016,3542,3542,3687,3687,1,145,145,0.039327366,0.039327366
FALSE,Kane County,5/1/17,Hide,Hide,5,2017,3602,3602,3732,3732,1,130,130,0.034833869,0.034833869
FALSE,Kane County,5/1/18,Hide,Hide,5,2018,3664,3664,3782,3782,1,118,118,0.031200423,0.031200423
FALSE,Kane County,5/1/19,Show,Show,5,2019,3694,3694,3809,3809,1,115,115,0.030191651,0.030191651
TRUE,Kane County,5/1/20,Show,Show,5,2020,3363,3363,3758,3758,1,395,395,0.105109101,0.105109101
FALSE,Millard County,5/1/93,Hide,Hide,5,1993,4408,4408,4674,4674,1,266,266,0.056910569,0.056910569
FALSE,Millard County,5/1/94,Hide,Hide,5,1994,4463,4463,4690,4690,1,227,227,0.048400853,0.048400853
FALSE,Millard County,5/1/95,Hide,Hide,5,1995,4515,4515,4749,4749,1,234,234,0.049273531,0.049273531
FALSE,Millard County,5/1/96,Hide,Hide,5,1996,4551,4551,4749,4749,1,198,198,0.041692988,0.041692988
FALSE,Millard County,5/1/97,Hide,Hide,5,1997,4553,4553,4728,4728,1,175,175,0.037013536,0.037013536
FALSE,Millard County,5/1/98,Hide,Hide,5,1998,4489,4489,4706,4706,1,217,217,0.046111347,0.046111347
FALSE,Millard County,5/1/99,Hide,Hide,5,1999,4547,4547,4752,4752,1,205,205,0.043139731,0.043139731
FALSE,Millard County,5/1/00,Hide,Hide,5,2000,5084,5084,5257,5257,1,173,173,0.032908503,0.032908503
FALSE,Millard County,5/1/01,Hide,Hide,5,2001,5274,5274,5490,5490,1,216,216,0.039344262,0.039344262
FALSE,Millard County,5/1/02,Hide,Hide,5,2002,5593,5593,5879,5879,1,286,286,0.048647729,0.048647729
FALSE,Millard County,5/1/03,Hide,Hide,5,2003,5611,5611,5902,5902,1,291,291,0.04930532,0.04930532
FALSE,Millard County,5/1/04,Hide,Hide,5,2004,6032,6032,6336,6336,1,304,304,0.047979798,0.047979798
FALSE,Millard County,5/1/05,Hide,Hide,5,2005,5858,5858,6108,6108,1,250,250,0.040929928,0.040929928
FALSE,Millard County,5/1/06,Hide,Hide,5,2006,6018,6018,6208,6208,1,190,190,0.03060567,0.03060567
FALSE,Millard County,5/1/07,Hide,Hide,5,2007,6097,6097,6243,6243,1,146,146,0.023386193,0.023386193
FALSE,Millard County,5/1/08,Hide,Hide,5,2008,5748,5748,5934,5934,1,186,186,0.031344793,0.031344793
FALSE,Millard County,5/1/09,Hide,Hide,5,2009,6080,6080,6436,6436,1,356,356,0.05531386,0.05531386
FALSE,Millard County,5/1/10,Hide,Hide,5,2010,5878,5878,6276,6276,1,398,398,0.063416189,0.063416189
FALSE,Millard County,5/1/11,Hide,Hide,5,2011,5875,5875,6203,6203,1,328,328,0.05287764,0.05287764
FALSE,Millard County,5/1/12,Hide,Hide,5,2012,5680,5680,5965,5965,1,285,285,0.047778709,0.047778709
FALSE,Millard County,5/1/13,Hide,Hide,5,2013,5719,5719,5970,5970,1,251,251,0.042043551,0.042043551
FALSE,Millard County,5/1/14,Hide,Hide,5,2014,5778,5778,5979,5979,1,201,201,0.033617662,0.033617662
FALSE,Millard County,5/1/15,Hide,Hide,5,2015,6003,6003,6217,6217,1,214,214,0.034421747,0.034421747
FALSE,Millard County,5/1/16,Hide,Hide,5,2016,6005,6005,6209,6209,1,204,204,0.032855532,0.032855532
FALSE,Millard County,5/1/17,Hide,Hide,5,2017,6175,6175,6392,6392,1,217,217,0.033948686,0.033948686
FALSE,Millard County,5/1/18,Hide,Hide,5,2018,6003,6003,6202,6202,1,199,199,0.032086424,0.032086424
FALSE,Millard County,5/1/19,Show,Show,5,2019,5839,5839,6010,6010,1,171,171,0.028452579,0.028452579
TRUE,Millard County,5/1/20,Show,Show,5,2020,5542,5542,5806,5806,1,264,264,0.045470203,0.045470203
FALSE,Morgan County,5/1/93,Hide,Hide,5,1993,2786,2786,2960,2960,1,174,174,0.058783784,0.058783784
FALSE,Morgan County,5/1/94,Hide,Hide,5,1994,2818,2818,2956,2956,1,138,138,0.046684709,0.046684709
FALSE,Morgan County,5/1/95,Hide,Hide,5,1995,3255,3255,3411,3411,1,156,156,0.045734389,0.045734389
FALSE,Morgan County,5/1/96,Hide,Hide,5,1996,3375,3375,3521,3521,1,146,146,0.041465493,0.041465493
FALSE,Morgan County,5/1/97,Hide,Hide,5,1997,3432,3432,3570,3570,1,138,138,0.038655462,0.038655462
FALSE,Morgan County,5/1/98,Hide,Hide,5,1998,3542,3542,3686,3686,1,144,144,0.039066739,0.039066739
FALSE,Morgan County,5/1/99,Hide,Hide,5,1999,3421,3421,3565,3565,1,144,144,0.040392707,0.040392707
FALSE,Morgan County,5/1/00,Hide,Hide,5,2000,3299,3299,3417,3417,1,118,118,0.034533216,0.034533216
FALSE,Morgan County,5/1/01,Hide,Hide,5,2001,3332,3332,3460,3460,1,128,128,0.03699422,0.03699422
FALSE,Morgan County,5/1/02,Hide,Hide,5,2002,3346,3346,3532,3532,1,186,186,0.052661382,0.052661382
FALSE,Morgan County,5/1/03,Hide,Hide,5,2003,3382,3382,3568,3568,1,186,186,0.052130045,0.052130045
FALSE,Morgan County,5/1/04,Hide,Hide,5,2004,3487,3487,3667,3667,1,180,180,0.049086447,0.049086447
FALSE,Morgan County,5/1/05,Hide,Hide,5,2005,3639,3639,3800,3800,1,161,161,0.042368421,0.042368421
FALSE,Morgan County,5/1/06,Hide,Hide,5,2006,3810,3810,3931,3931,1,121,121,0.030780972,0.030780972
FALSE,Morgan County,5/1/07,Hide,Hide,5,2007,3881,3881,3983,3983,1,102,102,0.025608838,0.025608838
FALSE,Morgan County,5/1/08,Hide,Hide,5,2008,3937,3937,4061,4061,1,124,124,0.030534351,0.030534351
FALSE,Morgan County,5/1/09,Hide,Hide,5,2009,3814,3814,4064,4064,1,250,250,0.061515748,0.061515748
FALSE,Morgan County,5/1/10,Hide,Hide,5,2010,3980,3980,4277,4277,1,297,297,0.069441197,0.069441197
FALSE,Morgan County,5/1/11,Hide,Hide,5,2011,3976,3976,4219,4219,1,243,243,0.057596587,0.057596587
FALSE,Morgan County,5/1/12,Hide,Hide,5,2012,4096,4096,4312,4312,1,216,216,0.050092764,0.050092764
FALSE,Morgan County,5/1/13,Hide,Hide,5,2013,4295,4295,4481,4481,1,186,186,0.041508592,0.041508592
FALSE,Morgan County,5/1/14,Hide,Hide,5,2014,4506,4506,4665,4665,1,159,159,0.034083601,0.034083601
FALSE,Morgan County,5/1/15,Hide,Hide,5,2015,4756,4756,4911,4911,1,155,155,0.0315618,0.0315618
FALSE,Morgan County,5/1/16,Hide,Hide,5,2016,4950,4950,5103,5103,1,153,153,0.029982363,0.029982363
FALSE,Morgan County,5/1/17,Hide,Hide,5,2017,5225,5225,5381,5381,1,156,156,0.028990894,0.028990894
FALSE,Morgan County,5/1/18,Hide,Hide,5,2018,5276,5276,5424,5424,1,148,148,0.027286136,0.027286136
FALSE,Morgan County,5/1/19,Show,Show,5,2019,5409,5409,5549,5549,1,140,140,0.025229771,0.025229771
TRUE,Morgan County,5/1/20,Show,Show,5,2020,5248,5248,5555,5555,1,307,307,0.055265527,0.055265527
FALSE,Piute County,5/1/93,Hide,Hide,5,1993,433,433,458,458,1,25,25,0.054585153,0.054585153
FALSE,Piute County,5/1/94,Hide,Hide,5,1994,444,444,487,487,1,43,43,0.088295688,0.088295688
FALSE,Piute County,5/1/95,Hide,Hide,5,1995,461,461,489,489,1,28,28,0.057259714,0.057259714
FALSE,Piute County,5/1/96,Hide,Hide,5,1996,485,485,508,508,1,23,23,0.045275591,0.045275591
FALSE,Piute County,5/1/97,Hide,Hide,5,1997,489,489,514,514,1,25,25,0.048638132,0.048638132
FALSE,Piute County,5/1/98,Hide,Hide,5,1998,486,486,507,507,1,21,21,0.041420118,0.041420118
FALSE,Piute County,5/1/99,Hide,Hide,5,1999,526,526,562,562,1,36,36,0.06405694,0.06405694
FALSE,Piute County,5/1/00,Hide,Hide,5,2000,600,600,625,625,1,25,25,0.04,0.04
FALSE,Piute County,5/1/01,Hide,Hide,5,2001,718,718,762,762,1,44,44,0.057742782,0.057742782
FALSE,Piute County,5/1/02,Hide,Hide,5,2002,673,673,720,720,1,47,47,0.065277778,0.065277778
FALSE,Piute County,5/1/03,Hide,Hide,5,2003,748,748,793,793,1,45,45,0.056746532,0.056746532
FALSE,Piute County,5/1/04,Hide,Hide,5,2004,845,845,881,881,1,36,36,0.040862656,0.040862656
FALSE,Piute County,5/1/05,Hide,Hide,5,2005,817,817,852,852,1,35,35,0.041079812,0.041079812
FALSE,Piute County,5/1/06,Hide,Hide,5,2006,867,867,895,895,1,28,28,0.031284916,0.031284916
FALSE,Piute County,5/1/07,Hide,Hide,5,2007,925,925,943,943,1,18,18,0.019088017,0.019088017
FALSE,Piute County,5/1/08,Hide,Hide,5,2008,867,867,892,892,1,25,25,0.028026906,0.028026906
FALSE,Piute County,5/1/09,Hide,Hide,5,2009,826,826,886,886,1,60,60,0.06772009,0.06772009
FALSE,Piute County,5/1/10,Hide,Hide,5,2010,511,511,568,568,1,57,57,0.100352113,0.100352113
FALSE,Piute County,5/1/11,Hide,Hide,5,2011,483,483,538,538,1,55,55,0.102230483,0.102230483
FALSE,Piute County,5/1/12,Hide,Hide,5,2012,459,459,503,503,1,44,44,0.087475149,0.087475149
FALSE,Piute County,5/1/13,Hide,Hide,5,2013,457,457,495,495,1,38,38,0.076767677,0.076767677
FALSE,Piute County,5/1/14,Hide,Hide,5,2014,422,422,453,453,1,31,31,0.068432671,0.068432671
FALSE,Piute County,5/1/15,Hide,Hide,5,2015,451,451,481,481,1,30,30,0.062370062,0.062370062
FALSE,Piute County,5/1/16,Hide,Hide,5,2016,425,425,453,453,1,28,28,0.061810155,0.061810155
FALSE,Piute County,5/1/17,Hide,Hide,5,2017,454,454,478,478,1,24,24,0.050209205,0.050209205
FALSE,Piute County,5/1/18,Hide,Hide,5,2018,456,456,480,480,1,24,24,0.05,0.05
FALSE,Piute County,5/1/19,Show,Show,5,2019,460,460,482,482,1,22,22,0.045643154,0.045643154
TRUE,Piute County,5/1/20,Show,Show,5,2020,442,442,485,485,1,43,43,0.088659794,0.088659794
FALSE,Rich County,5/1/93,Hide,Hide,5,1993,756,756,779,779,1,23,23,0.029525032,0.029525032
FALSE,Rich County,5/1/94,Hide,Hide,5,1994,777,777,808,808,1,31,31,0.038366337,0.038366337
FALSE,Rich County,5/1/95,Hide,Hide,5,1995,835,835,874,874,1,39,39,0.044622426,0.044622426
FALSE,Rich County,5/1/96,Hide,Hide,5,1996,947,947,984,984,1,37,37,0.037601626,0.037601626
FALSE,Rich County,5/1/97,Hide,Hide,5,1997,892,892,920,920,1,28,28,0.030434783,0.030434783
FALSE,Rich County,5/1/98,Hide,Hide,5,1998,952,952,984,984,1,32,32,0.032520325,0.032520325
FALSE,Rich County,5/1/99,Hide,Hide,5,1999,979,979,1014,1014,1,35,35,0.034516765,0.034516765
FALSE,Rich County,5/1/00,Hide,Hide,5,2000,1027,1027,1056,1056,1,29,29,0.027462121,0.027462121
FALSE,Rich County,5/1/01,Hide,Hide,5,2001,1089,1089,1126,1126,1,37,37,0.03285968,0.03285968
FALSE,Rich County,5/1/02,Hide,Hide,5,2002,1174,1174,1224,1224,1,50,50,0.040849673,0.040849673
FALSE,Rich County,5/1/03,Hide,Hide,5,2003,1201,1201,1250,1250,1,49,49,0.0392,0.0392
FALSE,Rich County,5/1/04,Hide,Hide,5,2004,1344,1344,1388,1388,1,44,44,0.031700288,0.031700288
FALSE,Rich County,5/1/05,Hide,Hide,5,2005,1239,1239,1280,1280,1,41,41,0.03203125,0.03203125
FALSE,Rich County,5/1/06,Hide,Hide,5,2006,1392,1392,1426,1426,1,34,34,0.023842917,0.023842917
FALSE,Rich County,5/1/07,Hide,Hide,5,2007,1423,1423,1450,1450,1,27,27,0.01862069,0.01862069
FALSE,Rich County,5/1/08,Hide,Hide,5,2008,1357,1357,1389,1389,1,32,32,0.023038157,0.023038157
FALSE,Rich County,5/1/09,Hide,Hide,5,2009,1388,1388,1465,1465,1,77,77,0.052559727,0.052559727
FALSE,Rich County,5/1/10,Hide,Hide,5,2010,964,964,1040,1040,1,76,76,0.073076923,0.073076923
FALSE,Rich County,5/1/11,Hide,Hide,5,2011,913,913,986,986,1,73,73,0.074036511,0.074036511
FALSE,Rich County,5/1/12,Hide,Hide,5,2012,914,914,962,962,1,48,48,0.04989605,0.04989605
FALSE,Rich County,5/1/13,Hide,Hide,5,2013,933,933,979,979,1,46,46,0.046986721,0.046986721
FALSE,Rich County,5/1/14,Hide,Hide,5,2014,963,963,1002,1002,1,39,39,0.038922156,0.038922156
FALSE,Rich County,5/1/15,Hide,Hide,5,2015,1030,1030,1068,1068,1,38,38,0.035580524,0.035580524
FALSE,Rich County,5/1/16,Hide,Hide,5,2016,1065,1065,1097,1097,1,32,32,0.029170465,0.029170465
FALSE,Rich County,5/1/17,Hide,Hide,5,2017,1090,1090,1128,1128,1,38,38,0.033687943,0.033687943
FALSE,Rich County,5/1/18,Hide,Hide,5,2018,1123,1123,1159,1159,1,36,36,0.03106126,0.03106126
FALSE,Rich County,5/1/19,Show,Show,5,2019,1156,1156,1192,1192,1,36,36,0.030201342,0.030201342
TRUE,Rich County,5/1/20,Show,Show,5,2020,1068,1068,1117,1117,1,49,49,0.043867502,0.043867502
FALSE,Salt Lake County,5/1/93,Hide,Hide,5,1993,402562,402562,418077,418077,1,15515,15515,0.037110389,0.037110389
FALSE,Salt Lake County,5/1/94,Hide,Hide,5,1994,426126,426126,440756,440756,1,14630,14630,0.033192968,0.033192968
FALSE,Salt Lake County,5/1/95,Hide,Hide,5,1995,438970,438970,452811,452811,1,13841,13841,0.030566837,0.030566837
FALSE,Salt Lake County,5/1/96,Hide,Hide,5,1996,446217,446217,459757,459757,1,13540,13540,0.02945034,0.02945034
FALSE,Salt Lake County,5/1/97,Hide,Hide,5,1997,460192,460192,473137,473137,1,12945,12945,0.02735994,0.02735994
FALSE,Salt Lake County,5/1/98,Hide,Hide,5,1998,466546,466546,482427,482427,1,15881,15881,0.03291897,0.03291897
FALSE,Salt Lake County,5/1/99,Hide,Hide,5,1999,473665,473665,489970,489970,1,16305,16305,0.033277548,0.033277548
FALSE,Salt Lake County,5/1/00,Hide,Hide,5,2000,469089,469089,483670,483670,1,14581,14581,0.030146588,0.030146588
FALSE,Salt Lake County,5/1/01,Hide,Hide,5,2001,473322,473322,493624,493624,1,20302,20302,0.04112847,0.04112847
FALSE,Salt Lake County,5/1/02,Hide,Hide,5,2002,464638,464638,494145,494145,1,29507,29507,0.059713242,0.059713242
FALSE,Salt Lake County,5/1/03,Hide,Hide,5,2003,467311,467311,496176,496176,1,28865,28865,0.058174922,0.058174922
FALSE,Salt Lake County,5/1/04,Hide,Hide,5,2004,472403,472403,498077,498077,1,25674,25674,0.051546247,0.051546247
FALSE,Salt Lake County,5/1/05,Hide,Hide,5,2005,494033,494033,514886,514886,1,20853,20853,0.040500227,0.040500227
FALSE,Salt Lake County,5/1/06,Hide,Hide,5,2006,516522,516522,532618,532618,1,16096,16096,0.030220533,0.030220533
FALSE,Salt Lake County,5/1/07,Hide,Hide,5,2007,536057,536057,548876,548876,1,12819,12819,0.023355002,0.023355002
FALSE,Salt Lake County,5/1/08,Hide,Hide,5,2008,541075,541075,557876,557876,1,16801,16801,0.030116011,0.030116011
FALSE,Salt Lake County,5/1/09,Hide,Hide,5,2009,516879,516879,555802,555802,1,38923,38923,0.070030335,0.070030335
FALSE,Salt Lake County,5/1/10,Hide,Hide,5,2010,507032,507032,549429,549429,1,42397,42397,0.077165566,0.077165566
FALSE,Salt Lake County,5/1/11,Hide,Hide,5,2011,507988,507988,544986,544986,1,36998,36998,0.067887982,0.067887982
FALSE,Salt Lake County,5/1/12,Hide,Hide,5,2012,525309,525309,554936,554936,1,29627,29627,0.053388138,0.053388138
FALSE,Salt Lake County,5/1/13,Hide,Hide,5,2013,542774,542774,568334,568334,1,25560,25560,0.044973554,0.044973554
FALSE,Salt Lake County,5/1/14,Hide,Hide,5,2014,553180,553180,574348,574348,1,21168,21168,0.036855704,0.036855704
FALSE,Salt Lake County,5/1/15,Hide,Hide,5,2015,563189,563189,583073,583073,1,19884,19884,0.034102076,0.034102076
FALSE,Salt Lake County,5/1/16,Hide,Hide,5,2016,580360,580360,599568,599568,1,19208,19208,0.0320364,0.0320364
FALSE,Salt Lake County,5/1/17,Hide,Hide,5,2017,594816,594816,614307,614307,1,19491,19491,0.031728435,0.031728435
FALSE,Salt Lake County,5/1/18,Hide,Hide,5,2018,599871,599871,618048,618048,1,18177,18177,0.029410337,0.029410337
FALSE,Salt Lake County,5/1/19,Show,Show,5,2019,615858,615858,632189,632189,1,16331,16331,0.025832465,0.025832465
TRUE,Salt Lake County,5/1/20,Show,Show,5,2020,573932,573932,633766,633766,1,59834,59834,0.09441024,0.09441024
FALSE,San Juan County,5/1/93,Hide,Hide,5,1993,4742,4742,5084,5084,1,342,342,0.067269866,0.067269866
FALSE,San Juan County,5/1/94,Hide,Hide,5,1994,4660,4660,5099,5099,1,439,439,0.086095313,0.086095313
FALSE,San Juan County,5/1/95,Hide,Hide,5,1995,4749,4749,5201,5201,1,452,452,0.086906364,0.086906364
FALSE,San Juan County,5/1/96,Hide,Hide,5,1996,4653,4653,5126,5126,1,473,473,0.092274678,0.092274678
FALSE,San Juan County,5/1/97,Hide,Hide,5,1997,4470,4470,4913,4913,1,443,443,0.09016894,0.09016894
FALSE,San Juan County,5/1/98,Hide,Hide,5,1998,4575,4575,4962,4962,1,387,387,0.077992745,0.077992745
FALSE,San Juan County,5/1/99,Hide,Hide,5,1999,4718,4718,5115,5115,1,397,397,0.077614858,0.077614858
FALSE,San Juan County,5/1/00,Hide,Hide,5,2000,4381,4381,4743,4743,1,362,362,0.076323002,0.076323002
FALSE,San Juan County,5/1/01,Hide,Hide,5,2001,4160,4160,4533,4533,1,373,373,0.082285462,0.082285462
FALSE,San Juan County,5/1/02,Hide,Hide,5,2002,4336,4336,4739,4739,1,403,403,0.085039038,0.085039038
FALSE,San Juan County,5/1/03,Hide,Hide,5,2003,4302,4302,4733,4733,1,431,431,0.091062751,0.091062751
FALSE,San Juan County,5/1/04,Hide,Hide,5,2004,4461,4461,4919,4919,1,458,458,0.093108355,0.093108355
FALSE,San Juan County,5/1/05,Hide,Hide,5,2005,4375,4375,4758,4758,1,383,383,0.080496007,0.080496007
FALSE,San Juan County,5/1/06,Hide,Hide,5,2006,4585,4585,4892,4892,1,307,307,0.062755519,0.062755519
FALSE,San Juan County,5/1/07,Hide,Hide,5,2007,4718,4718,4964,4964,1,246,246,0.049556809,0.049556809
FALSE,San Juan County,5/1/08,Hide,Hide,5,2008,4638,4638,4943,4943,1,305,305,0.061703419,0.061703419
FALSE,San Juan County,5/1/09,Hide,Hide,5,2009,4633,4633,5230,5230,1,597,597,0.11414914,0.11414914
FALSE,San Juan County,5/1/10,Hide,Hide,5,2010,5426,5426,6087,6087,1,661,661,0.108592081,0.108592081
FALSE,San Juan County,5/1/11,Hide,Hide,5,2011,5368,5368,5971,5971,1,603,603,0.100988109,0.100988109
FALSE,San Juan County,5/1/12,Hide,Hide,5,2012,5220,5220,5738,5738,1,518,518,0.090275357,0.090275357
FALSE,San Juan County,5/1/13,Hide,Hide,5,2013,5166,5166,5621,5621,1,455,455,0.080946451,0.080946451
FALSE,San Juan County,5/1/14,Hide,Hide,5,2014,5178,5178,5598,5598,1,420,420,0.075026795,0.075026795
FALSE,San Juan County,5/1/15,Hide,Hide,5,2015,5290,5290,5744,5744,1,454,454,0.079038997,0.079038997
FALSE,San Juan County,5/1/16,Hide,Hide,5,2016,5275,5275,5757,5757,1,482,482,0.083724162,0.083724162
FALSE,San Juan County,5/1/17,Hide,Hide,5,2017,5269,5269,5672,5672,1,403,403,0.071050776,0.071050776
FALSE,San Juan County,5/1/18,Hide,Hide,5,2018,5338,5338,5690,5690,1,352,352,0.061862917,0.061862917
FALSE,San Juan County,5/1/19,Show,Show,5,2019,5452,5452,5739,5739,1,287,287,0.050008712,0.050008712
TRUE,San Juan County,5/1/20,Show,Show,5,2020,5430,5430,6285,6285,1,855,855,0.136038186,0.136038186
FALSE,Sanpete County,5/1/93,Hide,Hide,5,1993,6667,6667,7139,7139,1,472,472,0.066115702,0.066115702
FALSE,Sanpete County,5/1/94,Hide,Hide,5,1994,6934,6934,7434,7434,1,500,500,0.067258542,0.067258542
FALSE,Sanpete County,5/1/95,Hide,Hide,5,1995,7233,7233,7706,7706,1,473,473,0.061380742,0.061380742
FALSE,Sanpete County,5/1/96,Hide,Hide,5,1996,7713,7713,8198,8198,1,485,485,0.059160771,0.059160771
FALSE,Sanpete County,5/1/97,Hide,Hide,5,1997,8080,8080,8543,8543,1,463,463,0.054196418,0.054196418
FALSE,Sanpete County,5/1/98,Hide,Hide,5,1998,8421,8421,8950,8950,1,529,529,0.059106145,0.059106145
FALSE,Sanpete County,5/1/99,Hide,Hide,5,1999,8553,8553,9050,9050,1,497,497,0.054917127,0.054917127
FALSE,Sanpete County,5/1/00,Hide,Hide,5,2000,9225,9225,9635,9635,1,410,410,0.042553191,0.042553191
FALSE,Sanpete County,5/1/01,Hide,Hide,5,2001,9382,9382,9919,9919,1,537,537,0.054138522,0.054138522
FALSE,Sanpete County,5/1/02,Hide,Hide,5,2002,9442,9442,10098,10098,1,656,656,0.064963359,0.064963359
FALSE,Sanpete County,5/1/03,Hide,Hide,5,2003,9527,9527,10221,10221,1,694,694,0.067899423,0.067899423
FALSE,Sanpete County,5/1/04,Hide,Hide,5,2004,9996,9996,10661,10661,1,665,665,0.062376888,0.062376888
FALSE,Sanpete County,5/1/05,Hide,Hide,5,2005,9922,9922,10493,10493,1,571,571,0.054417231,0.054417231
FALSE,Sanpete County,5/1/06,Hide,Hide,5,2006,10207,10207,10626,10626,1,419,419,0.039431583,0.039431583
FALSE,Sanpete County,5/1/07,Hide,Hide,5,2007,10627,10627,10950,10950,1,323,323,0.029497717,0.029497717
FALSE,Sanpete County,5/1/08,Hide,Hide,5,2008,10562,10562,10985,10985,1,423,423,0.038507055,0.038507055
FALSE,Sanpete County,5/1/09,Hide,Hide,5,2009,10346,10346,11286,11286,1,940,940,0.083289031,0.083289031
FALSE,Sanpete County,5/1/10,Hide,Hide,5,2010,10413,10413,11451,11451,1,1038,1038,0.090647105,0.090647105
FALSE,Sanpete County,5/1/11,Hide,Hide,5,2011,10135,10135,11030,11030,1,895,895,0.081142339,0.081142339
FALSE,Sanpete County,5/1/12,Hide,Hide,5,2012,10515,10515,11249,11249,1,734,734,0.065250244,0.065250244
FALSE,Sanpete County,5/1/13,Hide,Hide,5,2013,10512,10512,11155,11155,1,643,643,0.057642313,0.057642313
FALSE,Sanpete County,5/1/14,Hide,Hide,5,2014,10543,10543,11044,11044,1,501,501,0.045363999,0.045363999
FALSE,Sanpete County,5/1/15,Hide,Hide,5,2015,11030,11030,11509,11509,1,479,479,0.041619602,0.041619602
FALSE,Sanpete County,5/1/16,Hide,Hide,5,2016,11338,11338,11814,11814,1,476,476,0.04029118,0.04029118
FALSE,Sanpete County,5/1/17,Hide,Hide,5,2017,11401,11401,11874,11874,1,473,473,0.039834933,0.039834933
FALSE,Sanpete County,5/1/18,Hide,Hide,5,2018,11922,11922,12377,12377,1,455,455,0.036761735,0.036761735
FALSE,Sanpete County,5/1/19,Show,Show,5,2019,12078,12078,12485,12485,1,407,407,0.032599119,0.032599119
TRUE,Sanpete County,5/1/20,Show,Show,5,2020,11485,11485,12120,12120,1,635,635,0.052392739,0.052392739
FALSE,Sevier County,5/1/93,Hide,Hide,5,1993,6662,6662,7064,7064,1,402,402,0.056908267,0.056908267
FALSE,Sevier County,5/1/94,Hide,Hide,5,1994,7050,7050,7413,7413,1,363,363,0.048968029,0.048968029
FALSE,Sevier County,5/1/95,Hide,Hide,5,1995,7235,7235,7625,7625,1,390,390,0.051147541,0.051147541
FALSE,Sevier County,5/1/96,Hide,Hide,5,1996,7476,7476,7830,7830,1,354,354,0.045210728,0.045210728
FALSE,Sevier County,5/1/97,Hide,Hide,5,1997,7733,7733,8039,8039,1,306,306,0.038064436,0.038064436
FALSE,Sevier County,5/1/98,Hide,Hide,5,1998,7933,7933,8335,8335,1,402,402,0.048230354,0.048230354
FALSE,Sevier County,5/1/99,Hide,Hide,5,1999,8109,8109,8464,8464,1,355,355,0.041942344,0.041942344
FALSE,Sevier County,5/1/00,Hide,Hide,5,2000,8067,8067,8368,8368,1,301,301,0.035970363,0.035970363
FALSE,Sevier County,5/1/01,Hide,Hide,5,2001,8072,8072,8461,8461,1,389,389,0.045975653,0.045975653
FALSE,Sevier County,5/1/02,Hide,Hide,5,2002,8307,8307,8812,8812,1,505,505,0.057308216,0.057308216
FALSE,Sevier County,5/1/03,Hide,Hide,5,2003,8183,8183,8689,8689,1,506,506,0.058234549,0.058234549
FALSE,Sevier County,5/1/04,Hide,Hide,5,2004,8848,8848,9334,9334,1,486,486,0.052067709,0.052067709
FALSE,Sevier County,5/1/05,Hide,Hide,5,2005,8681,8681,9095,9095,1,414,414,0.045519516,0.045519516
FALSE,Sevier County,5/1/06,Hide,Hide,5,2006,9042,9042,9358,9358,1,316,316,0.033767899,0.033767899
FALSE,Sevier County,5/1/07,Hide,Hide,5,2007,9232,9232,9478,9478,1,246,246,0.025954843,0.025954843
FALSE,Sevier County,5/1/08,Hide,Hide,5,2008,9251,9251,9589,9589,1,338,338,0.035248722,0.035248722
FALSE,Sevier County,5/1/09,Hide,Hide,5,2009,9056,9056,9813,9813,1,757,757,0.077142566,0.077142566
FALSE,Sevier County,5/1/10,Hide,Hide,5,2010,8860,8860,9672,9672,1,812,812,0.083953681,0.083953681
FALSE,Sevier County,5/1/11,Hide,Hide,5,2011,8764,8764,9494,9494,1,730,730,0.076890668,0.076890668
FALSE,Sevier County,5/1/12,Hide,Hide,5,2012,8845,8845,9436,9436,1,591,591,0.062632471,0.062632471
FALSE,Sevier County,5/1/13,Hide,Hide,5,2013,8765,8765,9282,9282,1,517,517,0.055699203,0.055699203
FALSE,Sevier County,5/1/14,Hide,Hide,5,2014,8850,8850,9267,9267,1,417,417,0.044998381,0.044998381
FALSE,Sevier County,5/1/15,Hide,Hide,5,2015,9159,9159,9584,9584,1,425,425,0.044344741,0.044344741
FALSE,Sevier County,5/1/16,Hide,Hide,5,2016,9142,9142,9569,9569,1,427,427,0.044623263,0.044623263
FALSE,Sevier County,5/1/17,Hide,Hide,5,2017,9357,9357,9744,9744,1,387,387,0.039716749,0.039716749
FALSE,Sevier County,5/1/18,Hide,Hide,5,2018,9478,9478,9824,9824,1,346,346,0.03521987,0.03521987
FALSE,Sevier County,5/1/19,Show,Show,5,2019,9417,9417,9728,9728,1,311,311,0.031969572,0.031969572
TRUE,Sevier County,5/1/20,Show,Show,5,2020,8951,8951,9538,9538,1,587,587,0.0615433,0.0615433
FALSE,State of Utah,5/1/93,Hide,Hide,5,1993,894681,894681,933773,933773,1,39092,39092,0.041864565,0.041864565
FALSE,State of Utah,5/1/94,Hide,Hide,5,1994,950968,950968,988022,988022,1,37054,37054,0.037503213,0.037503213
FALSE,State of Utah,5/1/95,Hide,Hide,5,1995,973365,973365,1009063,1009063,1,35698,35698,0.035377375,0.035377375
FALSE,State of Utah,5/1/96,Hide,Hide,5,1996,999400,999400,1034545,1034545,1,35145,35145,0.033971456,0.033971456
FALSE,State of Utah,5/1/97,Hide,Hide,5,1997,1034003,1034003,1066964,1066964,1,32961,32961,0.030892326,0.030892326
FALSE,State of Utah,5/1/98,Hide,Hide,5,1998,1056757,1056757,1097069,1097069,1,40312,40312,0.036745182,0.036745182
FALSE,State of Utah,5/1/99,Hide,Hide,5,1999,1079012,1079012,1120052,1120052,1,41040,41040,0.036641156,0.036641156
FALSE,State of Utah,5/1/00,Hide,Hide,5,2000,1101945,1101945,1138332,1138332,1,36387,36387,0.031965191,0.031965191
FALSE,State of Utah,5/1/01,Hide,Hide,5,2001,1113154,1113154,1162154,1162154,1,49000,49000,0.042163087,0.042163087
FALSE,State of Utah,5/1/02,Hide,Hide,5,2002,1113771,1113771,1182607,1182607,1,68836,68836,0.058206995,0.058206995
FALSE,State of Utah,5/1/03,Hide,Hide,5,2003,1127693,1127693,1196044,1196044,1,68351,68351,0.057147563,0.057147563
FALSE,State of Utah,5/1/04,Hide,Hide,5,2004,1164603,1164603,1227403,1227403,1,62800,62800,0.051164939,0.051164939
FALSE,State of Utah,5/1/05,Hide,Hide,5,2005,1213626,1213626,1265797,1265797,1,52171,52171,0.04121593,0.04121593
FALSE,State of Utah,5/1/06,Hide,Hide,5,2006,1272979,1272979,1313723,1313723,1,40744,40744,0.031014148,0.031014148
FALSE,State of Utah,5/1/07,Hide,Hide,5,2007,1323017,1323017,1356284,1356284,1,33267,33267,0.024528049,0.024528049
FALSE,State of Utah,5/1/08,Hide,Hide,5,2008,1326818,1326818,1371314,1371314,1,44496,44496,0.032447711,0.032447711
FALSE,State of Utah,5/1/09,Hide,Hide,5,2009,1269323,1269323,1369447,1369447,1,100124,100124,0.073112724,0.073112724
FALSE,State of Utah,5/1/10,Hide,Hide,5,2010,1250301,1250301,1358240,1358240,1,107939,107939,0.079469755,0.079469755
FALSE,State of Utah,5/1/11,Hide,Hide,5,2011,1254595,1254595,1348372,1348372,1,93777,93777,0.069548315,0.069548315
FALSE,State of Utah,5/1/12,Hide,Hide,5,2012,1293997,1293997,1369443,1369443,1,75446,75446,0.055092472,0.055092472
FALSE,State of Utah,5/1/13,Hide,Hide,5,2013,1336692,1336692,1402385,1402385,1,65693,65693,0.04684377,0.04684377
FALSE,State of Utah,5/1/14,Hide,Hide,5,2014,1368063,1368063,1422094,1422094,1,54031,54031,0.037993972,0.037993972
FALSE,State of Utah,5/1/15,Hide,Hide,5,2015,1403625,1403625,1456598,1456598,1,52973,52973,0.036367618,0.036367618
FALSE,State of Utah,5/1/16,Hide,Hide,5,2016,1447740,1447740,1500259,1500259,1,52519,52519,0.035006622,0.035006622
FALSE,State of Utah,5/1/17,Hide,Hide,5,2017,1493810,1493810,1544873,1544873,1,51063,51063,0.033053202,0.033053202
FALSE,State of Utah,5/1/18,Hide,Hide,5,2018,1519271,1519271,1567681,1567681,1,48410,48410,0.030880007,0.030880007
FALSE,State of Utah,5/1/19,Show,Show,5,2019,1542357,1542357,1587815,1587815,1,45458,45458,0.02862928,0.02862928
TRUE,State of Utah,5/1/20,Show,Show,5,2020,1473599,1473599,1610853,1610853,1,137254,137254,0.085205788,0.085205788
FALSE,Summit County,5/1/93,Hide,Hide,5,1993,9714,9714,10270,10270,1,556,556,0.054138267,0.054138267
FALSE,Summit County,5/1/94,Hide,Hide,5,1994,10736,10736,11227,11227,1,491,491,0.043733856,0.043733856
FALSE,Summit County,5/1/95,Hide,Hide,5,1995,11525,11525,11982,11982,1,457,457,0.038140544,0.038140544
FALSE,Summit County,5/1/96,Hide,Hide,5,1996,12216,12216,12673,12673,1,457,457,0.036060917,0.036060917
FALSE,Summit County,5/1/97,Hide,Hide,5,1997,12800,12800,13245,13245,1,445,445,0.033597584,0.033597584
FALSE,Summit County,5/1/98,Hide,Hide,5,1998,13316,13316,13942,13942,1,626,626,0.044900301,0.044900301
FALSE,Summit County,5/1/99,Hide,Hide,5,1999,13817,13817,14519,14519,1,702,702,0.048350437,0.048350437
FALSE,Summit County,5/1/00,Hide,Hide,5,2000,17653,17653,18273,18273,1,620,620,0.033929842,0.033929842
FALSE,Summit County,5/1/01,Hide,Hide,5,2001,18124,18124,18896,18896,1,772,772,0.040855207,0.040855207
FALSE,Summit County,5/1/02,Hide,Hide,5,2002,18122,18122,19402,19402,1,1280,1280,0.06597258,0.06597258
FALSE,Summit County,5/1/03,Hide,Hide,5,2003,18623,18623,19858,19858,1,1235,1235,0.06219156,0.06219156
FALSE,Summit County,5/1/04,Hide,Hide,5,2004,19300,19300,20404,20404,1,1104,1104,0.054107038,0.054107038
FALSE,Summit County,5/1/05,Hide,Hide,5,2005,20503,20503,21363,21363,1,860,860,0.040256518,0.040256518
FALSE,Summit County,5/1/06,Hide,Hide,5,2006,21056,21056,21720,21720,1,664,664,0.030570902,0.030570902
FALSE,Summit County,5/1/07,Hide,Hide,5,2007,21217,21217,21735,21735,1,518,518,0.023832528,0.023832528
FALSE,Summit County,5/1/08,Hide,Hide,5,2008,21530,21530,22186,22186,1,656,656,0.029568196,0.029568196
FALSE,Summit County,5/1/09,Hide,Hide,5,2009,20803,20803,22334,22334,1,1531,1531,0.068550193,0.068550193
FALSE,Summit County,5/1/10,Hide,Hide,5,2010,19155,19155,20700,20700,1,1545,1545,0.074637681,0.074637681
FALSE,Summit County,5/1/11,Hide,Hide,5,2011,19718,19718,21043,21043,1,1325,1325,0.062966307,0.062966307
FALSE,Summit County,5/1/12,Hide,Hide,5,2012,20172,20172,21245,21245,1,1073,1073,0.050506001,0.050506001
FALSE,Summit County,5/1/13,Hide,Hide,5,2013,21013,21013,21949,21949,1,936,936,0.042644312,0.042644312
FALSE,Summit County,5/1/14,Hide,Hide,5,2014,21792,21792,22569,22569,1,777,777,0.034427755,0.034427755
FALSE,Summit County,5/1/15,Hide,Hide,5,2015,22207,22207,22971,22971,1,764,764,0.033259327,0.033259327
FALSE,Summit County,5/1/16,Hide,Hide,5,2016,23046,23046,23786,23786,1,740,740,0.031110737,0.031110737
FALSE,Summit County,5/1/17,Hide,Hide,5,2017,23587,23587,24353,24353,1,766,766,0.03145403,0.03145403
FALSE,Summit County,5/1/18,Hide,Hide,5,2018,23634,23634,24361,24361,1,727,727,0.029842781,0.029842781
FALSE,Summit County,5/1/19,Show,Show,5,2019,24402,24402,25033,25033,1,631,631,0.025206727,0.025206727
TRUE,Summit County,5/1/20,Show,Show,5,2020,20221,20221,24339,24339,1,4118,4118,0.169193475,0.169193475
FALSE,Tooele County,5/1/93,Hide,Hide,5,1993,11411,11411,12086,12086,1,675,675,0.055849744,0.055849744
FALSE,Tooele County,5/1/94,Hide,Hide,5,1994,10942,10942,11620,11620,1,678,678,0.058347676,0.058347676
FALSE,Tooele County,5/1/95,Hide,Hide,5,1995,10846,10846,11502,11502,1,656,656,0.057033559,0.057033559
FALSE,Tooele County,5/1/96,Hide,Hide,5,1996,11055,11055,11674,11674,1,619,619,0.053023814,0.053023814
FALSE,Tooele County,5/1/97,Hide,Hide,5,1997,11100,11100,11626,11626,1,526,526,0.04524342,0.04524342
FALSE,Tooele County,5/1/98,Hide,Hide,5,1998,11199,11199,11772,11772,1,573,573,0.048674822,0.048674822
FALSE,Tooele County,5/1/99,Hide,Hide,5,1999,11367,11367,12023,12023,1,656,656,0.054562089,0.054562089
FALSE,Tooele County,5/1/00,Hide,Hide,5,2000,19220,19220,19922,19922,1,702,702,0.035237426,0.035237426
FALSE,Tooele County,5/1/01,Hide,Hide,5,2001,20226,20226,21212,21212,1,986,986,0.046483123,0.046483123
FALSE,Tooele County,5/1/02,Hide,Hide,5,2002,20691,20691,22110,22110,1,1419,1419,0.064179104,0.064179104
FALSE,Tooele County,5/1/03,Hide,Hide,5,2003,21671,21671,23111,23111,1,1440,1440,0.062307992,0.062307992
FALSE,Tooele County,5/1/04,Hide,Hide,5,2004,22476,22476,23810,23810,1,1334,1334,0.056026879,0.056026879
FALSE,Tooele County,5/1/05,Hide,Hide,5,2005,23890,23890,24988,24988,1,1098,1098,0.043941092,0.043941092
FALSE,Tooele County,5/1/06,Hide,Hide,5,2006,25271,25271,26146,26146,1,875,875,0.033465922,0.033465922
FALSE,Tooele County,5/1/07,Hide,Hide,5,2007,26081,26081,26792,26792,1,711,711,0.026537772,0.026537772
FALSE,Tooele County,5/1/08,Hide,Hide,5,2008,26978,26978,27927,27927,1,949,949,0.033981452,0.033981452
FALSE,Tooele County,5/1/09,Hide,Hide,5,2009,26083,26083,28314,28314,1,2231,2231,0.078794942,0.078794942
FALSE,Tooele County,5/1/10,Hide,Hide,5,2010,25179,25179,27501,27501,1,2322,2322,0.084433293,0.084433293
FALSE,Tooele County,5/1/11,Hide,Hide,5,2011,25222,25222,27211,27211,1,1989,1989,0.073095439,0.073095439
FALSE,Tooele County,5/1/12,Hide,Hide,5,2012,25995,25995,27683,27683,1,1688,1688,0.06097605,0.06097605
FALSE,Tooele County,5/1/13,Hide,Hide,5,2013,26824,26824,28387,28387,1,1563,1563,0.055060415,0.055060415
FALSE,Tooele County,5/1/14,Hide,Hide,5,2014,27420,27420,28800,28800,1,1380,1380,0.047916667,0.047916667
FALSE,Tooele County,5/1/15,Hide,Hide,5,2015,28146,28146,29378,29378,1,1232,1232,0.041936143,0.041936143
FALSE,Tooele County,5/1/16,Hide,Hide,5,2016,29372,29372,30563,30563,1,1191,1191,0.038968688,0.038968688
FALSE,Tooele County,5/1/17,Hide,Hide,5,2017,30989,30989,32185,32185,1,1196,1196,0.037160168,0.037160168
FALSE,Tooele County,5/1/18,Hide,Hide,5,2018,31928,31928,33037,33037,1,1109,1109,0.033568423,0.033568423
FALSE,Tooele County,5/1/19,Show,Show,5,2019,32684,32684,33682,33682,1,998,998,0.029630069,0.029630069
TRUE,Tooele County,5/1/20,Show,Show,5,2020,30615,30615,33642,33642,1,3027,3027,0.089976815,0.089976815
FALSE,Uintah County,5/1/93,Hide,Hide,5,1993,9191,9191,9960,9960,1,769,769,0.077208835,0.077208835
FALSE,Uintah County,5/1/94,Hide,Hide,5,1994,9431,9431,10195,10195,1,764,764,0.074938695,0.074938695
FALSE,Uintah County,5/1/95,Hide,Hide,5,1995,9667,9667,10370,10370,1,703,703,0.067791707,0.067791707
FALSE,Uintah County,5/1/96,Hide,Hide,5,1996,9407,9407,10139,10139,1,732,732,0.072196469,0.072196469
FALSE,Uintah County,5/1/97,Hide,Hide,5,1997,10084,10084,10698,10698,1,614,614,0.057393905,0.057393905
FALSE,Uintah County,5/1/98,Hide,Hide,5,1998,10191,10191,10818,10818,1,627,627,0.057958957,0.057958957
FALSE,Uintah County,5/1/99,Hide,Hide,5,1999,10329,10329,11139,11139,1,810,810,0.072717479,0.072717479
FALSE,Uintah County,5/1/00,Hide,Hide,5,2000,10862,10862,11324,11324,1,462,462,0.040798304,0.040798304
FALSE,Uintah County,5/1/01,Hide,Hide,5,2001,11542,11542,12052,12052,1,510,510,0.042316628,0.042316628
FALSE,Uintah County,5/1/02,Hide,Hide,5,2002,11852,11852,12621,12621,1,769,769,0.060930196,0.060930196
FALSE,Uintah County,5/1/03,Hide,Hide,5,2003,12236,12236,12981,12981,1,745,745,0.057391572,0.057391572
FALSE,Uintah County,5/1/04,Hide,Hide,5,2004,13045,13045,13765,13765,1,720,720,0.052306575,0.052306575
FALSE,Uintah County,5/1/05,Hide,Hide,5,2005,13943,13943,14504,14504,1,561,561,0.038678985,0.038678985
FALSE,Uintah County,5/1/06,Hide,Hide,5,2006,15623,15623,16037,16037,1,414,414,0.025815302,0.025815302
FALSE,Uintah County,5/1/07,Hide,Hide,5,2007,17093,17093,17432,17432,1,339,339,0.019446994,0.019446994
FALSE,Uintah County,5/1/08,Hide,Hide,5,2008,17951,17951,18340,18340,1,389,389,0.021210469,0.021210469
FALSE,Uintah County,5/1/09,Hide,Hide,5,2009,16400,16400,17844,17844,1,1444,1444,0.08092356,0.08092356
FALSE,Uintah County,5/1/10,Hide,Hide,5,2010,13900,13900,15183,15183,1,1283,1283,0.084502404,0.084502404
FALSE,Uintah County,5/1/11,Hide,Hide,5,2011,14479,14479,15442,15442,1,963,963,0.062362388,0.062362388
FALSE,Uintah County,5/1/12,Hide,Hide,5,2012,15393,15393,16087,16087,1,694,694,0.043140424,0.043140424
FALSE,Uintah County,5/1/13,Hide,Hide,5,2013,15072,15072,15759,15759,1,687,687,0.043594137,0.043594137
FALSE,Uintah County,5/1/14,Hide,Hide,5,2014,15427,15427,15974,15974,1,547,547,0.034243145,0.034243145
FALSE,Uintah County,5/1/15,Hide,Hide,5,2015,14388,14388,15395,15395,1,1007,1007,0.065410848,0.065410848
FALSE,Uintah County,5/1/16,Hide,Hide,5,2016,12913,12913,14290,14290,1,1377,1377,0.096361092,0.096361092
FALSE,Uintah County,5/1/17,Hide,Hide,5,2017,12851,12851,13683,13683,1,832,832,0.060805379,0.060805379
FALSE,Uintah County,5/1/18,Hide,Hide,5,2018,12928,12928,13548,13548,1,620,620,0.045763212,0.045763212
FALSE,Uintah County,5/1/19,Show,Show,5,2019,13083,13083,13636,13636,1,553,553,0.040554415,0.040554415
TRUE,Uintah County,5/1/20,Show,Show,5,2020,12246,12246,14135,14135,1,1889,1889,0.133639901,0.133639901
FALSE,United States,5/1/93,Hide,Hide,5,1993,120115,120115000,129264,129264000,1,9149,9149000,0.071,0.071
FALSE,United States,5/1/94,Hide,Hide,5,1994,122864,122864000,130779,130779000,1,7915,7915000,0.061,0.061
FALSE,United States,5/1/95,Hide,Hide,5,1995,124421,124421000,131851,131851000,1,7430,7430000,0.056,0.056
FALSE,United States,5/1/96,Hide,Hide,5,1996,126244,126244000,133667,133667000,1,7423,7423000,0.056,0.056
FALSE,United States,5/1/97,Hide,Hide,5,1997,129464,129464000,136119,136119000,1,6655,6655000,0.049,0.049
FALSE,United States,5/1/98,Hide,Hide,5,1998,131325,131325000,137372,137372000,1,6047,6047000,0.044,0.044
FALSE,United States,5/1/99,Hide,Hide,5,1999,133311,133311000,139107,139107000,1,5796,5796000,0.042,0.042
FALSE,United States,5/1/00,Hide,Hide,5,2000,136630,136630000,142388,142388000,1,5758,5758000,0.04,0.04
FALSE,United States,5/1/01,Hide,Hide,5,2001,137092,137092000,143318,143318000,1,6226,6226000,0.043,0.043
FALSE,United States,5/1/02,Hide,Hide,5,2002,136539,136539000,144938,144938000,1,8399,8399000,0.058,0.058
FALSE,United States,5/1/03,Hide,Hide,5,2003,137544,137544000,146500,146500000,1,8957,8957000,0.061,0.061
FALSE,United States,5/1/04,Hide,Hide,5,2004,138852,138852000,147065,147065000,1,8212,8212000,0.056,0.056
FALSE,United States,5/1/05,Hide,Hide,5,2005,141609,141609000,149261,149261000,1,7651,7651000,0.051,0.051
FALSE,United States,5/1/06,Hide,Hide,5,2006,144089,144089000,151069,151069000,1,6980,6980000,0.046,0.046
FALSE,United States,5/1/07,Hide,Hide,5,2007,145903,145903000,152670,152670000,1,6766,6766000,0.044,0.044
FALSE,United States,5/1/08,Hide,Hide,5,2008,145908,145908000,154303,154303000,1,8395,8395000,0.054,0.054
FALSE,United States,5/1/09,Hide,Hide,5,2009,140248,140248000,154747,154747000,1,14499,14499000,0.094,0.094
FALSE,United States,5/1/10,Hide,Hide,5,2010,139241,139241000,154091,154091000,1,14849,14849000,0.096,0.096
FALSE,United States,5/1/11,Hide,Hide,5,2011,139624,139624000,153479,153479000,1,13855,13855000,0.09,0.09
FALSE,United States,5/1/12,Hide,Hide,5,2012,142206,142206000,154866,154866000,1,12660,12660000,0.082,0.082
FALSE,United States,5/1/13,Hide,Hide,5,2013,143882,143882000,155536,155536000,1,11654,11654000,0.075,0.075
FALSE,United States,5/1/14,Hide,Hide,5,2014,145825,145825000,155684,155684000,1,9859,9859000,0.063,0.063
FALSE,United States,5/1/15,Hide,Hide,5,2015,148817,148817000,157651,157651000,1,8834,8834000,0.056,0.056
FALSE,United States,5/1/16,Hide,Hide,5,2016,151119,151119000,158787,158787000,1,7668,7668000,0.048,0.048
FALSE,United States,5/1/17,Hide,Hide,5,2017,153001,153001000,160060,160060000,1,7059,7059000,0.044,0.044
FALSE,United States,5/1/18,Hide,Hide,5,2018,155665,155665000,161874,161874000,1,6209,6209000,0.038,0.038
FALSE,United States,5/1/19,Show,Show,5,2019,156844,156844000,162782,162782000,1,5938,5938000,0.036,0.036
TRUE,United States,5/1/20,Show,Show,5,2020,137242,137242000,158227,158227000,1,20985,20985000,0.132625911,0.132625911
FALSE,Utah County,5/1/93,Hide,Hide,5,1993,130884,130884,135875,135875,1,4991,4991,0.036732291,0.036732291
FALSE,Utah County,5/1/94,Hide,Hide,5,1994,140960,140960,145561,145561,1,4601,4601,0.031608741,0.031608741
FALSE,Utah County,5/1/95,Hide,Hide,5,1995,143024,143024,147382,147382,1,4358,4358,0.029569418,0.029569418
FALSE,Utah County,5/1/96,Hide,Hide,5,1996,148276,148276,152648,152648,1,4372,4372,0.028641057,0.028641057
FALSE,Utah County,5/1/97,Hide,Hide,5,1997,153825,153825,157890,157890,1,4065,4065,0.025745772,0.025745772
FALSE,Utah County,5/1/98,Hide,Hide,5,1998,159297,159297,164190,164190,1,4893,4893,0.02980084,0.02980084
FALSE,Utah County,5/1/99,Hide,Hide,5,1999,164378,164378,169716,169716,1,5338,5338,0.031452544,0.031452544
FALSE,Utah County,5/1/00,Hide,Hide,5,2000,175113,175113,180217,180217,1,5104,5104,0.028321413,0.028321413
FALSE,Utah County,5/1/01,Hide,Hide,5,2001,176470,176470,183512,183512,1,7042,7042,0.038373512,0.038373512
FALSE,Utah County,5/1/02,Hide,Hide,5,2002,174837,174837,185688,185688,1,10851,10851,0.058436733,0.058436733
FALSE,Utah County,5/1/03,Hide,Hide,5,2003,178034,178034,188012,188012,1,9978,9978,0.053071081,0.053071081
FALSE,Utah County,5/1/04,Hide,Hide,5,2004,186538,186538,196041,196041,1,9503,9503,0.048474554,0.048474554
FALSE,Utah County,5/1/05,Hide,Hide,5,2005,196139,196139,204315,204315,1,8176,8176,0.040016641,0.040016641
FALSE,Utah County,5/1/06,Hide,Hide,5,2006,206067,206067,212404,212404,1,6337,6337,0.029834655,0.029834655
FALSE,Utah County,5/1/07,Hide,Hide,5,2007,217335,217335,222527,222527,1,5192,5192,0.023332,0.023332
FALSE,Utah County,5/1/08,Hide,Hide,5,2008,216322,216322,223454,223454,1,7132,7132,0.031917084,0.031917084
FALSE,Utah County,5/1/09,Hide,Hide,5,2009,206413,206413,221617,221617,1,15204,15204,0.068604845,0.068604845
FALSE,Utah County,5/1/10,Hide,Hide,5,2010,212869,212869,230166,230166,1,17297,17297,0.075150109,0.075150109
FALSE,Utah County,5/1/11,Hide,Hide,5,2011,215303,215303,230252,230252,1,14949,14949,0.064924517,0.064924517
FALSE,Utah County,5/1/12,Hide,Hide,5,2012,225606,225606,237621,237621,1,12015,12015,0.050563713,0.050563713
FALSE,Utah County,5/1/13,Hide,Hide,5,2013,236878,236878,247707,247707,1,10829,10829,0.043716972,0.043716972
FALSE,Utah County,5/1/14,Hide,Hide,5,2014,244673,244673,253558,253558,1,8885,8885,0.035041292,0.035041292
FALSE,Utah County,5/1/15,Hide,Hide,5,2015,255677,255677,264402,264402,1,8725,8725,0.032998994,0.032998994
FALSE,Utah County,5/1/16,Hide,Hide,5,2016,268699,268699,277425,277425,1,8726,8726,0.031453546,0.031453546
FALSE,Utah County,5/1/17,Hide,Hide,5,2017,280608,280608,289174,289174,1,8566,8566,0.029622304,0.029622304
FALSE,Utah County,5/1/18,Hide,Hide,5,2018,289814,289814,298089,298089,1,8275,8275,0.027760166,0.027760166
FALSE,Utah County,5/1/19,Show,Show,5,2019,298360,298360,305794,305794,1,7434,7434,0.024310484,0.024310484
TRUE,Utah County,5/1/20,Show,Show,5,2020,284605,284605,303470,303470,1,18865,18865,0.0621643,0.0621643
FALSE,Wasatch County,5/1/93,Hide,Hide,5,1993,4751,4751,5066,5066,1,315,315,0.062179234,0.062179234
FALSE,Wasatch County,5/1/94,Hide,Hide,5,1994,5040,5040,5350,5350,1,310,310,0.057943925,0.057943925
FALSE,Wasatch County,5/1/95,Hide,Hide,5,1995,5158,5158,5439,5439,1,281,281,0.051663909,0.051663909
FALSE,Wasatch County,5/1/96,Hide,Hide,5,1996,5390,5390,5633,5633,1,243,243,0.043138647,0.043138647
FALSE,Wasatch County,5/1/97,Hide,Hide,5,1997,5640,5640,5861,5861,1,221,221,0.037706876,0.037706876
FALSE,Wasatch County,5/1/98,Hide,Hide,5,1998,5834,5834,6131,6131,1,297,297,0.048442342,0.048442342
FALSE,Wasatch County,5/1/99,Hide,Hide,5,1999,6006,6006,6334,6334,1,328,328,0.051784023,0.051784023
FALSE,Wasatch County,5/1/00,Hide,Hide,5,2000,7596,7596,7853,7853,1,257,257,0.032726347,0.032726347
FALSE,Wasatch County,5/1/01,Hide,Hide,5,2001,7602,7602,7933,7933,1,331,331,0.041724442,0.041724442
FALSE,Wasatch County,5/1/02,Hide,Hide,5,2002,7702,7702,8219,8219,1,517,517,0.06290303,0.06290303
FALSE,Wasatch County,5/1/03,Hide,Hide,5,2003,7925,7925,8452,8452,1,527,527,0.062352106,0.062352106
FALSE,Wasatch County,5/1/04,Hide,Hide,5,2004,8233,8233,8722,8722,1,489,489,0.056065123,0.056065123
FALSE,Wasatch County,5/1/05,Hide,Hide,5,2005,8861,8861,9239,9239,1,378,378,0.040913519,0.040913519
FALSE,Wasatch County,5/1/06,Hide,Hide,5,2006,9687,9687,10021,10021,1,334,334,0.033330007,0.033330007
FALSE,Wasatch County,5/1/07,Hide,Hide,5,2007,10444,10444,10686,10686,1,242,242,0.022646453,0.022646453
FALSE,Wasatch County,5/1/08,Hide,Hide,5,2008,9993,9993,10318,10318,1,325,325,0.031498352,0.031498352
FALSE,Wasatch County,5/1/09,Hide,Hide,5,2009,9241,9241,10073,10073,1,832,832,0.082597042,0.082597042
FALSE,Wasatch County,5/1/10,Hide,Hide,5,2010,10314,10314,11290,11290,1,976,976,0.086448184,0.086448184
FALSE,Wasatch County,5/1/11,Hide,Hide,5,2011,10392,10392,11211,11211,1,819,819,0.073053251,0.073053251
FALSE,Wasatch County,5/1/12,Hide,Hide,5,2012,10904,10904,11581,11581,1,677,677,0.058457819,0.058457819
FALSE,Wasatch County,5/1/13,Hide,Hide,5,2013,11568,11568,12151,12151,1,583,583,0.04797959,0.04797959
FALSE,Wasatch County,5/1/14,Hide,Hide,5,2014,12183,12183,12661,12661,1,478,478,0.037753732,0.037753732
FALSE,Wasatch County,5/1/15,Hide,Hide,5,2015,12787,12787,13254,13254,1,467,467,0.035234646,0.035234646
FALSE,Wasatch County,5/1/16,Hide,Hide,5,2016,13354,13354,13837,13837,1,483,483,0.03490641,0.03490641
FALSE,Wasatch County,5/1/17,Hide,Hide,5,2017,14004,14004,14497,14497,1,493,493,0.034007036,0.034007036
FALSE,Wasatch County,5/1/18,Hide,Hide,5,2018,14550,14550,15023,15023,1,473,473,0.031485056,0.031485056
FALSE,Wasatch County,5/1/19,Show,Show,5,2019,15592,15592,16028,16028,1,436,436,0.027202396,0.027202396
TRUE,Wasatch County,5/1/20,Show,Show,5,2020,14187,14187,16530,16530,1,2343,2343,0.141742287,0.141742287
FALSE,Washington County,5/1/93,Hide,Hide,5,1993,24603,24603,25590,25590,1,987,987,0.038569754,0.038569754
FALSE,Washington County,5/1/94,Hide,Hide,5,1994,29228,29228,30098,30098,1,870,870,0.028905575,0.028905575
FALSE,Washington County,5/1/95,Hide,Hide,5,1995,31392,31392,32446,32446,1,1054,1054,0.032484744,0.032484744
FALSE,Washington County,5/1/96,Hide,Hide,5,1996,33316,33316,34529,34529,1,1213,1213,0.035129891,0.035129891
FALSE,Washington County,5/1/97,Hide,Hide,5,1997,34140,34140,35310,35310,1,1170,1170,0.033135089,0.033135089
FALSE,Washington County,5/1/98,Hide,Hide,5,1998,35605,35605,36969,36969,1,1364,1364,0.036895778,0.036895778
FALSE,Washington County,5/1/99,Hide,Hide,5,1999,37127,37127,38485,38485,1,1358,1358,0.035286475,0.035286475
FALSE,Washington County,5/1/00,Hide,Hide,5,2000,37870,37870,39202,39202,1,1332,1332,0.033977858,0.033977858
FALSE,Washington County,5/1/01,Hide,Hide,5,2001,40122,40122,41805,41805,1,1683,1683,0.040258342,0.040258342
FALSE,Washington County,5/1/02,Hide,Hide,5,2002,42061,42061,44335,44335,1,2274,2274,0.051291305,0.051291305
FALSE,Washington County,5/1/03,Hide,Hide,5,2003,44345,44345,46880,46880,1,2535,2535,0.054074232,0.054074232
FALSE,Washington County,5/1/04,Hide,Hide,5,2004,48876,48876,51442,51442,1,2566,2566,0.04988142,0.04988142
FALSE,Washington County,5/1/05,Hide,Hide,5,2005,54150,54150,56498,56498,1,2348,2348,0.041558993,0.041558993
FALSE,Washington County,5/1/06,Hide,Hide,5,2006,59376,59376,61256,61256,1,1880,1880,0.030690871,0.030690871
FALSE,Washington County,5/1/07,Hide,Hide,5,2007,61409,61409,63038,63038,1,1629,1629,0.025841556,0.025841556
FALSE,Washington County,5/1/08,Hide,Hide,5,2008,59432,59432,61953,61953,1,2521,2521,0.040692138,0.040692138
FALSE,Washington County,5/1/09,Hide,Hide,5,2009,54826,54826,60657,60657,1,5831,5831,0.096130702,0.096130702
FALSE,Washington County,5/1/10,Hide,Hide,5,2010,50992,50992,57028,57028,1,6036,6036,0.105842744,0.105842744
FALSE,Washington County,5/1/11,Hide,Hide,5,2011,50792,50792,55868,55868,1,5076,5076,0.09085702,0.09085702
FALSE,Washington County,5/1/12,Hide,Hide,5,2012,52831,52831,56812,56812,1,3981,3981,0.070073224,0.070073224
FALSE,Washington County,5/1/13,Hide,Hide,5,2013,55827,55827,59217,59217,1,3390,3390,0.057247074,0.057247074
FALSE,Washington County,5/1/14,Hide,Hide,5,2014,58367,58367,61042,61042,1,2675,2675,0.043822286,0.043822286
FALSE,Washington County,5/1/15,Hide,Hide,5,2015,60619,60619,63231,63231,1,2612,2612,0.041308852,0.041308852
FALSE,Washington County,5/1/16,Hide,Hide,5,2016,64324,64324,66872,66872,1,2548,2548,0.038102644,0.038102644
FALSE,Washington County,5/1/17,Hide,Hide,5,2017,67904,67904,70403,70403,1,2499,2499,0.035495646,0.035495646
FALSE,Washington County,5/1/18,Hide,Hide,5,2018,71261,71261,73747,73747,1,2486,2486,0.033709846,0.033709846
FALSE,Washington County,5/1/19,Show,Show,5,2019,73275,73275,75554,75554,1,2279,2279,0.030163856,0.030163856
TRUE,Washington County,5/1/20,Show,Show,5,2020,70067,70067,77279,77279,1,7212,7212,0.093324189,0.093324189
FALSE,Wayne County,5/1/93,Hide,Hide,5,1993,978,978,1053,1053,1,75,75,0.071225071,0.071225071
FALSE,Wayne County,5/1/94,Hide,Hide,5,1994,1076,1076,1170,1170,1,94,94,0.08034188,0.08034188
FALSE,Wayne County,5/1/95,Hide,Hide,5,1995,1253,1253,1338,1338,1,85,85,0.063527653,0.063527653
FALSE,Wayne County,5/1/96,Hide,Hide,5,1996,1270,1270,1346,1346,1,76,76,0.056463596,0.056463596
FALSE,Wayne County,5/1/97,Hide,Hide,5,1997,1294,1294,1358,1358,1,64,64,0.04712813,0.04712813
FALSE,Wayne County,5/1/98,Hide,Hide,5,1998,1416,1416,1504,1504,1,88,88,0.058510638,0.058510638
FALSE,Wayne County,5/1/99,Hide,Hide,5,1999,1387,1387,1474,1474,1,87,87,0.059023066,0.059023066
FALSE,Wayne County,5/1/00,Hide,Hide,5,2000,1252,1252,1310,1310,1,58,58,0.044274809,0.044274809
FALSE,Wayne County,5/1/01,Hide,Hide,5,2001,1345,1345,1415,1415,1,70,70,0.049469965,0.049469965
FALSE,Wayne County,5/1/02,Hide,Hide,5,2002,1355,1355,1444,1444,1,89,89,0.061634349,0.061634349
FALSE,Wayne County,5/1/03,Hide,Hide,5,2003,1231,1231,1323,1323,1,92,92,0.069538927,0.069538927
FALSE,Wayne County,5/1/04,Hide,Hide,5,2004,1327,1327,1416,1416,1,89,89,0.062853107,0.062853107
FALSE,Wayne County,5/1/05,Hide,Hide,5,2005,1239,1239,1310,1310,1,71,71,0.054198473,0.054198473
FALSE,Wayne County,5/1/06,Hide,Hide,5,2006,1333,1333,1397,1397,1,64,64,0.045812455,0.045812455
FALSE,Wayne County,5/1/07,Hide,Hide,5,2007,1341,1341,1397,1397,1,56,56,0.040085898,0.040085898
FALSE,Wayne County,5/1/08,Hide,Hide,5,2008,1272,1272,1340,1340,1,68,68,0.050746269,0.050746269
FALSE,Wayne County,5/1/09,Hide,Hide,5,2009,1334,1334,1449,1449,1,115,115,0.079365079,0.079365079
FALSE,Wayne County,5/1/10,Hide,Hide,5,2010,1456,1456,1590,1590,1,134,134,0.08427673,0.08427673
FALSE,Wayne County,5/1/11,Hide,Hide,5,2011,1325,1325,1469,1469,1,144,144,0.098025868,0.098025868
FALSE,Wayne County,5/1/12,Hide,Hide,5,2012,1215,1215,1365,1365,1,150,150,0.10989011,0.10989011
FALSE,Wayne County,5/1/13,Hide,Hide,5,2013,1213,1213,1364,1364,1,151,151,0.110703812,0.110703812
FALSE,Wayne County,5/1/14,Hide,Hide,5,2014,1241,1241,1369,1369,1,128,128,0.093498904,0.093498904
FALSE,Wayne County,5/1/15,Hide,Hide,5,2015,1283,1283,1411,1411,1,128,128,0.090715804,0.090715804
FALSE,Wayne County,5/1/16,Hide,Hide,5,2016,1322,1322,1434,1434,1,112,112,0.078103208,0.078103208
FALSE,Wayne County,5/1/17,Hide,Hide,5,2017,1347,1347,1460,1460,1,113,113,0.07739726,0.07739726
FALSE,Wayne County,5/1/18,Hide,Hide,5,2018,1355,1355,1439,1439,1,84,84,0.058373871,0.058373871
FALSE,Wayne County,5/1/19,Show,Show,5,2019,1335,1335,1411,1411,1,76,76,0.053862509,0.053862509
TRUE,Wayne County,5/1/20,Show,Show,5,2020,1288,1288,1459,1459,1,171,171,0.117203564,0.117203564
FALSE,Weber County,5/1/93,Hide,Hide,5,1993,82637,82637,87353,87353,1,4716,4716,0.053987842,0.053987842
FALSE,Weber County,5/1/94,Hide,Hide,5,1994,87752,87752,91776,91776,1,4024,4024,0.043845886,0.043845886
FALSE,Weber County,5/1/95,Hide,Hide,5,1995,87962,87962,91879,91879,1,3917,3917,0.042632158,0.042632158
FALSE,Weber County,5/1/96,Hide,Hide,5,1996,91726,91726,95594,95594,1,3868,3868,0.040462791,0.040462791
FALSE,Weber County,5/1/97,Hide,Hide,5,1997,94835,94835,98559,98559,1,3724,3724,0.037784474,0.037784474
FALSE,Weber County,5/1/98,Hide,Hide,5,1998,96311,96311,101126,101126,1,4815,4815,0.047613868,0.047613868
FALSE,Weber County,5/1/99,Hide,Hide,5,1999,98083,98083,102519,102519,1,4436,4436,0.043270028,0.043270028
FALSE,Weber County,5/1/00,Hide,Hide,5,2000,96535,96535,100588,100588,1,4053,4053,0.040293077,0.040293077
FALSE,Weber County,5/1/01,Hide,Hide,5,2001,96870,96870,101970,101970,1,5100,5100,0.05001471,0.05001471
FALSE,Weber County,5/1/02,Hide,Hide,5,2002,97230,97230,103756,103756,1,6526,6526,0.062897567,0.062897567
FALSE,Weber County,5/1/03,Hide,Hide,5,2003,98451,98451,105366,105366,1,6915,6915,0.065628381,0.065628381
FALSE,Weber County,5/1/04,Hide,Hide,5,2004,100890,100890,106911,106911,1,6021,6021,0.056317872,0.056317872
FALSE,Weber County,5/1/05,Hide,Hide,5,2005,102804,102804,107801,107801,1,4997,4997,0.04635393,0.04635393
FALSE,Weber County,5/1/06,Hide,Hide,5,2006,105894,105894,109796,109796,1,3902,3902,0.035538635,0.035538635
FALSE,Weber County,5/1/07,Hide,Hide,5,2007,109240,109240,112479,112479,1,3239,3239,0.028796486,0.028796486
FALSE,Weber County,5/1/08,Hide,Hide,5,2008,109494,109494,113667,113667,1,4173,4173,0.036712502,0.036712502
FALSE,Weber County,5/1/09,Hide,Hide,5,2009,105399,105399,115142,115142,1,9743,9743,0.084617255,0.084617255
FALSE,Weber County,5/1/10,Hide,Hide,5,2010,103628,103628,113726,113726,1,10098,10098,0.088792361,0.088792361
FALSE,Weber County,5/1/11,Hide,Hide,5,2011,103218,103218,112341,112341,1,9123,9123,0.081208107,0.081208107
FALSE,Weber County,5/1/12,Hide,Hide,5,2012,105785,105785,113167,113167,1,7382,7382,0.06523103,0.06523103
FALSE,Weber County,5/1/13,Hide,Hide,5,2013,107883,107883,114099,114099,1,6216,6216,0.054479005,0.054479005
FALSE,Weber County,5/1/14,Hide,Hide,5,2014,109516,109516,114542,114542,1,5026,5026,0.043879101,0.043879101
FALSE,Weber County,5/1/15,Hide,Hide,5,2015,112073,112073,116926,116926,1,4853,4853,0.041504883,0.041504883
FALSE,Weber County,5/1/16,Hide,Hide,5,2016,114741,114741,119434,119434,1,4693,4693,0.039293668,0.039293668
FALSE,Weber County,5/1/17,Hide,Hide,5,2017,118682,118682,123192,123192,1,4510,4510,0.03660952,0.03660952
FALSE,Weber County,5/1/18,Hide,Hide,5,2018,120315,120315,124641,124641,1,4326,4326,0.03470768,0.03470768
FALSE,Weber County,5/1/19,Show,Show,5,2019,123267,123267,127079,127079,1,3812,3812,0.029997088,0.029997088
TRUE,Weber County,5/1/20,Show,Show,5,2020,119753,119753,131043,131043,1,11290,11290,0.086154926,0.086154926
FALSE,Beaver County,6/1/93,Hide,Hide,6,1993,2048,2048,2156,2156,1,108,108,0.050092764,0.050092764
FALSE,Beaver County,6/1/94,Hide,Hide,6,1994,2093,2093,2179,2179,1,86,86,0.039467646,0.039467646
FALSE,Beaver County,6/1/95,Hide,Hide,6,1995,2262,2262,2346,2346,1,84,84,0.035805627,0.035805627
FALSE,Beaver County,6/1/96,Hide,Hide,6,1996,2322,2322,2446,2446,1,124,124,0.050695012,0.050695012
FALSE,Beaver County,6/1/97,Hide,Hide,6,1997,2448,2448,2565,2565,1,117,117,0.045614035,0.045614035
FALSE,Beaver County,6/1/98,Hide,Hide,6,1998,2391,2391,2528,2528,1,137,137,0.054193038,0.054193038
FALSE,Beaver County,6/1/99,Hide,Hide,6,1999,2354,2354,2441,2441,1,87,87,0.035641131,0.035641131
FALSE,Beaver County,6/1/00,Hide,Hide,6,2000,2643,2643,2735,2735,1,92,92,0.033638026,0.033638026
FALSE,Beaver County,6/1/01,Hide,Hide,6,2001,2852,2852,2967,2967,1,115,115,0.03875969,0.03875969
FALSE,Beaver County,6/1/02,Hide,Hide,6,2002,2881,2881,3026,3026,1,145,145,0.047918044,0.047918044
FALSE,Beaver County,6/1/03,Hide,Hide,6,2003,2801,2801,2956,2956,1,155,155,0.052435724,0.052435724
FALSE,Beaver County,6/1/04,Hide,Hide,6,2004,3036,3036,3169,3169,1,133,133,0.041969075,0.041969075
FALSE,Beaver County,6/1/05,Hide,Hide,6,2005,2933,2933,3058,3058,1,125,125,0.04087639,0.04087639
FALSE,Beaver County,6/1/06,Hide,Hide,6,2006,3040,3040,3136,3136,1,96,96,0.030612245,0.030612245
FALSE,Beaver County,6/1/07,Hide,Hide,6,2007,3059,3059,3139,3139,1,80,80,0.025485824,0.025485824
FALSE,Beaver County,6/1/08,Hide,Hide,6,2008,2975,2975,3071,3071,1,96,96,0.031260176,0.031260176
FALSE,Beaver County,6/1/09,Hide,Hide,6,2009,3365,3365,3571,3571,1,206,206,0.057686922,0.057686922
FALSE,Beaver County,6/1/10,Hide,Hide,6,2010,2807,2807,3137,3137,1,330,330,0.105196047,0.105196047
FALSE,Beaver County,6/1/11,Hide,Hide,6,2011,2822,2822,3066,3066,1,244,244,0.079582518,0.079582518
FALSE,Beaver County,6/1/12,Hide,Hide,6,2012,2719,2719,2897,2897,1,178,178,0.061442872,0.061442872
FALSE,Beaver County,6/1/13,Hide,Hide,6,2013,2862,2862,3006,3006,1,144,144,0.047904192,0.047904192
FALSE,Beaver County,6/1/14,Hide,Hide,6,2014,2813,2813,2928,2928,1,115,115,0.039275956,0.039275956
FALSE,Beaver County,6/1/15,Hide,Hide,6,2015,3066,3066,3189,3189,1,123,123,0.038570085,0.038570085
FALSE,Beaver County,6/1/16,Hide,Hide,6,2016,2949,2949,3105,3105,1,156,156,0.050241546,0.050241546
FALSE,Beaver County,6/1/17,Hide,Hide,6,2017,2898,2898,3014,3014,1,116,116,0.03848706,0.03848706
FALSE,Beaver County,6/1/18,Hide,Hide,6,2018,2891,2891,2995,2995,1,104,104,0.034724541,0.034724541
FALSE,Beaver County,6/1/19,Hide,Hide,6,2019,2777,2777,2868,2868,1,91,91,0.031729428,0.031729428
FALSE,Box Elder County,6/1/93,Hide,Hide,6,1993,16541,16541,17457,17457,1,916,916,0.052471788,0.052471788
FALSE,Box Elder County,6/1/94,Hide,Hide,6,1994,17108,17108,17963,17963,1,855,855,0.04759784,0.04759784
FALSE,Box Elder County,6/1/95,Hide,Hide,6,1995,17018,17018,17852,17852,1,834,834,0.046717455,0.046717455
FALSE,Box Elder County,6/1/96,Hide,Hide,6,1996,17070,17070,17816,17816,1,746,746,0.041872474,0.041872474
FALSE,Box Elder County,6/1/97,Hide,Hide,6,1997,18013,18013,18706,18706,1,693,693,0.037046937,0.037046937
FALSE,Box Elder County,6/1/98,Hide,Hide,6,1998,18331,18331,19257,19257,1,926,926,0.04808641,0.04808641
FALSE,Box Elder County,6/1/99,Hide,Hide,6,1999,17583,17583,18449,18449,1,866,866,0.046940214,0.046940214
FALSE,Box Elder County,6/1/00,Hide,Hide,6,2000,19368,19368,20085,20085,1,717,717,0.035698282,0.035698282
FALSE,Box Elder County,6/1/01,Hide,Hide,6,2001,19412,19412,20316,20316,1,904,904,0.044496948,0.044496948
FALSE,Box Elder County,6/1/02,Hide,Hide,6,2002,19923,19923,21112,21112,1,1189,1189,0.056318681,0.056318681
FALSE,Box Elder County,6/1/03,Hide,Hide,6,2003,20023,20023,21199,21199,1,1176,1176,0.055474315,0.055474315
FALSE,Box Elder County,6/1/04,Hide,Hide,6,2004,20993,20993,22114,22114,1,1121,1121,0.050691869,0.050691869
FALSE,Box Elder County,6/1/05,Hide,Hide,6,2005,21414,21414,22385,22385,1,971,971,0.043377262,0.043377262
FALSE,Box Elder County,6/1/06,Hide,Hide,6,2006,22112,22112,22863,22863,1,751,751,0.032847833,0.032847833
FALSE,Box Elder County,6/1/07,Hide,Hide,6,2007,22824,22824,23451,23451,1,627,627,0.0267366,0.0267366
FALSE,Box Elder County,6/1/08,Hide,Hide,6,2008,22830,22830,23696,23696,1,866,866,0.036546253,0.036546253
FALSE,Box Elder County,6/1/09,Hide,Hide,6,2009,21240,21240,23096,23096,1,1856,1856,0.080360236,0.080360236
FALSE,Box Elder County,6/1/10,Hide,Hide,6,2010,21719,21719,23734,23734,1,2015,2015,0.084899301,0.084899301
FALSE,Box Elder County,6/1/11,Hide,Hide,6,2011,21424,21424,23194,23194,1,1770,1770,0.07631284,0.07631284
FALSE,Box Elder County,6/1/12,Hide,Hide,6,2012,21608,21608,22946,22946,1,1338,1338,0.058310817,0.058310817
FALSE,Box Elder County,6/1/13,Hide,Hide,6,2013,22019,22019,23115,23115,1,1096,1096,0.047415098,0.047415098
FALSE,Box Elder County,6/1/14,Hide,Hide,6,2014,22449,22449,23355,23355,1,906,906,0.03879255,0.03879255
FALSE,Box Elder County,6/1/15,Hide,Hide,6,2015,23144,23144,24040,24040,1,896,896,0.037271215,0.037271215
FALSE,Box Elder County,6/1/16,Hide,Hide,6,2016,23819,23819,24674,24674,1,855,855,0.03465186,0.03465186
FALSE,Box Elder County,6/1/17,Hide,Hide,6,2017,24434,24434,25267,25267,1,833,833,0.032967903,0.032967903
FALSE,Box Elder County,6/1/18,Hide,Hide,6,2018,24593,24593,25349,25349,1,756,756,0.029823662,0.029823662
FALSE,Box Elder County,6/1/19,Hide,Hide,6,2019,25197,25197,25872,25872,1,675,675,0.026089981,0.026089981
FALSE,Cache County,6/1/93,Hide,Hide,6,1993,37471,37471,38639,38639,1,1168,1168,0.030228526,0.030228526
FALSE,Cache County,6/1/94,Hide,Hide,6,1994,39035,39035,40187,40187,1,1152,1152,0.028665987,0.028665987
FALSE,Cache County,6/1/95,Hide,Hide,6,1995,40535,40535,41843,41843,1,1308,1308,0.031259709,0.031259709
FALSE,Cache County,6/1/96,Hide,Hide,6,1996,40762,40762,42002,42002,1,1240,1240,0.029522404,0.029522404
FALSE,Cache County,6/1/97,Hide,Hide,6,1997,42301,42301,43354,43354,1,1053,1053,0.024288416,0.024288416
FALSE,Cache County,6/1/98,Hide,Hide,6,1998,43081,43081,44493,44493,1,1412,1412,0.031735329,0.031735329
FALSE,Cache County,6/1/99,Hide,Hide,6,1999,44047,44047,45234,45234,1,1187,1187,0.026241323,0.026241323
FALSE,Cache County,6/1/00,Hide,Hide,6,2000,46976,46976,48296,48296,1,1320,1320,0.027331456,0.027331456
FALSE,Cache County,6/1/01,Hide,Hide,6,2001,48147,48147,49867,49867,1,1720,1720,0.034491748,0.034491748
FALSE,Cache County,6/1/02,Hide,Hide,6,2002,50315,50315,52528,52528,1,2213,2213,0.042129912,0.042129912
FALSE,Cache County,6/1/03,Hide,Hide,6,2003,51527,51527,53625,53625,1,2098,2098,0.039123543,0.039123543
FALSE,Cache County,6/1/04,Hide,Hide,6,2004,54213,54213,56287,56287,1,2074,2074,0.036846874,0.036846874
FALSE,Cache County,6/1/05,Hide,Hide,6,2005,55203,55203,57056,57056,1,1853,1853,0.032476865,0.032476865
FALSE,Cache County,6/1/06,Hide,Hide,6,2006,57114,57114,58462,58462,1,1348,1348,0.023057713,0.023057713
FALSE,Cache County,6/1/07,Hide,Hide,6,2007,59501,59501,60704,60704,1,1203,1203,0.019817475,0.019817475
FALSE,Cache County,6/1/08,Hide,Hide,6,2008,60028,60028,61571,61571,1,1543,1543,0.025060499,0.025060499
FALSE,Cache County,6/1/09,Hide,Hide,6,2009,58602,58602,62091,62091,1,3489,3489,0.056191719,0.056191719
FALSE,Cache County,6/1/10,Hide,Hide,6,2010,53500,53500,56994,56994,1,3494,3494,0.061304699,0.061304699
FALSE,Cache County,6/1/11,Hide,Hide,6,2011,53712,53712,56670,56670,1,2958,2958,0.05219693,0.05219693
FALSE,Cache County,6/1/12,Hide,Hide,6,2012,54429,54429,56965,56965,1,2536,2536,0.044518564,0.044518564
FALSE,Cache County,6/1/13,Hide,Hide,6,2013,55349,55349,57697,57697,1,2348,2348,0.040695357,0.040695357
FALSE,Cache County,6/1/14,Hide,Hide,6,2014,56893,56893,58748,58748,1,1855,1855,0.031575543,0.031575543
FALSE,Cache County,6/1/15,Hide,Hide,6,2015,58407,58407,60253,60253,1,1846,1846,0.030637479,0.030637479
FALSE,Cache County,6/1/16,Hide,Hide,6,2016,59276,59276,61168,61168,1,1892,1892,0.030931206,0.030931206
FALSE,Cache County,6/1/17,Hide,Hide,6,2017,60700,60700,62441,62441,1,1741,1741,0.027882321,0.027882321
FALSE,Cache County,6/1/18,Hide,Hide,6,2018,61524,61524,63208,63208,1,1684,1684,0.026642197,0.026642197
FALSE,Cache County,6/1/19,Hide,Hide,6,2019,62688,62688,64074,64074,1,1386,1386,0.021631239,0.021631239
FALSE,Carbon County,6/1/93,Hide,Hide,6,1993,8313,8313,8984,8984,1,671,671,0.074688335,0.074688335
FALSE,Carbon County,6/1/94,Hide,Hide,6,1994,8647,8647,9382,9382,1,735,735,0.078341505,0.078341505
FALSE,Carbon County,6/1/95,Hide,Hide,6,1995,8494,8494,9080,9080,1,586,586,0.064537445,0.064537445
FALSE,Carbon County,6/1/96,Hide,Hide,6,1996,8855,8855,9424,9424,1,569,569,0.060377759,0.060377759
FALSE,Carbon County,6/1/97,Hide,Hide,6,1997,9232,9232,9703,9703,1,471,471,0.048541688,0.048541688
FALSE,Carbon County,6/1/98,Hide,Hide,6,1998,9255,9255,9840,9840,1,585,585,0.05945122,0.05945122
FALSE,Carbon County,6/1/99,Hide,Hide,6,1999,9227,9227,9921,9921,1,694,694,0.069952626,0.069952626
FALSE,Carbon County,6/1/00,Hide,Hide,6,2000,8800,8800,9297,9297,1,497,497,0.053458105,0.053458105
FALSE,Carbon County,6/1/01,Hide,Hide,6,2001,8410,8410,8994,8994,1,584,584,0.064932177,0.064932177
FALSE,Carbon County,6/1/02,Hide,Hide,6,2002,8832,8832,9484,9484,1,652,652,0.068747364,0.068747364
FALSE,Carbon County,6/1/03,Hide,Hide,6,2003,8650,8650,9371,9371,1,721,721,0.076939494,0.076939494
FALSE,Carbon County,6/1/04,Hide,Hide,6,2004,8662,8662,9274,9274,1,612,612,0.065990942,0.065990942
FALSE,Carbon County,6/1/05,Hide,Hide,6,2005,9038,9038,9497,9497,1,459,459,0.048331052,0.048331052
FALSE,Carbon County,6/1/06,Hide,Hide,6,2006,9526,9526,9878,9878,1,352,352,0.035634744,0.035634744
FALSE,Carbon County,6/1/07,Hide,Hide,6,2007,9362,9362,9689,9689,1,327,327,0.033749613,0.033749613
FALSE,Carbon County,6/1/08,Hide,Hide,6,2008,9563,9563,10003,10003,1,440,440,0.043986804,0.043986804
FALSE,Carbon County,6/1/09,Hide,Hide,6,2009,9685,9685,10526,10526,1,841,841,0.079897397,0.079897397
FALSE,Carbon County,6/1/10,Hide,Hide,6,2010,9063,9063,9906,9906,1,843,843,0.085099939,0.085099939
FALSE,Carbon County,6/1/11,Hide,Hide,6,2011,8817,8817,9533,9533,1,716,716,0.075107521,0.075107521
FALSE,Carbon County,6/1/12,Hide,Hide,6,2012,8643,8643,9288,9288,1,645,645,0.069444444,0.069444444
FALSE,Carbon County,6/1/13,Hide,Hide,6,2013,8436,8436,9007,9007,1,571,571,0.063395137,0.063395137
FALSE,Carbon County,6/1/14,Hide,Hide,6,2014,8207,8207,8644,8644,1,437,437,0.050555298,0.050555298
FALSE,Carbon County,6/1/15,Hide,Hide,6,2015,8220,8220,8720,8720,1,500,500,0.05733945,0.05733945
FALSE,Carbon County,6/1/16,Hide,Hide,6,2016,7865,7865,8354,8354,1,489,489,0.058534834,0.058534834
FALSE,Carbon County,6/1/17,Hide,Hide,6,2017,7852,7852,8267,8267,1,415,415,0.050199589,0.050199589
FALSE,Carbon County,6/1/18,Hide,Hide,6,2018,8091,8091,8470,8470,1,379,379,0.044746163,0.044746163
FALSE,Carbon County,6/1/19,Hide,Hide,6,2019,8186,8186,8504,8504,1,318,318,0.037394167,0.037394167
FALSE,Daggett County,6/1/93,Hide,Hide,6,1993,385,385,401,401,1,16,16,0.039900249,0.039900249
FALSE,Daggett County,6/1/94,Hide,Hide,6,1994,460,460,481,481,1,21,21,0.043659044,0.043659044
FALSE,Daggett County,6/1/95,Hide,Hide,6,1995,421,421,448,448,1,27,27,0.060267857,0.060267857
FALSE,Daggett County,6/1/96,Hide,Hide,6,1996,391,391,409,409,1,18,18,0.04400978,0.04400978
FALSE,Daggett County,6/1/97,Hide,Hide,6,1997,392,392,409,409,1,17,17,0.041564792,0.041564792
FALSE,Daggett County,6/1/98,Hide,Hide,6,1998,406,406,424,424,1,18,18,0.04245283,0.04245283
FALSE,Daggett County,6/1/99,Hide,Hide,6,1999,432,432,448,448,1,16,16,0.035714286,0.035714286
FALSE,Daggett County,6/1/00,Hide,Hide,6,2000,457,457,473,473,1,16,16,0.033826638,0.033826638
FALSE,Daggett County,6/1/01,Hide,Hide,6,2001,439,439,461,461,1,22,22,0.047722343,0.047722343
FALSE,Daggett County,6/1/02,Hide,Hide,6,2002,475,475,500,500,1,25,25,0.05,0.05
FALSE,Daggett County,6/1/03,Hide,Hide,6,2003,453,453,479,479,1,26,26,0.054279749,0.054279749
FALSE,Daggett County,6/1/04,Hide,Hide,6,2004,490,490,518,518,1,28,28,0.054054054,0.054054054
FALSE,Daggett County,6/1/05,Hide,Hide,6,2005,469,469,491,491,1,22,22,0.044806517,0.044806517
FALSE,Daggett County,6/1/06,Hide,Hide,6,2006,487,487,512,512,1,25,25,0.048828125,0.048828125
FALSE,Daggett County,6/1/07,Hide,Hide,6,2007,515,515,534,534,1,19,19,0.035580524,0.035580524
FALSE,Daggett County,6/1/08,Hide,Hide,6,2008,415,415,433,433,1,18,18,0.041570439,0.041570439
FALSE,Daggett County,6/1/09,Hide,Hide,6,2009,444,444,470,470,1,26,26,0.055319149,0.055319149
FALSE,Daggett County,6/1/10,Hide,Hide,6,2010,460,460,497,497,1,37,37,0.07444668,0.07444668
FALSE,Daggett County,6/1/11,Hide,Hide,6,2011,446,446,476,476,1,30,30,0.06302521,0.06302521
FALSE,Daggett County,6/1/12,Hide,Hide,6,2012,416,416,438,438,1,22,22,0.050228311,0.050228311
FALSE,Daggett County,6/1/13,Hide,Hide,6,2013,413,413,435,435,1,22,22,0.050574713,0.050574713
FALSE,Daggett County,6/1/14,Hide,Hide,6,2014,402,402,419,419,1,17,17,0.040572792,0.040572792
FALSE,Daggett County,6/1/15,Hide,Hide,6,2015,444,444,465,465,1,21,21,0.04516129,0.04516129
FALSE,Daggett County,6/1/16,Hide,Hide,6,2016,451,451,475,475,1,24,24,0.050526316,0.050526316
FALSE,Daggett County,6/1/17,Hide,Hide,6,2017,400,400,423,423,1,23,23,0.054373522,0.054373522
FALSE,Daggett County,6/1/18,Hide,Hide,6,2018,386,386,404,404,1,18,18,0.044554455,0.044554455
FALSE,Daggett County,6/1/19,Hide,Hide,6,2019,377,377,393,393,1,16,16,0.040712468,0.040712468
FALSE,Davis County,6/1/93,Hide,Hide,6,1993,96354,96354,100117,100117,1,3763,3763,0.037586024,0.037586024
FALSE,Davis County,6/1/94,Hide,Hide,6,1994,102196,102196,105826,105826,1,3630,3630,0.034301589,0.034301589
FALSE,Davis County,6/1/95,Hide,Hide,6,1995,102068,102068,105605,105605,1,3537,3537,0.033492732,0.033492732
FALSE,Davis County,6/1/96,Hide,Hide,6,1996,107685,107685,111150,111150,1,3465,3465,0.031174089,0.031174089
FALSE,Davis County,6/1/97,Hide,Hide,6,1997,112283,112283,115701,115701,1,3418,3418,0.029541663,0.029541663
FALSE,Davis County,6/1/98,Hide,Hide,6,1998,116394,116394,120429,120429,1,4035,4035,0.033505219,0.033505219
FALSE,Davis County,6/1/99,Hide,Hide,6,1999,120261,120261,124380,124380,1,4119,4119,0.033116257,0.033116257
FALSE,Davis County,6/1/00,Hide,Hide,6,2000,116431,116431,120007,120007,1,3576,3576,0.029798262,0.029798262
FALSE,Davis County,6/1/01,Hide,Hide,6,2001,117297,117297,122132,122132,1,4835,4835,0.039588314,0.039588314
FALSE,Davis County,6/1/02,Hide,Hide,6,2002,118555,118555,124917,124917,1,6362,6362,0.050929817,0.050929817
FALSE,Davis County,6/1/03,Hide,Hide,6,2003,121348,121348,127911,127911,1,6563,6563,0.051309113,0.051309113
FALSE,Davis County,6/1/04,Hide,Hide,6,2004,125971,125971,132213,132213,1,6242,6242,0.047211696,0.047211696
FALSE,Davis County,6/1/05,Hide,Hide,6,2005,130258,130258,135636,135636,1,5378,5378,0.03965024,0.03965024
FALSE,Davis County,6/1/06,Hide,Hide,6,2006,136492,136492,140606,140606,1,4114,4114,0.029259064,0.029259064
FALSE,Davis County,6/1/07,Hide,Hide,6,2007,141077,141077,144612,144612,1,3535,3535,0.024444721,0.024444721
FALSE,Davis County,6/1/08,Hide,Hide,6,2008,140955,140955,145512,145512,1,4557,4557,0.031317005,0.031317005
FALSE,Davis County,6/1/09,Hide,Hide,6,2009,135352,135352,144993,144993,1,9641,9641,0.066492865,0.066492865
FALSE,Davis County,6/1/10,Hide,Hide,6,2010,137178,137178,147529,147529,1,10351,10351,0.070162477,0.070162477
FALSE,Davis County,6/1/11,Hide,Hide,6,2011,137341,137341,146305,146305,1,8964,8964,0.061269266,0.061269266
FALSE,Davis County,6/1/12,Hide,Hide,6,2012,141109,141109,148325,148325,1,7216,7216,0.048649924,0.048649924
FALSE,Davis County,6/1/13,Hide,Hide,6,2013,145775,145775,152310,152310,1,6535,6535,0.042905916,0.042905916
FALSE,Davis County,6/1/14,Hide,Hide,6,2014,150017,150017,155554,155554,1,5537,5537,0.035595356,0.035595356
FALSE,Davis County,6/1/15,Hide,Hide,6,2015,154320,154320,159813,159813,1,5493,5493,0.034371422,0.034371422
FALSE,Davis County,6/1/16,Hide,Hide,6,2016,158657,158657,163818,163818,1,5161,5161,0.031504474,0.031504474
FALSE,Davis County,6/1/17,Hide,Hide,6,2017,163647,163647,168886,168886,1,5239,5239,0.031020925,0.031020925
FALSE,Davis County,6/1/18,Hide,Hide,6,2018,164862,164862,169707,169707,1,4845,4845,0.028549205,0.028549205
FALSE,Davis County,6/1/19,Hide,Hide,6,2019,169402,169402,173614,173614,1,4212,4212,0.024260716,0.024260716
FALSE,Duchesne County,6/1/93,Hide,Hide,6,1993,5279,5279,5776,5776,1,497,497,0.086045706,0.086045706
FALSE,Duchesne County,6/1/94,Hide,Hide,6,1994,5271,5271,5868,5868,1,597,597,0.101738241,0.101738241
FALSE,Duchesne County,6/1/95,Hide,Hide,6,1995,5217,5217,5739,5739,1,522,522,0.090956613,0.090956613
FALSE,Duchesne County,6/1/96,Hide,Hide,6,1996,5288,5288,5777,5777,1,489,489,0.08464601,0.08464601
FALSE,Duchesne County,6/1/97,Hide,Hide,6,1997,5504,5504,5895,5895,1,391,391,0.066327396,0.066327396
FALSE,Duchesne County,6/1/98,Hide,Hide,6,1998,5671,5671,6100,6100,1,429,429,0.070327869,0.070327869
FALSE,Duchesne County,6/1/99,Hide,Hide,6,1999,5466,5466,6036,6036,1,570,570,0.0944334,0.0944334
FALSE,Duchesne County,6/1/00,Hide,Hide,6,2000,5824,5824,6127,6127,1,303,303,0.04945324,0.04945324
FALSE,Duchesne County,6/1/01,Hide,Hide,6,2001,6323,6323,6656,6656,1,333,333,0.050030048,0.050030048
FALSE,Duchesne County,6/1/02,Hide,Hide,6,2002,6528,6528,7000,7000,1,472,472,0.067428571,0.067428571
FALSE,Duchesne County,6/1/03,Hide,Hide,6,2003,6427,6427,6870,6870,1,443,443,0.064483261,0.064483261
FALSE,Duchesne County,6/1/04,Hide,Hide,6,2004,6976,6976,7387,7387,1,411,411,0.055638283,0.055638283
FALSE,Duchesne County,6/1/05,Hide,Hide,6,2005,7309,7309,7639,7639,1,330,330,0.043199372,0.043199372
FALSE,Duchesne County,6/1/06,Hide,Hide,6,2006,8212,8212,8459,8459,1,247,247,0.029199669,0.029199669
FALSE,Duchesne County,6/1/07,Hide,Hide,6,2007,8977,8977,9184,9184,1,207,207,0.022539199,0.022539199
FALSE,Duchesne County,6/1/08,Hide,Hide,6,2008,9984,9984,10241,10241,1,257,257,0.025095206,0.025095206
FALSE,Duchesne County,6/1/09,Hide,Hide,6,2009,9403,9403,10333,10333,1,930,930,0.090002903,0.090002903
FALSE,Duchesne County,6/1/10,Hide,Hide,6,2010,7386,7386,8161,8161,1,775,775,0.094963852,0.094963852
FALSE,Duchesne County,6/1/11,Hide,Hide,6,2011,7865,7865,8412,8412,1,547,547,0.065026153,0.065026153
FALSE,Duchesne County,6/1/12,Hide,Hide,6,2012,8759,8759,9179,9179,1,420,420,0.045756618,0.045756618
FALSE,Duchesne County,6/1/13,Hide,Hide,6,2013,8910,8910,9313,9313,1,403,403,0.043272844,0.043272844
FALSE,Duchesne County,6/1/14,Hide,Hide,6,2014,9255,9255,9591,9591,1,336,336,0.035032843,0.035032843
FALSE,Duchesne County,6/1/15,Hide,Hide,6,2015,8134,8134,8817,8817,1,683,683,0.07746399,0.07746399
FALSE,Duchesne County,6/1/16,Hide,Hide,6,2016,7361,7361,8081,8081,1,720,720,0.089097884,0.089097884
FALSE,Duchesne County,6/1/17,Hide,Hide,6,2017,7547,7547,7981,7981,1,434,434,0.05437915,0.05437915
FALSE,Duchesne County,6/1/18,Hide,Hide,6,2018,7376,7376,7720,7720,1,344,344,0.044559585,0.044559585
FALSE,Duchesne County,6/1/19,Hide,Hide,6,2019,7426,7426,7737,7737,1,311,311,0.040196459,0.040196459
FALSE,Emery County,6/1/93,Hide,Hide,6,1993,3746,3746,4107,4107,1,361,361,0.08789871,0.08789871
FALSE,Emery County,6/1/94,Hide,Hide,6,1994,3821,3821,4149,4149,1,328,328,0.079055194,0.079055194
FALSE,Emery County,6/1/95,Hide,Hide,6,1995,3903,3903,4232,4232,1,329,329,0.077741021,0.077741021
FALSE,Emery County,6/1/96,Hide,Hide,6,1996,3853,3853,4173,4173,1,320,320,0.076683441,0.076683441
FALSE,Emery County,6/1/97,Hide,Hide,6,1997,3918,3918,4191,4191,1,273,273,0.065139585,0.065139585
FALSE,Emery County,6/1/98,Hide,Hide,6,1998,3911,3911,4255,4255,1,344,344,0.080846063,0.080846063
FALSE,Emery County,6/1/99,Hide,Hide,6,1999,3726,3726,4007,4007,1,281,281,0.070127277,0.070127277
FALSE,Emery County,6/1/00,Hide,Hide,6,2000,4530,4530,4746,4746,1,216,216,0.04551201,0.04551201
FALSE,Emery County,6/1/01,Hide,Hide,6,2001,4389,4389,4710,4710,1,321,321,0.068152866,0.068152866
FALSE,Emery County,6/1/02,Hide,Hide,6,2002,4452,4452,4780,4780,1,328,328,0.068619247,0.068619247
FALSE,Emery County,6/1/03,Hide,Hide,6,2003,4478,4478,4865,4865,1,387,387,0.07954779,0.07954779
FALSE,Emery County,6/1/04,Hide,Hide,6,2004,4789,4789,5140,5140,1,351,351,0.068287938,0.068287938
FALSE,Emery County,6/1/05,Hide,Hide,6,2005,4859,4859,5125,5125,1,266,266,0.051902439,0.051902439
FALSE,Emery County,6/1/06,Hide,Hide,6,2006,5092,5092,5276,5276,1,184,184,0.034874905,0.034874905
FALSE,Emery County,6/1/07,Hide,Hide,6,2007,4930,4930,5096,5096,1,166,166,0.032574568,0.032574568
FALSE,Emery County,6/1/08,Hide,Hide,6,2008,4902,4902,5090,5090,1,188,188,0.036935167,0.036935167
FALSE,Emery County,6/1/09,Hide,Hide,6,2009,4868,4868,5236,5236,1,368,368,0.070282659,0.070282659
FALSE,Emery County,6/1/10,Hide,Hide,6,2010,4865,4865,5258,5258,1,393,393,0.074743248,0.074743248
FALSE,Emery County,6/1/11,Hide,Hide,6,2011,4614,4614,4989,4989,1,375,375,0.075165364,0.075165364
FALSE,Emery County,6/1/12,Hide,Hide,6,2012,4389,4389,4734,4734,1,345,345,0.07287706,0.07287706
FALSE,Emery County,6/1/13,Hide,Hide,6,2013,4447,4447,4733,4733,1,286,286,0.060426791,0.060426791
FALSE,Emery County,6/1/14,Hide,Hide,6,2014,4368,4368,4608,4608,1,240,240,0.052083333,0.052083333
FALSE,Emery County,6/1/15,Hide,Hide,6,2015,4138,4138,4406,4406,1,268,268,0.060826146,0.060826146
FALSE,Emery County,6/1/16,Hide,Hide,6,2016,3995,3995,4259,4259,1,264,264,0.061986382,0.061986382
FALSE,Emery County,6/1/17,Hide,Hide,6,2017,3964,3964,4181,4181,1,217,217,0.051901459,0.051901459
FALSE,Emery County,6/1/18,Hide,Hide,6,2018,4116,4116,4320,4320,1,204,204,0.047222222,0.047222222
FALSE,Emery County,6/1/19,Hide,Hide,6,2019,4132,4132,4301,4301,1,169,169,0.039293188,0.039293188
FALSE,Garfield County,6/1/93,Hide,Hide,6,1993,2110,2110,2311,2311,1,201,201,0.086975335,0.086975335
FALSE,Garfield County,6/1/94,Hide,Hide,6,1994,2317,2317,2570,2570,1,253,253,0.09844358,0.09844358
FALSE,Garfield County,6/1/95,Hide,Hide,6,1995,2289,2289,2632,2632,1,343,343,0.130319149,0.130319149
FALSE,Garfield County,6/1/96,Hide,Hide,6,1996,2393,2393,2654,2654,1,261,261,0.098342125,0.098342125
FALSE,Garfield County,6/1/97,Hide,Hide,6,1997,2526,2526,2755,2755,1,229,229,0.083121597,0.083121597
FALSE,Garfield County,6/1/98,Hide,Hide,6,1998,2494,2494,2734,2734,1,240,240,0.087783467,0.087783467
FALSE,Garfield County,6/1/99,Hide,Hide,6,1999,2736,2736,2962,2962,1,226,226,0.076299797,0.076299797
FALSE,Garfield County,6/1/00,Hide,Hide,6,2000,2313,2313,2471,2471,1,158,158,0.063941724,0.063941724
FALSE,Garfield County,6/1/01,Hide,Hide,6,2001,2393,2393,2586,2586,1,193,193,0.074632637,0.074632637
FALSE,Garfield County,6/1/02,Hide,Hide,6,2002,2301,2301,2574,2574,1,273,273,0.106060606,0.106060606
FALSE,Garfield County,6/1/03,Hide,Hide,6,2003,2312,2312,2547,2547,1,235,235,0.09226541,0.09226541
FALSE,Garfield County,6/1/04,Hide,Hide,6,2004,2447,2447,2655,2655,1,208,208,0.07834275,0.07834275
FALSE,Garfield County,6/1/05,Hide,Hide,6,2005,2511,2511,2709,2709,1,198,198,0.073089701,0.073089701
FALSE,Garfield County,6/1/06,Hide,Hide,6,2006,2534,2534,2672,2672,1,138,138,0.051646707,0.051646707
FALSE,Garfield County,6/1/07,Hide,Hide,6,2007,2570,2570,2683,2683,1,113,113,0.042117033,0.042117033
FALSE,Garfield County,6/1/08,Hide,Hide,6,2008,2657,2657,2813,2813,1,156,156,0.055456808,0.055456808
FALSE,Garfield County,6/1/09,Hide,Hide,6,2009,2555,2555,2858,2858,1,303,303,0.106018195,0.106018195
FALSE,Garfield County,6/1/10,Hide,Hide,6,2010,2780,2780,3102,3102,1,322,322,0.103803997,0.103803997
FALSE,Garfield County,6/1/11,Hide,Hide,6,2011,2666,2666,3002,3002,1,336,336,0.111925383,0.111925383
FALSE,Garfield County,6/1/12,Hide,Hide,6,2012,2605,2605,2888,2888,1,283,283,0.09799169,0.09799169
FALSE,Garfield County,6/1/13,Hide,Hide,6,2013,2511,2511,2766,2766,1,255,255,0.092190889,0.092190889
FALSE,Garfield County,6/1/14,Hide,Hide,6,2014,2442,2442,2672,2672,1,230,230,0.086077844,0.086077844
FALSE,Garfield County,6/1/15,Hide,Hide,6,2015,2510,2510,2758,2758,1,248,248,0.089920232,0.089920232
FALSE,Garfield County,6/1/16,Hide,Hide,6,2016,2542,2542,2778,2778,1,236,236,0.084953204,0.084953204
FALSE,Garfield County,6/1/17,Hide,Hide,6,2017,2687,2687,2901,2901,1,214,214,0.073767666,0.073767666
FALSE,Garfield County,6/1/18,Hide,Hide,6,2018,2567,2567,2774,2774,1,207,207,0.074621485,0.074621485
FALSE,Garfield County,6/1/19,Hide,Hide,6,2019,2617,2617,2780,2780,1,163,163,0.058633094,0.058633094
FALSE,Grand County,6/1/93,Hide,Hide,6,1993,4386,4386,4666,4666,1,280,280,0.060008573,0.060008573
FALSE,Grand County,6/1/94,Hide,Hide,6,1994,4575,4575,4901,4901,1,326,326,0.066517037,0.066517037
FALSE,Grand County,6/1/95,Hide,Hide,6,1995,4663,4663,4986,4986,1,323,323,0.064781388,0.064781388
FALSE,Grand County,6/1/96,Hide,Hide,6,1996,4706,4706,5057,5057,1,351,351,0.06940874,0.06940874
FALSE,Grand County,6/1/97,Hide,Hide,6,1997,4929,4929,5248,5248,1,319,319,0.060785061,0.060785061
FALSE,Grand County,6/1/98,Hide,Hide,6,1998,4856,4856,5232,5232,1,376,376,0.071865443,0.071865443
FALSE,Grand County,6/1/99,Hide,Hide,6,1999,5249,5249,5591,5591,1,342,342,0.061169737,0.061169737
FALSE,Grand County,6/1/00,Hide,Hide,6,2000,4325,4325,4637,4637,1,312,312,0.067284882,0.067284882
FALSE,Grand County,6/1/01,Hide,Hide,6,2001,4365,4365,4685,4685,1,320,320,0.068303095,0.068303095
FALSE,Grand County,6/1/02,Hide,Hide,6,2002,4448,4448,4813,4813,1,365,365,0.075836277,0.075836277
FALSE,Grand County,6/1/03,Hide,Hide,6,2003,4532,4532,4908,4908,1,376,376,0.076609617,0.076609617
FALSE,Grand County,6/1/04,Hide,Hide,6,2004,4498,4498,4862,4862,1,364,364,0.07486631,0.07486631
FALSE,Grand County,6/1/05,Hide,Hide,6,2005,4670,4670,4976,4976,1,306,306,0.061495177,0.061495177
FALSE,Grand County,6/1/06,Hide,Hide,6,2006,4788,4788,5036,5036,1,248,248,0.049245433,0.049245433
FALSE,Grand County,6/1/07,Hide,Hide,6,2007,4904,4904,5141,5141,1,237,237,0.046099981,0.046099981
FALSE,Grand County,6/1/08,Hide,Hide,6,2008,4978,4978,5257,5257,1,279,279,0.053072094,0.053072094
FALSE,Grand County,6/1/09,Hide,Hide,6,2009,4899,4899,5435,5435,1,536,536,0.098620055,0.098620055
FALSE,Grand County,6/1/10,Hide,Hide,6,2010,4746,4746,5321,5321,1,575,575,0.108062394,0.108062394
FALSE,Grand County,6/1/11,Hide,Hide,6,2011,4778,4778,5317,5317,1,539,539,0.101372955,0.101372955
FALSE,Grand County,6/1/12,Hide,Hide,6,2012,4961,4961,5424,5424,1,463,463,0.085361357,0.085361357
FALSE,Grand County,6/1/13,Hide,Hide,6,2013,5030,5030,5456,5456,1,426,426,0.078079179,0.078079179
FALSE,Grand County,6/1/14,Hide,Hide,6,2014,5154,5154,5496,5496,1,342,342,0.062227074,0.062227074
FALSE,Grand County,6/1/15,Hide,Hide,6,2015,5237,5237,5579,5579,1,342,342,0.061301308,0.061301308
FALSE,Grand County,6/1/16,Hide,Hide,6,2016,5388,5388,5718,5718,1,330,330,0.057712487,0.057712487
FALSE,Grand County,6/1/17,Hide,Hide,6,2017,5591,5591,5905,5905,1,314,314,0.053175275,0.053175275
FALSE,Grand County,6/1/18,Hide,Hide,6,2018,5796,5796,6069,6069,1,273,273,0.044982699,0.044982699
FALSE,Grand County,6/1/19,Hide,Hide,6,2019,5944,5944,6183,6183,1,239,239,0.038654375,0.038654375
FALSE,Iron County,6/1/93,Hide,Hide,6,1993,10672,10672,11099,11099,1,427,427,0.038471934,0.038471934
FALSE,Iron County,6/1/94,Hide,Hide,6,1994,11799,11799,12224,12224,1,425,425,0.03476767,0.03476767
FALSE,Iron County,6/1/95,Hide,Hide,6,1995,12556,12556,12983,12983,1,427,427,0.032889163,0.032889163
FALSE,Iron County,6/1/96,Hide,Hide,6,1996,12829,12829,13330,13330,1,501,501,0.037584396,0.037584396
FALSE,Iron County,6/1/97,Hide,Hide,6,1997,13772,13772,14236,14236,1,464,464,0.032593425,0.032593425
FALSE,Iron County,6/1/98,Hide,Hide,6,1998,14259,14259,14829,14829,1,570,570,0.038438195,0.038438195
FALSE,Iron County,6/1/99,Hide,Hide,6,1999,14562,14562,15110,15110,1,548,548,0.036267373,0.036267373
FALSE,Iron County,6/1/00,Hide,Hide,6,2000,16488,16488,17025,17025,1,537,537,0.03154185,0.03154185
FALSE,Iron County,6/1/01,Hide,Hide,6,2001,16304,16304,17086,17086,1,782,782,0.045768465,0.045768465
FALSE,Iron County,6/1/02,Hide,Hide,6,2002,16727,16727,17666,17666,1,939,939,0.053152949,0.053152949
FALSE,Iron County,6/1/03,Hide,Hide,6,2003,16871,16871,17797,17797,1,926,926,0.052031241,0.052031241
FALSE,Iron County,6/1/04,Hide,Hide,6,2004,17928,17928,18798,18798,1,870,870,0.046281519,0.046281519
FALSE,Iron County,6/1/05,Hide,Hide,6,2005,19006,19006,19768,19768,1,762,762,0.038547147,0.038547147
FALSE,Iron County,6/1/06,Hide,Hide,6,2006,20352,20352,20958,20958,1,606,606,0.028914973,0.028914973
FALSE,Iron County,6/1/07,Hide,Hide,6,2007,20506,20506,21100,21100,1,594,594,0.028151659,0.028151659
FALSE,Iron County,6/1/08,Hide,Hide,6,2008,20065,20065,20909,20909,1,844,844,0.040365393,0.040365393
FALSE,Iron County,6/1/09,Hide,Hide,6,2009,18945,18945,20801,20801,1,1856,1856,0.089226479,0.089226479
FALSE,Iron County,6/1/10,Hide,Hide,6,2010,18463,18463,20478,20478,1,2015,2015,0.098398281,0.098398281
FALSE,Iron County,6/1/11,Hide,Hide,6,2011,18182,18182,19821,19821,1,1639,1639,0.082690076,0.082690076
FALSE,Iron County,6/1/12,Hide,Hide,6,2012,18146,18146,19486,19486,1,1340,1340,0.06876732,0.06876732
FALSE,Iron County,6/1/13,Hide,Hide,6,2013,18300,18300,19383,19383,1,1083,1083,0.055873704,0.055873704
FALSE,Iron County,6/1/14,Hide,Hide,6,2014,18942,18942,19818,19818,1,876,876,0.04420224,0.04420224
FALSE,Iron County,6/1/15,Hide,Hide,6,2015,19435,19435,20332,20332,1,897,897,0.044117647,0.044117647
FALSE,Iron County,6/1/16,Hide,Hide,6,2016,20619,20619,21560,21560,1,941,941,0.04364564,0.04364564
FALSE,Iron County,6/1/17,Hide,Hide,6,2017,21197,21197,22146,22146,1,949,949,0.042851982,0.042851982
FALSE,Iron County,6/1/18,Hide,Hide,6,2018,22038,22038,22849,22849,1,811,811,0.035493895,0.035493895
FALSE,Iron County,6/1/19,Hide,Hide,6,2019,23261,23261,23970,23970,1,709,709,0.02957864,0.02957864
FALSE,Juab County,6/1/93,Hide,Hide,6,1993,3037,3037,3252,3252,1,215,215,0.066113161,0.066113161
FALSE,Juab County,6/1/94,Hide,Hide,6,1994,3175,3175,3332,3332,1,157,157,0.047118848,0.047118848
FALSE,Juab County,6/1/95,Hide,Hide,6,1995,3162,3162,3329,3329,1,167,167,0.050165215,0.050165215
FALSE,Juab County,6/1/96,Hide,Hide,6,1996,3297,3297,3431,3431,1,134,134,0.039055669,0.039055669
FALSE,Juab County,6/1/97,Hide,Hide,6,1997,3267,3267,3393,3393,1,126,126,0.037135279,0.037135279
FALSE,Juab County,6/1/98,Hide,Hide,6,1998,3488,3488,3642,3642,1,154,154,0.042284459,0.042284459
FALSE,Juab County,6/1/99,Hide,Hide,6,1999,3501,3501,3685,3685,1,184,184,0.049932157,0.049932157
FALSE,Juab County,6/1/00,Hide,Hide,6,2000,3579,3579,3707,3707,1,128,128,0.034529269,0.034529269
FALSE,Juab County,6/1/01,Hide,Hide,6,2001,3568,3568,3752,3752,1,184,184,0.049040512,0.049040512
FALSE,Juab County,6/1/02,Hide,Hide,6,2002,3396,3396,3674,3674,1,278,278,0.075666848,0.075666848
FALSE,Juab County,6/1/03,Hide,Hide,6,2003,3407,3407,3664,3664,1,257,257,0.070141921,0.070141921
FALSE,Juab County,6/1/04,Hide,Hide,6,2004,3576,3576,3823,3823,1,247,247,0.064608946,0.064608946
FALSE,Juab County,6/1/05,Hide,Hide,6,2005,3720,3720,3900,3900,1,180,180,0.046153846,0.046153846
FALSE,Juab County,6/1/06,Hide,Hide,6,2006,3870,3870,4028,4028,1,158,158,0.039225422,0.039225422
FALSE,Juab County,6/1/07,Hide,Hide,6,2007,3988,3988,4114,4114,1,126,126,0.030627127,0.030627127
FALSE,Juab County,6/1/08,Hide,Hide,6,2008,3740,3740,3930,3930,1,190,190,0.048346056,0.048346056
FALSE,Juab County,6/1/09,Hide,Hide,6,2009,3559,3559,3940,3940,1,381,381,0.096700508,0.096700508
FALSE,Juab County,6/1/10,Hide,Hide,6,2010,4196,4196,4633,4633,1,437,437,0.094323333,0.094323333
FALSE,Juab County,6/1/11,Hide,Hide,6,2011,4204,4204,4598,4598,1,394,394,0.08568943,0.08568943
FALSE,Juab County,6/1/12,Hide,Hide,6,2012,4339,4339,4623,4623,1,284,284,0.061431971,0.061431971
FALSE,Juab County,6/1/13,Hide,Hide,6,2013,4463,4463,4701,4701,1,238,238,0.050627526,0.050627526
FALSE,Juab County,6/1/14,Hide,Hide,6,2014,4583,4583,4775,4775,1,192,192,0.040209424,0.040209424
FALSE,Juab County,6/1/15,Hide,Hide,6,2015,4739,4739,4937,4937,1,198,198,0.040105327,0.040105327
FALSE,Juab County,6/1/16,Hide,Hide,6,2016,5029,5029,5222,5222,1,193,193,0.03695902,0.03695902
FALSE,Juab County,6/1/17,Hide,Hide,6,2017,5222,5222,5402,5402,1,180,180,0.033320992,0.033320992
FALSE,Juab County,6/1/18,Hide,Hide,6,2018,5382,5382,5543,5543,1,161,161,0.029045643,0.029045643
FALSE,Juab County,6/1/19,Hide,Hide,6,2019,5555,5555,5704,5704,1,149,149,0.02612202,0.02612202
FALSE,Kane County,6/1/93,Hide,Hide,6,1993,2221,2221,2364,2364,1,143,143,0.060490694,0.060490694
FALSE,Kane County,6/1/94,Hide,Hide,6,1994,2454,2454,2703,2703,1,249,249,0.092119867,0.092119867
FALSE,Kane County,6/1/95,Hide,Hide,6,1995,2450,2450,2701,2701,1,251,251,0.092928545,0.092928545
FALSE,Kane County,6/1/96,Hide,Hide,6,1996,2369,2369,2570,2570,1,201,201,0.078210117,0.078210117
FALSE,Kane County,6/1/97,Hide,Hide,6,1997,2458,2458,2572,2572,1,114,114,0.044323484,0.044323484
FALSE,Kane County,6/1/98,Hide,Hide,6,1998,2566,2566,2652,2652,1,86,86,0.032428356,0.032428356
FALSE,Kane County,6/1/99,Hide,Hide,6,1999,2607,2607,2705,2705,1,98,98,0.036229205,0.036229205
FALSE,Kane County,6/1/00,Hide,Hide,6,2000,3034,3034,3152,3152,1,118,118,0.037436548,0.037436548
FALSE,Kane County,6/1/01,Hide,Hide,6,2001,3044,3044,3181,3181,1,137,137,0.043068218,0.043068218
FALSE,Kane County,6/1/02,Hide,Hide,6,2002,2810,2810,2978,2978,1,168,168,0.0564137,0.0564137
FALSE,Kane County,6/1/03,Hide,Hide,6,2003,2952,2952,3128,3128,1,176,176,0.056265985,0.056265985
FALSE,Kane County,6/1/04,Hide,Hide,6,2004,3117,3117,3306,3306,1,189,189,0.057168784,0.057168784
FALSE,Kane County,6/1/05,Hide,Hide,6,2005,3090,3090,3253,3253,1,163,163,0.050107593,0.050107593
FALSE,Kane County,6/1/06,Hide,Hide,6,2006,3311,3311,3436,3436,1,125,125,0.036379511,0.036379511
FALSE,Kane County,6/1/07,Hide,Hide,6,2007,3369,3369,3477,3477,1,108,108,0.03106126,0.03106126
FALSE,Kane County,6/1/08,Hide,Hide,6,2008,3338,3338,3472,3472,1,134,134,0.03859447,0.03859447
FALSE,Kane County,6/1/09,Hide,Hide,6,2009,3213,3213,3478,3478,1,265,265,0.076193214,0.076193214
FALSE,Kane County,6/1/10,Hide,Hide,6,2010,3278,3278,3557,3557,1,279,279,0.078436885,0.078436885
FALSE,Kane County,6/1/11,Hide,Hide,6,2011,3230,3230,3491,3491,1,261,261,0.074763678,0.074763678
FALSE,Kane County,6/1/12,Hide,Hide,6,2012,3234,3234,3475,3475,1,241,241,0.069352518,0.069352518
FALSE,Kane County,6/1/13,Hide,Hide,6,2013,3283,3283,3467,3467,1,184,184,0.05307182,0.05307182
FALSE,Kane County,6/1/14,Hide,Hide,6,2014,3414,3414,3580,3580,1,166,166,0.046368715,0.046368715
FALSE,Kane County,6/1/15,Hide,Hide,6,2015,3466,3466,3625,3625,1,159,159,0.043862069,0.043862069
FALSE,Kane County,6/1/16,Hide,Hide,6,2016,3543,3543,3686,3686,1,143,143,0.038795442,0.038795442
FALSE,Kane County,6/1/17,Hide,Hide,6,2017,3606,3606,3736,3736,1,130,130,0.034796574,0.034796574
FALSE,Kane County,6/1/18,Hide,Hide,6,2018,3657,3657,3774,3774,1,117,117,0.03100159,0.03100159
FALSE,Kane County,6/1/19,Hide,Hide,6,2019,3704,3704,3817,3817,1,113,113,0.029604401,0.029604401
FALSE,Millard County,6/1/93,Hide,Hide,6,1993,4408,4408,4674,4674,1,266,266,0.056910569,0.056910569
FALSE,Millard County,6/1/94,Hide,Hide,6,1994,4497,4497,4726,4726,1,229,229,0.048455353,0.048455353
FALSE,Millard County,6/1/95,Hide,Hide,6,1995,4487,4487,4715,4715,1,228,228,0.04835631,0.04835631
FALSE,Millard County,6/1/96,Hide,Hide,6,1996,4557,4557,4754,4754,1,197,197,0.041438788,0.041438788
FALSE,Millard County,6/1/97,Hide,Hide,6,1997,4556,4556,4728,4728,1,172,172,0.036379019,0.036379019
FALSE,Millard County,6/1/98,Hide,Hide,6,1998,4480,4480,4697,4697,1,217,217,0.046199702,0.046199702
FALSE,Millard County,6/1/99,Hide,Hide,6,1999,4511,4511,4717,4717,1,206,206,0.043671825,0.043671825
FALSE,Millard County,6/1/00,Hide,Hide,6,2000,5069,5069,5246,5246,1,177,177,0.033739992,0.033739992
FALSE,Millard County,6/1/01,Hide,Hide,6,2001,5389,5389,5612,5612,1,223,223,0.039736279,0.039736279
FALSE,Millard County,6/1/02,Hide,Hide,6,2002,5640,5640,5928,5928,1,288,288,0.048582996,0.048582996
FALSE,Millard County,6/1/03,Hide,Hide,6,2003,5628,5628,5918,5918,1,290,290,0.049003042,0.049003042
FALSE,Millard County,6/1/04,Hide,Hide,6,2004,5956,5956,6256,6256,1,300,300,0.047953964,0.047953964
FALSE,Millard County,6/1/05,Hide,Hide,6,2005,5870,5870,6119,6119,1,249,249,0.040692924,0.040692924
FALSE,Millard County,6/1/06,Hide,Hide,6,2006,6040,6040,6225,6225,1,185,185,0.029718876,0.029718876
FALSE,Millard County,6/1/07,Hide,Hide,6,2007,6029,6029,6180,6180,1,151,151,0.024433657,0.024433657
FALSE,Millard County,6/1/08,Hide,Hide,6,2008,5825,5825,6017,6017,1,192,192,0.031909589,0.031909589
FALSE,Millard County,6/1/09,Hide,Hide,6,2009,6096,6096,6459,6459,1,363,363,0.05620065,0.05620065
FALSE,Millard County,6/1/10,Hide,Hide,6,2010,5957,5957,6355,6355,1,398,398,0.062627852,0.062627852
FALSE,Millard County,6/1/11,Hide,Hide,6,2011,5873,5873,6198,6198,1,325,325,0.05243627,0.05243627
FALSE,Millard County,6/1/12,Hide,Hide,6,2012,5671,5671,5954,5954,1,283,283,0.047531072,0.047531072
FALSE,Millard County,6/1/13,Hide,Hide,6,2013,5680,5680,5928,5928,1,248,248,0.041835358,0.041835358
FALSE,Millard County,6/1/14,Hide,Hide,6,2014,5732,5732,5933,5933,1,201,201,0.033878308,0.033878308
FALSE,Millard County,6/1/15,Hide,Hide,6,2015,5976,5976,6190,6190,1,214,214,0.03457189,0.03457189
FALSE,Millard County,6/1/16,Hide,Hide,6,2016,6059,6059,6263,6263,1,204,204,0.03257225,0.03257225
FALSE,Millard County,6/1/17,Hide,Hide,6,2017,6162,6162,6376,6376,1,214,214,0.033563363,0.033563363
FALSE,Millard County,6/1/18,Hide,Hide,6,2018,5972,5972,6171,6171,1,199,199,0.03224761,0.03224761
FALSE,Millard County,6/1/19,Hide,Hide,6,2019,5841,5841,6008,6008,1,167,167,0.027796272,0.027796272
FALSE,Morgan County,6/1/93,Hide,Hide,6,1993,2792,2792,2965,2965,1,173,173,0.058347386,0.058347386
FALSE,Morgan County,6/1/94,Hide,Hide,6,1994,2839,2839,2982,2982,1,143,143,0.047954393,0.047954393
FALSE,Morgan County,6/1/95,Hide,Hide,6,1995,3297,3297,3449,3449,1,152,152,0.044070745,0.044070745
FALSE,Morgan County,6/1/96,Hide,Hide,6,1996,3394,3394,3539,3539,1,145,145,0.040972026,0.040972026
FALSE,Morgan County,6/1/97,Hide,Hide,6,1997,3437,3437,3576,3576,1,139,139,0.038870246,0.038870246
FALSE,Morgan County,6/1/98,Hide,Hide,6,1998,3541,3541,3686,3686,1,145,145,0.039338036,0.039338036
FALSE,Morgan County,6/1/99,Hide,Hide,6,1999,3421,3421,3565,3565,1,144,144,0.040392707,0.040392707
FALSE,Morgan County,6/1/00,Hide,Hide,6,2000,3285,3285,3404,3404,1,119,119,0.034958872,0.034958872
FALSE,Morgan County,6/1/01,Hide,Hide,6,2001,3327,3327,3457,3457,1,130,130,0.03760486,0.03760486
FALSE,Morgan County,6/1/02,Hide,Hide,6,2002,3353,3353,3539,3539,1,186,186,0.05255722,0.05255722
FALSE,Morgan County,6/1/03,Hide,Hide,6,2003,3386,3386,3571,3571,1,185,185,0.051806217,0.051806217
FALSE,Morgan County,6/1/04,Hide,Hide,6,2004,3496,3496,3675,3675,1,179,179,0.048707483,0.048707483
FALSE,Morgan County,6/1/05,Hide,Hide,6,2005,3651,3651,3811,3811,1,160,160,0.041983731,0.041983731
FALSE,Morgan County,6/1/06,Hide,Hide,6,2006,3818,3818,3937,3937,1,119,119,0.03022606,0.03022606
FALSE,Morgan County,6/1/07,Hide,Hide,6,2007,3890,3890,3997,3997,1,107,107,0.026770078,0.026770078
FALSE,Morgan County,6/1/08,Hide,Hide,6,2008,3932,3932,4057,4057,1,125,125,0.030810944,0.030810944
FALSE,Morgan County,6/1/09,Hide,Hide,6,2009,3806,3806,4058,4058,1,252,252,0.062099556,0.062099556
FALSE,Morgan County,6/1/10,Hide,Hide,6,2010,3991,3991,4290,4290,1,299,299,0.06969697,0.06969697
FALSE,Morgan County,6/1/11,Hide,Hide,6,2011,3990,3990,4229,4229,1,239,239,0.056514542,0.056514542
FALSE,Morgan County,6/1/12,Hide,Hide,6,2012,4111,4111,4324,4324,1,213,213,0.049259944,0.049259944
FALSE,Morgan County,6/1/13,Hide,Hide,6,2013,4310,4310,4494,4494,1,184,184,0.04094348,0.04094348
FALSE,Morgan County,6/1/14,Hide,Hide,6,2014,4517,4517,4676,4676,1,159,159,0.034003422,0.034003422
FALSE,Morgan County,6/1/15,Hide,Hide,6,2015,4770,4770,4926,4926,1,156,156,0.031668697,0.031668697
FALSE,Morgan County,6/1/16,Hide,Hide,6,2016,4977,4977,5128,5128,1,151,151,0.029446178,0.029446178
FALSE,Morgan County,6/1/17,Hide,Hide,6,2017,5237,5237,5392,5392,1,155,155,0.028746291,0.028746291
FALSE,Morgan County,6/1/18,Hide,Hide,6,2018,5282,5282,5431,5431,1,149,149,0.027435095,0.027435095
FALSE,Morgan County,6/1/19,Hide,Hide,6,2019,5426,5426,5565,5565,1,139,139,0.024977538,0.024977538
FALSE,Piute County,6/1/93,Hide,Hide,6,1993,445,445,472,472,1,27,27,0.05720339,0.05720339
FALSE,Piute County,6/1/94,Hide,Hide,6,1994,448,448,493,493,1,45,45,0.09127789,0.09127789
FALSE,Piute County,6/1/95,Hide,Hide,6,1995,460,460,489,489,1,29,29,0.059304703,0.059304703
FALSE,Piute County,6/1/96,Hide,Hide,6,1996,489,489,512,512,1,23,23,0.044921875,0.044921875
FALSE,Piute County,6/1/97,Hide,Hide,6,1997,487,487,510,510,1,23,23,0.045098039,0.045098039
FALSE,Piute County,6/1/98,Hide,Hide,6,1998,481,481,502,502,1,21,21,0.041832669,0.041832669
FALSE,Piute County,6/1/99,Hide,Hide,6,1999,523,523,559,559,1,36,36,0.064400716,0.064400716
FALSE,Piute County,6/1/00,Hide,Hide,6,2000,609,609,635,635,1,26,26,0.040944882,0.040944882
FALSE,Piute County,6/1/01,Hide,Hide,6,2001,728,728,772,772,1,44,44,0.056994819,0.056994819
FALSE,Piute County,6/1/02,Hide,Hide,6,2002,676,676,724,724,1,48,48,0.066298343,0.066298343
FALSE,Piute County,6/1/03,Hide,Hide,6,2003,754,754,799,799,1,45,45,0.056320401,0.056320401
FALSE,Piute County,6/1/04,Hide,Hide,6,2004,846,846,883,883,1,37,37,0.041902605,0.041902605
FALSE,Piute County,6/1/05,Hide,Hide,6,2005,812,812,846,846,1,34,34,0.040189125,0.040189125
FALSE,Piute County,6/1/06,Hide,Hide,6,2006,875,875,902,902,1,27,27,0.029933481,0.029933481
FALSE,Piute County,6/1/07,Hide,Hide,6,2007,921,921,940,940,1,19,19,0.020212766,0.020212766
FALSE,Piute County,6/1/08,Hide,Hide,6,2008,872,872,897,897,1,25,25,0.02787068,0.02787068
FALSE,Piute County,6/1/09,Hide,Hide,6,2009,828,828,888,888,1,60,60,0.067567568,0.067567568
FALSE,Piute County,6/1/10,Hide,Hide,6,2010,501,501,558,558,1,57,57,0.102150538,0.102150538
FALSE,Piute County,6/1/11,Hide,Hide,6,2011,476,476,530,530,1,54,54,0.101886792,0.101886792
FALSE,Piute County,6/1/12,Hide,Hide,6,2012,453,453,496,496,1,43,43,0.086693548,0.086693548
FALSE,Piute County,6/1/13,Hide,Hide,6,2013,457,457,495,495,1,38,38,0.076767677,0.076767677
FALSE,Piute County,6/1/14,Hide,Hide,6,2014,419,419,451,451,1,32,32,0.070953437,0.070953437
FALSE,Piute County,6/1/15,Hide,Hide,6,2015,447,447,476,476,1,29,29,0.06092437,0.06092437
FALSE,Piute County,6/1/16,Hide,Hide,6,2016,429,429,457,457,1,28,28,0.061269147,0.061269147
FALSE,Piute County,6/1/17,Hide,Hide,6,2017,456,456,480,480,1,24,24,0.05,0.05
FALSE,Piute County,6/1/18,Hide,Hide,6,2018,454,454,478,478,1,24,24,0.050209205,0.050209205
FALSE,Piute County,6/1/19,Hide,Hide,6,2019,460,460,482,482,1,22,22,0.045643154,0.045643154
FALSE,Rich County,6/1/93,Hide,Hide,6,1993,762,762,785,785,1,23,23,0.029299363,0.029299363
FALSE,Rich County,6/1/94,Hide,Hide,6,1994,801,801,832,832,1,31,31,0.037259615,0.037259615
FALSE,Rich County,6/1/95,Hide,Hide,6,1995,842,842,882,882,1,40,40,0.045351474,0.045351474
FALSE,Rich County,6/1/96,Hide,Hide,6,1996,943,943,980,980,1,37,37,0.037755102,0.037755102
FALSE,Rich County,6/1/97,Hide,Hide,6,1997,899,899,928,928,1,29,29,0.03125,0.03125
FALSE,Rich County,6/1/98,Hide,Hide,6,1998,943,943,975,975,1,32,32,0.032820513,0.032820513
FALSE,Rich County,6/1/99,Hide,Hide,6,1999,973,973,1010,1010,1,37,37,0.036633663,0.036633663
FALSE,Rich County,6/1/00,Hide,Hide,6,2000,1046,1046,1075,1075,1,29,29,0.026976744,0.026976744
FALSE,Rich County,6/1/01,Hide,Hide,6,2001,1113,1113,1147,1147,1,34,34,0.029642546,0.029642546
FALSE,Rich County,6/1/02,Hide,Hide,6,2002,1166,1166,1217,1217,1,51,51,0.041906327,0.041906327
FALSE,Rich County,6/1/03,Hide,Hide,6,2003,1208,1208,1256,1256,1,48,48,0.038216561,0.038216561
FALSE,Rich County,6/1/04,Hide,Hide,6,2004,1342,1342,1386,1386,1,44,44,0.031746032,0.031746032
FALSE,Rich County,6/1/05,Hide,Hide,6,2005,1238,1238,1278,1278,1,40,40,0.031298905,0.031298905
FALSE,Rich County,6/1/06,Hide,Hide,6,2006,1401,1401,1434,1434,1,33,33,0.023012552,0.023012552
FALSE,Rich County,6/1/07,Hide,Hide,6,2007,1397,1397,1427,1427,1,30,30,0.021023125,0.021023125
FALSE,Rich County,6/1/08,Hide,Hide,6,2008,1374,1374,1408,1408,1,34,34,0.024147727,0.024147727
FALSE,Rich County,6/1/09,Hide,Hide,6,2009,1379,1379,1457,1457,1,78,78,0.05353466,0.05353466
FALSE,Rich County,6/1/10,Hide,Hide,6,2010,962,962,1037,1037,1,75,75,0.072324012,0.072324012
FALSE,Rich County,6/1/11,Hide,Hide,6,2011,913,913,984,984,1,71,71,0.072154472,0.072154472
FALSE,Rich County,6/1/12,Hide,Hide,6,2012,917,917,965,965,1,48,48,0.049740933,0.049740933
FALSE,Rich County,6/1/13,Hide,Hide,6,2013,927,927,973,973,1,46,46,0.047276465,0.047276465
FALSE,Rich County,6/1/14,Hide,Hide,6,2014,946,946,985,985,1,39,39,0.039593909,0.039593909
FALSE,Rich County,6/1/15,Hide,Hide,6,2015,1024,1024,1063,1063,1,39,39,0.036688617,0.036688617
FALSE,Rich County,6/1/16,Hide,Hide,6,2016,1074,1074,1107,1107,1,33,33,0.029810298,0.029810298
FALSE,Rich County,6/1/17,Hide,Hide,6,2017,1092,1092,1130,1130,1,38,38,0.033628319,0.033628319
FALSE,Rich County,6/1/18,Hide,Hide,6,2018,1128,1128,1164,1164,1,36,36,0.030927835,0.030927835
FALSE,Rich County,6/1/19,Hide,Hide,6,2019,1157,1157,1192,1192,1,35,35,0.029362416,0.029362416
FALSE,Salt Lake County,6/1/93,Hide,Hide,6,1993,405211,405211,420377,420377,1,15166,15166,0.03607714,0.03607714
FALSE,Salt Lake County,6/1/94,Hide,Hide,6,1994,427033,427033,441890,441890,1,14857,14857,0.03362149,0.03362149
FALSE,Salt Lake County,6/1/95,Hide,Hide,6,1995,439551,439551,453196,453196,1,13645,13645,0.030108386,0.030108386
FALSE,Salt Lake County,6/1/96,Hide,Hide,6,1996,447648,447648,461059,461059,1,13411,13411,0.029087384,0.029087384
FALSE,Salt Lake County,6/1/97,Hide,Hide,6,1997,461146,461146,474215,474215,1,13069,13069,0.027559229,0.027559229
FALSE,Salt Lake County,6/1/98,Hide,Hide,6,1998,467386,467386,483301,483301,1,15915,15915,0.032929789,0.032929789
FALSE,Salt Lake County,6/1/99,Hide,Hide,6,1999,474298,474298,490568,490568,1,16270,16270,0.033165637,0.033165637
FALSE,Salt Lake County,6/1/00,Hide,Hide,6,2000,469119,469119,484058,484058,1,14939,14939,0.030862004,0.030862004
FALSE,Salt Lake County,6/1/01,Hide,Hide,6,2001,472284,472284,493232,493232,1,20948,20948,0.042470886,0.042470886
FALSE,Salt Lake County,6/1/02,Hide,Hide,6,2002,464017,464017,493926,493926,1,29909,29909,0.060553605,0.060553605
FALSE,Salt Lake County,6/1/03,Hide,Hide,6,2003,467798,467798,496461,496461,1,28663,28663,0.057734646,0.057734646
FALSE,Salt Lake County,6/1/04,Hide,Hide,6,2004,473307,473307,498622,498622,1,25315,25315,0.050769922,0.050769922
FALSE,Salt Lake County,6/1/05,Hide,Hide,6,2005,496438,496438,516939,516939,1,20501,20501,0.039658451,0.039658451
FALSE,Salt Lake County,6/1/06,Hide,Hide,6,2006,518320,518320,534055,534055,1,15735,15735,0.029463258,0.029463258
FALSE,Salt Lake County,6/1/07,Hide,Hide,6,2007,537074,537074,550371,550371,1,13297,13297,0.024160067,0.024160067
FALSE,Salt Lake County,6/1/08,Hide,Hide,6,2008,540108,540108,557585,557585,1,17477,17477,0.0313441,0.0313441
FALSE,Salt Lake County,6/1/09,Hide,Hide,6,2009,514635,514635,554370,554370,1,39735,39735,0.071675956,0.071675956
FALSE,Salt Lake County,6/1/10,Hide,Hide,6,2010,506993,506993,549515,549515,1,42522,42522,0.077380963,0.077380963
FALSE,Salt Lake County,6/1/11,Hide,Hide,6,2011,508603,508603,544948,544948,1,36345,36345,0.066694437,0.066694437
FALSE,Salt Lake County,6/1/12,Hide,Hide,6,2012,526983,526983,556185,556185,1,29202,29202,0.052504113,0.052504113
FALSE,Salt Lake County,6/1/13,Hide,Hide,6,2013,544147,544147,569439,569439,1,25292,25292,0.044415644,0.044415644
FALSE,Salt Lake County,6/1/14,Hide,Hide,6,2014,553816,553816,574799,574799,1,20983,20983,0.036504935,0.036504935
FALSE,Salt Lake County,6/1/15,Hide,Hide,6,2015,564173,564173,584060,584060,1,19887,19887,0.034049584,0.034049584
FALSE,Salt Lake County,6/1/16,Hide,Hide,6,2016,582140,582140,601095,601095,1,18955,18955,0.031534117,0.031534117
FALSE,Salt Lake County,6/1/17,Hide,Hide,6,2017,595415,595415,614906,614906,1,19491,19491,0.031697528,0.031697528
FALSE,Salt Lake County,6/1/18,Hide,Hide,6,2018,600483,600483,618696,618696,1,18213,18213,0.029437721,0.029437721
FALSE,Salt Lake County,6/1/19,Hide,Hide,6,2019,618051,618051,634074,634074,1,16023,16023,0.025269921,0.025269921
FALSE,San Juan County,6/1/93,Hide,Hide,6,1993,4759,4759,5102,5102,1,343,343,0.067228538,0.067228538
FALSE,San Juan County,6/1/94,Hide,Hide,6,1994,4696,4696,5132,5132,1,436,436,0.084957132,0.084957132
FALSE,San Juan County,6/1/95,Hide,Hide,6,1995,4775,4775,5231,5231,1,456,456,0.087172625,0.087172625
FALSE,San Juan County,6/1/96,Hide,Hide,6,1996,4629,4629,5102,5102,1,473,473,0.092708742,0.092708742
FALSE,San Juan County,6/1/97,Hide,Hide,6,1997,4468,4468,4897,4897,1,429,429,0.087604656,0.087604656
FALSE,San Juan County,6/1/98,Hide,Hide,6,1998,4591,4591,4979,4979,1,388,388,0.077927295,0.077927295
FALSE,San Juan County,6/1/99,Hide,Hide,6,1999,4708,4708,5100,5100,1,392,392,0.076862745,0.076862745
FALSE,San Juan County,6/1/00,Hide,Hide,6,2000,4335,4335,4703,4703,1,368,368,0.078247927,0.078247927
FALSE,San Juan County,6/1/01,Hide,Hide,6,2001,4170,4170,4541,4541,1,371,371,0.081700066,0.081700066
FALSE,San Juan County,6/1/02,Hide,Hide,6,2002,4346,4346,4751,4751,1,405,405,0.085245212,0.085245212
FALSE,San Juan County,6/1/03,Hide,Hide,6,2003,4292,4292,4725,4725,1,433,433,0.091640212,0.091640212
FALSE,San Juan County,6/1/04,Hide,Hide,6,2004,4459,4459,4915,4915,1,456,456,0.092777213,0.092777213
FALSE,San Juan County,6/1/05,Hide,Hide,6,2005,4394,4394,4769,4769,1,375,375,0.078632837,0.078632837
FALSE,San Juan County,6/1/06,Hide,Hide,6,2006,4599,4599,4907,4907,1,308,308,0.062767475,0.062767475
FALSE,San Juan County,6/1/07,Hide,Hide,6,2007,4711,4711,4968,4968,1,257,257,0.051731079,0.051731079
FALSE,San Juan County,6/1/08,Hide,Hide,6,2008,4663,4663,4970,4970,1,307,307,0.061770624,0.061770624
FALSE,San Juan County,6/1/09,Hide,Hide,6,2009,4643,4643,5260,5260,1,617,617,0.11730038,0.11730038
FALSE,San Juan County,6/1/10,Hide,Hide,6,2010,5461,5461,6119,6119,1,658,658,0.107533911,0.107533911
FALSE,San Juan County,6/1/11,Hide,Hide,6,2011,5363,5363,5959,5959,1,596,596,0.100016781,0.100016781
FALSE,San Juan County,6/1/12,Hide,Hide,6,2012,5212,5212,5724,5724,1,512,512,0.089447939,0.089447939
FALSE,San Juan County,6/1/13,Hide,Hide,6,2013,5179,5179,5634,5634,1,455,455,0.080759673,0.080759673
FALSE,San Juan County,6/1/14,Hide,Hide,6,2014,5165,5165,5587,5587,1,422,422,0.075532486,0.075532486
FALSE,San Juan County,6/1/15,Hide,Hide,6,2015,5280,5280,5735,5735,1,455,455,0.079337402,0.079337402
FALSE,San Juan County,6/1/16,Hide,Hide,6,2016,5279,5279,5753,5753,1,474,474,0.082391796,0.082391796
FALSE,San Juan County,6/1/17,Hide,Hide,6,2017,5272,5272,5669,5669,1,397,397,0.070029988,0.070029988
FALSE,San Juan County,6/1/18,Hide,Hide,6,2018,5354,5354,5706,5706,1,352,352,0.06168945,0.06168945
FALSE,San Juan County,6/1/19,Hide,Hide,6,2019,5450,5450,5734,5734,1,284,284,0.049529125,0.049529125
FALSE,Sanpete County,6/1/93,Hide,Hide,6,1993,6717,6717,7185,7185,1,468,468,0.065135699,0.065135699
FALSE,Sanpete County,6/1/94,Hide,Hide,6,1994,6999,6999,7500,7500,1,501,501,0.0668,0.0668
FALSE,Sanpete County,6/1/95,Hide,Hide,6,1995,7257,7257,7726,7726,1,469,469,0.060704116,0.060704116
FALSE,Sanpete County,6/1/96,Hide,Hide,6,1996,7759,7759,8238,8238,1,479,479,0.058145181,0.058145181
FALSE,Sanpete County,6/1/97,Hide,Hide,6,1997,8082,8082,8538,8538,1,456,456,0.053408292,0.053408292
FALSE,Sanpete County,6/1/98,Hide,Hide,6,1998,8453,8453,8977,8977,1,524,524,0.058371394,0.058371394
FALSE,Sanpete County,6/1/99,Hide,Hide,6,1999,8525,8525,9021,9021,1,496,496,0.054982818,0.054982818
FALSE,Sanpete County,6/1/00,Hide,Hide,6,2000,9316,9316,9737,9737,1,421,421,0.043237137,0.043237137
FALSE,Sanpete County,6/1/01,Hide,Hide,6,2001,9467,9467,10009,10009,1,542,542,0.054151264,0.054151264
FALSE,Sanpete County,6/1/02,Hide,Hide,6,2002,9427,9427,10090,10090,1,663,663,0.065708622,0.065708622
FALSE,Sanpete County,6/1/03,Hide,Hide,6,2003,9514,9514,10201,10201,1,687,687,0.067346339,0.067346339
FALSE,Sanpete County,6/1/04,Hide,Hide,6,2004,9963,9963,10629,10629,1,666,666,0.062658764,0.062658764
FALSE,Sanpete County,6/1/05,Hide,Hide,6,2005,9962,9962,10526,10526,1,564,564,0.053581607,0.053581607
FALSE,Sanpete County,6/1/06,Hide,Hide,6,2006,10234,10234,10644,10644,1,410,410,0.038519354,0.038519354
FALSE,Sanpete County,6/1/07,Hide,Hide,6,2007,10594,10594,10928,10928,1,334,334,0.03056369,0.03056369
FALSE,Sanpete County,6/1/08,Hide,Hide,6,2008,10652,10652,11085,11085,1,433,433,0.039061795,0.039061795
FALSE,Sanpete County,6/1/09,Hide,Hide,6,2009,10332,10332,11271,11271,1,939,939,0.083311153,0.083311153
FALSE,Sanpete County,6/1/10,Hide,Hide,6,2010,10395,10395,11461,11461,1,1066,1066,0.093011081,0.093011081
FALSE,Sanpete County,6/1/11,Hide,Hide,6,2011,10163,10163,11047,11047,1,884,884,0.080021725,0.080021725
FALSE,Sanpete County,6/1/12,Hide,Hide,6,2012,10522,10522,11242,11242,1,720,720,0.064045543,0.064045543
FALSE,Sanpete County,6/1/13,Hide,Hide,6,2013,10447,10447,11079,11079,1,632,632,0.05704486,0.05704486
FALSE,Sanpete County,6/1/14,Hide,Hide,6,2014,10550,10550,11048,11048,1,498,498,0.045076032,0.045076032
FALSE,Sanpete County,6/1/15,Hide,Hide,6,2015,11036,11036,11515,11515,1,479,479,0.041597916,0.041597916
FALSE,Sanpete County,6/1/16,Hide,Hide,6,2016,11399,11399,11870,11870,1,471,471,0.039679865,0.039679865
FALSE,Sanpete County,6/1/17,Hide,Hide,6,2017,11412,11412,11886,11886,1,474,474,0.039878849,0.039878849
FALSE,Sanpete County,6/1/18,Hide,Hide,6,2018,11953,11953,12409,12409,1,456,456,0.036747522,0.036747522
FALSE,Sanpete County,6/1/19,Hide,Hide,6,2019,12086,12086,12486,12486,1,400,400,0.03203588,0.03203588
FALSE,Sevier County,6/1/93,Hide,Hide,6,1993,6724,6724,7117,7117,1,393,393,0.055219896,0.055219896
FALSE,Sevier County,6/1/94,Hide,Hide,6,1994,7094,7094,7464,7464,1,370,370,0.049571275,0.049571275
FALSE,Sevier County,6/1/95,Hide,Hide,6,1995,7237,7237,7623,7623,1,386,386,0.050636232,0.050636232
FALSE,Sevier County,6/1/96,Hide,Hide,6,1996,7476,7476,7829,7829,1,353,353,0.045088773,0.045088773
FALSE,Sevier County,6/1/97,Hide,Hide,6,1997,7751,7751,8051,8051,1,300,300,0.037262452,0.037262452
FALSE,Sevier County,6/1/98,Hide,Hide,6,1998,7931,7931,8337,8337,1,406,406,0.048698573,0.048698573
FALSE,Sevier County,6/1/99,Hide,Hide,6,1999,8134,8134,8485,8485,1,351,351,0.041367118,0.041367118
FALSE,Sevier County,6/1/00,Hide,Hide,6,2000,8071,8071,8380,8380,1,309,309,0.036873508,0.036873508
FALSE,Sevier County,6/1/01,Hide,Hide,6,2001,8119,8119,8512,8512,1,393,393,0.046170113,0.046170113
FALSE,Sevier County,6/1/02,Hide,Hide,6,2002,8304,8304,8812,8812,1,508,508,0.057648661,0.057648661
FALSE,Sevier County,6/1/03,Hide,Hide,6,2003,8192,8192,8696,8696,1,504,504,0.057957682,0.057957682
FALSE,Sevier County,6/1/04,Hide,Hide,6,2004,8840,8840,9327,9327,1,487,487,0.052214002,0.052214002
FALSE,Sevier County,6/1/05,Hide,Hide,6,2005,8700,8700,9106,9106,1,406,406,0.044585987,0.044585987
FALSE,Sevier County,6/1/06,Hide,Hide,6,2006,9075,9075,9389,9389,1,314,314,0.033443391,0.033443391
FALSE,Sevier County,6/1/07,Hide,Hide,6,2007,9191,9191,9455,9455,1,264,264,0.027921735,0.027921735
FALSE,Sevier County,6/1/08,Hide,Hide,6,2008,9254,9254,9609,9609,1,355,355,0.036944531,0.036944531
FALSE,Sevier County,6/1/09,Hide,Hide,6,2009,9065,9065,9831,9831,1,766,766,0.077916794,0.077916794
FALSE,Sevier County,6/1/10,Hide,Hide,6,2010,8904,8904,9708,9708,1,804,804,0.082818294,0.082818294
FALSE,Sevier County,6/1/11,Hide,Hide,6,2011,8777,8777,9494,9494,1,717,717,0.075521382,0.075521382
FALSE,Sevier County,6/1/12,Hide,Hide,6,2012,8856,8856,9437,9437,1,581,581,0.061566176,0.061566176
FALSE,Sevier County,6/1/13,Hide,Hide,6,2013,8739,8739,9249,9249,1,510,510,0.055141096,0.055141096
FALSE,Sevier County,6/1/14,Hide,Hide,6,2014,8827,8827,9244,9244,1,417,417,0.045110342,0.045110342
FALSE,Sevier County,6/1/15,Hide,Hide,6,2015,9134,9134,9559,9559,1,425,425,0.044460718,0.044460718
FALSE,Sevier County,6/1/16,Hide,Hide,6,2016,9182,9182,9608,9608,1,426,426,0.044338052,0.044338052
FALSE,Sevier County,6/1/17,Hide,Hide,6,2017,9364,9364,9750,9750,1,386,386,0.039589744,0.039589744
FALSE,Sevier County,6/1/18,Hide,Hide,6,2018,9484,9484,9828,9828,1,344,344,0.035002035,0.035002035
FALSE,Sevier County,6/1/19,Hide,Hide,6,2019,9422,9422,9726,9726,1,304,304,0.031256426,0.031256426
FALSE,State of Utah,6/1/93,Hide,Hide,6,1993,900453,900453,939043,939043,1,38590,38590,0.04109503,0.04109503
FALSE,State of Utah,6/1/94,Hide,Hide,6,1994,953806,953806,991218,991218,1,37412,37412,0.037743463,0.037743463
FALSE,State of Utah,6/1/95,Hide,Hide,6,1995,975427,975427,1010865,1010865,1,35438,35438,0.035057105,0.035057105
FALSE,State of Utah,6/1/96,Hide,Hide,6,1996,1002243,1002243,1037180,1037180,1,34937,34937,0.033684606,0.033684606
FALSE,State of Utah,6/1/97,Hide,Hide,6,1997,1036363,1036363,1069413,1069413,1,33050,33050,0.030904805,0.030904805
FALSE,State of Utah,6/1/98,Hide,Hide,6,1998,1059209,1059209,1099864,1099864,1,40655,40655,0.036963661,0.036963661
FALSE,State of Utah,6/1/99,Hide,Hide,6,1999,1080396,1080396,1121467,1121467,1,41071,41071,0.036622567,0.036622567
FALSE,State of Utah,6/1/00,Hide,Hide,6,2000,1103366,1103366,1140607,1140607,1,37241,37241,0.032650159,0.032650159
FALSE,State of Utah,6/1/01,Hide,Hide,6,2001,1113018,1113018,1163088,1163088,1,50070,50070,0.043049193,0.043049193
FALSE,State of Utah,6/1/02,Hide,Hide,6,2002,1113976,1113976,1183447,1183447,1,69471,69471,0.058702249,0.058702249
FALSE,State of Utah,6/1/03,Hide,Hide,6,2003,1129861,1129861,1197664,1197664,1,67803,67803,0.056612706,0.056612706
FALSE,State of Utah,6/1/04,Hide,Hide,6,2004,1168068,1168068,1230132,1230132,1,62064,62064,0.050453122,0.050453122
FALSE,State of Utah,6/1/05,Hide,Hide,6,2005,1218800,1218800,1270397,1270397,1,51597,51597,0.040614863,0.040614863
FALSE,State of Utah,6/1/06,Hide,Hide,6,2006,1277660,1277660,1317494,1317494,1,39834,39834,0.030234673,0.030234673
FALSE,State of Utah,6/1/07,Hide,Hide,6,2007,1324675,1324675,1359008,1359008,1,34333,34333,0.02526328,0.02526328
FALSE,State of Utah,6/1/08,Hide,Hide,6,2008,1325788,1325788,1371540,1371540,1,45752,45752,0.033358123,0.033358123
FALSE,State of Utah,6/1/09,Hide,Hide,6,2009,1265021,1265021,1366277,1366277,1,101256,101256,0.074110887,0.074110887
FALSE,State of Utah,6/1/10,Hide,Hide,6,2010,1250702,1250702,1358279,1358279,1,107577,107577,0.079200959,0.079200959
FALSE,State of Utah,6/1/11,Hide,Hide,6,2011,1255940,1255940,1347853,1347853,1,91913,91913,0.068192154,0.068192154
FALSE,State of Utah,6/1/12,Hide,Hide,6,2012,1297527,1297527,1371758,1371758,1,74231,74231,0.054113772,0.054113772
FALSE,State of Utah,6/1/13,Hide,Hide,6,2013,1340161,1340161,1405140,1405140,1,64979,64979,0.046243791,0.046243791
FALSE,State of Utah,6/1/14,Hide,Hide,6,2014,1369960,1369960,1423798,1423798,1,53838,53838,0.037812948,0.037812948
FALSE,State of Utah,6/1/15,Hide,Hide,6,2015,1406336,1406336,1459469,1459469,1,53133,53133,0.036405706,0.036405706
FALSE,State of Utah,6/1/16,Hide,Hide,6,2016,1453012,1453012,1504924,1504924,1,51912,51912,0.034494765,0.034494765
FALSE,State of Utah,6/1/17,Hide,Hide,6,2017,1496530,1496530,1547504,1547504,1,50974,50974,0.032939495,0.032939495
FALSE,State of Utah,6/1/18,Hide,Hide,6,2018,1520151,1520151,1568864,1568864,1,48713,48713,0.031049855,0.031049855
FALSE,State of Utah,6/1/19,Hide,Hide,6,2019,1545287,1545287,1590502,1590502,1,45215,45215,0.028428131,0.028428131
FALSE,Summit County,6/1/93,Hide,Hide,6,1993,9777,9777,10323,10323,1,546,546,0.052891601,0.052891601
FALSE,Summit County,6/1/94,Hide,Hide,6,1994,10822,10822,11312,11312,1,490,490,0.043316832,0.043316832
FALSE,Summit County,6/1/95,Hide,Hide,6,1995,11557,11557,12018,12018,1,461,461,0.038359128,0.038359128
FALSE,Summit County,6/1/96,Hide,Hide,6,1996,12311,12311,12760,12760,1,449,449,0.035188088,0.035188088
FALSE,Summit County,6/1/97,Hide,Hide,6,1997,12849,12849,13305,13305,1,456,456,0.03427283,0.03427283
FALSE,Summit County,6/1/98,Hide,Hide,6,1998,13324,13324,13950,13950,1,626,626,0.044874552,0.044874552
FALSE,Summit County,6/1/99,Hide,Hide,6,1999,13761,13761,14473,14473,1,712,712,0.049195053,0.049195053
FALSE,Summit County,6/1/00,Hide,Hide,6,2000,17854,17854,18484,18484,1,630,630,0.034083532,0.034083532
FALSE,Summit County,6/1/01,Hide,Hide,6,2001,18226,18226,19029,19029,1,803,803,0.042198749,0.042198749
FALSE,Summit County,6/1/02,Hide,Hide,6,2002,18185,18185,19471,19471,1,1286,1286,0.066046942,0.066046942
FALSE,Summit County,6/1/03,Hide,Hide,6,2003,18689,18689,19920,19920,1,1231,1231,0.061797189,0.061797189
FALSE,Summit County,6/1/04,Hide,Hide,6,2004,19375,19375,20458,20458,1,1083,1083,0.052937726,0.052937726
FALSE,Summit County,6/1/05,Hide,Hide,6,2005,20611,20611,21457,21457,1,846,846,0.039427693,0.039427693
FALSE,Summit County,6/1/06,Hide,Hide,6,2006,21138,21138,21786,21786,1,648,648,0.029743872,0.029743872
FALSE,Summit County,6/1/07,Hide,Hide,6,2007,21303,21303,21829,21829,1,526,526,0.024096386,0.024096386
FALSE,Summit County,6/1/08,Hide,Hide,6,2008,21600,21600,22277,22277,1,677,677,0.030390088,0.030390088
FALSE,Summit County,6/1/09,Hide,Hide,6,2009,20972,20972,22553,22553,1,1581,1581,0.070101539,0.070101539
FALSE,Summit County,6/1/10,Hide,Hide,6,2010,18910,18910,20465,20465,1,1555,1555,0.075983386,0.075983386
FALSE,Summit County,6/1/11,Hide,Hide,6,2011,19528,19528,20831,20831,1,1303,1303,0.062551006,0.062551006
FALSE,Summit County,6/1/12,Hide,Hide,6,2012,20220,20220,21279,21279,1,1059,1059,0.049767376,0.049767376
FALSE,Summit County,6/1/13,Hide,Hide,6,2013,21117,21117,22040,22040,1,923,923,0.041878403,0.041878403
FALSE,Summit County,6/1/14,Hide,Hide,6,2014,21809,21809,22579,22579,1,770,770,0.034102485,0.034102485
FALSE,Summit County,6/1/15,Hide,Hide,6,2015,22231,22231,22993,22993,1,762,762,0.033140521,0.033140521
FALSE,Summit County,6/1/16,Hide,Hide,6,2016,23159,23159,23895,23895,1,736,736,0.030801423,0.030801423
FALSE,Summit County,6/1/17,Hide,Hide,6,2017,23623,23623,24388,24388,1,765,765,0.031367886,0.031367886
FALSE,Summit County,6/1/18,Hide,Hide,6,2018,23639,23639,24367,24367,1,728,728,0.029876472,0.029876472
FALSE,Summit County,6/1/19,Hide,Hide,6,2019,24511,24511,25129,25129,1,618,618,0.0245931,0.0245931
FALSE,Tooele County,6/1/93,Hide,Hide,6,1993,11391,11391,12044,12044,1,653,653,0.054217868,0.054217868
FALSE,Tooele County,6/1/94,Hide,Hide,6,1994,10979,10979,11656,11656,1,677,677,0.058081675,0.058081675
FALSE,Tooele County,6/1/95,Hide,Hide,6,1995,10800,10800,11459,11459,1,659,659,0.057509381,0.057509381
FALSE,Tooele County,6/1/96,Hide,Hide,6,1996,11089,11089,11698,11698,1,609,609,0.052060181,0.052060181
FALSE,Tooele County,6/1/97,Hide,Hide,6,1997,11106,11106,11623,11623,1,517,517,0.044480771,0.044480771
FALSE,Tooele County,6/1/98,Hide,Hide,6,1998,11359,11359,11940,11940,1,581,581,0.048659966,0.048659966
FALSE,Tooele County,6/1/99,Hide,Hide,6,1999,11544,11544,12212,12212,1,668,668,0.054700295,0.054700295
FALSE,Tooele County,6/1/00,Hide,Hide,6,2000,19401,19401,20118,20118,1,717,717,0.035639726,0.035639726
FALSE,Tooele County,6/1/01,Hide,Hide,6,2001,20348,20348,21355,21355,1,1007,1007,0.047155233,0.047155233
FALSE,Tooele County,6/1/02,Hide,Hide,6,2002,20791,20791,22233,22233,1,1442,1442,0.064858544,0.064858544
FALSE,Tooele County,6/1/03,Hide,Hide,6,2003,21774,21774,23218,23218,1,1444,1444,0.062193126,0.062193126
FALSE,Tooele County,6/1/04,Hide,Hide,6,2004,22587,22587,23903,23903,1,1316,1316,0.055055851,0.055055851
FALSE,Tooele County,6/1/05,Hide,Hide,6,2005,24039,24039,25123,25123,1,1084,1084,0.043147713,0.043147713
FALSE,Tooele County,6/1/06,Hide,Hide,6,2006,25385,25385,26239,26239,1,854,854,0.032546972,0.032546972
FALSE,Tooele County,6/1/07,Hide,Hide,6,2007,26154,26154,26893,26893,1,739,739,0.02747927,0.02747927
FALSE,Tooele County,6/1/08,Hide,Hide,6,2008,26926,26926,27920,27920,1,994,994,0.035601719,0.035601719
FALSE,Tooele County,6/1/09,Hide,Hide,6,2009,25973,25973,28236,28236,1,2263,2263,0.080145913,0.080145913
FALSE,Tooele County,6/1/10,Hide,Hide,6,2010,25204,25204,27526,27526,1,2322,2322,0.084356608,0.084356608
FALSE,Tooele County,6/1/11,Hide,Hide,6,2011,25263,25263,27216,27216,1,1953,1953,0.071759259,0.071759259
FALSE,Tooele County,6/1/12,Hide,Hide,6,2012,26073,26073,27742,27742,1,1669,1669,0.060161488,0.060161488
FALSE,Tooele County,6/1/13,Hide,Hide,6,2013,26894,26894,28458,28458,1,1564,1564,0.054958184,0.054958184
FALSE,Tooele County,6/1/14,Hide,Hide,6,2014,27454,27454,28826,28826,1,1372,1372,0.04759592,0.04759592
FALSE,Tooele County,6/1/15,Hide,Hide,6,2015,28229,28229,29449,29449,1,1220,1220,0.041427553,0.041427553
FALSE,Tooele County,6/1/16,Hide,Hide,6,2016,29474,29474,30652,30652,1,1178,1178,0.038431424,0.038431424
FALSE,Tooele County,6/1/17,Hide,Hide,6,2017,31069,31069,32267,32267,1,1198,1198,0.037127716,0.037127716
FALSE,Tooele County,6/1/18,Hide,Hide,6,2018,32001,32001,33115,33115,1,1114,1114,0.033640344,0.033640344
FALSE,Tooele County,6/1/19,Hide,Hide,6,2019,32840,32840,33824,33824,1,984,984,0.029091769,0.029091769
FALSE,Uintah County,6/1/93,Hide,Hide,6,1993,9306,9306,10056,10056,1,750,750,0.074582339,0.074582339
FALSE,Uintah County,6/1/94,Hide,Hide,6,1994,9385,9385,10149,10149,1,764,764,0.075278353,0.075278353
FALSE,Uintah County,6/1/95,Hide,Hide,6,1995,9612,9612,10323,10323,1,711,711,0.068875327,0.068875327
FALSE,Uintah County,6/1/96,Hide,Hide,6,1996,9458,9458,10186,10186,1,728,728,0.071470646,0.071470646
FALSE,Uintah County,6/1/97,Hide,Hide,6,1997,10095,10095,10712,10712,1,617,617,0.057598954,0.057598954
FALSE,Uintah County,6/1/98,Hide,Hide,6,1998,10199,10199,10845,10845,1,646,646,0.059566621,0.059566621
FALSE,Uintah County,6/1/99,Hide,Hide,6,1999,10429,10429,11215,11215,1,786,786,0.070084708,0.070084708
FALSE,Uintah County,6/1/00,Hide,Hide,6,2000,10851,10851,11321,11321,1,470,470,0.041515767,0.041515767
FALSE,Uintah County,6/1/01,Hide,Hide,6,2001,11600,11600,12117,12117,1,517,517,0.042667327,0.042667327
FALSE,Uintah County,6/1/02,Hide,Hide,6,2002,11888,11888,12663,12663,1,775,775,0.061201927,0.061201927
FALSE,Uintah County,6/1/03,Hide,Hide,6,2003,12256,12256,12994,12994,1,738,738,0.056795444,0.056795444
FALSE,Uintah County,6/1/04,Hide,Hide,6,2004,13125,13125,13834,13834,1,709,709,0.051250542,0.051250542
FALSE,Uintah County,6/1/05,Hide,Hide,6,2005,14030,14030,14573,14573,1,543,543,0.037260688,0.037260688
FALSE,Uintah County,6/1/06,Hide,Hide,6,2006,15767,15767,16173,16173,1,406,406,0.025103568,0.025103568
FALSE,Uintah County,6/1/07,Hide,Hide,6,2007,17064,17064,17417,17417,1,353,353,0.020267555,0.020267555
FALSE,Uintah County,6/1/08,Hide,Hide,6,2008,18226,18226,18626,18626,1,400,400,0.021475357,0.021475357
FALSE,Uintah County,6/1/09,Hide,Hide,6,2009,16039,16039,17557,17557,1,1518,1518,0.086461241,0.086461241
FALSE,Uintah County,6/1/10,Hide,Hide,6,2010,13923,13923,15178,15178,1,1255,1255,0.082685466,0.082685466
FALSE,Uintah County,6/1/11,Hide,Hide,6,2011,14525,14525,15460,15460,1,935,935,0.060478655,0.060478655
FALSE,Uintah County,6/1/12,Hide,Hide,6,2012,15353,15353,16040,16040,1,687,687,0.042830424,0.042830424
FALSE,Uintah County,6/1/13,Hide,Hide,6,2013,15031,15031,15709,15709,1,678,678,0.043159972,0.043159972
FALSE,Uintah County,6/1/14,Hide,Hide,6,2014,15445,15445,16006,16006,1,561,561,0.035049356,0.035049356
FALSE,Uintah County,6/1/15,Hide,Hide,6,2015,14217,14217,15260,15260,1,1043,1043,0.068348624,0.068348624
FALSE,Uintah County,6/1/16,Hide,Hide,6,2016,12907,12907,14247,14247,1,1340,1340,0.094054889,0.094054889
FALSE,Uintah County,6/1/17,Hide,Hide,6,2017,12860,12860,13670,13670,1,810,810,0.059253841,0.059253841
FALSE,Uintah County,6/1/18,Hide,Hide,6,2018,12917,12917,13532,13532,1,615,615,0.045447827,0.045447827
FALSE,Uintah County,6/1/19,Hide,Hide,6,2019,13088,13088,13644,13644,1,556,556,0.040750513,0.040750513
FALSE,United States,6/1/93,Hide,Hide,6,1993,120290,120290000,129411,129411000,1,9121,9121000,0.07,0.07
FALSE,United States,6/1/94,Hide,Hide,6,1994,122634,122634000,130561,130561000,1,7927,7927000,0.061,0.061
FALSE,United States,6/1/95,Hide,Hide,6,1995,124522,124522000,131949,131949000,1,7427,7427000,0.056,0.056
FALSE,United States,6/1/96,Hide,Hide,6,1996,126602,126602000,133697,133697000,1,7095,7095000,0.053,0.053
FALSE,United States,6/1/97,Hide,Hide,6,1997,129412,129412000,136211,136211000,1,6799,6799000,0.05,0.05
FALSE,United States,6/1/98,Hide,Hide,6,1998,131244,131244000,137455,137455000,1,6212,6212000,0.045,0.045
FALSE,United States,6/1/99,Hide,Hide,6,1999,133378,133378000,139329,139329000,1,5951,5951000,0.043,0.043
FALSE,United States,6/1/00,Hide,Hide,6,2000,136940,136940000,142591,142591000,1,5651,5651000,0.04,0.04
FALSE,United States,6/1/01,Hide,Hide,6,2001,136873,136873000,143357,143357000,1,6484,6484000,0.045,0.045
FALSE,United States,6/1/02,Hide,Hide,6,2002,136415,136415000,144808,144808000,1,8393,8393000,0.058,0.058
FALSE,United States,6/1/03,Hide,Hide,6,2003,137790,137790000,147056,147056000,1,9266,9266000,0.063,0.063
FALSE,United States,6/1/04,Hide,Hide,6,2004,139174,139174000,147460,147460000,1,8286,8286000,0.056,0.056
FALSE,United States,6/1/05,Hide,Hide,6,2005,141714,141714000,149238,149238000,1,7524,7524000,0.05,0.05
FALSE,United States,6/1/06,Hide,Hide,6,2006,144353,144353000,151354,151354000,1,7001,7001000,0.046,0.046
FALSE,United States,6/1/07,Hide,Hide,6,2007,146063,146063000,153041,153041000,1,6979,6979000,0.046,0.046
FALSE,United States,6/1/08,Hide,Hide,6,2008,145737,145737000,154313,154313000,1,8575,8575000,0.056,0.056
FALSE,United States,6/1/09,Hide,Hide,6,2009,140009,140009000,154716,154716000,1,14707,14707000,0.095,0.095
FALSE,United States,6/1/10,Hide,Hide,6,2010,139141,139141000,153616,153616000,1,14474,14474000,0.094,0.094
FALSE,United States,6/1/11,Hide,Hide,6,2011,139384,139384000,153346,153346000,1,13962,13962000,0.091,0.091
FALSE,United States,6/1/12,Hide,Hide,6,2012,142391,142391000,155083,155083000,1,12692,12692000,0.082,0.082
FALSE,United States,6/1/13,Hide,Hide,6,2013,143999,143999000,155749,155749000,1,11751,11751000,0.075,0.075
FALSE,United States,6/1/14,Hide,Hide,6,2014,146247,146247000,155707,155707000,1,9460,9460000,0.061,0.061
FALSE,United States,6/1/15,Hide,Hide,6,2015,148816,148816000,157062,157062000,1,8247,8247000,0.053,0.053
FALSE,United States,6/1/16,Hide,Hide,6,2016,151187,151187000,158973,158973000,1,7786,7786000,0.049,0.049
FALSE,United States,6/1/17,Hide,Hide,6,2017,153299,153299000,160232,160232000,1,6933,6933000,0.043,0.043
FALSE,United States,6/1/18,Hide,Hide,6,2018,155750,155750000,162269,162269000,1,6519,6519000,0.04,0.04
FALSE,United States,6/1/19,Hide,Hide,6,2019,157148,157148000,163133,163133000,1,5985,5985000,0.037,0.037
FALSE,Utah County,6/1/93,Hide,Hide,6,1993,131771,131771,136787,136787,1,5016,5016,0.036670151,0.036670151
FALSE,Utah County,6/1/94,Hide,Hide,6,1994,141508,141508,146157,146157,1,4649,4649,0.031808261,0.031808261
FALSE,Utah County,6/1/95,Hide,Hide,6,1995,143567,143567,147899,147899,1,4332,4332,0.029290259,0.029290259
FALSE,Utah County,6/1/96,Hide,Hide,6,1996,148667,148667,153060,153060,1,4393,4393,0.028701163,0.028701163
FALSE,Utah County,6/1/97,Hide,Hide,6,1997,153964,153964,158028,158028,1,4064,4064,0.025716962,0.025716962
FALSE,Utah County,6/1/98,Hide,Hide,6,1998,160092,160092,164979,164979,1,4887,4887,0.029621952,0.029621952
FALSE,Utah County,6/1/99,Hide,Hide,6,1999,164637,164637,169903,169903,1,5266,5266,0.030994155,0.030994155
FALSE,Utah County,6/1/00,Hide,Hide,6,2000,175764,175764,181071,181071,1,5307,5307,0.029308945,0.029308945
FALSE,Utah County,6/1/01,Hide,Hide,6,2001,176317,176317,183613,183613,1,7296,7296,0.039735749,0.039735749
FALSE,Utah County,6/1/02,Hide,Hide,6,2002,174920,174920,185748,185748,1,10828,10828,0.058294033,0.058294033
FALSE,Utah County,6/1/03,Hide,Hide,6,2003,178252,178252,188079,188079,1,9827,9827,0.052249321,0.052249321
FALSE,Utah County,6/1/04,Hide,Hide,6,2004,187581,187581,196992,196992,1,9411,9411,0.047773514,0.047773514
FALSE,Utah County,6/1/05,Hide,Hide,6,2005,196910,196910,204944,204944,1,8034,8034,0.039200952,0.039200952
FALSE,Utah County,6/1/06,Hide,Hide,6,2006,207192,207192,213474,213474,1,6282,6282,0.029427471,0.029427471
FALSE,Utah County,6/1/07,Hide,Hide,6,2007,217976,217976,223410,223410,1,5434,5434,0.024322994,0.024322994
FALSE,Utah County,6/1/08,Hide,Hide,6,2008,215890,215890,223279,223279,1,7389,7389,0.033093126,0.033093126
FALSE,Utah County,6/1/09,Hide,Hide,6,2009,205738,205738,221074,221074,1,15336,15336,0.069370437,0.069370437
FALSE,Utah County,6/1/10,Hide,Hide,6,2010,212886,212886,230190,230190,1,17304,17304,0.075172683,0.075172683
FALSE,Utah County,6/1/11,Hide,Hide,6,2011,215883,215883,230600,230600,1,14717,14717,0.063820468,0.063820468
FALSE,Utah County,6/1/12,Hide,Hide,6,2012,226558,226558,238404,238404,1,11846,11846,0.049688764,0.049688764
FALSE,Utah County,6/1/13,Hide,Hide,6,2013,238133,238133,248840,248840,1,10707,10707,0.043027648,0.043027648
FALSE,Utah County,6/1/14,Hide,Hide,6,2014,245403,245403,254221,254221,1,8818,8818,0.034686356,0.034686356
FALSE,Utah County,6/1/15,Hide,Hide,6,2015,256842,256842,265617,265617,1,8775,8775,0.033036289,0.033036289
FALSE,Utah County,6/1/16,Hide,Hide,6,2016,269991,269991,278654,278654,1,8663,8663,0.031088734,0.031088734
FALSE,Utah County,6/1/17,Hide,Hide,6,2017,281557,281557,290144,290144,1,8587,8587,0.029595649,0.029595649
FALSE,Utah County,6/1/18,Hide,Hide,6,2018,290017,290017,298308,298308,1,8291,8291,0.027793422,0.027793422
FALSE,Utah County,6/1/19,Hide,Hide,6,2019,299220,299220,306529,306529,1,7309,7309,0.0238444,0.0238444
FALSE,Wasatch County,6/1/93,Hide,Hide,6,1993,4761,4761,5075,5075,1,314,314,0.061871921,0.061871921
FALSE,Wasatch County,6/1/94,Hide,Hide,6,1994,5063,5063,5383,5383,1,320,320,0.059446405,0.059446405
FALSE,Wasatch County,6/1/95,Hide,Hide,6,1995,5162,5162,5446,5446,1,284,284,0.052148366,0.052148366
FALSE,Wasatch County,6/1/96,Hide,Hide,6,1996,5420,5420,5658,5658,1,238,238,0.042064334,0.042064334
FALSE,Wasatch County,6/1/97,Hide,Hide,6,1997,5646,5646,5869,5869,1,223,223,0.037996251,0.037996251
FALSE,Wasatch County,6/1/98,Hide,Hide,6,1998,5812,5812,6104,6104,1,292,292,0.047837484,0.047837484
FALSE,Wasatch County,6/1/99,Hide,Hide,6,1999,5971,5971,6308,6308,1,337,337,0.053424223,0.053424223
FALSE,Wasatch County,6/1/00,Hide,Hide,6,2000,7689,7689,7954,7954,1,265,265,0.03331657,0.03331657
FALSE,Wasatch County,6/1/01,Hide,Hide,6,2001,7674,7674,8010,8010,1,336,336,0.041947566,0.041947566
FALSE,Wasatch County,6/1/02,Hide,Hide,6,2002,7778,7778,8297,8297,1,519,519,0.06255273,0.06255273
FALSE,Wasatch County,6/1/03,Hide,Hide,6,2003,7991,7991,8515,8515,1,524,524,0.061538462,0.061538462
FALSE,Wasatch County,6/1/04,Hide,Hide,6,2004,8254,8254,8739,8739,1,485,485,0.055498341,0.055498341
FALSE,Wasatch County,6/1/05,Hide,Hide,6,2005,8860,8860,9234,9234,1,374,374,0.040502491,0.040502491
FALSE,Wasatch County,6/1/06,Hide,Hide,6,2006,9817,9817,10147,10147,1,330,330,0.032521928,0.032521928
FALSE,Wasatch County,6/1/07,Hide,Hide,6,2007,10477,10477,10737,10737,1,260,260,0.02421533,0.02421533
FALSE,Wasatch County,6/1/08,Hide,Hide,6,2008,10009,10009,10348,10348,1,339,339,0.032759954,0.032759954
FALSE,Wasatch County,6/1/09,Hide,Hide,6,2009,9226,9226,10069,10069,1,843,843,0.083722316,0.083722316
FALSE,Wasatch County,6/1/10,Hide,Hide,6,2010,10265,10265,11240,11240,1,975,975,0.086743772,0.086743772
FALSE,Wasatch County,6/1/11,Hide,Hide,6,2011,10435,10435,11238,11238,1,803,803,0.071453995,0.071453995
FALSE,Wasatch County,6/1/12,Hide,Hide,6,2012,10939,10939,11611,11611,1,672,672,0.057876152,0.057876152
FALSE,Wasatch County,6/1/13,Hide,Hide,6,2013,11595,11595,12176,12176,1,581,581,0.04771682,0.04771682
FALSE,Wasatch County,6/1/14,Hide,Hide,6,2014,12226,12226,12702,12702,1,476,476,0.037474413,0.037474413
FALSE,Wasatch County,6/1/15,Hide,Hide,6,2015,12835,12835,13301,13301,1,466,466,0.03503496,0.03503496
FALSE,Wasatch County,6/1/16,Hide,Hide,6,2016,13423,13423,13896,13896,1,473,473,0.034038572,0.034038572
FALSE,Wasatch County,6/1/17,Hide,Hide,6,2017,14051,14051,14548,14548,1,497,497,0.034162772,0.034162772
FALSE,Wasatch County,6/1/18,Hide,Hide,6,2018,14624,14624,15098,15098,1,474,474,0.031394887,0.031394887
FALSE,Wasatch County,6/1/19,Hide,Hide,6,2019,15699,15699,16133,16133,1,434,434,0.026901382,0.026901382
FALSE,Washington County,6/1/93,Hide,Hide,6,1993,24987,24987,25958,25958,1,971,971,0.03740658,0.03740658
FALSE,Washington County,6/1/94,Hide,Hide,6,1994,29500,29500,30392,30392,1,892,892,0.029349829,0.029349829
FALSE,Washington County,6/1/95,Hide,Hide,6,1995,31550,31550,32601,32601,1,1051,1051,0.032238275,0.032238275
FALSE,Washington County,6/1/96,Hide,Hide,6,1996,33486,33486,34701,34701,1,1215,1215,0.0350134,0.0350134
FALSE,Washington County,6/1/97,Hide,Hide,6,1997,34278,34278,35453,35453,1,1175,1175,0.03314247,0.03314247
FALSE,Washington County,6/1/98,Hide,Hide,6,1998,35684,35684,37067,37067,1,1383,1383,0.037310816,0.037310816
FALSE,Washington County,6/1/99,Hide,Hide,6,1999,37236,37236,38588,38588,1,1352,1352,0.035036799,0.035036799
FALSE,Washington County,6/1/00,Hide,Hide,6,2000,37956,37956,39327,39327,1,1371,1371,0.034861546,0.034861546
FALSE,Washington County,6/1/01,Hide,Hide,6,2001,40397,40397,42078,42078,1,1681,1681,0.039949617,0.039949617
FALSE,Washington County,6/1/02,Hide,Hide,6,2002,42217,42217,44541,44541,1,2324,2324,0.052176646,0.052176646
FALSE,Washington County,6/1/03,Hide,Hide,6,2003,44518,44518,47040,47040,1,2522,2522,0.053613946,0.053613946
FALSE,Washington County,6/1/04,Hide,Hide,6,2004,49350,49350,51905,51905,1,2555,2555,0.049224545,0.049224545
FALSE,Washington County,6/1/05,Hide,Hide,6,2005,54555,54555,56865,56865,1,2310,2310,0.040622527,0.040622527
FALSE,Washington County,6/1/06,Hide,Hide,6,2006,59573,59573,61452,61452,1,1879,1879,0.03057671,0.03057671
FALSE,Washington County,6/1/07,Hide,Hide,6,2007,61621,61621,63319,63319,1,1698,1698,0.026816595,0.026816595
FALSE,Washington County,6/1/08,Hide,Hide,6,2008,58982,58982,61659,61659,1,2677,2677,0.043416209,0.043416209
FALSE,Washington County,6/1/09,Hide,Hide,6,2009,54490,54490,60324,60324,1,5834,5834,0.096711093,0.096711093
FALSE,Washington County,6/1/10,Hide,Hide,6,2010,50962,50962,57008,57008,1,6046,6046,0.10605529,0.10605529
FALSE,Washington County,6/1/11,Hide,Hide,6,2011,50827,50827,55806,55806,1,4979,4979,0.089219797,0.089219797
FALSE,Washington County,6/1/12,Hide,Hide,6,2012,53038,53038,56950,56950,1,3912,3912,0.068691835,0.068691835
FALSE,Washington County,6/1/13,Hide,Hide,6,2013,56205,56205,59546,59546,1,3341,3341,0.056107883,0.056107883
FALSE,Washington County,6/1/14,Hide,Hide,6,2014,58487,58487,61145,61145,1,2658,2658,0.043470439,0.043470439
FALSE,Washington County,6/1/15,Hide,Hide,6,2015,60759,60759,63357,63357,1,2598,2598,0.041005729,0.041005729
FALSE,Washington County,6/1/16,Hide,Hide,6,2016,64708,64708,67232,67232,1,2524,2524,0.037541647,0.037541647
FALSE,Washington County,6/1/17,Hide,Hide,6,2017,68138,68138,70641,70641,1,2503,2503,0.035432681,0.035432681
FALSE,Washington County,6/1/18,Hide,Hide,6,2018,71436,71436,73925,73925,1,2489,2489,0.033669259,0.033669259
FALSE,Washington County,6/1/19,Hide,Hide,6,2019,73540,73540,75800,75800,1,2260,2260,0.029815303,0.029815303
FALSE,Wayne County,6/1/93,Hide,Hide,6,1993,996,996,1068,1068,1,72,72,0.06741573,0.06741573
FALSE,Wayne County,6/1/94,Hide,Hide,6,1994,1087,1087,1182,1182,1,95,95,0.08037225,0.08037225
FALSE,Wayne County,6/1/95,Hide,Hide,6,1995,1271,1271,1361,1361,1,90,90,0.066127847,0.066127847
FALSE,Wayne County,6/1/96,Hide,Hide,6,1996,1267,1267,1341,1341,1,74,74,0.055182699,0.055182699
FALSE,Wayne County,6/1/97,Hide,Hide,6,1997,1301,1301,1363,1363,1,62,62,0.045487894,0.045487894
FALSE,Wayne County,6/1/98,Hide,Hide,6,1998,1408,1408,1498,1498,1,90,90,0.060080107,0.060080107
FALSE,Wayne County,6/1/99,Hide,Hide,6,1999,1386,1386,1470,1470,1,84,84,0.057142857,0.057142857
FALSE,Wayne County,6/1/00,Hide,Hide,6,2000,1258,1258,1317,1317,1,59,59,0.044798785,0.044798785
FALSE,Wayne County,6/1/01,Hide,Hide,6,2001,1363,1363,1430,1430,1,67,67,0.046853147,0.046853147
FALSE,Wayne County,6/1/02,Hide,Hide,6,2002,1337,1337,1429,1429,1,92,92,0.064380686,0.064380686
FALSE,Wayne County,6/1/03,Hide,Hide,6,2003,1223,1223,1317,1317,1,94,94,0.071374336,0.071374336
FALSE,Wayne County,6/1/04,Hide,Hide,6,2004,1317,1317,1407,1407,1,90,90,0.063965885,0.063965885
FALSE,Wayne County,6/1/05,Hide,Hide,6,2005,1247,1247,1319,1319,1,72,72,0.054586808,0.054586808
FALSE,Wayne County,6/1/06,Hide,Hide,6,2006,1338,1338,1400,1400,1,62,62,0.044285714,0.044285714
FALSE,Wayne County,6/1/07,Hide,Hide,6,2007,1326,1326,1382,1382,1,56,56,0.040520984,0.040520984
FALSE,Wayne County,6/1/08,Hide,Hide,6,2008,1289,1289,1359,1359,1,70,70,0.051508462,0.051508462
FALSE,Wayne County,6/1/09,Hide,Hide,6,2009,1337,1337,1452,1452,1,115,115,0.079201102,0.079201102
FALSE,Wayne County,6/1/10,Hide,Hide,6,2010,1460,1460,1596,1596,1,136,136,0.085213033,0.085213033
FALSE,Wayne County,6/1/11,Hide,Hide,6,2011,1305,1305,1452,1452,1,147,147,0.101239669,0.101239669
FALSE,Wayne County,6/1/12,Hide,Hide,6,2012,1220,1220,1372,1372,1,152,152,0.110787172,0.110787172
FALSE,Wayne County,6/1/13,Hide,Hide,6,2013,1222,1222,1372,1372,1,150,150,0.109329446,0.109329446
FALSE,Wayne County,6/1/14,Hide,Hide,6,2014,1231,1231,1359,1359,1,128,128,0.094186902,0.094186902
FALSE,Wayne County,6/1/15,Hide,Hide,6,2015,1291,1291,1418,1418,1,127,127,0.089562764,0.089562764
FALSE,Wayne County,6/1/16,Hide,Hide,6,2016,1315,1315,1427,1427,1,112,112,0.078486335,0.078486335
FALSE,Wayne County,6/1/17,Hide,Hide,6,2017,1352,1352,1464,1464,1,112,112,0.076502732,0.076502732
FALSE,Wayne County,6/1/18,Hide,Hide,6,2018,1351,1351,1433,1433,1,82,82,0.05722261,0.05722261
FALSE,Wayne County,6/1/19,Hide,Hide,6,2019,1334,1334,1409,1409,1,75,75,0.053229241,0.053229241
FALSE,Weber County,6/1/93,Hide,Hide,6,1993,83156,83156,87812,87812,1,4656,4656,0.053022366,0.053022366
FALSE,Weber County,6/1/94,Hide,Hide,6,1994,87907,87907,91945,91945,1,4038,4038,0.043917559,0.043917559
FALSE,Weber County,6/1/95,Hide,Hide,6,1995,88118,88118,91978,91978,1,3860,3860,0.041966557,0.041966557
FALSE,Weber County,6/1/96,Hide,Hide,6,1996,91998,91998,95861,95861,1,3863,3863,0.040297931,0.040297931
FALSE,Weber County,6/1/97,Hide,Hide,6,1997,95059,95059,98811,98811,1,3752,3752,0.037971481,0.037971481
FALSE,Weber County,6/1/98,Hide,Hide,6,1998,96458,96458,101319,101319,1,4861,4861,0.047977181,0.047977181
FALSE,Weber County,6/1/99,Hide,Hide,6,1999,98141,98141,102603,102603,1,4462,4462,0.043488007,0.043488007
FALSE,Weber County,6/1/00,Hide,Hide,6,2000,96319,96319,100485,100485,1,4166,4166,0.041458924,0.041458924
FALSE,Weber County,6/1/01,Hide,Hide,6,2001,96811,96811,101867,101867,1,5056,5056,0.049633345,0.049633345
FALSE,Weber County,6/1/02,Hide,Hide,6,2002,97439,97439,103964,103964,1,6525,6525,0.06276211,0.06276211
FALSE,Weber County,6/1/03,Hide,Hide,6,2003,98501,98501,105451,105451,1,6950,6950,0.065907388,0.065907388
FALSE,Weber County,6/1/04,Hide,Hide,6,2004,101111,101111,107012,107012,1,5901,5901,0.055143348,0.055143348
FALSE,Weber County,6/1/05,Hide,Hide,6,2005,103067,103067,107934,107934,1,4867,4867,0.045092371,0.045092371
FALSE,Weber County,6/1/06,Hide,Hide,6,2006,106080,106080,109867,109867,1,3787,3787,0.034468949,0.034468949
FALSE,Weber County,6/1/07,Hide,Hide,6,2007,109406,109406,112846,112846,1,3440,3440,0.030484022,0.030484022
FALSE,Weber County,6/1/08,Hide,Hide,6,2008,109318,109318,113631,113631,1,4313,4313,0.037956192,0.037956192
FALSE,Weber County,6/1/09,Hide,Hide,6,2009,105021,105021,114849,114849,1,9828,9828,0.085573231,0.085573231
FALSE,Weber County,6/1/10,Hide,Hide,6,2010,103698,103698,113778,113778,1,10080,10080,0.088593577,0.088593577
FALSE,Weber County,6/1/11,Hide,Hide,6,2011,103382,103382,112374,112374,1,8992,8992,0.08001851,0.08001851
FALSE,Weber County,6/1/12,Hide,Hide,6,2012,105978,105978,113250,113250,1,7272,7272,0.064211921,0.064211921
FALSE,Weber County,6/1/13,Hide,Hide,6,2013,108098,108098,114234,114234,1,6136,6136,0.053714306,0.053714306
FALSE,Weber County,6/1/14,Hide,Hide,6,2014,109632,109632,114657,114657,1,5025,5025,0.043826369,0.043826369
FALSE,Weber County,6/1/15,Hide,Hide,6,2015,112250,112250,117105,117105,1,4855,4855,0.04145852,0.04145852
FALSE,Weber County,6/1/16,Hide,Hide,6,2016,115140,115140,119745,119745,1,4605,4605,0.038456721,0.038456721
FALSE,Weber County,6/1/17,Hide,Hide,6,2017,118817,118817,123323,123323,1,4506,4506,0.036538196,0.036538196
FALSE,Weber County,6/1/18,Hide,Hide,6,2018,120354,120354,124678,124678,1,4324,4324,0.034681339,0.034681339
FALSE,Weber County,6/1/19,Hide,Hide,6,2019,123621,123621,127341,127341,1,3720,3720,0.029212901,0.029212901
FALSE,Beaver County,7/1/93,Hide,Hide,7,1993,2058,2058,2167,2167,1,109,109,0.050299954,0.050299954
FALSE,Beaver County,7/1/94,Hide,Hide,7,1994,2121,2121,2207,2207,1,86,86,0.038966923,0.038966923
FALSE,Beaver County,7/1/95,Hide,Hide,7,1995,2268,2268,2356,2356,1,88,88,0.037351443,0.037351443
FALSE,Beaver County,7/1/96,Hide,Hide,7,1996,2326,2326,2453,2453,1,127,127,0.051773339,0.051773339
FALSE,Beaver County,7/1/97,Hide,Hide,7,1997,2448,2448,2564,2564,1,116,116,0.04524181,0.04524181
FALSE,Beaver County,7/1/98,Hide,Hide,7,1998,2386,2386,2516,2516,1,130,130,0.051669316,0.051669316
FALSE,Beaver County,7/1/99,Hide,Hide,7,1999,2339,2339,2428,2428,1,89,89,0.036655684,0.036655684
FALSE,Beaver County,7/1/00,Hide,Hide,7,2000,2643,2643,2737,2737,1,94,94,0.034344172,0.034344172
FALSE,Beaver County,7/1/01,Hide,Hide,7,2001,2923,2923,3041,3041,1,118,118,0.038803025,0.038803025
FALSE,Beaver County,7/1/02,Hide,Hide,7,2002,2883,2883,3030,3030,1,147,147,0.048514851,0.048514851
FALSE,Beaver County,7/1/03,Hide,Hide,7,2003,2805,2805,2960,2960,1,155,155,0.052364865,0.052364865
FALSE,Beaver County,7/1/04,Hide,Hide,7,2004,2962,2962,3093,3093,1,131,131,0.042353702,0.042353702
FALSE,Beaver County,7/1/05,Hide,Hide,7,2005,2949,2949,3075,3075,1,126,126,0.04097561,0.04097561
FALSE,Beaver County,7/1/06,Hide,Hide,7,2006,3061,3061,3155,3155,1,94,94,0.029793978,0.029793978
FALSE,Beaver County,7/1/07,Hide,Hide,7,2007,3016,3016,3099,3099,1,83,83,0.026782833,0.026782833
FALSE,Beaver County,7/1/08,Hide,Hide,7,2008,3014,3014,3117,3117,1,103,103,0.033044594,0.033044594
FALSE,Beaver County,7/1/09,Hide,Hide,7,2009,3414,3414,3625,3625,1,211,211,0.058206897,0.058206897
FALSE,Beaver County,7/1/10,Hide,Hide,7,2010,2849,2849,3176,3176,1,327,327,0.102959698,0.102959698
FALSE,Beaver County,7/1/11,Hide,Hide,7,2011,2811,2811,3049,3049,1,238,238,0.07805838,0.07805838
FALSE,Beaver County,7/1/12,Hide,Hide,7,2012,2720,2720,2896,2896,1,176,176,0.060773481,0.060773481
FALSE,Beaver County,7/1/13,Hide,Hide,7,2013,2862,2862,3002,3002,1,140,140,0.046635576,0.046635576
FALSE,Beaver County,7/1/14,Hide,Hide,7,2014,2783,2783,2896,2896,1,113,113,0.039019337,0.039019337
FALSE,Beaver County,7/1/15,Hide,Hide,7,2015,3046,3046,3169,3169,1,123,123,0.038813506,0.038813506
FALSE,Beaver County,7/1/16,Hide,Hide,7,2016,2935,2935,3097,3097,1,162,162,0.052308686,0.052308686
FALSE,Beaver County,7/1/17,Hide,Hide,7,2017,2906,2906,3018,3018,1,112,112,0.037110669,0.037110669
FALSE,Beaver County,7/1/18,Hide,Hide,7,2018,2899,2899,3001,3001,1,102,102,0.03398867,0.03398867
FALSE,Beaver County,7/1/19,Hide,Hide,7,2019,2765,2765,2853,2853,1,88,88,0.030844725,0.030844725
FALSE,Box Elder County,7/1/93,Hide,Hide,7,1993,16674,16674,17594,17594,1,920,920,0.052290554,0.052290554
FALSE,Box Elder County,7/1/94,Hide,Hide,7,1994,17198,17198,18049,18049,1,851,851,0.047149427,0.047149427
FALSE,Box Elder County,7/1/95,Hide,Hide,7,1995,16910,16910,17737,17737,1,827,827,0.046625698,0.046625698
FALSE,Box Elder County,7/1/96,Hide,Hide,7,1996,17175,17175,17913,17913,1,738,738,0.041199129,0.041199129
FALSE,Box Elder County,7/1/97,Hide,Hide,7,1997,18045,18045,18756,18756,1,711,711,0.037907869,0.037907869
FALSE,Box Elder County,7/1/98,Hide,Hide,7,1998,18383,18383,19320,19320,1,937,937,0.048498965,0.048498965
FALSE,Box Elder County,7/1/99,Hide,Hide,7,1999,17499,17499,18349,18349,1,850,850,0.04632405,0.04632405
FALSE,Box Elder County,7/1/00,Hide,Hide,7,2000,19399,19399,20122,20122,1,723,723,0.035930822,0.035930822
FALSE,Box Elder County,7/1/01,Hide,Hide,7,2001,19575,19575,20499,20499,1,924,924,0.04507537,0.04507537
FALSE,Box Elder County,7/1/02,Hide,Hide,7,2002,19884,19884,21078,21078,1,1194,1194,0.056646741,0.056646741
FALSE,Box Elder County,7/1/03,Hide,Hide,7,2003,20131,20131,21308,21308,1,1177,1177,0.055237469,0.055237469
FALSE,Box Elder County,7/1/04,Hide,Hide,7,2004,20922,20922,22031,22031,1,1109,1109,0.05033816,0.05033816
FALSE,Box Elder County,7/1/05,Hide,Hide,7,2005,21530,21530,22489,22489,1,959,959,0.04264307,0.04264307
FALSE,Box Elder County,7/1/06,Hide,Hide,7,2006,22161,22161,22891,22891,1,730,730,0.031890263,0.031890263
FALSE,Box Elder County,7/1/07,Hide,Hide,7,2007,22795,22795,23435,23435,1,640,640,0.02730958,0.02730958
FALSE,Box Elder County,7/1/08,Hide,Hide,7,2008,22812,22812,23753,23753,1,941,941,0.039616048,0.039616048
FALSE,Box Elder County,7/1/09,Hide,Hide,7,2009,21245,21245,23089,23089,1,1844,1844,0.079864871,0.079864871
FALSE,Box Elder County,7/1/10,Hide,Hide,7,2010,21759,21759,23785,23785,1,2026,2026,0.085179735,0.085179735
FALSE,Box Elder County,7/1/11,Hide,Hide,7,2011,21470,21470,23198,23198,1,1728,1728,0.07448918,0.07448918
FALSE,Box Elder County,7/1/12,Hide,Hide,7,2012,21633,21633,22949,22949,1,1316,1316,0.057344547,0.057344547
FALSE,Box Elder County,7/1/13,Hide,Hide,7,2013,22022,22022,23104,23104,1,1082,1082,0.046831717,0.046831717
FALSE,Box Elder County,7/1/14,Hide,Hide,7,2014,22455,22455,23368,23368,1,913,913,0.039070524,0.039070524
FALSE,Box Elder County,7/1/15,Hide,Hide,7,2015,23144,23144,24032,24032,1,888,888,0.036950732,0.036950732
FALSE,Box Elder County,7/1/16,Hide,Hide,7,2016,23913,23913,24761,24761,1,848,848,0.034247405,0.034247405
FALSE,Box Elder County,7/1/17,Hide,Hide,7,2017,24476,24476,25303,25303,1,827,827,0.032683871,0.032683871
FALSE,Box Elder County,7/1/18,Hide,Hide,7,2018,24599,24599,25355,25355,1,756,756,0.029816604,0.029816604
FALSE,Box Elder County,7/1/19,Hide,Hide,7,2019,25245,25245,25904,25904,1,659,659,0.025440086,0.025440086
FALSE,Cache County,7/1/93,Hide,Hide,7,1993,37805,37805,38973,38973,1,1168,1168,0.029969466,0.029969466
FALSE,Cache County,7/1/94,Hide,Hide,7,1994,39161,39161,40352,40352,1,1191,1191,0.029515266,0.029515266
FALSE,Cache County,7/1/95,Hide,Hide,7,1995,40537,40537,41832,41832,1,1295,1295,0.030957162,0.030957162
FALSE,Cache County,7/1/96,Hide,Hide,7,1996,40852,40852,42083,42083,1,1231,1231,0.029251717,0.029251717
FALSE,Cache County,7/1/97,Hide,Hide,7,1997,42246,42246,43291,43291,1,1045,1045,0.024138967,0.024138967
FALSE,Cache County,7/1/98,Hide,Hide,7,1998,43247,43247,44673,44673,1,1426,1426,0.031920847,0.031920847
FALSE,Cache County,7/1/99,Hide,Hide,7,1999,43998,43998,45212,45212,1,1214,1214,0.026851278,0.026851278
FALSE,Cache County,7/1/00,Hide,Hide,7,2000,47180,47180,48508,48508,1,1328,1328,0.027376928,0.027376928
FALSE,Cache County,7/1/01,Hide,Hide,7,2001,48494,48494,50239,50239,1,1745,1745,0.034733972,0.034733972
FALSE,Cache County,7/1/02,Hide,Hide,7,2002,50345,50345,52609,52609,1,2264,2264,0.043034462,0.043034462
FALSE,Cache County,7/1/03,Hide,Hide,7,2003,51907,51907,53983,53983,1,2076,2076,0.038456551,0.038456551
FALSE,Cache County,7/1/04,Hide,Hide,7,2004,54237,54237,56312,56312,1,2075,2075,0.036848274,0.036848274
FALSE,Cache County,7/1/05,Hide,Hide,7,2005,55281,55281,57128,57128,1,1847,1847,0.032330906,0.032330906
FALSE,Cache County,7/1/06,Hide,Hide,7,2006,57233,57233,58544,58544,1,1311,1311,0.022393414,0.022393414
FALSE,Cache County,7/1/07,Hide,Hide,7,2007,59439,59439,60688,60688,1,1249,1249,0.020580675,0.020580675
FALSE,Cache County,7/1/08,Hide,Hide,7,2008,60040,60040,61655,61655,1,1615,1615,0.026194145,0.026194145
FALSE,Cache County,7/1/09,Hide,Hide,7,2009,58737,58737,62234,62234,1,3497,3497,0.05619115,0.05619115
FALSE,Cache County,7/1/10,Hide,Hide,7,2010,53562,53562,57068,57068,1,3506,3506,0.06143548,0.06143548
FALSE,Cache County,7/1/11,Hide,Hide,7,2011,53507,53507,56441,56441,1,2934,2934,0.051983487,0.051983487
FALSE,Cache County,7/1/12,Hide,Hide,7,2012,54433,54433,56931,56931,1,2498,2498,0.043877676,0.043877676
FALSE,Cache County,7/1/13,Hide,Hide,7,2013,55456,55456,57758,57758,1,2302,2302,0.039855951,0.039855951
FALSE,Cache County,7/1/14,Hide,Hide,7,2014,56927,56927,58805,58805,1,1878,1878,0.03193606,0.03193606
FALSE,Cache County,7/1/15,Hide,Hide,7,2015,58463,58463,60323,60323,1,1860,1860,0.03083401,0.03083401
FALSE,Cache County,7/1/16,Hide,Hide,7,2016,59424,59424,61281,61281,1,1857,1857,0.03030303,0.03030303
FALSE,Cache County,7/1/17,Hide,Hide,7,2017,60837,60837,62565,62565,1,1728,1728,0.027619276,0.027619276
FALSE,Cache County,7/1/18,Hide,Hide,7,2018,61618,61618,63301,63301,1,1683,1683,0.026587258,0.026587258
FALSE,Cache County,7/1/19,Hide,Hide,7,2019,62688,62688,64045,64045,1,1357,1357,0.021188227,0.021188227
FALSE,Carbon County,7/1/93,Hide,Hide,7,1993,8386,8386,9042,9042,1,656,656,0.072550321,0.072550321
FALSE,Carbon County,7/1/94,Hide,Hide,7,1994,8630,8630,9352,9352,1,722,722,0.077202737,0.077202737
FALSE,Carbon County,7/1/95,Hide,Hide,7,1995,8496,8496,9081,9081,1,585,585,0.064420218,0.064420218
FALSE,Carbon County,7/1/96,Hide,Hide,7,1996,8890,8890,9452,9452,1,562,562,0.059458316,0.059458316
FALSE,Carbon County,7/1/97,Hide,Hide,7,1997,9244,9244,9721,9721,1,477,477,0.049069026,0.049069026
FALSE,Carbon County,7/1/98,Hide,Hide,7,1998,9252,9252,9857,9857,1,605,605,0.061377701,0.061377701
FALSE,Carbon County,7/1/99,Hide,Hide,7,1999,9228,9228,9904,9904,1,676,676,0.06825525,0.06825525
FALSE,Carbon County,7/1/00,Hide,Hide,7,2000,8690,8690,9206,9206,1,516,516,0.056050402,0.056050402
FALSE,Carbon County,7/1/01,Hide,Hide,7,2001,8483,8483,9052,9052,1,569,569,0.062859037,0.062859037
FALSE,Carbon County,7/1/02,Hide,Hide,7,2002,8819,8819,9484,9484,1,665,665,0.070118094,0.070118094
FALSE,Carbon County,7/1/03,Hide,Hide,7,2003,8624,8624,9344,9344,1,720,720,0.077054795,0.077054795
FALSE,Carbon County,7/1/04,Hide,Hide,7,2004,8689,8689,9292,9292,1,603,603,0.064894533,0.064894533
FALSE,Carbon County,7/1/05,Hide,Hide,7,2005,9089,9089,9539,9539,1,450,450,0.047174756,0.047174756
FALSE,Carbon County,7/1/06,Hide,Hide,7,2006,9557,9557,9894,9894,1,337,337,0.034061047,0.034061047
FALSE,Carbon County,7/1/07,Hide,Hide,7,2007,9309,9309,9653,9653,1,344,344,0.03563659,0.03563659
FALSE,Carbon County,7/1/08,Hide,Hide,7,2008,9628,9628,10075,10075,1,447,447,0.044367246,0.044367246
FALSE,Carbon County,7/1/09,Hide,Hide,7,2009,9630,9630,10491,10491,1,861,861,0.082070346,0.082070346
FALSE,Carbon County,7/1/10,Hide,Hide,7,2010,9065,9065,9906,9906,1,841,841,0.084898042,0.084898042
FALSE,Carbon County,7/1/11,Hide,Hide,7,2011,8822,8822,9531,9531,1,709,709,0.074388836,0.074388836
FALSE,Carbon County,7/1/12,Hide,Hide,7,2012,8588,8588,9230,9230,1,642,642,0.069555796,0.069555796
FALSE,Carbon County,7/1/13,Hide,Hide,7,2013,8410,8410,8972,8972,1,562,562,0.062639322,0.062639322
FALSE,Carbon County,7/1/14,Hide,Hide,7,2014,8214,8214,8649,8649,1,435,435,0.050294832,0.050294832
FALSE,Carbon County,7/1/15,Hide,Hide,7,2015,8201,8201,8710,8710,1,509,509,0.058438576,0.058438576
FALSE,Carbon County,7/1/16,Hide,Hide,7,2016,7828,7828,8310,8310,1,482,482,0.058002407,0.058002407
FALSE,Carbon County,7/1/17,Hide,Hide,7,2017,7853,7853,8266,8266,1,413,413,0.049963707,0.049963707
FALSE,Carbon County,7/1/18,Hide,Hide,7,2018,8110,8110,8482,8482,1,372,372,0.043857581,0.043857581
FALSE,Carbon County,7/1/19,Hide,Hide,7,2019,8211,8211,8521,8521,1,310,310,0.036380706,0.036380706
FALSE,Daggett County,7/1/93,Hide,Hide,7,1993,382,382,397,397,1,15,15,0.037783375,0.037783375
FALSE,Daggett County,7/1/94,Hide,Hide,7,1994,458,458,482,482,1,24,24,0.049792531,0.049792531
FALSE,Daggett County,7/1/95,Hide,Hide,7,1995,423,423,446,446,1,23,23,0.051569507,0.051569507
FALSE,Daggett County,7/1/96,Hide,Hide,7,1996,392,392,412,412,1,20,20,0.048543689,0.048543689
FALSE,Daggett County,7/1/97,Hide,Hide,7,1997,389,389,406,406,1,17,17,0.041871921,0.041871921
FALSE,Daggett County,7/1/98,Hide,Hide,7,1998,403,403,420,420,1,17,17,0.04047619,0.04047619
FALSE,Daggett County,7/1/99,Hide,Hide,7,1999,438,438,454,454,1,16,16,0.035242291,0.035242291
FALSE,Daggett County,7/1/00,Hide,Hide,7,2000,461,461,478,478,1,17,17,0.035564854,0.035564854
FALSE,Daggett County,7/1/01,Hide,Hide,7,2001,451,451,473,473,1,22,22,0.046511628,0.046511628
FALSE,Daggett County,7/1/02,Hide,Hide,7,2002,472,472,497,497,1,25,25,0.050301811,0.050301811
FALSE,Daggett County,7/1/03,Hide,Hide,7,2003,456,456,482,482,1,26,26,0.053941909,0.053941909
FALSE,Daggett County,7/1/04,Hide,Hide,7,2004,477,477,505,505,1,28,28,0.055445545,0.055445545
FALSE,Daggett County,7/1/05,Hide,Hide,7,2005,476,476,499,499,1,23,23,0.046092184,0.046092184
FALSE,Daggett County,7/1/06,Hide,Hide,7,2006,488,488,512,512,1,24,24,0.046875,0.046875
FALSE,Daggett County,7/1/07,Hide,Hide,7,2007,508,508,527,527,1,19,19,0.036053131,0.036053131
FALSE,Daggett County,7/1/08,Hide,Hide,7,2008,416,416,435,435,1,19,19,0.043678161,0.043678161
FALSE,Daggett County,7/1/09,Hide,Hide,7,2009,455,455,481,481,1,26,26,0.054054054,0.054054054
FALSE,Daggett County,7/1/10,Hide,Hide,7,2010,464,464,501,501,1,37,37,0.073852295,0.073852295
FALSE,Daggett County,7/1/11,Hide,Hide,7,2011,445,445,474,474,1,29,29,0.061181435,0.061181435
FALSE,Daggett County,7/1/12,Hide,Hide,7,2012,417,417,440,440,1,23,23,0.052272727,0.052272727
FALSE,Daggett County,7/1/13,Hide,Hide,7,2013,408,408,429,429,1,21,21,0.048951049,0.048951049
FALSE,Daggett County,7/1/14,Hide,Hide,7,2014,402,402,419,419,1,17,17,0.040572792,0.040572792
FALSE,Daggett County,7/1/15,Hide,Hide,7,2015,442,442,462,462,1,20,20,0.043290043,0.043290043
FALSE,Daggett County,7/1/16,Hide,Hide,7,2016,447,447,471,471,1,24,24,0.050955414,0.050955414
FALSE,Daggett County,7/1/17,Hide,Hide,7,2017,396,396,421,421,1,25,25,0.059382423,0.059382423
FALSE,Daggett County,7/1/18,Hide,Hide,7,2018,386,386,404,404,1,18,18,0.044554455,0.044554455
FALSE,Daggett County,7/1/19,Hide,Hide,7,2019,378,378,393,393,1,15,15,0.038167939,0.038167939
FALSE,Davis County,7/1/93,Hide,Hide,7,1993,96957,96957,100679,100679,1,3722,3722,0.036968981,0.036968981
FALSE,Davis County,7/1/94,Hide,Hide,7,1994,102379,102379,106087,106087,1,3708,3708,0.034952445,0.034952445
FALSE,Davis County,7/1/95,Hide,Hide,7,1995,102391,102391,105871,105871,1,3480,3480,0.032870191,0.032870191
FALSE,Davis County,7/1/96,Hide,Hide,7,1996,108055,108055,111490,111490,1,3435,3435,0.030809938,0.030809938
FALSE,Davis County,7/1/97,Hide,Hide,7,1997,112564,112564,116008,116008,1,3444,3444,0.029687608,0.029687608
FALSE,Davis County,7/1/98,Hide,Hide,7,1998,116629,116629,120675,120675,1,4046,4046,0.033528071,0.033528071
FALSE,Davis County,7/1/99,Hide,Hide,7,1999,120539,120539,124681,124681,1,4142,4142,0.033220779,0.033220779
FALSE,Davis County,7/1/00,Hide,Hide,7,2000,116193,116193,119856,119856,1,3663,3663,0.030561674,0.030561674
FALSE,Davis County,7/1/01,Hide,Hide,7,2001,117189,117189,122092,122092,1,4903,4903,0.040158241,0.040158241
FALSE,Davis County,7/1/02,Hide,Hide,7,2002,118871,118871,125293,125293,1,6422,6422,0.051255856,0.051255856
FALSE,Davis County,7/1/03,Hide,Hide,7,2003,121623,121623,128169,128169,1,6546,6546,0.051073192,0.051073192
FALSE,Davis County,7/1/04,Hide,Hide,7,2004,126301,126301,132464,132464,1,6163,6163,0.046525849,0.046525849
FALSE,Davis County,7/1/05,Hide,Hide,7,2005,130774,130774,136104,136104,1,5330,5330,0.03916123,0.03916123
FALSE,Davis County,7/1/06,Hide,Hide,7,2006,136823,136823,140853,140853,1,4030,4030,0.028611389,0.028611389
FALSE,Davis County,7/1/07,Hide,Hide,7,2007,141276,141276,144948,144948,1,3672,3672,0.025333223,0.025333223
FALSE,Davis County,7/1/08,Hide,Hide,7,2008,140839,140839,145551,145551,1,4712,4712,0.032373532,0.032373532
FALSE,Davis County,7/1/09,Hide,Hide,7,2009,135011,135011,144844,144844,1,9833,9833,0.06788683,0.06788683
FALSE,Davis County,7/1/10,Hide,Hide,7,2010,137066,137066,147409,147409,1,10343,10343,0.070165322,0.070165322
FALSE,Davis County,7/1/11,Hide,Hide,7,2011,137689,137689,146548,146548,1,8859,8859,0.060451183,0.060451183
FALSE,Davis County,7/1/12,Hide,Hide,7,2012,141535,141535,148633,148633,1,7098,7098,0.047755209,0.047755209
FALSE,Davis County,7/1/13,Hide,Hide,7,2013,146231,146231,152674,152674,1,6443,6443,0.04220103,0.04220103
FALSE,Davis County,7/1/14,Hide,Hide,7,2014,150318,150318,155864,155864,1,5546,5546,0.035582303,0.035582303
FALSE,Davis County,7/1/15,Hide,Hide,7,2015,154587,154587,160079,160079,1,5492,5492,0.03430806,0.03430806
FALSE,Davis County,7/1/16,Hide,Hide,7,2016,159289,159289,164386,164386,1,5097,5097,0.03100629,0.03100629
FALSE,Davis County,7/1/17,Hide,Hide,7,2017,163823,163823,169061,169061,1,5238,5238,0.0309829,0.0309829
FALSE,Davis County,7/1/18,Hide,Hide,7,2018,164908,164908,169760,169760,1,4852,4852,0.028581527,0.028581527
FALSE,Davis County,7/1/19,Hide,Hide,7,2019,169919,169919,174027,174027,1,4108,4108,0.023605532,0.023605532
FALSE,Duchesne County,7/1/93,Hide,Hide,7,1993,5347,5347,5843,5843,1,496,496,0.0848879,0.0848879
FALSE,Duchesne County,7/1/94,Hide,Hide,7,1994,5332,5332,5924,5924,1,592,592,0.099932478,0.099932478
FALSE,Duchesne County,7/1/95,Hide,Hide,7,1995,5182,5182,5714,5714,1,532,532,0.093104655,0.093104655
FALSE,Duchesne County,7/1/96,Hide,Hide,7,1996,5287,5287,5761,5761,1,474,474,0.082277382,0.082277382
FALSE,Duchesne County,7/1/97,Hide,Hide,7,1997,5519,5519,5908,5908,1,389,389,0.065842925,0.065842925
FALSE,Duchesne County,7/1/98,Hide,Hide,7,1998,5667,5667,6116,6116,1,449,449,0.073413996,0.073413996
FALSE,Duchesne County,7/1/99,Hide,Hide,7,1999,5383,5383,5926,5926,1,543,543,0.091630105,0.091630105
FALSE,Duchesne County,7/1/00,Hide,Hide,7,2000,5864,5864,6171,6171,1,307,307,0.049748825,0.049748825
FALSE,Duchesne County,7/1/01,Hide,Hide,7,2001,6446,6446,6787,6787,1,341,341,0.050243112,0.050243112
FALSE,Duchesne County,7/1/02,Hide,Hide,7,2002,6522,6522,7001,7001,1,479,479,0.068418797,0.068418797
FALSE,Duchesne County,7/1/03,Hide,Hide,7,2003,6444,6444,6886,6886,1,442,442,0.064188208,0.064188208
FALSE,Duchesne County,7/1/04,Hide,Hide,7,2004,6953,6953,7354,7354,1,401,401,0.054528148,0.054528148
FALSE,Duchesne County,7/1/05,Hide,Hide,7,2005,7379,7379,7703,7703,1,324,324,0.042061534,0.042061534
FALSE,Duchesne County,7/1/06,Hide,Hide,7,2006,8330,8330,8572,8572,1,242,242,0.028231451,0.028231451
FALSE,Duchesne County,7/1/07,Hide,Hide,7,2007,8951,8951,9169,9169,1,218,218,0.023775766,0.023775766
FALSE,Duchesne County,7/1/08,Hide,Hide,7,2008,10108,10108,10367,10367,1,259,259,0.02498312,0.02498312
FALSE,Duchesne County,7/1/09,Hide,Hide,7,2009,9324,9324,10282,10282,1,958,958,0.093172535,0.093172535
FALSE,Duchesne County,7/1/10,Hide,Hide,7,2010,7366,7366,8128,8128,1,762,762,0.09375,0.09375
FALSE,Duchesne County,7/1/11,Hide,Hide,7,2011,7903,7903,8442,8442,1,539,539,0.06384743,0.06384743
FALSE,Duchesne County,7/1/12,Hide,Hide,7,2012,8804,8804,9224,9224,1,420,420,0.045533391,0.045533391
FALSE,Duchesne County,7/1/13,Hide,Hide,7,2013,8919,8919,9321,9321,1,402,402,0.04312842,0.04312842
FALSE,Duchesne County,7/1/14,Hide,Hide,7,2014,9236,9236,9584,9584,1,348,348,0.036310518,0.036310518
FALSE,Duchesne County,7/1/15,Hide,Hide,7,2015,8009,8009,8705,8705,1,696,696,0.079954049,0.079954049
FALSE,Duchesne County,7/1/16,Hide,Hide,7,2016,7370,7370,8060,8060,1,690,690,0.08560794,0.08560794
FALSE,Duchesne County,7/1/17,Hide,Hide,7,2017,7544,7544,7965,7965,1,421,421,0.052856246,0.052856246
FALSE,Duchesne County,7/1/18,Hide,Hide,7,2018,7338,7338,7685,7685,1,347,347,0.045152895,0.045152895
FALSE,Duchesne County,7/1/19,Hide,Hide,7,2019,7444,7444,7751,7751,1,307,307,0.039607793,0.039607793
FALSE,Emery County,7/1/93,Hide,Hide,7,1993,3783,3783,4138,4138,1,355,355,0.085790237,0.085790237
FALSE,Emery County,7/1/94,Hide,Hide,7,1994,3817,3817,4142,4142,1,325,325,0.07846451,0.07846451
FALSE,Emery County,7/1/95,Hide,Hide,7,1995,3895,3895,4226,4226,1,331,331,0.078324657,0.078324657
FALSE,Emery County,7/1/96,Hide,Hide,7,1996,3840,3840,4155,4155,1,315,315,0.075812274,0.075812274
FALSE,Emery County,7/1/97,Hide,Hide,7,1997,3929,3929,4194,4194,1,265,265,0.063185503,0.063185503
FALSE,Emery County,7/1/98,Hide,Hide,7,1998,3926,3926,4268,4268,1,342,342,0.080131209,0.080131209
FALSE,Emery County,7/1/99,Hide,Hide,7,1999,3705,3705,3982,3982,1,277,277,0.069563034,0.069563034
FALSE,Emery County,7/1/00,Hide,Hide,7,2000,4514,4514,4739,4739,1,225,225,0.047478371,0.047478371
FALSE,Emery County,7/1/01,Hide,Hide,7,2001,4437,4437,4762,4762,1,325,325,0.068248635,0.068248635
FALSE,Emery County,7/1/02,Hide,Hide,7,2002,4465,4465,4803,4803,1,338,338,0.070372684,0.070372684
FALSE,Emery County,7/1/03,Hide,Hide,7,2003,4467,4467,4852,4852,1,385,385,0.079348722,0.079348722
FALSE,Emery County,7/1/04,Hide,Hide,7,2004,4793,4793,5135,5135,1,342,342,0.066601753,0.066601753
FALSE,Emery County,7/1/05,Hide,Hide,7,2005,4901,4901,5162,5162,1,261,261,0.050561798,0.050561798
FALSE,Emery County,7/1/06,Hide,Hide,7,2006,5100,5100,5279,5279,1,179,179,0.033907937,0.033907937
FALSE,Emery County,7/1/07,Hide,Hide,7,2007,4917,4917,5085,5085,1,168,168,0.033038348,0.033038348
FALSE,Emery County,7/1/08,Hide,Hide,7,2008,4868,4868,5058,5058,1,190,190,0.037564255,0.037564255
FALSE,Emery County,7/1/09,Hide,Hide,7,2009,4902,4902,5290,5290,1,388,388,0.073345936,0.073345936
FALSE,Emery County,7/1/10,Hide,Hide,7,2010,4854,4854,5245,5245,1,391,391,0.074547188,0.074547188
FALSE,Emery County,7/1/11,Hide,Hide,7,2011,4601,4601,4974,4974,1,373,373,0.074989948,0.074989948
FALSE,Emery County,7/1/12,Hide,Hide,7,2012,4395,4395,4738,4738,1,343,343,0.072393415,0.072393415
FALSE,Emery County,7/1/13,Hide,Hide,7,2013,4437,4437,4716,4716,1,279,279,0.059160305,0.059160305
FALSE,Emery County,7/1/14,Hide,Hide,7,2014,4332,4332,4571,4571,1,239,239,0.052286152,0.052286152
FALSE,Emery County,7/1/15,Hide,Hide,7,2015,4126,4126,4405,4405,1,279,279,0.063337117,0.063337117
FALSE,Emery County,7/1/16,Hide,Hide,7,2016,3986,3986,4241,4241,1,255,255,0.060127328,0.060127328
FALSE,Emery County,7/1/17,Hide,Hide,7,2017,3979,3979,4193,4193,1,214,214,0.051037443,0.051037443
FALSE,Emery County,7/1/18,Hide,Hide,7,2018,4131,4131,4333,4333,1,202,202,0.046618971,0.046618971
FALSE,Emery County,7/1/19,Hide,Hide,7,2019,4116,4116,4282,4282,1,166,166,0.038766931,0.038766931
FALSE,Garfield County,7/1/93,Hide,Hide,7,1993,2121,2121,2310,2310,1,189,189,0.081818182,0.081818182
FALSE,Garfield County,7/1/94,Hide,Hide,7,1994,2311,2311,2570,2570,1,259,259,0.10077821,0.10077821
FALSE,Garfield County,7/1/95,Hide,Hide,7,1995,2313,2313,2653,2653,1,340,340,0.128156804,0.128156804
FALSE,Garfield County,7/1/96,Hide,Hide,7,1996,2402,2402,2669,2669,1,267,267,0.100037467,0.100037467
FALSE,Garfield County,7/1/97,Hide,Hide,7,1997,2527,2527,2755,2755,1,228,228,0.082758621,0.082758621
FALSE,Garfield County,7/1/98,Hide,Hide,7,1998,2485,2485,2719,2719,1,234,234,0.086061052,0.086061052
FALSE,Garfield County,7/1/99,Hide,Hide,7,1999,2748,2748,2969,2969,1,221,221,0.074435837,0.074435837
FALSE,Garfield County,7/1/00,Hide,Hide,7,2000,2301,2301,2462,2462,1,161,161,0.065393989,0.065393989
FALSE,Garfield County,7/1/01,Hide,Hide,7,2001,2402,2402,2594,2594,1,192,192,0.074016962,0.074016962
FALSE,Garfield County,7/1/02,Hide,Hide,7,2002,2307,2307,2575,2575,1,268,268,0.10407767,0.10407767
FALSE,Garfield County,7/1/03,Hide,Hide,7,2003,2311,2311,2545,2545,1,234,234,0.09194499,0.09194499
FALSE,Garfield County,7/1/04,Hide,Hide,7,2004,2442,2442,2652,2652,1,210,210,0.07918552,0.07918552
FALSE,Garfield County,7/1/05,Hide,Hide,7,2005,2525,2525,2722,2722,1,197,197,0.072373255,0.072373255
FALSE,Garfield County,7/1/06,Hide,Hide,7,2006,2532,2532,2667,2667,1,135,135,0.050618673,0.050618673
FALSE,Garfield County,7/1/07,Hide,Hide,7,2007,2554,2554,2671,2671,1,117,117,0.043803819,0.043803819
FALSE,Garfield County,7/1/08,Hide,Hide,7,2008,2686,2686,2847,2847,1,161,161,0.056550755,0.056550755
FALSE,Garfield County,7/1/09,Hide,Hide,7,2009,2551,2551,2857,2857,1,306,306,0.107105355,0.107105355
FALSE,Garfield County,7/1/10,Hide,Hide,7,2010,2778,2778,3099,3099,1,321,321,0.103581801,0.103581801
FALSE,Garfield County,7/1/11,Hide,Hide,7,2011,2668,2668,3004,3004,1,336,336,0.111850866,0.111850866
FALSE,Garfield County,7/1/12,Hide,Hide,7,2012,2611,2611,2896,2896,1,285,285,0.098411602,0.098411602
FALSE,Garfield County,7/1/13,Hide,Hide,7,2013,2500,2500,2759,2759,1,259,259,0.093874592,0.093874592
FALSE,Garfield County,7/1/14,Hide,Hide,7,2014,2442,2442,2674,2674,1,232,232,0.086761406,0.086761406
FALSE,Garfield County,7/1/15,Hide,Hide,7,2015,2491,2491,2737,2737,1,246,246,0.08987943,0.08987943
FALSE,Garfield County,7/1/16,Hide,Hide,7,2016,2546,2546,2781,2781,1,235,235,0.084501978,0.084501978
FALSE,Garfield County,7/1/17,Hide,Hide,7,2017,2699,2699,2913,2913,1,214,214,0.073463783,0.073463783
FALSE,Garfield County,7/1/18,Hide,Hide,7,2018,2561,2561,2763,2763,1,202,202,0.07310894,0.07310894
FALSE,Garfield County,7/1/19,Hide,Hide,7,2019,2614,2614,2775,2775,1,161,161,0.058018018,0.058018018
FALSE,Grand County,7/1/93,Hide,Hide,7,1993,4432,4432,4720,4720,1,288,288,0.061016949,0.061016949
FALSE,Grand County,7/1/94,Hide,Hide,7,1994,4579,4579,4905,4905,1,326,326,0.066462793,0.066462793
FALSE,Grand County,7/1/95,Hide,Hide,7,1995,4683,4683,5007,5007,1,324,324,0.064709407,0.064709407
FALSE,Grand County,7/1/96,Hide,Hide,7,1996,4668,4668,5021,5021,1,353,353,0.07030472,0.07030472
FALSE,Grand County,7/1/97,Hide,Hide,7,1997,4946,4946,5263,5263,1,317,317,0.060231807,0.060231807
FALSE,Grand County,7/1/98,Hide,Hide,7,1998,4867,4867,5244,5244,1,377,377,0.071891686,0.071891686
FALSE,Grand County,7/1/99,Hide,Hide,7,1999,5246,5246,5578,5578,1,332,332,0.059519541,0.059519541
FALSE,Grand County,7/1/00,Hide,Hide,7,2000,4325,4325,4637,4637,1,312,312,0.067284882,0.067284882
FALSE,Grand County,7/1/01,Hide,Hide,7,2001,4380,4380,4702,4702,1,322,322,0.068481497,0.068481497
FALSE,Grand County,7/1/02,Hide,Hide,7,2002,4428,4428,4795,4795,1,367,367,0.07653806,0.07653806
FALSE,Grand County,7/1/03,Hide,Hide,7,2003,4522,4522,4896,4896,1,374,374,0.076388889,0.076388889
FALSE,Grand County,7/1/04,Hide,Hide,7,2004,4494,4494,4856,4856,1,362,362,0.074546952,0.074546952
FALSE,Grand County,7/1/05,Hide,Hide,7,2005,4713,4713,5020,5020,1,307,307,0.061155378,0.061155378
FALSE,Grand County,7/1/06,Hide,Hide,7,2006,4804,4804,5045,5045,1,241,241,0.047770069,0.047770069
FALSE,Grand County,7/1/07,Hide,Hide,7,2007,4878,4878,5121,5121,1,243,243,0.04745167,0.04745167
FALSE,Grand County,7/1/08,Hide,Hide,7,2008,4994,4994,5283,5283,1,289,289,0.054703767,0.054703767
FALSE,Grand County,7/1/09,Hide,Hide,7,2009,4916,4916,5458,5458,1,542,542,0.099303774,0.099303774
FALSE,Grand County,7/1/10,Hide,Hide,7,2010,4728,4728,5308,5308,1,580,580,0.109269028,0.109269028
FALSE,Grand County,7/1/11,Hide,Hide,7,2011,4789,4789,5323,5323,1,534,534,0.100319369,0.100319369
FALSE,Grand County,7/1/12,Hide,Hide,7,2012,4959,4959,5424,5424,1,465,465,0.085730088,0.085730088
FALSE,Grand County,7/1/13,Hide,Hide,7,2013,5041,5041,5467,5467,1,426,426,0.077922078,0.077922078
FALSE,Grand County,7/1/14,Hide,Hide,7,2014,5165,5165,5503,5503,1,338,338,0.061421043,0.061421043
FALSE,Grand County,7/1/15,Hide,Hide,7,2015,5248,5248,5591,5591,1,343,343,0.061348596,0.061348596
FALSE,Grand County,7/1/16,Hide,Hide,7,2016,5393,5393,5720,5720,1,327,327,0.057167832,0.057167832
FALSE,Grand County,7/1/17,Hide,Hide,7,2017,5617,5617,5930,5930,1,313,313,0.052782462,0.052782462
FALSE,Grand County,7/1/18,Hide,Hide,7,2018,5783,5783,6054,6054,1,271,271,0.044763793,0.044763793
FALSE,Grand County,7/1/19,Hide,Hide,7,2019,5983,5983,6217,6217,1,234,234,0.037638733,0.037638733
FALSE,Iron County,7/1/93,Hide,Hide,7,1993,10752,10752,11179,11179,1,427,427,0.038196619,0.038196619
FALSE,Iron County,7/1/94,Hide,Hide,7,1994,11899,11899,12333,12333,1,434,434,0.03519014,0.03519014
FALSE,Iron County,7/1/95,Hide,Hide,7,1995,12599,12599,13034,13034,1,435,435,0.033374252,0.033374252
FALSE,Iron County,7/1/96,Hide,Hide,7,1996,12903,12903,13389,13389,1,486,486,0.036298454,0.036298454
FALSE,Iron County,7/1/97,Hide,Hide,7,1997,13782,13782,14260,14260,1,478,478,0.033520337,0.033520337
FALSE,Iron County,7/1/98,Hide,Hide,7,1998,14336,14336,14910,14910,1,574,574,0.038497653,0.038497653
FALSE,Iron County,7/1/99,Hide,Hide,7,1999,14603,14603,15142,15142,1,539,539,0.035596355,0.035596355
FALSE,Iron County,7/1/00,Hide,Hide,7,2000,16521,16521,17073,17073,1,552,552,0.032331752,0.032331752
FALSE,Iron County,7/1/01,Hide,Hide,7,2001,16488,16488,17285,17285,1,797,797,0.046109343,0.046109343
FALSE,Iron County,7/1/02,Hide,Hide,7,2002,16710,16710,17654,17654,1,944,944,0.053472301,0.053472301
FALSE,Iron County,7/1/03,Hide,Hide,7,2003,16951,16951,17872,17872,1,921,921,0.051533124,0.051533124
FALSE,Iron County,7/1/04,Hide,Hide,7,2004,17983,17983,18850,18850,1,867,867,0.045994695,0.045994695
FALSE,Iron County,7/1/05,Hide,Hide,7,2005,19086,19086,19842,19842,1,756,756,0.038100998,0.038100998
FALSE,Iron County,7/1/06,Hide,Hide,7,2006,20474,20474,21082,21082,1,608,608,0.028839769,0.028839769
FALSE,Iron County,7/1/07,Hide,Hide,7,2007,20378,20378,21000,21000,1,622,622,0.029619048,0.029619048
FALSE,Iron County,7/1/08,Hide,Hide,7,2008,20000,20000,20893,20893,1,893,893,0.042741588,0.042741588
FALSE,Iron County,7/1/09,Hide,Hide,7,2009,18962,18962,20827,20827,1,1865,1865,0.089547222,0.089547222
FALSE,Iron County,7/1/10,Hide,Hide,7,2010,18471,18471,20469,20469,1,1998,1998,0.097611022,0.097611022
FALSE,Iron County,7/1/11,Hide,Hide,7,2011,18165,18165,19781,19781,1,1616,1616,0.081694555,0.081694555
FALSE,Iron County,7/1/12,Hide,Hide,7,2012,18136,18136,19461,19461,1,1325,1325,0.068084888,0.068084888
FALSE,Iron County,7/1/13,Hide,Hide,7,2013,18262,18262,19326,19326,1,1064,1064,0.055055366,0.055055366
FALSE,Iron County,7/1/14,Hide,Hide,7,2014,18992,18992,19875,19875,1,883,883,0.044427673,0.044427673
FALSE,Iron County,7/1/15,Hide,Hide,7,2015,19477,19477,20373,20373,1,896,896,0.043979777,0.043979777
FALSE,Iron County,7/1/16,Hide,Hide,7,2016,20749,20749,21696,21696,1,947,947,0.043648599,0.043648599
FALSE,Iron County,7/1/17,Hide,Hide,7,2017,21279,21279,22209,22209,1,930,930,0.041874916,0.041874916
FALSE,Iron County,7/1/18,Hide,Hide,7,2018,22095,22095,22903,22903,1,808,808,0.035279221,0.035279221
FALSE,Iron County,7/1/19,Hide,Hide,7,2019,23373,23373,24070,24070,1,697,697,0.028957208,0.028957208
FALSE,Juab County,7/1/93,Hide,Hide,7,1993,3072,3072,3282,3282,1,210,210,0.063985375,0.063985375
FALSE,Juab County,7/1/94,Hide,Hide,7,1994,3159,3159,3321,3321,1,162,162,0.048780488,0.048780488
FALSE,Juab County,7/1/95,Hide,Hide,7,1995,3178,3178,3342,3342,1,164,164,0.049072412,0.049072412
FALSE,Juab County,7/1/96,Hide,Hide,7,1996,3292,3292,3426,3426,1,134,134,0.039112668,0.039112668
FALSE,Juab County,7/1/97,Hide,Hide,7,1997,3273,3273,3400,3400,1,127,127,0.037352941,0.037352941
FALSE,Juab County,7/1/98,Hide,Hide,7,1998,3518,3518,3673,3673,1,155,155,0.042199837,0.042199837
FALSE,Juab County,7/1/99,Hide,Hide,7,1999,3497,3497,3677,3677,1,180,180,0.048952951,0.048952951
FALSE,Juab County,7/1/00,Hide,Hide,7,2000,3586,3586,3718,3718,1,132,132,0.035502959,0.035502959
FALSE,Juab County,7/1/01,Hide,Hide,7,2001,3560,3560,3746,3746,1,186,186,0.049652963,0.049652963
FALSE,Juab County,7/1/02,Hide,Hide,7,2002,3397,3397,3679,3679,1,282,282,0.076651264,0.076651264
FALSE,Juab County,7/1/03,Hide,Hide,7,2003,3410,3410,3664,3664,1,254,254,0.069323144,0.069323144
FALSE,Juab County,7/1/04,Hide,Hide,7,2004,3585,3585,3826,3826,1,241,241,0.062990068,0.062990068
FALSE,Juab County,7/1/05,Hide,Hide,7,2005,3734,3734,3914,3914,1,180,180,0.045988758,0.045988758
FALSE,Juab County,7/1/06,Hide,Hide,7,2006,3890,3890,4047,4047,1,157,157,0.038794169,0.038794169
FALSE,Juab County,7/1/07,Hide,Hide,7,2007,3997,3997,4125,4125,1,128,128,0.031030303,0.031030303
FALSE,Juab County,7/1/08,Hide,Hide,7,2008,3734,3734,3934,3934,1,200,200,0.050838841,0.050838841
FALSE,Juab County,7/1/09,Hide,Hide,7,2009,3546,3546,3931,3931,1,385,385,0.097939456,0.097939456
FALSE,Juab County,7/1/10,Hide,Hide,7,2010,4200,4200,4639,4639,1,439,439,0.094632464,0.094632464
FALSE,Juab County,7/1/11,Hide,Hide,7,2011,4221,4221,4610,4610,1,389,389,0.084381779,0.084381779
FALSE,Juab County,7/1/12,Hide,Hide,7,2012,4354,4354,4633,4633,1,279,279,0.06022016,0.06022016
FALSE,Juab County,7/1/13,Hide,Hide,7,2013,4485,4485,4720,4720,1,235,235,0.049788136,0.049788136
FALSE,Juab County,7/1/14,Hide,Hide,7,2014,4597,4597,4790,4790,1,193,193,0.040292276,0.040292276
FALSE,Juab County,7/1/15,Hide,Hide,7,2015,4757,4757,4955,4955,1,198,198,0.039959637,0.039959637
FALSE,Juab County,7/1/16,Hide,Hide,7,2016,5050,5050,5239,5239,1,189,189,0.036075587,0.036075587
FALSE,Juab County,7/1/17,Hide,Hide,7,2017,5240,5240,5420,5420,1,180,180,0.033210332,0.033210332
FALSE,Juab County,7/1/18,Hide,Hide,7,2018,5389,5389,5551,5551,1,162,162,0.029183931,0.029183931
FALSE,Juab County,7/1/19,Hide,Hide,7,2019,5576,5576,5720,5720,1,144,144,0.025174825,0.025174825
FALSE,Kane County,7/1/93,Hide,Hide,7,1993,2212,2212,2348,2348,1,136,136,0.057921635,0.057921635
FALSE,Kane County,7/1/94,Hide,Hide,7,1994,2441,2441,2706,2706,1,265,265,0.097930525,0.097930525
FALSE,Kane County,7/1/95,Hide,Hide,7,1995,2452,2452,2697,2697,1,245,245,0.090841676,0.090841676
FALSE,Kane County,7/1/96,Hide,Hide,7,1996,2385,2385,2594,2594,1,209,209,0.080570547,0.080570547
FALSE,Kane County,7/1/97,Hide,Hide,7,1997,2452,2452,2562,2562,1,110,110,0.042935207,0.042935207
FALSE,Kane County,7/1/98,Hide,Hide,7,1998,2548,2548,2631,2631,1,83,83,0.03154694,0.03154694
FALSE,Kane County,7/1/99,Hide,Hide,7,1999,2599,2599,2693,2693,1,94,94,0.03490531,0.03490531
FALSE,Kane County,7/1/00,Hide,Hide,7,2000,3031,3031,3152,3152,1,121,121,0.038388325,0.038388325
FALSE,Kane County,7/1/01,Hide,Hide,7,2001,3061,3061,3197,3197,1,136,136,0.042539881,0.042539881
FALSE,Kane County,7/1/02,Hide,Hide,7,2002,2811,2811,2982,2982,1,171,171,0.057344064,0.057344064
FALSE,Kane County,7/1/03,Hide,Hide,7,2003,2951,2951,3130,3130,1,179,179,0.057188498,0.057188498
FALSE,Kane County,7/1/04,Hide,Hide,7,2004,3106,3106,3295,3295,1,189,189,0.057359636,0.057359636
FALSE,Kane County,7/1/05,Hide,Hide,7,2005,3123,3123,3283,3283,1,160,160,0.048735912,0.048735912
FALSE,Kane County,7/1/06,Hide,Hide,7,2006,3318,3318,3440,3440,1,122,122,0.035465116,0.035465116
FALSE,Kane County,7/1/07,Hide,Hide,7,2007,3347,3347,3458,3458,1,111,111,0.032099479,0.032099479
FALSE,Kane County,7/1/08,Hide,Hide,7,2008,3358,3358,3500,3500,1,142,142,0.040571429,0.040571429
FALSE,Kane County,7/1/09,Hide,Hide,7,2009,3223,3223,3491,3491,1,268,268,0.076768834,0.076768834
FALSE,Kane County,7/1/10,Hide,Hide,7,2010,3272,3272,3553,3553,1,281,281,0.079088095,0.079088095
FALSE,Kane County,7/1/11,Hide,Hide,7,2011,3223,3223,3481,3481,1,258,258,0.074116633,0.074116633
FALSE,Kane County,7/1/12,Hide,Hide,7,2012,3234,3234,3470,3470,1,236,236,0.068011527,0.068011527
FALSE,Kane County,7/1/13,Hide,Hide,7,2013,3284,3284,3467,3467,1,183,183,0.052783386,0.052783386
FALSE,Kane County,7/1/14,Hide,Hide,7,2014,3426,3426,3591,3591,1,165,165,0.045948204,0.045948204
FALSE,Kane County,7/1/15,Hide,Hide,7,2015,3478,3478,3636,3636,1,158,158,0.043454345,0.043454345
FALSE,Kane County,7/1/16,Hide,Hide,7,2016,3545,3545,3685,3685,1,140,140,0.037991859,0.037991859
FALSE,Kane County,7/1/17,Hide,Hide,7,2017,3612,3612,3742,3742,1,130,130,0.03474078,0.03474078
FALSE,Kane County,7/1/18,Hide,Hide,7,2018,3654,3654,3770,3770,1,116,116,0.030769231,0.030769231
FALSE,Kane County,7/1/19,Hide,Hide,7,2019,3714,3714,3825,3825,1,111,111,0.029019608,0.029019608
FALSE,Millard County,7/1/93,Hide,Hide,7,1993,4428,4428,4692,4692,1,264,264,0.056265985,0.056265985
FALSE,Millard County,7/1/94,Hide,Hide,7,1994,4540,4540,4770,4770,1,230,230,0.048218029,0.048218029
FALSE,Millard County,7/1/95,Hide,Hide,7,1995,4461,4461,4683,4683,1,222,222,0.047405509,0.047405509
FALSE,Millard County,7/1/96,Hide,Hide,7,1996,4562,4562,4757,4757,1,195,195,0.040992222,0.040992222
FALSE,Millard County,7/1/97,Hide,Hide,7,1997,4567,4567,4739,4739,1,172,172,0.036294577,0.036294577
FALSE,Millard County,7/1/98,Hide,Hide,7,1998,4483,4483,4702,4702,1,219,219,0.046575925,0.046575925
FALSE,Millard County,7/1/99,Hide,Hide,7,1999,4447,4447,4651,4651,1,204,204,0.043861535,0.043861535
FALSE,Millard County,7/1/00,Hide,Hide,7,2000,5047,5047,5227,5227,1,180,180,0.034436579,0.034436579
FALSE,Millard County,7/1/01,Hide,Hide,7,2001,5512,5512,5742,5742,1,230,230,0.04005573,0.04005573
FALSE,Millard County,7/1/02,Hide,Hide,7,2002,5743,5743,6032,6032,1,289,289,0.047911141,0.047911141
FALSE,Millard County,7/1/03,Hide,Hide,7,2003,5637,5637,5929,5929,1,292,292,0.049249452,0.049249452
FALSE,Millard County,7/1/04,Hide,Hide,7,2004,5838,5838,6133,6133,1,295,295,0.04810044,0.04810044
FALSE,Millard County,7/1/05,Hide,Hide,7,2005,5879,5879,6126,6126,1,247,247,0.040319948,0.040319948
FALSE,Millard County,7/1/06,Hide,Hide,7,2006,6053,6053,6234,6234,1,181,181,0.029034328,0.029034328
FALSE,Millard County,7/1/07,Hide,Hide,7,2007,5967,5967,6123,6123,1,156,156,0.025477707,0.025477707
FALSE,Millard County,7/1/08,Hide,Hide,7,2008,5901,5901,6101,6101,1,200,200,0.032781511,0.032781511
FALSE,Millard County,7/1/09,Hide,Hide,7,2009,6130,6130,6498,6498,1,368,368,0.05663281,0.05663281
FALSE,Millard County,7/1/10,Hide,Hide,7,2010,6062,6062,6462,6462,1,400,400,0.06190034,0.06190034
FALSE,Millard County,7/1/11,Hide,Hide,7,2011,5860,5860,6183,6183,1,323,323,0.052240013,0.052240013
FALSE,Millard County,7/1/12,Hide,Hide,7,2012,5659,5659,5939,5939,1,280,280,0.047145984,0.047145984
FALSE,Millard County,7/1/13,Hide,Hide,7,2013,5633,5633,5876,5876,1,243,243,0.041354663,0.041354663
FALSE,Millard County,7/1/14,Hide,Hide,7,2014,5697,5697,5901,5901,1,204,204,0.034570412,0.034570412
FALSE,Millard County,7/1/15,Hide,Hide,7,2015,5943,5943,6157,6157,1,214,214,0.034757187,0.034757187
FALSE,Millard County,7/1/16,Hide,Hide,7,2016,6090,6090,6294,6294,1,204,204,0.032411821,0.032411821
FALSE,Millard County,7/1/17,Hide,Hide,7,2017,6172,6172,6382,6382,1,210,210,0.032905045,0.032905045
FALSE,Millard County,7/1/18,Hide,Hide,7,2018,5954,5954,6152,6152,1,198,198,0.032184655,0.032184655
FALSE,Millard County,7/1/19,Hide,Hide,7,2019,5839,5839,6002,6002,1,163,163,0.027157614,0.027157614
FALSE,Morgan County,7/1/93,Hide,Hide,7,1993,2798,2798,2969,2969,1,171,171,0.05759515,0.05759515
FALSE,Morgan County,7/1/94,Hide,Hide,7,1994,2875,2875,3023,3023,1,148,148,0.048957989,0.048957989
FALSE,Morgan County,7/1/95,Hide,Hide,7,1995,3321,3321,3471,3471,1,150,150,0.043215212,0.043215212
FALSE,Morgan County,7/1/96,Hide,Hide,7,1996,3399,3399,3542,3542,1,143,143,0.040372671,0.040372671
FALSE,Morgan County,7/1/97,Hide,Hide,7,1997,3452,3452,3592,3592,1,140,140,0.038975501,0.038975501
FALSE,Morgan County,7/1/98,Hide,Hide,7,1998,3546,3546,3693,3693,1,147,147,0.039805037,0.039805037
FALSE,Morgan County,7/1/99,Hide,Hide,7,1999,3419,3419,3562,3562,1,143,143,0.040145985,0.040145985
FALSE,Morgan County,7/1/00,Hide,Hide,7,2000,3276,3276,3395,3395,1,119,119,0.035051546,0.035051546
FALSE,Morgan County,7/1/01,Hide,Hide,7,2001,3323,3323,3456,3456,1,133,133,0.038483796,0.038483796
FALSE,Morgan County,7/1/02,Hide,Hide,7,2002,3363,3363,3551,3551,1,188,188,0.052942833,0.052942833
FALSE,Morgan County,7/1/03,Hide,Hide,7,2003,3394,3394,3578,3578,1,184,184,0.051425377,0.051425377
FALSE,Morgan County,7/1/04,Hide,Hide,7,2004,3505,3505,3681,3681,1,176,176,0.047813094,0.047813094
FALSE,Morgan County,7/1/05,Hide,Hide,7,2005,3665,3665,3824,3824,1,159,159,0.041579498,0.041579498
FALSE,Morgan County,7/1/06,Hide,Hide,7,2006,3828,3828,3945,3945,1,117,117,0.029657795,0.029657795
FALSE,Morgan County,7/1/07,Hide,Hide,7,2007,3896,3896,4006,4006,1,110,110,0.027458812,0.027458812
FALSE,Morgan County,7/1/08,Hide,Hide,7,2008,3929,3929,4057,4057,1,128,128,0.031550407,0.031550407
FALSE,Morgan County,7/1/09,Hide,Hide,7,2009,3798,3798,4053,4053,1,255,255,0.062916358,0.062916358
FALSE,Morgan County,7/1/10,Hide,Hide,7,2010,3999,3999,4299,4299,1,300,300,0.069783671,0.069783671
FALSE,Morgan County,7/1/11,Hide,Hide,7,2011,4006,4006,4241,4241,1,235,235,0.05541146,0.05541146
FALSE,Morgan County,7/1/12,Hide,Hide,7,2012,4126,4126,4336,4336,1,210,210,0.048431734,0.048431734
FALSE,Morgan County,7/1/13,Hide,Hide,7,2013,4326,4326,4507,4507,1,181,181,0.040159751,0.040159751
FALSE,Morgan County,7/1/14,Hide,Hide,7,2014,4528,4528,4688,4688,1,160,160,0.034129693,0.034129693
FALSE,Morgan County,7/1/15,Hide,Hide,7,2015,4781,4781,4937,4937,1,156,156,0.031598137,0.031598137
FALSE,Morgan County,7/1/16,Hide,Hide,7,2016,5005,5005,5155,5155,1,150,150,0.029097963,0.029097963
FALSE,Morgan County,7/1/17,Hide,Hide,7,2017,5249,5249,5402,5402,1,153,153,0.028322843,0.028322843
FALSE,Morgan County,7/1/18,Hide,Hide,7,2018,5288,5288,5438,5438,1,150,150,0.02758367,0.02758367
FALSE,Morgan County,7/1/19,Hide,Hide,7,2019,5441,5441,5577,5577,1,136,136,0.024385871,0.024385871
FALSE,Piute County,7/1/93,Hide,Hide,7,1993,457,457,485,485,1,28,28,0.057731959,0.057731959
FALSE,Piute County,7/1/94,Hide,Hide,7,1994,454,454,500,500,1,46,46,0.092,0.092
FALSE,Piute County,7/1/95,Hide,Hide,7,1995,459,459,488,488,1,29,29,0.05942623,0.05942623
FALSE,Piute County,7/1/96,Hide,Hide,7,1996,495,495,518,518,1,23,23,0.044401544,0.044401544
FALSE,Piute County,7/1/97,Hide,Hide,7,1997,487,487,509,509,1,22,22,0.043222004,0.043222004
FALSE,Piute County,7/1/98,Hide,Hide,7,1998,482,482,503,503,1,21,21,0.041749503,0.041749503
FALSE,Piute County,7/1/99,Hide,Hide,7,1999,513,513,548,548,1,35,35,0.063868613,0.063868613
FALSE,Piute County,7/1/00,Hide,Hide,7,2000,614,614,641,641,1,27,27,0.042121685,0.042121685
FALSE,Piute County,7/1/01,Hide,Hide,7,2001,739,739,782,782,1,43,43,0.054987212,0.054987212
FALSE,Piute County,7/1/02,Hide,Hide,7,2002,682,682,731,731,1,49,49,0.067031464,0.067031464
FALSE,Piute County,7/1/03,Hide,Hide,7,2003,761,761,806,806,1,45,45,0.055831266,0.055831266
FALSE,Piute County,7/1/04,Hide,Hide,7,2004,844,844,881,881,1,37,37,0.04199773,0.04199773
FALSE,Piute County,7/1/05,Hide,Hide,7,2005,806,806,839,839,1,33,33,0.039332539,0.039332539
FALSE,Piute County,7/1/06,Hide,Hide,7,2006,877,877,903,903,1,26,26,0.028792913,0.028792913
FALSE,Piute County,7/1/07,Hide,Hide,7,2007,912,912,933,933,1,21,21,0.022508039,0.022508039
FALSE,Piute County,7/1/08,Hide,Hide,7,2008,878,878,904,904,1,26,26,0.028761062,0.028761062
FALSE,Piute County,7/1/09,Hide,Hide,7,2009,831,831,892,892,1,61,61,0.06838565,0.06838565
FALSE,Piute County,7/1/10,Hide,Hide,7,2010,499,499,557,557,1,58,58,0.104129264,0.104129264
FALSE,Piute County,7/1/11,Hide,Hide,7,2011,469,469,522,522,1,53,53,0.101532567,0.101532567
FALSE,Piute County,7/1/12,Hide,Hide,7,2012,447,447,490,490,1,43,43,0.087755102,0.087755102
FALSE,Piute County,7/1/13,Hide,Hide,7,2013,457,457,495,495,1,38,38,0.076767677,0.076767677
FALSE,Piute County,7/1/14,Hide,Hide,7,2014,416,416,448,448,1,32,32,0.071428571,0.071428571
FALSE,Piute County,7/1/15,Hide,Hide,7,2015,441,441,469,469,1,28,28,0.059701493,0.059701493
FALSE,Piute County,7/1/16,Hide,Hide,7,2016,433,433,460,460,1,27,27,0.058695652,0.058695652
FALSE,Piute County,7/1/17,Hide,Hide,7,2017,458,458,482,482,1,24,24,0.049792531,0.049792531
FALSE,Piute County,7/1/18,Hide,Hide,7,2018,454,454,478,478,1,24,24,0.050209205,0.050209205
FALSE,Piute County,7/1/19,Hide,Hide,7,2019,460,460,483,483,1,23,23,0.047619048,0.047619048
FALSE,Rich County,7/1/93,Hide,Hide,7,1993,770,770,792,792,1,22,22,0.027777778,0.027777778
FALSE,Rich County,7/1/94,Hide,Hide,7,1994,821,821,854,854,1,33,33,0.038641686,0.038641686
FALSE,Rich County,7/1/95,Hide,Hide,7,1995,848,848,887,887,1,39,39,0.043968433,0.043968433
FALSE,Rich County,7/1/96,Hide,Hide,7,1996,938,938,974,974,1,36,36,0.036960986,0.036960986
FALSE,Rich County,7/1/97,Hide,Hide,7,1997,908,908,939,939,1,31,31,0.033013845,0.033013845
FALSE,Rich County,7/1/98,Hide,Hide,7,1998,937,937,969,969,1,32,32,0.033023736,0.033023736
FALSE,Rich County,7/1/99,Hide,Hide,7,1999,961,961,1000,1000,1,39,39,0.039,0.039
FALSE,Rich County,7/1/00,Hide,Hide,7,2000,1052,1052,1081,1081,1,29,29,0.026827012,0.026827012
FALSE,Rich County,7/1/01,Hide,Hide,7,2001,1146,1146,1179,1179,1,33,33,0.027989822,0.027989822
FALSE,Rich County,7/1/02,Hide,Hide,7,2002,1167,1167,1220,1220,1,53,53,0.043442623,0.043442623
FALSE,Rich County,7/1/03,Hide,Hide,7,2003,1214,1214,1262,1262,1,48,48,0.038034865,0.038034865
FALSE,Rich County,7/1/04,Hide,Hide,7,2004,1330,1330,1374,1374,1,44,44,0.03202329,0.03202329
FALSE,Rich County,7/1/05,Hide,Hide,7,2005,1242,1242,1282,1282,1,40,40,0.031201248,0.031201248
FALSE,Rich County,7/1/06,Hide,Hide,7,2006,1402,1402,1434,1434,1,32,32,0.022315202,0.022315202
FALSE,Rich County,7/1/07,Hide,Hide,7,2007,1376,1376,1408,1408,1,32,32,0.022727273,0.022727273
FALSE,Rich County,7/1/08,Hide,Hide,7,2008,1392,1392,1428,1428,1,36,36,0.025210084,0.025210084
FALSE,Rich County,7/1/09,Hide,Hide,7,2009,1378,1378,1455,1455,1,77,77,0.052920962,0.052920962
FALSE,Rich County,7/1/10,Hide,Hide,7,2010,964,964,1038,1038,1,74,74,0.071290944,0.071290944
FALSE,Rich County,7/1/11,Hide,Hide,7,2011,912,912,982,982,1,70,70,0.071283096,0.071283096
FALSE,Rich County,7/1/12,Hide,Hide,7,2012,914,914,962,962,1,48,48,0.04989605,0.04989605
FALSE,Rich County,7/1/13,Hide,Hide,7,2013,923,923,968,968,1,45,45,0.046487603,0.046487603
FALSE,Rich County,7/1/14,Hide,Hide,7,2014,938,938,977,977,1,39,39,0.039918117,0.039918117
FALSE,Rich County,7/1/15,Hide,Hide,7,2015,1012,1012,1052,1052,1,40,40,0.038022814,0.038022814
FALSE,Rich County,7/1/16,Hide,Hide,7,2016,1079,1079,1113,1113,1,34,34,0.030548068,0.030548068
FALSE,Rich County,7/1/17,Hide,Hide,7,2017,1098,1098,1135,1135,1,37,37,0.032599119,0.032599119
FALSE,Rich County,7/1/18,Hide,Hide,7,2018,1136,1136,1172,1172,1,36,36,0.030716724,0.030716724
FALSE,Rich County,7/1/19,Hide,Hide,7,2019,1154,1154,1189,1189,1,35,35,0.029436501,0.029436501
FALSE,Salt Lake County,7/1/93,Hide,Hide,7,1993,407796,407796,422574,422574,1,14778,14778,0.03497139,0.03497139
FALSE,Salt Lake County,7/1/94,Hide,Hide,7,1994,427624,427624,442665,442665,1,15041,15041,0.033978291,0.033978291
FALSE,Salt Lake County,7/1/95,Hide,Hide,7,1995,440589,440589,454053,454053,1,13464,13464,0.029652926,0.029652926
FALSE,Salt Lake County,7/1/96,Hide,Hide,7,1996,448868,448868,462175,462175,1,13307,13307,0.028792124,0.028792124
FALSE,Salt Lake County,7/1/97,Hide,Hide,7,1997,461930,461930,475116,475116,1,13186,13186,0.027753222,0.027753222
FALSE,Salt Lake County,7/1/98,Hide,Hide,7,1998,468026,468026,483968,483968,1,15942,15942,0.032940194,0.032940194
FALSE,Salt Lake County,7/1/99,Hide,Hide,7,1999,475044,475044,491200,491200,1,16156,16156,0.032890879,0.032890879
FALSE,Salt Lake County,7/1/00,Hide,Hide,7,2000,469530,469530,484849,484849,1,15319,15319,0.031595404,0.031595404
FALSE,Salt Lake County,7/1/01,Hide,Hide,7,2001,470911,470911,492615,492615,1,21704,21704,0.044058748,0.044058748
FALSE,Salt Lake County,7/1/02,Hide,Hide,7,2002,464084,464084,494318,494318,1,30234,30234,0.061163057,0.061163057
FALSE,Salt Lake County,7/1/03,Hide,Hide,7,2003,468168,468168,496580,496580,1,28412,28412,0.057215353,0.057215353
FALSE,Salt Lake County,7/1/04,Hide,Hide,7,2004,474675,474675,499634,499634,1,24959,24959,0.049954567,0.049954567
FALSE,Salt Lake County,7/1/05,Hide,Hide,7,2005,498652,498652,518916,518916,1,20264,20264,0.039050636,0.039050636
FALSE,Salt Lake County,7/1/06,Hide,Hide,7,2006,520078,520078,535483,535483,1,15405,15405,0.02876842,0.02876842
FALSE,Salt Lake County,7/1/07,Hide,Hide,7,2007,537921,537921,551774,551774,1,13853,13853,0.025106294,0.025106294
FALSE,Salt Lake County,7/1/08,Hide,Hide,7,2008,539269,539269,557491,557491,1,18222,18222,0.032685729,0.032685729
FALSE,Salt Lake County,7/1/09,Hide,Hide,7,2009,512141,512141,552567,552567,1,40426,40426,0.073160359,0.073160359
FALSE,Salt Lake County,7/1/10,Hide,Hide,7,2010,506767,506767,549275,549275,1,42508,42508,0.077389286,0.077389286
FALSE,Salt Lake County,7/1/11,Hide,Hide,7,2011,509750,509750,545556,545556,1,35806,35806,0.065632126,0.065632126
FALSE,Salt Lake County,7/1/12,Hide,Hide,7,2012,528427,528427,557202,557202,1,28775,28775,0.051641954,0.051641954
FALSE,Salt Lake County,7/1/13,Hide,Hide,7,2013,545481,545481,570344,570344,1,24863,24863,0.043592989,0.043592989
FALSE,Salt Lake County,7/1/14,Hide,Hide,7,2014,554364,554364,575343,575343,1,20979,20979,0.036463466,0.036463466
FALSE,Salt Lake County,7/1/15,Hide,Hide,7,2015,565269,565269,585062,585062,1,19793,19793,0.033830603,0.033830603
FALSE,Salt Lake County,7/1/16,Hide,Hide,7,2016,583929,583929,602726,602726,1,18797,18797,0.031186642,0.031186642
FALSE,Salt Lake County,7/1/17,Hide,Hide,7,2017,595949,595949,615363,615363,1,19414,19414,0.031548858,0.031548858
FALSE,Salt Lake County,7/1/18,Hide,Hide,7,2018,600994,600994,619267,619267,1,18273,18273,0.029507466,0.029507466
FALSE,Salt Lake County,7/1/19,Hide,Hide,7,2019,620191,620191,635902,635902,1,15711,15711,0.024706637,0.024706637
FALSE,San Juan County,7/1/93,Hide,Hide,7,1993,4768,4768,5116,5116,1,348,348,0.068021892,0.068021892
FALSE,San Juan County,7/1/94,Hide,Hide,7,1994,4725,4725,5156,5156,1,431,431,0.083591932,0.083591932
FALSE,San Juan County,7/1/95,Hide,Hide,7,1995,4799,4799,5255,5255,1,456,456,0.0867745,0.0867745
FALSE,San Juan County,7/1/96,Hide,Hide,7,1996,4606,4606,5084,5084,1,478,478,0.094020456,0.094020456
FALSE,San Juan County,7/1/97,Hide,Hide,7,1997,4465,4465,4880,4880,1,415,415,0.085040984,0.085040984
FALSE,San Juan County,7/1/98,Hide,Hide,7,1998,4613,4613,5004,5004,1,391,391,0.07813749,0.07813749
FALSE,San Juan County,7/1/99,Hide,Hide,7,1999,4684,4684,5068,5068,1,384,384,0.075769534,0.075769534
FALSE,San Juan County,7/1/00,Hide,Hide,7,2000,4295,4295,4668,4668,1,373,373,0.079905741,0.079905741
FALSE,San Juan County,7/1/01,Hide,Hide,7,2001,4188,4188,4559,4559,1,371,371,0.081377495,0.081377495
FALSE,San Juan County,7/1/02,Hide,Hide,7,2002,4360,4360,4767,4767,1,407,407,0.085378645,0.085378645
FALSE,San Juan County,7/1/03,Hide,Hide,7,2003,4283,4283,4718,4718,1,435,435,0.092200085,0.092200085
FALSE,San Juan County,7/1/04,Hide,Hide,7,2004,4446,4446,4899,4899,1,453,453,0.092467851,0.092467851
FALSE,San Juan County,7/1/05,Hide,Hide,7,2005,4415,4415,4783,4783,1,368,368,0.07693916,0.07693916
FALSE,San Juan County,7/1/06,Hide,Hide,7,2006,4609,4609,4917,4917,1,308,308,0.062639821,0.062639821
FALSE,San Juan County,7/1/07,Hide,Hide,7,2007,4703,4703,4972,4972,1,269,269,0.054102977,0.054102977
FALSE,San Juan County,7/1/08,Hide,Hide,7,2008,4694,4694,5001,5001,1,307,307,0.061387722,0.061387722
FALSE,San Juan County,7/1/09,Hide,Hide,7,2009,4659,4659,5295,5295,1,636,636,0.120113314,0.120113314
FALSE,San Juan County,7/1/10,Hide,Hide,7,2010,5488,5488,6145,6145,1,657,657,0.106916192,0.106916192
FALSE,San Juan County,7/1/11,Hide,Hide,7,2011,5355,5355,5945,5945,1,590,590,0.099243061,0.099243061
FALSE,San Juan County,7/1/12,Hide,Hide,7,2012,5199,5199,5704,5704,1,505,505,0.088534362,0.088534362
FALSE,San Juan County,7/1/13,Hide,Hide,7,2013,5204,5204,5659,5659,1,455,455,0.080402898,0.080402898
FALSE,San Juan County,7/1/14,Hide,Hide,7,2014,5155,5155,5582,5582,1,427,427,0.07649588,0.07649588
FALSE,San Juan County,7/1/15,Hide,Hide,7,2015,5265,5265,5720,5720,1,455,455,0.079545455,0.079545455
FALSE,San Juan County,7/1/16,Hide,Hide,7,2016,5280,5280,5746,5746,1,466,466,0.081099896,0.081099896
FALSE,San Juan County,7/1/17,Hide,Hide,7,2017,5282,5282,5675,5675,1,393,393,0.069251101,0.069251101
FALSE,San Juan County,7/1/18,Hide,Hide,7,2018,5369,5369,5720,5720,1,351,351,0.061363636,0.061363636
FALSE,San Juan County,7/1/19,Hide,Hide,7,2019,5444,5444,5727,5727,1,283,283,0.049415052,0.049415052
FALSE,Sanpete County,7/1/93,Hide,Hide,7,1993,6763,6763,7227,7227,1,464,464,0.064203681,0.064203681
FALSE,Sanpete County,7/1/94,Hide,Hide,7,1994,7066,7066,7568,7568,1,502,502,0.066331924,0.066331924
FALSE,Sanpete County,7/1/95,Hide,Hide,7,1995,7288,7288,7755,7755,1,467,467,0.060219213,0.060219213
FALSE,Sanpete County,7/1/96,Hide,Hide,7,1996,7805,7805,8279,8279,1,474,474,0.057253291,0.057253291
FALSE,Sanpete County,7/1/97,Hide,Hide,7,1997,8093,8093,8543,8543,1,450,450,0.052674704,0.052674704
FALSE,Sanpete County,7/1/98,Hide,Hide,7,1998,8492,8492,9012,9012,1,520,520,0.057700843,0.057700843
FALSE,Sanpete County,7/1/99,Hide,Hide,7,1999,8475,8475,8961,8961,1,486,486,0.054235018,0.054235018
FALSE,Sanpete County,7/1/00,Hide,Hide,7,2000,9398,9398,9831,9831,1,433,433,0.04404435,0.04404435
FALSE,Sanpete County,7/1/01,Hide,Hide,7,2001,9566,9566,10111,10111,1,545,545,0.053901691,0.053901691
FALSE,Sanpete County,7/1/02,Hide,Hide,7,2002,9424,9424,10096,10096,1,672,672,0.066561014,0.066561014
FALSE,Sanpete County,7/1/03,Hide,Hide,7,2003,9524,9524,10206,10206,1,682,682,0.066823437,0.066823437
FALSE,Sanpete County,7/1/04,Hide,Hide,7,2004,9888,9888,10551,10551,1,663,663,0.062837646,0.062837646
FALSE,Sanpete County,7/1/05,Hide,Hide,7,2005,10018,10018,10575,10575,1,557,557,0.052671395,0.052671395
FALSE,Sanpete County,7/1/06,Hide,Hide,7,2006,10256,10256,10655,10655,1,399,399,0.037447208,0.037447208
FALSE,Sanpete County,7/1/07,Hide,Hide,7,2007,10570,10570,10915,10915,1,345,345,0.031607879,0.031607879
FALSE,Sanpete County,7/1/08,Hide,Hide,7,2008,10728,10728,11179,11179,1,451,451,0.040343501,0.040343501
FALSE,Sanpete County,7/1/09,Hide,Hide,7,2009,10340,10340,11280,11280,1,940,940,0.083333333,0.083333333
FALSE,Sanpete County,7/1/10,Hide,Hide,7,2010,10391,10391,11479,11479,1,1088,1088,0.094781775,0.094781775
FALSE,Sanpete County,7/1/11,Hide,Hide,7,2011,10197,10197,11068,11068,1,871,871,0.078695338,0.078695338
FALSE,Sanpete County,7/1/12,Hide,Hide,7,2012,10536,10536,11244,11244,1,708,708,0.062966916,0.062966916
FALSE,Sanpete County,7/1/13,Hide,Hide,7,2013,10373,10373,10993,10993,1,620,620,0.056399527,0.056399527
FALSE,Sanpete County,7/1/14,Hide,Hide,7,2014,10560,10560,11057,11057,1,497,497,0.044948901,0.044948901
FALSE,Sanpete County,7/1/15,Hide,Hide,7,2015,11021,11021,11498,11498,1,477,477,0.041485476,0.041485476
FALSE,Sanpete County,7/1/16,Hide,Hide,7,2016,11443,11443,11910,11910,1,467,467,0.039210747,0.039210747
FALSE,Sanpete County,7/1/17,Hide,Hide,7,2017,11450,11450,11926,11926,1,476,476,0.039912796,0.039912796
FALSE,Sanpete County,7/1/18,Hide,Hide,7,2018,11990,11990,12447,12447,1,457,457,0.036715674,0.036715674
FALSE,Sanpete County,7/1/19,Hide,Hide,7,2019,12090,12090,12483,12483,1,393,393,0.031482817,0.031482817
FALSE,Sevier County,7/1/93,Hide,Hide,7,1993,6790,6790,7175,7175,1,385,385,0.053658537,0.053658537
FALSE,Sevier County,7/1/94,Hide,Hide,7,1994,7136,7136,7510,7510,1,374,374,0.049800266,0.049800266
FALSE,Sevier County,7/1/95,Hide,Hide,7,1995,7240,7240,7622,7622,1,382,382,0.050118079,0.050118079
FALSE,Sevier County,7/1/96,Hide,Hide,7,1996,7480,7480,7833,7833,1,353,353,0.045065747,0.045065747
FALSE,Sevier County,7/1/97,Hide,Hide,7,1997,7777,7777,8076,8076,1,299,299,0.037023279,0.037023279
FALSE,Sevier County,7/1/98,Hide,Hide,7,1998,7928,7928,8331,8331,1,403,403,0.048373545,0.048373545
FALSE,Sevier County,7/1/99,Hide,Hide,7,1999,8148,8148,8494,8494,1,346,346,0.040734636,0.040734636
FALSE,Sevier County,7/1/00,Hide,Hide,7,2000,8059,8059,8380,8380,1,321,321,0.038305489,0.038305489
FALSE,Sevier County,7/1/01,Hide,Hide,7,2001,8184,8184,8580,8580,1,396,396,0.046153846,0.046153846
FALSE,Sevier County,7/1/02,Hide,Hide,7,2002,8307,8307,8816,8816,1,509,509,0.057735935,0.057735935
FALSE,Sevier County,7/1/03,Hide,Hide,7,2003,8208,8208,8711,8711,1,503,503,0.057743083,0.057743083
FALSE,Sevier County,7/1/04,Hide,Hide,7,2004,8809,8809,9296,9296,1,487,487,0.052388124,0.052388124
FALSE,Sevier County,7/1/05,Hide,Hide,7,2005,8728,8728,9128,9128,1,400,400,0.043821209,0.043821209
FALSE,Sevier County,7/1/06,Hide,Hide,7,2006,9103,9103,9414,9414,1,311,311,0.033035904,0.033035904
FALSE,Sevier County,7/1/07,Hide,Hide,7,2007,9159,9159,9438,9438,1,279,279,0.029561348,0.029561348
FALSE,Sevier County,7/1/08,Hide,Hide,7,2008,9253,9253,9630,9630,1,377,377,0.039148494,0.039148494
FALSE,Sevier County,7/1/09,Hide,Hide,7,2009,9089,9089,9865,9865,1,776,776,0.078661936,0.078661936
FALSE,Sevier County,7/1/10,Hide,Hide,7,2010,8953,8953,9751,9751,1,798,798,0.08183776,0.08183776
FALSE,Sevier County,7/1/11,Hide,Hide,7,2011,8790,8790,9495,9495,1,705,705,0.074249605,0.074249605
FALSE,Sevier County,7/1/12,Hide,Hide,7,2012,8868,8868,9438,9438,1,570,570,0.060394151,0.060394151
FALSE,Sevier County,7/1/13,Hide,Hide,7,2013,8714,8714,9218,9218,1,504,504,0.054675635,0.054675635
FALSE,Sevier County,7/1/14,Hide,Hide,7,2014,8807,8807,9224,9224,1,417,417,0.045208153,0.045208153
FALSE,Sevier County,7/1/15,Hide,Hide,7,2015,9092,9092,9517,9517,1,425,425,0.04465693,0.04465693
FALSE,Sevier County,7/1/16,Hide,Hide,7,2016,9218,9218,9643,9643,1,425,425,0.044073421,0.044073421
FALSE,Sevier County,7/1/17,Hide,Hide,7,2017,9380,9380,9765,9765,1,385,385,0.039426523,0.039426523
FALSE,Sevier County,7/1/18,Hide,Hide,7,2018,9499,9499,9841,9841,1,342,342,0.034752566,0.034752566
FALSE,Sevier County,7/1/19,Hide,Hide,7,2019,9429,9429,9727,9727,1,298,298,0.030636373,0.030636373
FALSE,State of Utah,7/1/93,Hide,Hide,7,1993,906127,906127,944141,944141,1,38014,38014,0.040263054,0.040263054
FALSE,State of Utah,7/1/94,Hide,Hide,7,1994,956310,956310,994097,994097,1,37787,37787,0.038011381,0.038011381
FALSE,State of Utah,7/1/95,Hide,Hide,7,1995,977759,977759,1012954,1012954,1,35195,35195,0.034744914,0.034744914
FALSE,State of Utah,7/1/96,Hide,Hide,7,1996,1005197,1005197,1039963,1039963,1,34766,34766,0.033430035,0.033430035
FALSE,State of Utah,7/1/97,Hide,Hide,7,1997,1038390,1038390,1071713,1071713,1,33323,33323,0.031093212,0.031093212
FALSE,State of Utah,7/1/98,Hide,Hide,7,1998,1061830,1061830,1102725,1102725,1,40895,40895,0.037085402,0.037085402
FALSE,State of Utah,7/1/99,Hide,Hide,7,1999,1081752,1081752,1122586,1122586,1,40834,40834,0.036374941,0.036374941
FALSE,State of Utah,7/1/00,Hide,Hide,7,2000,1104672,1104672,1142892,1142892,1,38220,38220,0.03344148,0.03344148
FALSE,State of Utah,7/1/01,Hide,Hide,7,2001,1112834,1112834,1164046,1164046,1,51212,51212,0.043994825,0.043994825
FALSE,State of Utah,7/1/02,Hide,Hide,7,2002,1114742,1114742,1184683,1184683,1,69941,69941,0.059037734,0.059037734
FALSE,State of Utah,7/1/03,Hide,Hide,7,2003,1132323,1132323,1199599,1199599,1,67276,67276,0.056082074,0.056082074
FALSE,State of Utah,7/1/04,Hide,Hide,7,2004,1171424,1171424,1232699,1232699,1,61275,61275,0.049707998,0.049707998
FALSE,State of Utah,7/1/05,Hide,Hide,7,2005,1223769,1223769,1275042,1275042,1,51273,51273,0.040212793,0.040212793
FALSE,State of Utah,7/1/06,Hide,Hide,7,2006,1282068,1282068,1320893,1320893,1,38825,38825,0.029392994,0.029392994
FALSE,State of Utah,7/1/07,Hide,Hide,7,2007,1326162,1326162,1361588,1361588,1,35426,35426,0.026018149,0.026018149
FALSE,State of Utah,7/1/08,Hide,Hide,7,2008,1324473,1324473,1371741,1371741,1,47268,47268,0.0344584,0.0344584
FALSE,State of Utah,7/1/09,Hide,Hide,7,2009,1261275,1261275,1363368,1363368,1,102093,102093,0.074882937,0.074882937
FALSE,State of Utah,7/1/10,Hide,Hide,7,2010,1250758,1250758,1357782,1357782,1,107024,107024,0.078822668,0.078822668
FALSE,State of Utah,7/1/11,Hide,Hide,7,2011,1257868,1257868,1347981,1347981,1,90113,90113,0.066850349,0.066850349
FALSE,State of Utah,7/1/12,Hide,Hide,7,2012,1300979,1300979,1373996,1373996,1,73017,73017,0.053142076,0.053142076
FALSE,State of Utah,7/1/13,Hide,Hide,7,2013,1343422,1343422,1407731,1407731,1,64309,64309,0.045682733,0.045682733
FALSE,State of Utah,7/1/14,Hide,Hide,7,2014,1372207,1372207,1426066,1426066,1,53859,53859,0.037767537,0.037767537
FALSE,State of Utah,7/1/15,Hide,Hide,7,2015,1409003,1409003,1462151,1462151,1,53148,53148,0.036349187,0.036349187
FALSE,State of Utah,7/1/16,Hide,Hide,7,2016,1458150,1458150,1509453,1509453,1,51303,51303,0.033987809,0.033987809
FALSE,State of Utah,7/1/17,Hide,Hide,7,2017,1499328,1499328,1550143,1550143,1,50815,50815,0.032780847,0.032780847
FALSE,State of Utah,7/1/18,Hide,Hide,7,2018,1521900,1521900,1570938,1570938,1,49038,49038,0.031215745,0.031215745
FALSE,State of Utah,7/1/19,Hide,Hide,7,2019,1550525,1550525,1595978,1595978,1,45453,45453,0.028479716,0.028479716
FALSE,Summit County,7/1/93,Hide,Hide,7,1993,9841,9841,10376,10376,1,535,535,0.051561295,0.051561295
FALSE,Summit County,7/1/94,Hide,Hide,7,1994,10920,10920,11412,11412,1,492,492,0.043112513,0.043112513
FALSE,Summit County,7/1/95,Hide,Hide,7,1995,11602,11602,12070,12070,1,468,468,0.038773819,0.038773819
FALSE,Summit County,7/1/96,Hide,Hide,7,1996,12391,12391,12832,12832,1,441,441,0.034367207,0.034367207
FALSE,Summit County,7/1/97,Hide,Hide,7,1997,12911,12911,13381,13381,1,470,470,0.03512443,0.03512443
FALSE,Summit County,7/1/98,Hide,Hide,7,1998,13392,13392,14015,14015,1,623,623,0.044452372,0.044452372
FALSE,Summit County,7/1/99,Hide,Hide,7,1999,13754,13754,14468,14468,1,714,714,0.04935029,0.04935029
FALSE,Summit County,7/1/00,Hide,Hide,7,2000,17959,17959,18598,18598,1,639,639,0.034358533,0.034358533
FALSE,Summit County,7/1/01,Hide,Hide,7,2001,18223,18223,19072,19072,1,849,849,0.04451552,0.04451552
FALSE,Summit County,7/1/02,Hide,Hide,7,2002,18237,18237,19529,19529,1,1292,1292,0.066158021,0.066158021
FALSE,Summit County,7/1/03,Hide,Hide,7,2003,18727,18727,19953,19953,1,1226,1226,0.061444394,0.061444394
FALSE,Summit County,7/1/04,Hide,Hide,7,2004,19453,19453,20513,20513,1,1060,1060,0.051674548,0.051674548
FALSE,Summit County,7/1/05,Hide,Hide,7,2005,20707,20707,21545,21545,1,838,838,0.038895335,0.038895335
FALSE,Summit County,7/1/06,Hide,Hide,7,2006,21218,21218,21844,21844,1,626,626,0.028657755,0.028657755
FALSE,Summit County,7/1/07,Hide,Hide,7,2007,21383,21383,21918,21918,1,535,535,0.024409161,0.024409161
FALSE,Summit County,7/1/08,Hide,Hide,7,2008,21645,21645,22351,22351,1,706,706,0.031586954,0.031586954
FALSE,Summit County,7/1/09,Hide,Hide,7,2009,21035,21035,22656,22656,1,1621,1621,0.071548376,0.071548376
FALSE,Summit County,7/1/10,Hide,Hide,7,2010,18842,18842,20404,20404,1,1562,1562,0.076553617,0.076553617
FALSE,Summit County,7/1/11,Hide,Hide,7,2011,19527,19527,20808,20808,1,1281,1281,0.06156286,0.06156286
FALSE,Summit County,7/1/12,Hide,Hide,7,2012,20295,20295,21343,21343,1,1048,1048,0.04910275,0.04910275
FALSE,Summit County,7/1/13,Hide,Hide,7,2013,21211,21211,22122,22122,1,911,911,0.041180725,0.041180725
FALSE,Summit County,7/1/14,Hide,Hide,7,2014,21811,21811,22580,22580,1,769,769,0.034056687,0.034056687
FALSE,Summit County,7/1/15,Hide,Hide,7,2015,22269,22269,23026,23026,1,757,757,0.032875879,0.032875879
FALSE,Summit County,7/1/16,Hide,Hide,7,2016,23265,23265,24000,24000,1,735,735,0.030625,0.030625
FALSE,Summit County,7/1/17,Hide,Hide,7,2017,23679,23679,24442,24442,1,763,763,0.031216758,0.031216758
FALSE,Summit County,7/1/18,Hide,Hide,7,2018,23633,23633,24360,24360,1,727,727,0.029844007,0.029844007
FALSE,Summit County,7/1/19,Hide,Hide,7,2019,24604,24604,25209,25209,1,605,605,0.023999365,0.023999365
FALSE,Tooele County,7/1/93,Hide,Hide,7,1993,11404,11404,12046,12046,1,642,642,0.0532957,0.0532957
FALSE,Tooele County,7/1/94,Hide,Hide,7,1994,11021,11021,11699,11699,1,678,678,0.057953671,0.057953671
FALSE,Tooele County,7/1/95,Hide,Hide,7,1995,10754,10754,11410,11410,1,656,656,0.057493427,0.057493427
FALSE,Tooele County,7/1/96,Hide,Hide,7,1996,11114,11114,11715,11715,1,601,601,0.05130175,0.05130175
FALSE,Tooele County,7/1/97,Hide,Hide,7,1997,11179,11179,11694,11694,1,515,515,0.044039678,0.044039678
FALSE,Tooele County,7/1/98,Hide,Hide,7,1998,11550,11550,12140,12140,1,590,590,0.048599671,0.048599671
FALSE,Tooele County,7/1/99,Hide,Hide,7,1999,11713,11713,12386,12386,1,673,673,0.05433554,0.05433554
FALSE,Tooele County,7/1/00,Hide,Hide,7,2000,19567,19567,20305,20305,1,738,738,0.036345728,0.036345728
FALSE,Tooele County,7/1/01,Hide,Hide,7,2001,20443,20443,21474,21474,1,1031,1031,0.048011549,0.048011549
FALSE,Tooele County,7/1/02,Hide,Hide,7,2002,20919,20919,22367,22367,1,1448,1448,0.06473823,0.06473823
FALSE,Tooele County,7/1/03,Hide,Hide,7,2003,21859,21859,23315,23315,1,1456,1456,0.062449067,0.062449067
FALSE,Tooele County,7/1/04,Hide,Hide,7,2004,22699,22699,24001,24001,1,1302,1302,0.05424774,0.05424774
FALSE,Tooele County,7/1/05,Hide,Hide,7,2005,24177,24177,25248,25248,1,1071,1071,0.042419202,0.042419202
FALSE,Tooele County,7/1/06,Hide,Hide,7,2006,25495,25495,26331,26331,1,836,836,0.031749649,0.031749649
FALSE,Tooele County,7/1/07,Hide,Hide,7,2007,26210,26210,26983,26983,1,773,773,0.028647667,0.028647667
FALSE,Tooele County,7/1/08,Hide,Hide,7,2008,26883,26883,27931,27931,1,1048,1048,0.037521034,0.037521034
FALSE,Tooele County,7/1/09,Hide,Hide,7,2009,25848,25848,28137,28137,1,2289,2289,0.081351956,0.081351956
FALSE,Tooele County,7/1/10,Hide,Hide,7,2010,25215,25215,27527,27527,1,2312,2312,0.083990264,0.083990264
FALSE,Tooele County,7/1/11,Hide,Hide,7,2011,25328,25328,27253,27253,1,1925,1925,0.070634426,0.070634426
FALSE,Tooele County,7/1/12,Hide,Hide,7,2012,26143,26143,27792,27792,1,1649,1649,0.059333621,0.059333621
FALSE,Tooele County,7/1/13,Hide,Hide,7,2013,26970,26970,28524,28524,1,1554,1554,0.054480438,0.054480438
FALSE,Tooele County,7/1/14,Hide,Hide,7,2014,27491,27491,28863,28863,1,1372,1372,0.047534906,0.047534906
FALSE,Tooele County,7/1/15,Hide,Hide,7,2015,28318,28318,29524,29524,1,1206,1206,0.040848124,0.040848124
FALSE,Tooele County,7/1/16,Hide,Hide,7,2016,29593,29593,30758,30758,1,1165,1165,0.037876325,0.037876325
FALSE,Tooele County,7/1/17,Hide,Hide,7,2017,31132,31132,32328,32328,1,1196,1196,0.036995793,0.036995793
FALSE,Tooele County,7/1/18,Hide,Hide,7,2018,32079,32079,33194,33194,1,1115,1115,0.033590408,0.033590408
FALSE,Tooele County,7/1/19,Hide,Hide,7,2019,32984,32984,33957,33957,1,973,973,0.028653886,0.028653886
FALSE,Uintah County,7/1/93,Hide,Hide,7,1993,9406,9406,10129,10129,1,723,723,0.071379208,0.071379208
FALSE,Uintah County,7/1/94,Hide,Hide,7,1994,9347,9347,10114,10114,1,767,767,0.075835476,0.075835476
FALSE,Uintah County,7/1/95,Hide,Hide,7,1995,9573,9573,10298,10298,1,725,725,0.07040202,0.07040202
FALSE,Uintah County,7/1/96,Hide,Hide,7,1996,9506,9506,10227,10227,1,721,721,0.070499658,0.070499658
FALSE,Uintah County,7/1/97,Hide,Hide,7,1997,10093,10093,10706,10706,1,613,613,0.057257613,0.057257613
FALSE,Uintah County,7/1/98,Hide,Hide,7,1998,10225,10225,10888,10888,1,663,663,0.060892726,0.060892726
FALSE,Uintah County,7/1/99,Hide,Hide,7,1999,10514,10514,11273,11273,1,759,759,0.067329016,0.067329016
FALSE,Uintah County,7/1/00,Hide,Hide,7,2000,10857,10857,11339,11339,1,482,482,0.042508158,0.042508158
FALSE,Uintah County,7/1/01,Hide,Hide,7,2001,11681,11681,12208,12208,1,527,527,0.043168414,0.043168414
FALSE,Uintah County,7/1/02,Hide,Hide,7,2002,11904,11904,12682,12682,1,778,778,0.061346791,0.061346791
FALSE,Uintah County,7/1/03,Hide,Hide,7,2003,12297,12297,13029,13029,1,732,732,0.056182362,0.056182362
FALSE,Uintah County,7/1/04,Hide,Hide,7,2004,13186,13186,13882,13882,1,696,696,0.050136868,0.050136868
FALSE,Uintah County,7/1/05,Hide,Hide,7,2005,14114,14114,14646,14646,1,532,532,0.036323911,0.036323911
FALSE,Uintah County,7/1/06,Hide,Hide,7,2006,15927,15927,16324,16324,1,397,397,0.02432002,0.02432002
FALSE,Uintah County,7/1/07,Hide,Hide,7,2007,16974,16974,17340,17340,1,366,366,0.021107266,0.021107266
FALSE,Uintah County,7/1/08,Hide,Hide,7,2008,18474,18474,18881,18881,1,407,407,0.021556062,0.021556062
FALSE,Uintah County,7/1/09,Hide,Hide,7,2009,15790,15790,17379,17379,1,1589,1589,0.091432188,0.091432188
FALSE,Uintah County,7/1/10,Hide,Hide,7,2010,13925,13925,15165,15165,1,1240,1240,0.081767227,0.081767227
FALSE,Uintah County,7/1/11,Hide,Hide,7,2011,14577,14577,15485,15485,1,908,908,0.058637391,0.058637391
FALSE,Uintah County,7/1/12,Hide,Hide,7,2012,15312,15312,15998,15998,1,686,686,0.04288036,0.04288036
FALSE,Uintah County,7/1/13,Hide,Hide,7,2013,14981,14981,15652,15652,1,671,671,0.042869921,0.042869921
FALSE,Uintah County,7/1/14,Hide,Hide,7,2014,15453,15453,16030,16030,1,577,577,0.035995009,0.035995009
FALSE,Uintah County,7/1/15,Hide,Hide,7,2015,14088,14088,15164,15164,1,1076,1076,0.070957531,0.070957531
FALSE,Uintah County,7/1/16,Hide,Hide,7,2016,12884,12884,14188,14188,1,1304,1304,0.091908655,0.091908655
FALSE,Uintah County,7/1/17,Hide,Hide,7,2017,12862,12862,13651,13651,1,789,789,0.057797964,0.057797964
FALSE,Uintah County,7/1/18,Hide,Hide,7,2018,12912,12912,13526,13526,1,614,614,0.045394056,0.045394056
FALSE,Uintah County,7/1/19,Hide,Hide,7,2019,13099,13099,13657,13657,1,558,558,0.040858168,0.040858168
FALSE,United States,7/1/93,Hide,Hide,7,1993,120467,120467000,129397,129397000,1,8930,8930000,0.069,0.069
FALSE,United States,7/1/94,Hide,Hide,7,1994,122706,122706000,130652,130652000,1,7946,7946000,0.061,0.061
FALSE,United States,7/1/95,Hide,Hide,7,1995,124816,124816000,132343,132343000,1,7527,7527000,0.057,0.057
FALSE,United States,7/1/96,Hide,Hide,7,1996,126947,126947000,134284,134284000,1,7337,7337000,0.055,0.055
FALSE,United States,7/1/97,Hide,Hide,7,1997,129822,129822000,136477,136477000,1,6655,6655000,0.049,0.049
FALSE,United States,7/1/98,Hide,Hide,7,1998,131329,131329000,137588,137588000,1,6259,6259000,0.045,0.045
FALSE,United States,7/1/99,Hide,Hide,7,1999,133414,133414000,139439,139439000,1,6025,6025000,0.043,0.043
FALSE,United States,7/1/00,Hide,Hide,7,2000,136531,136531000,142278,142278000,1,5747,5747000,0.04,0.04
FALSE,United States,7/1/01,Hide,Hide,7,2001,137071,137071000,143654,143654000,1,6583,6583000,0.046,0.046
FALSE,United States,7/1/02,Hide,Hide,7,2002,136413,136413000,144803,144803000,1,8390,8390000,0.058,0.058
FALSE,United States,7/1/03,Hide,Hide,7,2003,137474,137474000,146485,146485000,1,9011,9011000,0.062,0.062
FALSE,United States,7/1/04,Hide,Hide,7,2004,139556,139556000,147692,147692000,1,8136,8136000,0.055,0.055
FALSE,United States,7/1/05,Hide,Hide,7,2005,142026,142026000,149432,149432000,1,7406,7406000,0.05,0.05
FALSE,United States,7/1/06,Hide,Hide,7,2006,144202,144202000,151377,151377000,1,7175,7175000,0.047,0.047
FALSE,United States,7/1/07,Hide,Hide,7,2007,145905,145905000,153054,153054000,1,7149,7149000,0.047,0.047
FALSE,United States,7/1/08,Hide,Hide,7,2008,145532,145532000,154469,154469000,1,8937,8937000,0.058,0.058
FALSE,United States,7/1/09,Hide,Hide,7,2009,139901,139901000,154502,154502000,1,14601,14601000,0.095,0.095
FALSE,United States,7/1/10,Hide,Hide,7,2010,139179,139179000,153691,153691000,1,14512,14512000,0.094,0.094
FALSE,United States,7/1/11,Hide,Hide,7,2011,139524,139524000,153288,153288000,1,13763,13763000,0.09,0.09
FALSE,United States,7/1/12,Hide,Hide,7,2012,142292,142292000,154948,154948000,1,12656,12656000,0.082,0.082
FALSE,United States,7/1/13,Hide,Hide,7,2013,144264,144264000,155599,155599000,1,11335,11335000,0.073,0.073
FALSE,United States,7/1/14,Hide,Hide,7,2014,146399,146399000,156007,156007000,1,9608,9608000,0.062,0.062
FALSE,United States,7/1/15,Hide,Hide,7,2015,148830,148830000,156997,156997000,1,8167,8167000,0.052,0.052
FALSE,United States,7/1/16,Hide,Hide,7,2016,151465,151465000,159123,159123000,1,7658,7658000,0.048,0.048
FALSE,United States,7/1/17,Hide,Hide,7,2017,153471,153471000,160339,160339000,1,6867,6867000,0.043,0.043
FALSE,United States,7/1/18,Hide,Hide,7,2018,155993,155993000,162173,162173000,1,6180,6180000,0.038,0.038
FALSE,United States,7/1/19,Hide,Hide,7,2019,157346,157346000,163373,163373000,1,6027,6027000,0.037,0.037
FALSE,Utah County,7/1/93,Hide,Hide,7,1993,132508,132508,137511,137511,1,5003,5003,0.036382544,0.036382544
FALSE,Utah County,7/1/94,Hide,Hide,7,1994,141892,141892,146559,146559,1,4667,4667,0.031843831,0.031843831
FALSE,Utah County,7/1/95,Hide,Hide,7,1995,144415,144415,148710,148710,1,4295,4295,0.028881716,0.028881716
FALSE,Utah County,7/1/96,Hide,Hide,7,1996,149151,149151,153583,153583,1,4432,4432,0.028857361,0.028857361
FALSE,Utah County,7/1/97,Hide,Hide,7,1997,154224,154224,158317,158317,1,4093,4093,0.025853193,0.025853193
FALSE,Utah County,7/1/98,Hide,Hide,7,1998,160905,160905,165818,165818,1,4913,4913,0.02962887,0.02962887
FALSE,Utah County,7/1/99,Hide,Hide,7,1999,164818,164818,169974,169974,1,5156,5156,0.030334051,0.030334051
FALSE,Utah County,7/1/00,Hide,Hide,7,2000,176392,176392,181862,181862,1,5470,5470,0.030077751,0.030077751
FALSE,Utah County,7/1/01,Hide,Hide,7,2001,176083,176083,183654,183654,1,7571,7571,0.041224259,0.041224259
FALSE,Utah County,7/1/02,Hide,Hide,7,2002,175018,175018,185870,185870,1,10852,10852,0.058384893,0.058384893
FALSE,Utah County,7/1/03,Hide,Hide,7,2003,178508,178508,188253,188253,1,9745,9745,0.051765443,0.051765443
FALSE,Utah County,7/1/04,Hide,Hide,7,2004,188494,188494,197829,197829,1,9335,9335,0.047187217,0.047187217
FALSE,Utah County,7/1/05,Hide,Hide,7,2005,197725,197725,205618,205618,1,7893,7893,0.038386717,0.038386717
FALSE,Utah County,7/1/06,Hide,Hide,7,2006,208386,208386,214582,214582,1,6196,6196,0.028874743,0.028874743
FALSE,Utah County,7/1/07,Hide,Hide,7,2007,218544,218544,224173,224173,1,5629,5629,0.025110071,0.025110071
FALSE,Utah County,7/1/08,Hide,Hide,7,2008,215504,215504,223149,223149,1,7645,7645,0.03425962,0.03425962
FALSE,Utah County,7/1/09,Hide,Hide,7,2009,205091,205091,220703,220703,1,15612,15612,0.070737598,0.070737598
FALSE,Utah County,7/1/10,Hide,Hide,7,2010,212910,212910,230196,230196,1,17286,17286,0.07509253,0.07509253
FALSE,Utah County,7/1/11,Hide,Hide,7,2011,216496,216496,230993,230993,1,14497,14497,0.062759478,0.062759478
FALSE,Utah County,7/1/12,Hide,Hide,7,2012,227361,227361,239059,239059,1,11698,11698,0.048933527,0.048933527
FALSE,Utah County,7/1/13,Hide,Hide,7,2013,239272,239272,249814,249814,1,10542,10542,0.042199396,0.042199396
FALSE,Utah County,7/1/14,Hide,Hide,7,2014,246261,246261,255059,255059,1,8798,8798,0.03449398,0.03449398
FALSE,Utah County,7/1/15,Hide,Hide,7,2015,257950,257950,266710,266710,1,8760,8760,0.032844663,0.032844663
FALSE,Utah County,7/1/16,Hide,Hide,7,2016,271181,271181,279801,279801,1,8620,8620,0.03080761,0.03080761
FALSE,Utah County,7/1/17,Hide,Hide,7,2017,282547,282547,291143,291143,1,8596,8596,0.02952501,0.02952501
FALSE,Utah County,7/1/18,Hide,Hide,7,2018,290369,290369,298682,298682,1,8313,8313,0.027832276,0.027832276
FALSE,Utah County,7/1/19,Hide,Hide,7,2019,300297,300297,307493,307493,1,7196,7196,0.023402159,0.023402159
FALSE,Wasatch County,7/1/93,Hide,Hide,7,1993,4769,4769,5085,5085,1,316,316,0.062143559,0.062143559
FALSE,Wasatch County,7/1/94,Hide,Hide,7,1994,5088,5088,5414,5414,1,326,326,0.060214259,0.060214259
FALSE,Wasatch County,7/1/95,Hide,Hide,7,1995,5165,5165,5449,5449,1,284,284,0.052119655,0.052119655
FALSE,Wasatch County,7/1/96,Hide,Hide,7,1996,5442,5442,5679,5679,1,237,237,0.041732699,0.041732699
FALSE,Wasatch County,7/1/97,Hide,Hide,7,1997,5655,5655,5880,5880,1,225,225,0.038265306,0.038265306
FALSE,Wasatch County,7/1/98,Hide,Hide,7,1998,5812,5812,6103,6103,1,291,291,0.047681468,0.047681468
FALSE,Wasatch County,7/1/99,Hide,Hide,7,1999,5962,5962,6298,6298,1,336,336,0.05335027,0.05335027
FALSE,Wasatch County,7/1/00,Hide,Hide,7,2000,7716,7716,7991,7991,1,275,275,0.034413715,0.034413715
FALSE,Wasatch County,7/1/01,Hide,Hide,7,2001,7688,7688,8032,8032,1,344,344,0.042828685,0.042828685
FALSE,Wasatch County,7/1/02,Hide,Hide,7,2002,7820,7820,8344,8344,1,524,524,0.062799616,0.062799616
FALSE,Wasatch County,7/1/03,Hide,Hide,7,2003,8049,8049,8566,8566,1,517,517,0.060354891,0.060354891
FALSE,Wasatch County,7/1/04,Hide,Hide,7,2004,8289,8289,8769,8769,1,480,480,0.054738283,0.054738283
FALSE,Wasatch County,7/1/05,Hide,Hide,7,2005,8868,8868,9239,9239,1,371,371,0.040155861,0.040155861
FALSE,Wasatch County,7/1/06,Hide,Hide,7,2006,9924,9924,10249,10249,1,325,325,0.031710411,0.031710411
FALSE,Wasatch County,7/1/07,Hide,Hide,7,2007,10508,10508,10789,10789,1,281,281,0.026045046,0.026045046
FALSE,Wasatch County,7/1/08,Hide,Hide,7,2008,10012,10012,10370,10370,1,358,358,0.034522662,0.034522662
FALSE,Wasatch County,7/1/09,Hide,Hide,7,2009,9201,9201,10051,10051,1,850,850,0.0845687,0.0845687
FALSE,Wasatch County,7/1/10,Hide,Hide,7,2010,10258,10258,11228,11228,1,970,970,0.086391165,0.086391165
FALSE,Wasatch County,7/1/11,Hide,Hide,7,2011,10538,10538,11325,11325,1,787,787,0.069492274,0.069492274
FALSE,Wasatch County,7/1/12,Hide,Hide,7,2012,10974,10974,11641,11641,1,667,667,0.057297483,0.057297483
FALSE,Wasatch County,7/1/13,Hide,Hide,7,2013,11621,11621,12196,12196,1,575,575,0.047146605,0.047146605
FALSE,Wasatch County,7/1/14,Hide,Hide,7,2014,12270,12270,12749,12749,1,479,479,0.037571574,0.037571574
FALSE,Wasatch County,7/1/15,Hide,Hide,7,2015,12873,12873,13336,13336,1,463,463,0.034718056,0.034718056
FALSE,Wasatch County,7/1/16,Hide,Hide,7,2016,13493,13493,13957,13957,1,464,464,0.033244967,0.033244967
FALSE,Wasatch County,7/1/17,Hide,Hide,7,2017,14119,14119,14618,14618,1,499,499,0.034135997,0.034135997
FALSE,Wasatch County,7/1/18,Hide,Hide,7,2018,14681,14681,15155,15155,1,474,474,0.031276806,0.031276806
FALSE,Wasatch County,7/1/19,Hide,Hide,7,2019,15795,15795,16227,16227,1,432,432,0.026622296,0.026622296
FALSE,Washington County,7/1/93,Hide,Hide,7,1993,25401,25401,26356,26356,1,955,955,0.036234633,0.036234633
FALSE,Washington County,7/1/94,Hide,Hide,7,1994,29764,29764,30683,30683,1,919,919,0.029951439,0.029951439
FALSE,Washington County,7/1/95,Hide,Hide,7,1995,31713,31713,32762,32762,1,1049,1049,0.032018802,0.032018802
FALSE,Washington County,7/1/96,Hide,Hide,7,1996,33652,33652,34860,34860,1,1208,1208,0.034652897,0.034652897
FALSE,Washington County,7/1/97,Hide,Hide,7,1997,34392,34392,35577,35577,1,1185,1185,0.033308036,0.033308036
FALSE,Washington County,7/1/98,Hide,Hide,7,1998,35781,35781,37185,37185,1,1404,1404,0.03775716,0.03775716
FALSE,Washington County,7/1/99,Hide,Hide,7,1999,37376,37376,38719,38719,1,1343,1343,0.034685813,0.034685813
FALSE,Washington County,7/1/00,Hide,Hide,7,2000,38045,38045,39447,39447,1,1402,1402,0.035541359,0.035541359
FALSE,Washington County,7/1/01,Hide,Hide,7,2001,40610,40610,42299,42299,1,1689,1689,0.039930022,0.039930022
FALSE,Washington County,7/1/02,Hide,Hide,7,2002,42430,42430,44812,44812,1,2382,2382,0.053155405,0.053155405
FALSE,Washington County,7/1/03,Hide,Hide,7,2003,44747,44747,47261,47261,1,2514,2514,0.053193965,0.053193965
FALSE,Washington County,7/1/04,Hide,Hide,7,2004,49794,49794,52334,52334,1,2540,2540,0.048534414,0.048534414
FALSE,Washington County,7/1/05,Hide,Hide,7,2005,54870,54870,57145,57145,1,2275,2275,0.039811007,0.039811007
FALSE,Washington County,7/1/06,Hide,Hide,7,2006,59782,59782,61653,61653,1,1871,1871,0.030347266,0.030347266
FALSE,Washington County,7/1/07,Hide,Hide,7,2007,61882,61882,63644,63644,1,1762,1762,0.027685249,0.027685249
FALSE,Washington County,7/1/08,Hide,Hide,7,2008,58594,58594,61453,61453,1,2859,2859,0.046523359,0.046523359
FALSE,Washington County,7/1/09,Hide,Hide,7,2009,54083,54083,59955,59955,1,5872,5872,0.097940122,0.097940122
FALSE,Washington County,7/1/10,Hide,Hide,7,2010,50892,50892,56925,56925,1,6033,6033,0.105981555,0.105981555
FALSE,Washington County,7/1/11,Hide,Hide,7,2011,50878,50878,55766,55766,1,4888,4888,0.087651974,0.087651974
FALSE,Washington County,7/1/12,Hide,Hide,7,2012,53289,53289,57136,57136,1,3847,3847,0.06733058,0.06733058
FALSE,Washington County,7/1/13,Hide,Hide,7,2013,56471,56471,59754,59754,1,3283,3283,0.054941929,0.054941929
FALSE,Washington County,7/1/14,Hide,Hide,7,2014,58704,58704,61361,61361,1,2657,2657,0.04330112,0.04330112
FALSE,Washington County,7/1/15,Hide,Hide,7,2015,60934,60934,63520,63520,1,2586,2586,0.040711587,0.040711587
FALSE,Washington County,7/1/16,Hide,Hide,7,2016,65040,65040,67541,67541,1,2501,2501,0.03702936,0.03702936
FALSE,Washington County,7/1/17,Hide,Hide,7,2017,68342,68342,70844,70844,1,2502,2502,0.035317035,0.035317035
FALSE,Washington County,7/1/18,Hide,Hide,7,2018,71658,71658,74149,74149,1,2491,2491,0.033594519,0.033594519
FALSE,Washington County,7/1/19,Hide,Hide,7,2019,73899,73899,76135,76135,1,2236,2236,0.029368884,0.029368884
FALSE,Wayne County,7/1/93,Hide,Hide,7,1993,1016,1016,1087,1087,1,71,71,0.065317387,0.065317387
FALSE,Wayne County,7/1/94,Hide,Hide,7,1994,1094,1094,1190,1190,1,96,96,0.080672269,0.080672269
FALSE,Wayne County,7/1/95,Hide,Hide,7,1995,1280,1280,1374,1374,1,94,94,0.068413392,0.068413392
FALSE,Wayne County,7/1/96,Hide,Hide,7,1996,1264,1264,1335,1335,1,71,71,0.053183521,0.053183521
FALSE,Wayne County,7/1/97,Hide,Hide,7,1997,1313,1313,1373,1373,1,60,60,0.043699927,0.043699927
FALSE,Wayne County,7/1/98,Hide,Hide,7,1998,1396,1396,1488,1488,1,92,92,0.061827957,0.061827957
FALSE,Wayne County,7/1/99,Hide,Hide,7,1999,1389,1389,1469,1469,1,80,80,0.054458816,0.054458816
FALSE,Wayne County,7/1/00,Hide,Hide,7,2000,1263,1263,1323,1323,1,60,60,0.045351474,0.045351474
FALSE,Wayne County,7/1/01,Hide,Hide,7,2001,1385,1385,1451,1451,1,66,66,0.045485872,0.045485872
FALSE,Wayne County,7/1/02,Hide,Hide,7,2002,1320,1320,1415,1415,1,95,95,0.067137809,0.067137809
FALSE,Wayne County,7/1/03,Hide,Hide,7,2003,1218,1218,1314,1314,1,96,96,0.073059361,0.073059361
FALSE,Wayne County,7/1/04,Hide,Hide,7,2004,1297,1297,1387,1387,1,90,90,0.064888248,0.064888248
FALSE,Wayne County,7/1/05,Hide,Hide,7,2005,1260,1260,1332,1332,1,72,72,0.054054054,0.054054054
FALSE,Wayne County,7/1/06,Hide,Hide,7,2006,1338,1338,1398,1398,1,60,60,0.042918455,0.042918455
FALSE,Wayne County,7/1/07,Hide,Hide,7,2007,1314,1314,1371,1371,1,57,57,0.041575492,0.041575492
FALSE,Wayne County,7/1/08,Hide,Hide,7,2008,1310,1310,1384,1384,1,74,74,0.053468208,0.053468208
FALSE,Wayne County,7/1/09,Hide,Hide,7,2009,1347,1347,1463,1463,1,116,116,0.079289132,0.079289132
FALSE,Wayne County,7/1/10,Hide,Hide,7,2010,1461,1461,1599,1599,1,138,138,0.08630394,0.08630394
FALSE,Wayne County,7/1/11,Hide,Hide,7,2011,1280,1280,1429,1429,1,149,149,0.104268719,0.104268719
FALSE,Wayne County,7/1/12,Hide,Hide,7,2012,1221,1221,1374,1374,1,153,153,0.111353712,0.111353712
FALSE,Wayne County,7/1/13,Hide,Hide,7,2013,1231,1231,1382,1382,1,151,151,0.109261939,0.109261939
FALSE,Wayne County,7/1/14,Hide,Hide,7,2014,1228,1228,1357,1357,1,129,129,0.095062638,0.095062638
FALSE,Wayne County,7/1/15,Hide,Hide,7,2015,1294,1294,1420,1420,1,126,126,0.088732394,0.088732394
FALSE,Wayne County,7/1/16,Hide,Hide,7,2016,1310,1310,1422,1422,1,112,112,0.078762307,0.078762307
FALSE,Wayne County,7/1/17,Hide,Hide,7,2017,1358,1358,1469,1469,1,111,111,0.075561607,0.075561607
FALSE,Wayne County,7/1/18,Hide,Hide,7,2018,1345,1345,1425,1425,1,80,80,0.056140351,0.056140351
FALSE,Wayne County,7/1/19,Hide,Hide,7,2019,1336,1336,1410,1410,1,74,74,0.05248227,0.05248227
FALSE,Weber County,7/1/93,Hide,Hide,7,1993,83640,83640,88217,88217,1,4577,4577,0.051883424,0.051883424
FALSE,Weber County,7/1/94,Hide,Hide,7,1994,88010,88010,92109,92109,1,4099,4099,0.044501623,0.044501623
FALSE,Weber County,7/1/95,Hide,Hide,7,1995,88344,88344,92142,92142,1,3798,3798,0.041218988,0.041218988
FALSE,Weber County,7/1/96,Hide,Hide,7,1996,92259,92259,96136,96136,1,3877,3877,0.040328285,0.040328285
FALSE,Weber County,7/1/97,Hide,Hide,7,1997,95239,95239,99036,99036,1,3797,3797,0.038339594,0.038339594
FALSE,Weber County,7/1/98,Hide,Hide,7,1998,96593,96593,101493,101493,1,4900,4900,0.048279192,0.048279192
FALSE,Weber County,7/1/99,Hide,Hide,7,1999,98297,98297,102790,102790,1,4493,4493,0.043710478,0.043710478
FALSE,Weber County,7/1/00,Hide,Hide,7,2000,96095,96095,100371,100371,1,4276,4276,0.042601947,0.042601947
FALSE,Weber County,7/1/01,Hide,Hide,7,2001,96665,96665,101728,101728,1,5063,5063,0.049769975,0.049769975
FALSE,Weber County,7/1/02,Hide,Hide,7,2002,97651,97651,104170,104170,1,6519,6519,0.062580397,0.062580397
FALSE,Weber County,7/1/03,Hide,Hide,7,2003,98626,98626,105575,105575,1,6949,6949,0.065820507,0.065820507
FALSE,Weber County,7/1/04,Hide,Hide,7,2004,101296,101296,107071,107071,1,5775,5775,0.053936173,0.053936173
FALSE,Weber County,7/1/05,Hide,Hide,7,2005,103394,103394,108196,108196,1,4802,4802,0.044382417,0.044382417
FALSE,Weber County,7/1/06,Hide,Hide,7,2006,106236,106236,109886,109886,1,3650,3650,0.033216242,0.033216242
FALSE,Weber County,7/1/07,Hide,Hide,7,2007,109509,109509,113149,113149,1,3640,3640,0.032169971,0.032169971
FALSE,Weber County,7/1/08,Hide,Hide,7,2008,109125,109125,113636,113636,1,4511,4511,0.039696927,0.039696927
FALSE,Weber County,7/1/09,Hide,Hide,7,2009,104640,104640,114507,114507,1,9867,9867,0.086169404,0.086169404
FALSE,Weber County,7/1/10,Hide,Hide,7,2010,103663,103663,113695,113695,1,10032,10032,0.08823607,0.08823607
FALSE,Weber County,7/1/11,Hide,Hide,7,2011,103615,103615,112447,112447,1,8832,8832,0.078543669,0.078543669
FALSE,Weber County,7/1/12,Hide,Hide,7,2012,106210,106210,113361,113361,1,7151,7151,0.063081659,0.063081659
FALSE,Weber County,7/1/13,Hide,Hide,7,2013,108358,108358,114424,114424,1,6066,6066,0.053013354,0.053013354
FALSE,Weber County,7/1/14,Hide,Hide,7,2014,109738,109738,114797,114797,1,5059,5059,0.044069096,0.044069096
FALSE,Weber County,7/1/15,Hide,Hide,7,2015,112390,112390,117221,117221,1,4831,4831,0.041212752,0.041212752
FALSE,Weber County,7/1/16,Hide,Hide,7,2016,115618,115618,120160,120160,1,4542,4542,0.037799601,0.037799601
FALSE,Weber County,7/1/17,Hide,Hide,7,2017,118935,118935,123451,123451,1,4516,4516,0.036581316,0.036581316
FALSE,Weber County,7/1/18,Hide,Hide,7,2018,120431,120431,124745,124745,1,4314,4314,0.034582548,0.034582548
FALSE,Weber County,7/1/19,Hide,Hide,7,2019,123967,123967,127586,127586,1,3619,3619,0.028365181,0.028365181
FALSE,Beaver County,8/1/93,Hide,Hide,8,1993,2062,2062,2170,2170,1,108,108,0.049769585,0.049769585
FALSE,Beaver County,8/1/94,Hide,Hide,8,1994,2151,2151,2236,2236,1,85,85,0.038014311,0.038014311
FALSE,Beaver County,8/1/95,Hide,Hide,8,1995,2271,2271,2366,2366,1,95,95,0.040152156,0.040152156
FALSE,Beaver County,8/1/96,Hide,Hide,8,1996,2343,2343,2474,2474,1,131,131,0.052950687,0.052950687
FALSE,Beaver County,8/1/97,Hide,Hide,8,1997,2446,2446,2560,2560,1,114,114,0.04453125,0.04453125
FALSE,Beaver County,8/1/98,Hide,Hide,8,1998,2378,2378,2500,2500,1,122,122,0.0488,0.0488
FALSE,Beaver County,8/1/99,Hide,Hide,8,1999,2335,2335,2426,2426,1,91,91,0.037510305,0.037510305
FALSE,Beaver County,8/1/00,Hide,Hide,8,2000,2635,2635,2730,2730,1,95,95,0.034798535,0.034798535
FALSE,Beaver County,8/1/01,Hide,Hide,8,2001,2995,2995,3115,3115,1,120,120,0.038523274,0.038523274
FALSE,Beaver County,8/1/02,Hide,Hide,8,2002,2897,2897,3046,3046,1,149,149,0.048916612,0.048916612
FALSE,Beaver County,8/1/03,Hide,Hide,8,2003,2800,2800,2955,2955,1,155,155,0.052453469,0.052453469
FALSE,Beaver County,8/1/04,Hide,Hide,8,2004,2875,2875,3005,3005,1,130,130,0.043261231,0.043261231
FALSE,Beaver County,8/1/05,Hide,Hide,8,2005,2968,2968,3095,3095,1,127,127,0.041033926,0.041033926
FALSE,Beaver County,8/1/06,Hide,Hide,8,2006,3073,3073,3164,3164,1,91,91,0.028761062,0.028761062
FALSE,Beaver County,8/1/07,Hide,Hide,8,2007,3002,3002,3086,3086,1,84,84,0.027219702,0.027219702
FALSE,Beaver County,8/1/08,Hide,Hide,8,2008,3049,3049,3161,3161,1,112,112,0.035431825,0.035431825
FALSE,Beaver County,8/1/09,Hide,Hide,8,2009,3444,3444,3664,3664,1,220,220,0.060043668,0.060043668
FALSE,Beaver County,8/1/10,Hide,Hide,8,2010,2876,2876,3196,3196,1,320,320,0.100125156,0.100125156
FALSE,Beaver County,8/1/11,Hide,Hide,8,2011,2801,2801,3034,3034,1,233,233,0.076796309,0.076796309
FALSE,Beaver County,8/1/12,Hide,Hide,8,2012,2727,2727,2900,2900,1,173,173,0.059655172,0.059655172
FALSE,Beaver County,8/1/13,Hide,Hide,8,2013,2868,2868,3004,3004,1,136,136,0.045272969,0.045272969
FALSE,Beaver County,8/1/14,Hide,Hide,8,2014,2772,2772,2886,2886,1,114,114,0.03950104,0.03950104
FALSE,Beaver County,8/1/15,Hide,Hide,8,2015,3018,3018,3140,3140,1,122,122,0.038853503,0.038853503
FALSE,Beaver County,8/1/16,Hide,Hide,8,2016,2917,2917,3082,3082,1,165,165,0.053536665,0.053536665
FALSE,Beaver County,8/1/17,Hide,Hide,8,2017,2921,2921,3032,3032,1,111,111,0.036609499,0.036609499
FALSE,Beaver County,8/1/18,Hide,Hide,8,2018,2906,2906,3006,3006,1,100,100,0.0332668,0.0332668
FALSE,Beaver County,8/1/19,Hide,Hide,8,2019,2758,2758,2842,2842,1,84,84,0.02955665,0.02955665
FALSE,Box Elder County,8/1/93,Hide,Hide,8,1993,16796,16796,17718,17718,1,922,922,0.052037476,0.052037476
FALSE,Box Elder County,8/1/94,Hide,Hide,8,1994,17278,17278,18135,18135,1,857,857,0.047256686,0.047256686
FALSE,Box Elder County,8/1/95,Hide,Hide,8,1995,16820,16820,17637,17637,1,817,817,0.046323071,0.046323071
FALSE,Box Elder County,8/1/96,Hide,Hide,8,1996,17291,17291,18028,18028,1,737,737,0.040880852,0.040880852
FALSE,Box Elder County,8/1/97,Hide,Hide,8,1997,18079,18079,18808,18808,1,729,729,0.038760102,0.038760102
FALSE,Box Elder County,8/1/98,Hide,Hide,8,1998,18438,18438,19373,19373,1,935,935,0.048263047,0.048263047
FALSE,Box Elder County,8/1/99,Hide,Hide,8,1999,17411,17411,18236,18236,1,825,825,0.045240184,0.045240184
FALSE,Box Elder County,8/1/00,Hide,Hide,8,2000,19419,19419,20153,20153,1,734,734,0.036421376,0.036421376
FALSE,Box Elder County,8/1/01,Hide,Hide,8,2001,19758,19758,20709,20709,1,951,951,0.045922063,0.045922063
FALSE,Box Elder County,8/1/02,Hide,Hide,8,2002,19845,19845,21049,21049,1,1204,1204,0.057199867,0.057199867
FALSE,Box Elder County,8/1/03,Hide,Hide,8,2003,20235,20235,21412,21412,1,1177,1177,0.054969176,0.054969176
FALSE,Box Elder County,8/1/04,Hide,Hide,8,2004,20836,20836,21933,21933,1,1097,1097,0.050015958,0.050015958
FALSE,Box Elder County,8/1/05,Hide,Hide,8,2005,21642,21642,22592,22592,1,950,950,0.042050283,0.042050283
FALSE,Box Elder County,8/1/06,Hide,Hide,8,2006,22203,22203,22906,22906,1,703,703,0.030690649,0.030690649
FALSE,Box Elder County,8/1/07,Hide,Hide,8,2007,22792,22792,23438,23438,1,646,646,0.027562079,0.027562079
FALSE,Box Elder County,8/1/08,Hide,Hide,8,2008,22777,22777,23811,23811,1,1034,1034,0.043425308,0.043425308
FALSE,Box Elder County,8/1/09,Hide,Hide,8,2009,21263,21263,23113,23113,1,1850,1850,0.080041535,0.080041535
FALSE,Box Elder County,8/1/10,Hide,Hide,8,2010,21766,21766,23804,23804,1,2038,2038,0.085615863,0.085615863
FALSE,Box Elder County,8/1/11,Hide,Hide,8,2011,21514,21514,23196,23196,1,1682,1682,0.072512502,0.072512502
FALSE,Box Elder County,8/1/12,Hide,Hide,8,2012,21661,21661,22955,22955,1,1294,1294,0.056371161,0.056371161
FALSE,Box Elder County,8/1/13,Hide,Hide,8,2013,22049,22049,23114,23114,1,1065,1065,0.046075971,0.046075971
FALSE,Box Elder County,8/1/14,Hide,Hide,8,2014,22484,22484,23402,23402,1,918,918,0.039227416,0.039227416
FALSE,Box Elder County,8/1/15,Hide,Hide,8,2015,23138,23138,24018,24018,1,880,880,0.036639187,0.036639187
FALSE,Box Elder County,8/1/16,Hide,Hide,8,2016,23990,23990,24835,24835,1,845,845,0.034024562,0.034024562
FALSE,Box Elder County,8/1/17,Hide,Hide,8,2017,24527,24527,25349,25349,1,822,822,0.032427315,0.032427315
FALSE,Box Elder County,8/1/18,Hide,Hide,8,2018,24625,24625,25379,25379,1,754,754,0.029709602,0.029709602
FALSE,Box Elder County,8/1/19,Hide,Hide,8,2019,25296,25296,25941,25941,1,645,645,0.024864115,0.024864115
FALSE,Cache County,8/1/93,Hide,Hide,8,1993,38124,38124,39309,39309,1,1185,1185,0.030145768,0.030145768
FALSE,Cache County,8/1/94,Hide,Hide,8,1994,39390,39390,40627,40627,1,1237,1237,0.030447732,0.030447732
FALSE,Cache County,8/1/95,Hide,Hide,8,1995,40477,40477,41752,41752,1,1275,1275,0.030537459,0.030537459
FALSE,Cache County,8/1/96,Hide,Hide,8,1996,40897,40897,42111,42111,1,1214,1214,0.028828572,0.028828572
FALSE,Cache County,8/1/97,Hide,Hide,8,1997,42170,42170,43222,43222,1,1052,1052,0.024339457,0.024339457
FALSE,Cache County,8/1/98,Hide,Hide,8,1998,43460,43460,44883,44883,1,1423,1423,0.031704654,0.031704654
FALSE,Cache County,8/1/99,Hide,Hide,8,1999,43976,43976,45197,45197,1,1221,1221,0.027015067,0.027015067
FALSE,Cache County,8/1/00,Hide,Hide,8,2000,47300,47300,48644,48644,1,1344,1344,0.027629307,0.027629307
FALSE,Cache County,8/1/01,Hide,Hide,8,2001,48892,48892,50662,50662,1,1770,1770,0.034937428,0.034937428
FALSE,Cache County,8/1/02,Hide,Hide,8,2002,50387,50387,52688,52688,1,2301,2301,0.043672183,0.043672183
FALSE,Cache County,8/1/03,Hide,Hide,8,2003,52266,52266,54334,54334,1,2068,2068,0.038060883,0.038060883
FALSE,Cache County,8/1/04,Hide,Hide,8,2004,54234,54234,56306,56306,1,2072,2072,0.03679892,0.03679892
FALSE,Cache County,8/1/05,Hide,Hide,8,2005,55383,55383,57230,57230,1,1847,1847,0.032273283,0.032273283
FALSE,Cache County,8/1/06,Hide,Hide,8,2006,57306,57306,58585,58585,1,1279,1279,0.021831527,0.021831527
FALSE,Cache County,8/1/07,Hide,Hide,8,2007,59429,59429,60729,60729,1,1300,1300,0.021406577,0.021406577
FALSE,Cache County,8/1/08,Hide,Hide,8,2008,59918,59918,61637,61637,1,1719,1719,0.027889093,0.027889093
FALSE,Cache County,8/1/09,Hide,Hide,8,2009,58811,58811,62283,62283,1,3472,3472,0.055745549,0.055745549
FALSE,Cache County,8/1/10,Hide,Hide,8,2010,53755,53755,57272,57272,1,3517,3517,0.061408716,0.061408716
FALSE,Cache County,8/1/11,Hide,Hide,8,2011,53289,53289,56192,56192,1,2903,2903,0.051662158,0.051662158
FALSE,Cache County,8/1/12,Hide,Hide,8,2012,54437,54437,56908,56908,1,2471,2471,0.04342096,0.04342096
FALSE,Cache County,8/1/13,Hide,Hide,8,2013,55625,55625,57873,57873,1,2248,2248,0.038843675,0.038843675
FALSE,Cache County,8/1/14,Hide,Hide,8,2014,57002,57002,58902,58902,1,1900,1900,0.032256969,0.032256969
FALSE,Cache County,8/1/15,Hide,Hide,8,2015,58422,58422,60293,60293,1,1871,1871,0.031031795,0.031031795
FALSE,Cache County,8/1/16,Hide,Hide,8,2016,59552,59552,61381,61381,1,1829,1829,0.029797494,0.029797494
FALSE,Cache County,8/1/17,Hide,Hide,8,2017,61035,61035,62749,62749,1,1714,1714,0.027315176,0.027315176
FALSE,Cache County,8/1/18,Hide,Hide,8,2018,61710,61710,63387,63387,1,1677,1677,0.026456529,0.026456529
FALSE,Cache County,8/1/19,Hide,Hide,8,2019,62759,62759,64096,64096,1,1337,1337,0.020859336,0.020859336
FALSE,Carbon County,8/1/93,Hide,Hide,8,1993,8460,8460,9099,9099,1,639,639,0.070227498,0.070227498
FALSE,Carbon County,8/1/94,Hide,Hide,8,1994,8618,8618,9324,9324,1,706,706,0.075718576,0.075718576
FALSE,Carbon County,8/1/95,Hide,Hide,8,1995,8504,8504,9088,9088,1,584,584,0.064260563,0.064260563
FALSE,Carbon County,8/1/96,Hide,Hide,8,1996,8921,8921,9476,9476,1,555,555,0.058569016,0.058569016
FALSE,Carbon County,8/1/97,Hide,Hide,8,1997,9247,9247,9731,9731,1,484,484,0.049737951,0.049737951
FALSE,Carbon County,8/1/98,Hide,Hide,8,1998,9256,9256,9884,9884,1,628,628,0.06353703,0.06353703
FALSE,Carbon County,8/1/99,Hide,Hide,8,1999,9218,9218,9867,9867,1,649,649,0.065774805,0.065774805
FALSE,Carbon County,8/1/00,Hide,Hide,8,2000,8588,8588,9124,9124,1,536,536,0.058746164,0.058746164
FALSE,Carbon County,8/1/01,Hide,Hide,8,2001,8565,8565,9123,9123,1,558,558,0.061164091,0.061164091
FALSE,Carbon County,8/1/02,Hide,Hide,8,2002,8799,8799,9481,9481,1,682,682,0.07193334,0.07193334
FALSE,Carbon County,8/1/03,Hide,Hide,8,2003,8600,8600,9319,9319,1,719,719,0.077154201,0.077154201
FALSE,Carbon County,8/1/04,Hide,Hide,8,2004,8710,8710,9304,9304,1,594,594,0.063843508,0.063843508
FALSE,Carbon County,8/1/05,Hide,Hide,8,2005,9147,9147,9591,9591,1,444,444,0.0462934,0.0462934
FALSE,Carbon County,8/1/06,Hide,Hide,8,2006,9580,9580,9900,9900,1,320,320,0.032323232,0.032323232
FALSE,Carbon County,8/1/07,Hide,Hide,8,2007,9239,9239,9601,9601,1,362,362,0.037704406,0.037704406
FALSE,Carbon County,8/1/08,Hide,Hide,8,2008,9720,9720,10170,10170,1,450,450,0.044247788,0.044247788
FALSE,Carbon County,8/1/09,Hide,Hide,8,2009,9576,9576,10458,10458,1,882,882,0.084337349,0.084337349
FALSE,Carbon County,8/1/10,Hide,Hide,8,2010,9064,9064,9905,9905,1,841,841,0.084906613,0.084906613
FALSE,Carbon County,8/1/11,Hide,Hide,8,2011,8824,8824,9526,9526,1,702,702,0.073693051,0.073693051
FALSE,Carbon County,8/1/12,Hide,Hide,8,2012,8534,8534,9174,9174,1,640,640,0.069762372,0.069762372
FALSE,Carbon County,8/1/13,Hide,Hide,8,2013,8383,8383,8933,8933,1,550,550,0.061569462,0.061569462
FALSE,Carbon County,8/1/14,Hide,Hide,8,2014,8231,8231,8665,8665,1,434,434,0.050086555,0.050086555
FALSE,Carbon County,8/1/15,Hide,Hide,8,2015,8180,8180,8697,8697,1,517,517,0.059445786,0.059445786
FALSE,Carbon County,8/1/16,Hide,Hide,8,2016,7787,7787,8263,8263,1,476,476,0.057606196,0.057606196
FALSE,Carbon County,8/1/17,Hide,Hide,8,2017,7865,7865,8277,8277,1,412,412,0.049776489,0.049776489
FALSE,Carbon County,8/1/18,Hide,Hide,8,2018,8123,8123,8489,8489,1,366,366,0.043114619,0.043114619
FALSE,Carbon County,8/1/19,Hide,Hide,8,2019,8234,8234,8537,8537,1,303,303,0.035492562,0.035492562
FALSE,Daggett County,8/1/93,Hide,Hide,8,1993,377,377,391,391,1,14,14,0.035805627,0.035805627
FALSE,Daggett County,8/1/94,Hide,Hide,8,1994,453,453,481,481,1,28,28,0.058212058,0.058212058
FALSE,Daggett County,8/1/95,Hide,Hide,8,1995,424,424,444,444,1,20,20,0.045045045,0.045045045
FALSE,Daggett County,8/1/96,Hide,Hide,8,1996,392,392,412,412,1,20,20,0.048543689,0.048543689
FALSE,Daggett County,8/1/97,Hide,Hide,8,1997,387,387,404,404,1,17,17,0.042079208,0.042079208
FALSE,Daggett County,8/1/98,Hide,Hide,8,1998,402,402,419,419,1,17,17,0.040572792,0.040572792
FALSE,Daggett County,8/1/99,Hide,Hide,8,1999,443,443,458,458,1,15,15,0.032751092,0.032751092
FALSE,Daggett County,8/1/00,Hide,Hide,8,2000,460,460,478,478,1,18,18,0.037656904,0.037656904
FALSE,Daggett County,8/1/01,Hide,Hide,8,2001,464,464,487,487,1,23,23,0.047227926,0.047227926
FALSE,Daggett County,8/1/02,Hide,Hide,8,2002,473,473,498,498,1,25,25,0.050200803,0.050200803
FALSE,Daggett County,8/1/03,Hide,Hide,8,2003,458,458,484,484,1,26,26,0.053719008,0.053719008
FALSE,Daggett County,8/1/04,Hide,Hide,8,2004,461,461,488,488,1,27,27,0.055327869,0.055327869
FALSE,Daggett County,8/1/05,Hide,Hide,8,2005,484,484,508,508,1,24,24,0.047244094,0.047244094
FALSE,Daggett County,8/1/06,Hide,Hide,8,2006,486,486,509,509,1,23,23,0.04518664,0.04518664
FALSE,Daggett County,8/1/07,Hide,Hide,8,2007,501,501,520,520,1,19,19,0.036538462,0.036538462
FALSE,Daggett County,8/1/08,Hide,Hide,8,2008,420,420,439,439,1,19,19,0.043280182,0.043280182
FALSE,Daggett County,8/1/09,Hide,Hide,8,2009,464,464,491,491,1,27,27,0.054989817,0.054989817
FALSE,Daggett County,8/1/10,Hide,Hide,8,2010,468,468,505,505,1,37,37,0.073267327,0.073267327
FALSE,Daggett County,8/1/11,Hide,Hide,8,2011,444,444,472,472,1,28,28,0.059322034,0.059322034
FALSE,Daggett County,8/1/12,Hide,Hide,8,2012,418,418,441,441,1,23,23,0.052154195,0.052154195
FALSE,Daggett County,8/1/13,Hide,Hide,8,2013,403,403,424,424,1,21,21,0.049528302,0.049528302
FALSE,Daggett County,8/1/14,Hide,Hide,8,2014,405,405,423,423,1,18,18,0.042553191,0.042553191
FALSE,Daggett County,8/1/15,Hide,Hide,8,2015,442,442,462,462,1,20,20,0.043290043,0.043290043
FALSE,Daggett County,8/1/16,Hide,Hide,8,2016,440,440,464,464,1,24,24,0.051724138,0.051724138
FALSE,Daggett County,8/1/17,Hide,Hide,8,2017,395,395,421,421,1,26,26,0.06175772,0.06175772
FALSE,Daggett County,8/1/18,Hide,Hide,8,2018,384,384,402,402,1,18,18,0.044776119,0.044776119
FALSE,Daggett County,8/1/19,Hide,Hide,8,2019,380,380,395,395,1,15,15,0.037974684,0.037974684
FALSE,Davis County,8/1/93,Hide,Hide,8,1993,97502,97502,101171,101171,1,3669,3669,0.036265333,0.036265333
FALSE,Davis County,8/1/94,Hide,Hide,8,1994,102573,102573,106362,106362,1,3789,3789,0.035623625,0.035623625
FALSE,Davis County,8/1/95,Hide,Hide,8,1995,102753,102753,106192,106192,1,3439,3439,0.032384737,0.032384737
FALSE,Davis County,8/1/96,Hide,Hide,8,1996,108385,108385,111805,111805,1,3420,3420,0.030588972,0.030588972
FALSE,Davis County,8/1/97,Hide,Hide,8,1997,112836,112836,116325,116325,1,3489,3489,0.029993553,0.029993553
FALSE,Davis County,8/1/98,Hide,Hide,8,1998,116841,116841,120897,120897,1,4056,4056,0.03354922,0.03354922
FALSE,Davis County,8/1/99,Hide,Hide,8,1999,120863,120863,124983,124983,1,4120,4120,0.032964483,0.032964483
FALSE,Davis County,8/1/00,Hide,Hide,8,2000,116048,116048,119815,119815,1,3767,3767,0.031440137,0.031440137
FALSE,Davis County,8/1/01,Hide,Hide,8,2001,116987,116987,121991,121991,1,5004,5004,0.041019419,0.041019419
FALSE,Davis County,8/1/02,Hide,Hide,8,2002,119145,119145,125620,125620,1,6475,6475,0.05154434,0.05154434
FALSE,Davis County,8/1/03,Hide,Hide,8,2003,122002,122002,128531,128531,1,6529,6529,0.050797084,0.050797084
FALSE,Davis County,8/1/04,Hide,Hide,8,2004,126631,126631,132717,132717,1,6086,6086,0.045856974,0.045856974
FALSE,Davis County,8/1/05,Hide,Hide,8,2005,131277,131277,136571,136571,1,5294,5294,0.03876372,0.03876372
FALSE,Davis County,8/1/06,Hide,Hide,8,2006,137145,137145,141082,141082,1,3937,3937,0.027905757,0.027905757
FALSE,Davis County,8/1/07,Hide,Hide,8,2007,141445,141445,145255,145255,1,3810,3810,0.026229734,0.026229734
FALSE,Davis County,8/1/08,Hide,Hide,8,2008,140727,140727,145666,145666,1,4939,4939,0.033906334,0.033906334
FALSE,Davis County,8/1/09,Hide,Hide,8,2009,134627,134627,144597,144597,1,9970,9970,0.068950255,0.068950255
FALSE,Davis County,8/1/10,Hide,Hide,8,2010,136876,136876,147211,147211,1,10335,10335,0.070205352,0.070205352
FALSE,Davis County,8/1/11,Hide,Hide,8,2011,138125,138125,146836,146836,1,8711,8711,0.059324689,0.059324689
FALSE,Davis County,8/1/12,Hide,Hide,8,2012,141910,141910,148911,148911,1,7001,7001,0.04701466,0.04701466
FALSE,Davis County,8/1/13,Hide,Hide,8,2013,146723,146723,153075,153075,1,6352,6352,0.041495999,0.041495999
FALSE,Davis County,8/1/14,Hide,Hide,8,2014,150605,150605,156159,156159,1,5554,5554,0.035566314,0.035566314
FALSE,Davis County,8/1/15,Hide,Hide,8,2015,154860,154860,160319,160319,1,5459,5459,0.034050861,0.034050861
FALSE,Davis County,8/1/16,Hide,Hide,8,2016,160003,160003,165081,165081,1,5078,5078,0.030760657,0.030760657
FALSE,Davis County,8/1/17,Hide,Hide,8,2017,163913,163913,169141,169141,1,5228,5228,0.030909123,0.030909123
FALSE,Davis County,8/1/18,Hide,Hide,8,2018,165021,165021,169871,169871,1,4850,4850,0.028551077,0.028551077
FALSE,Davis County,8/1/19,Hide,Hide,8,2019,170398,170398,174413,174413,1,4015,4015,0.023020073,0.023020073
FALSE,Duchesne County,8/1/93,Hide,Hide,8,1993,5394,5394,5884,5884,1,490,490,0.083276683,0.083276683
FALSE,Duchesne County,8/1/94,Hide,Hide,8,1994,5375,5375,5970,5970,1,595,595,0.099664992,0.099664992
FALSE,Duchesne County,8/1/95,Hide,Hide,8,1995,5159,5159,5695,5695,1,536,536,0.094117647,0.094117647
FALSE,Duchesne County,8/1/96,Hide,Hide,8,1996,5310,5310,5774,5774,1,464,464,0.080360236,0.080360236
FALSE,Duchesne County,8/1/97,Hide,Hide,8,1997,5547,5547,5932,5932,1,385,385,0.064902225,0.064902225
FALSE,Duchesne County,8/1/98,Hide,Hide,8,1998,5659,5659,6126,6126,1,467,467,0.076232452,0.076232452
FALSE,Duchesne County,8/1/99,Hide,Hide,8,1999,5315,5315,5832,5832,1,517,517,0.088648834,0.088648834
FALSE,Duchesne County,8/1/00,Hide,Hide,8,2000,5906,5906,6210,6210,1,304,304,0.048953301,0.048953301
FALSE,Duchesne County,8/1/01,Hide,Hide,8,2001,6569,6569,6921,6921,1,352,352,0.050859702,0.050859702
FALSE,Duchesne County,8/1/02,Hide,Hide,8,2002,6504,6504,6990,6990,1,486,486,0.069527897,0.069527897
FALSE,Duchesne County,8/1/03,Hide,Hide,8,2003,6446,6446,6891,6891,1,445,445,0.064576984,0.064576984
FALSE,Duchesne County,8/1/04,Hide,Hide,8,2004,6909,6909,7301,7301,1,392,392,0.053691275,0.053691275
FALSE,Duchesne County,8/1/05,Hide,Hide,8,2005,7459,7459,7783,7783,1,324,324,0.041629192,0.041629192
FALSE,Duchesne County,8/1/06,Hide,Hide,8,2006,8443,8443,8677,8677,1,234,234,0.026967846,0.026967846
FALSE,Duchesne County,8/1/07,Hide,Hide,8,2007,8949,8949,9172,9172,1,223,223,0.024313127,0.024313127
FALSE,Duchesne County,8/1/08,Hide,Hide,8,2008,10194,10194,10458,10458,1,264,264,0.025243832,0.025243832
FALSE,Duchesne County,8/1/09,Hide,Hide,8,2009,9256,9256,10242,10242,1,986,986,0.09627026,0.09627026
FALSE,Duchesne County,8/1/10,Hide,Hide,8,2010,7363,7363,8119,8119,1,756,756,0.093114916,0.093114916
FALSE,Duchesne County,8/1/11,Hide,Hide,8,2011,7941,7941,8478,8478,1,537,537,0.06334041,0.06334041
FALSE,Duchesne County,8/1/12,Hide,Hide,8,2012,8837,8837,9257,9257,1,420,420,0.045371071,0.045371071
FALSE,Duchesne County,8/1/13,Hide,Hide,8,2013,8923,8923,9322,9322,1,399,399,0.042801974,0.042801974
FALSE,Duchesne County,8/1/14,Hide,Hide,8,2014,9226,9226,9583,9583,1,357,357,0.03725347,0.03725347
FALSE,Duchesne County,8/1/15,Hide,Hide,8,2015,7889,7889,8602,8602,1,713,713,0.082887701,0.082887701
FALSE,Duchesne County,8/1/16,Hide,Hide,8,2016,7375,7375,8042,8042,1,667,667,0.082939567,0.082939567
FALSE,Duchesne County,8/1/17,Hide,Hide,8,2017,7543,7543,7958,7958,1,415,415,0.052148781,0.052148781
FALSE,Duchesne County,8/1/18,Hide,Hide,8,2018,7315,7315,7661,7661,1,346,346,0.045163817,0.045163817
FALSE,Duchesne County,8/1/19,Hide,Hide,8,2019,7470,7470,7770,7770,1,300,300,0.038610039,0.038610039
FALSE,Emery County,8/1/93,Hide,Hide,8,1993,3825,3825,4168,4168,1,343,343,0.082293666,0.082293666
FALSE,Emery County,8/1/94,Hide,Hide,8,1994,3821,3821,4146,4146,1,325,325,0.078388808,0.078388808
FALSE,Emery County,8/1/95,Hide,Hide,8,1995,3890,3890,4223,4223,1,333,333,0.078853895,0.078853895
FALSE,Emery County,8/1/96,Hide,Hide,8,1996,3839,3839,4149,4149,1,310,310,0.074716799,0.074716799
FALSE,Emery County,8/1/97,Hide,Hide,8,1997,3934,3934,4192,4192,1,258,258,0.061545802,0.061545802
FALSE,Emery County,8/1/98,Hide,Hide,8,1998,3939,3939,4277,4277,1,338,338,0.079027356,0.079027356
FALSE,Emery County,8/1/99,Hide,Hide,8,1999,3697,3697,3966,3966,1,269,269,0.067826525,0.067826525
FALSE,Emery County,8/1/00,Hide,Hide,8,2000,4490,4490,4725,4725,1,235,235,0.04973545,0.04973545
FALSE,Emery County,8/1/01,Hide,Hide,8,2001,4492,4492,4820,4820,1,328,328,0.068049793,0.068049793
FALSE,Emery County,8/1/02,Hide,Hide,8,2002,4471,4471,4819,4819,1,348,348,0.072214152,0.072214152
FALSE,Emery County,8/1/03,Hide,Hide,8,2003,4467,4467,4852,4852,1,385,385,0.079348722,0.079348722
FALSE,Emery County,8/1/04,Hide,Hide,8,2004,4789,4789,5122,5122,1,333,333,0.065013667,0.065013667
FALSE,Emery County,8/1/05,Hide,Hide,8,2005,4936,4936,5190,5190,1,254,254,0.04894027,0.04894027
FALSE,Emery County,8/1/06,Hide,Hide,8,2006,5100,5100,5273,5273,1,173,173,0.032808648,0.032808648
FALSE,Emery County,8/1/07,Hide,Hide,8,2007,4915,4915,5087,5087,1,172,172,0.033811677,0.033811677
FALSE,Emery County,8/1/08,Hide,Hide,8,2008,4822,4822,5015,5015,1,193,193,0.038484546,0.038484546
FALSE,Emery County,8/1/09,Hide,Hide,8,2009,4926,4926,5333,5333,1,407,407,0.07631727,0.07631727
FALSE,Emery County,8/1/10,Hide,Hide,8,2010,4851,4851,5237,5237,1,386,386,0.07370632,0.07370632
FALSE,Emery County,8/1/11,Hide,Hide,8,2011,4608,4608,4979,4979,1,371,371,0.074512954,0.074512954
FALSE,Emery County,8/1/12,Hide,Hide,8,2012,4398,4398,4739,4739,1,341,341,0.071956109,0.071956109
FALSE,Emery County,8/1/13,Hide,Hide,8,2013,4422,4422,4694,4694,1,272,272,0.057946314,0.057946314
FALSE,Emery County,8/1/14,Hide,Hide,8,2014,4299,4299,4539,4539,1,240,240,0.052875083,0.052875083
FALSE,Emery County,8/1/15,Hide,Hide,8,2015,4115,4115,4403,4403,1,288,288,0.065409948,0.065409948
FALSE,Emery County,8/1/16,Hide,Hide,8,2016,3975,3975,4223,4223,1,248,248,0.058726024,0.058726024
FALSE,Emery County,8/1/17,Hide,Hide,8,2017,3991,3991,4202,4202,1,211,211,0.050214184,0.050214184
FALSE,Emery County,8/1/18,Hide,Hide,8,2018,4144,4144,4344,4344,1,200,200,0.046040516,0.046040516
FALSE,Emery County,8/1/19,Hide,Hide,8,2019,4109,4109,4273,4273,1,164,164,0.038380529,0.038380529
FALSE,Garfield County,8/1/93,Hide,Hide,8,1993,2130,2130,2313,2313,1,183,183,0.079118029,0.079118029
FALSE,Garfield County,8/1/94,Hide,Hide,8,1994,2297,2297,2567,2567,1,270,270,0.105181145,0.105181145
FALSE,Garfield County,8/1/95,Hide,Hide,8,1995,2338,2338,2669,2669,1,331,331,0.124016486,0.124016486
FALSE,Garfield County,8/1/96,Hide,Hide,8,1996,2410,2410,2682,2682,1,272,272,0.101416853,0.101416853
FALSE,Garfield County,8/1/97,Hide,Hide,8,1997,2528,2528,2752,2752,1,224,224,0.081395349,0.081395349
FALSE,Garfield County,8/1/98,Hide,Hide,8,1998,2479,2479,2709,2709,1,230,230,0.084902178,0.084902178
FALSE,Garfield County,8/1/99,Hide,Hide,8,1999,2744,2744,2959,2959,1,215,215,0.072659682,0.072659682
FALSE,Garfield County,8/1/00,Hide,Hide,8,2000,2291,2291,2455,2455,1,164,164,0.066802444,0.066802444
FALSE,Garfield County,8/1/01,Hide,Hide,8,2001,2413,2413,2608,2608,1,195,195,0.074769939,0.074769939
FALSE,Garfield County,8/1/02,Hide,Hide,8,2002,2320,2320,2579,2579,1,259,259,0.100426522,0.100426522
FALSE,Garfield County,8/1/03,Hide,Hide,8,2003,2311,2311,2541,2541,1,230,230,0.090515545,0.090515545
FALSE,Garfield County,8/1/04,Hide,Hide,8,2004,2437,2437,2649,2649,1,212,212,0.0800302,0.0800302
FALSE,Garfield County,8/1/05,Hide,Hide,8,2005,2534,2534,2729,2729,1,195,195,0.071454745,0.071454745
FALSE,Garfield County,8/1/06,Hide,Hide,8,2006,2533,2533,2664,2664,1,131,131,0.049174174,0.049174174
FALSE,Garfield County,8/1/07,Hide,Hide,8,2007,2549,2549,2672,2672,1,123,123,0.046032934,0.046032934
FALSE,Garfield County,8/1/08,Hide,Hide,8,2008,2707,2707,2876,2876,1,169,169,0.05876217,0.05876217
FALSE,Garfield County,8/1/09,Hide,Hide,8,2009,2550,2550,2860,2860,1,310,310,0.108391608,0.108391608
FALSE,Garfield County,8/1/10,Hide,Hide,8,2010,2773,2773,3091,3091,1,318,318,0.102879327,0.102879327
FALSE,Garfield County,8/1/11,Hide,Hide,8,2011,2666,2666,2999,2999,1,333,333,0.111037012,0.111037012
FALSE,Garfield County,8/1/12,Hide,Hide,8,2012,2611,2611,2893,2893,1,282,282,0.097476668,0.097476668
FALSE,Garfield County,8/1/13,Hide,Hide,8,2013,2497,2497,2760,2760,1,263,263,0.095289855,0.095289855
FALSE,Garfield County,8/1/14,Hide,Hide,8,2014,2447,2447,2682,2682,1,235,235,0.087621178,0.087621178
FALSE,Garfield County,8/1/15,Hide,Hide,8,2015,2476,2476,2721,2721,1,245,245,0.090040426,0.090040426
FALSE,Garfield County,8/1/16,Hide,Hide,8,2016,2555,2555,2788,2788,1,233,233,0.083572453,0.083572453
FALSE,Garfield County,8/1/17,Hide,Hide,8,2017,2705,2705,2919,2919,1,214,214,0.073312778,0.073312778
FALSE,Garfield County,8/1/18,Hide,Hide,8,2018,2555,2555,2753,2753,1,198,198,0.07192154,0.07192154
FALSE,Garfield County,8/1/19,Hide,Hide,8,2019,2612,2612,2770,2770,1,158,158,0.057039711,0.057039711
FALSE,Grand County,8/1/93,Hide,Hide,8,1993,4462,4462,4760,4760,1,298,298,0.062605042,0.062605042
FALSE,Grand County,8/1/94,Hide,Hide,8,1994,4575,4575,4902,4902,1,327,327,0.066707466,0.066707466
FALSE,Grand County,8/1/95,Hide,Hide,8,1995,4689,4689,5014,5014,1,325,325,0.064818508,0.064818508
FALSE,Grand County,8/1/96,Hide,Hide,8,1996,4645,4645,5000,5000,1,355,355,0.071,0.071
FALSE,Grand County,8/1/97,Hide,Hide,8,1997,4948,4948,5263,5263,1,315,315,0.059851796,0.059851796
FALSE,Grand County,8/1/98,Hide,Hide,8,1998,4891,4891,5269,5269,1,378,378,0.071740368,0.071740368
FALSE,Grand County,8/1/99,Hide,Hide,8,1999,5234,5234,5559,5559,1,325,325,0.058463752,0.058463752
FALSE,Grand County,8/1/00,Hide,Hide,8,2000,4325,4325,4634,4634,1,309,309,0.066681053,0.066681053
FALSE,Grand County,8/1/01,Hide,Hide,8,2001,4405,4405,4731,4731,1,326,326,0.068907208,0.068907208
FALSE,Grand County,8/1/02,Hide,Hide,8,2002,4408,4408,4777,4777,1,369,369,0.077245133,0.077245133
FALSE,Grand County,8/1/03,Hide,Hide,8,2003,4514,4514,4883,4883,1,369,369,0.075568298,0.075568298
FALSE,Grand County,8/1/04,Hide,Hide,8,2004,4487,4487,4845,4845,1,358,358,0.073890609,0.073890609
FALSE,Grand County,8/1/05,Hide,Hide,8,2005,4754,4754,5063,5063,1,309,309,0.061031009,0.061031009
FALSE,Grand County,8/1/06,Hide,Hide,8,2006,4812,4812,5045,5045,1,233,233,0.046184341,0.046184341
FALSE,Grand County,8/1/07,Hide,Hide,8,2007,4872,4872,5121,5121,1,249,249,0.048623316,0.048623316
FALSE,Grand County,8/1/08,Hide,Hide,8,2008,5003,5003,5307,5307,1,304,304,0.057282834,0.057282834
FALSE,Grand County,8/1/09,Hide,Hide,8,2009,4915,4915,5465,5465,1,550,550,0.100640439,0.100640439
FALSE,Grand County,8/1/10,Hide,Hide,8,2010,4723,4723,5303,5303,1,580,580,0.109372054,0.109372054
FALSE,Grand County,8/1/11,Hide,Hide,8,2011,4804,4804,5329,5329,1,525,525,0.098517546,0.098517546
FALSE,Grand County,8/1/12,Hide,Hide,8,2012,4956,4956,5419,5419,1,463,463,0.085440118,0.085440118
FALSE,Grand County,8/1/13,Hide,Hide,8,2013,5052,5052,5479,5479,1,427,427,0.07793393,0.07793393
FALSE,Grand County,8/1/14,Hide,Hide,8,2014,5178,5178,5515,5515,1,337,337,0.061106074,0.061106074
FALSE,Grand County,8/1/15,Hide,Hide,8,2015,5263,5263,5606,5606,1,343,343,0.061184445,0.061184445
FALSE,Grand County,8/1/16,Hide,Hide,8,2016,5399,5399,5725,5725,1,326,326,0.056943231,0.056943231
FALSE,Grand County,8/1/17,Hide,Hide,8,2017,5645,5645,5956,5956,1,311,311,0.052216253,0.052216253
FALSE,Grand County,8/1/18,Hide,Hide,8,2018,5767,5767,6037,6037,1,270,270,0.044724201,0.044724201
FALSE,Grand County,8/1/19,Hide,Hide,8,2019,6018,6018,6245,6245,1,227,227,0.036349079,0.036349079
FALSE,Iron County,8/1/93,Hide,Hide,8,1993,10847,10847,11275,11275,1,428,428,0.037960089,0.037960089
FALSE,Iron County,8/1/94,Hide,Hide,8,1994,11972,11972,12419,12419,1,447,447,0.035993236,0.035993236
FALSE,Iron County,8/1/95,Hide,Hide,8,1995,12636,12636,13082,13082,1,446,446,0.034092646,0.034092646
FALSE,Iron County,8/1/96,Hide,Hide,8,1996,12993,12993,13469,13469,1,476,476,0.035340411,0.035340411
FALSE,Iron County,8/1/97,Hide,Hide,8,1997,13784,13784,14275,14275,1,491,491,0.034395797,0.034395797
FALSE,Iron County,8/1/98,Hide,Hide,8,1998,14430,14430,15006,15006,1,576,576,0.038384646,0.038384646
FALSE,Iron County,8/1/99,Hide,Hide,8,1999,14639,14639,15170,15170,1,531,531,0.035003296,0.035003296
FALSE,Iron County,8/1/00,Hide,Hide,8,2000,16515,16515,17080,17080,1,565,565,0.033079625,0.033079625
FALSE,Iron County,8/1/01,Hide,Hide,8,2001,16662,16662,17472,17472,1,810,810,0.04635989,0.04635989
FALSE,Iron County,8/1/02,Hide,Hide,8,2002,16729,16729,17679,17679,1,950,950,0.053736071,0.053736071
FALSE,Iron County,8/1/03,Hide,Hide,8,2003,17027,17027,17948,17948,1,921,921,0.05131491,0.05131491
FALSE,Iron County,8/1/04,Hide,Hide,8,2004,18029,18029,18891,18891,1,862,862,0.045630194,0.045630194
FALSE,Iron County,8/1/05,Hide,Hide,8,2005,19203,19203,19959,19959,1,756,756,0.037877649,0.037877649
FALSE,Iron County,8/1/06,Hide,Hide,8,2006,20573,20573,21183,21183,1,610,610,0.028796677,0.028796677
FALSE,Iron County,8/1/07,Hide,Hide,8,2007,20246,20246,20896,20896,1,650,650,0.031106432,0.031106432
FALSE,Iron County,8/1/08,Hide,Hide,8,2008,19902,19902,20851,20851,1,949,949,0.045513405,0.045513405
FALSE,Iron County,8/1/09,Hide,Hide,8,2009,19028,19028,20899,20899,1,1871,1871,0.089525815,0.089525815
FALSE,Iron County,8/1/10,Hide,Hide,8,2010,18466,18466,20439,20439,1,1973,1973,0.096531141,0.096531141
FALSE,Iron County,8/1/11,Hide,Hide,8,2011,18175,18175,19773,19773,1,1598,1598,0.080817276,0.080817276
FALSE,Iron County,8/1/12,Hide,Hide,8,2012,18160,18160,19465,19465,1,1305,1305,0.067043411,0.067043411
FALSE,Iron County,8/1/13,Hide,Hide,8,2013,18242,18242,19287,19287,1,1045,1045,0.054181573,0.054181573
FALSE,Iron County,8/1/14,Hide,Hide,8,2014,19037,19037,19927,19927,1,890,890,0.04466302,0.04466302
FALSE,Iron County,8/1/15,Hide,Hide,8,2015,19502,19502,20400,20400,1,898,898,0.044019608,0.044019608
FALSE,Iron County,8/1/16,Hide,Hide,8,2016,20810,20810,21762,21762,1,952,952,0.043745979,0.043745979
FALSE,Iron County,8/1/17,Hide,Hide,8,2017,21393,21393,22305,22305,1,912,912,0.040887693,0.040887693
FALSE,Iron County,8/1/18,Hide,Hide,8,2018,22165,22165,22965,22965,1,800,800,0.034835619,0.034835619
FALSE,Iron County,8/1/19,Hide,Hide,8,2019,23500,23500,24183,24183,1,683,683,0.028242981,0.028242981
FALSE,Juab County,8/1/93,Hide,Hide,8,1993,3108,3108,3311,3311,1,203,203,0.061310782,0.061310782
FALSE,Juab County,8/1/94,Hide,Hide,8,1994,3152,3152,3318,3318,1,166,166,0.050030139,0.050030139
FALSE,Juab County,8/1/95,Hide,Hide,8,1995,3192,3192,3353,3353,1,161,161,0.048016701,0.048016701
FALSE,Juab County,8/1/96,Hide,Hide,8,1996,3282,3282,3417,3417,1,135,135,0.039508341,0.039508341
FALSE,Juab County,8/1/97,Hide,Hide,8,1997,3293,3293,3424,3424,1,131,131,0.038259346,0.038259346
FALSE,Juab County,8/1/98,Hide,Hide,8,1998,3529,3529,3689,3689,1,160,160,0.043372188,0.043372188
FALSE,Juab County,8/1/99,Hide,Hide,8,1999,3468,3468,3640,3640,1,172,172,0.047252747,0.047252747
FALSE,Juab County,8/1/00,Hide,Hide,8,2000,3607,3607,3742,3742,1,135,135,0.036076964,0.036076964
FALSE,Juab County,8/1/01,Hide,Hide,8,2001,3563,3563,3753,3753,1,190,190,0.050626166,0.050626166
FALSE,Juab County,8/1/02,Hide,Hide,8,2002,3405,3405,3691,3691,1,286,286,0.077485776,0.077485776
FALSE,Juab County,8/1/03,Hide,Hide,8,2003,3415,3415,3667,3667,1,252,252,0.068721025,0.068721025
FALSE,Juab County,8/1/04,Hide,Hide,8,2004,3591,3591,3824,3824,1,233,233,0.060930962,0.060930962
FALSE,Juab County,8/1/05,Hide,Hide,8,2005,3749,3749,3931,3931,1,182,182,0.046298652,0.046298652
FALSE,Juab County,8/1/06,Hide,Hide,8,2006,3908,3908,4060,4060,1,152,152,0.037438424,0.037438424
FALSE,Juab County,8/1/07,Hide,Hide,8,2007,4005,4005,4135,4135,1,130,130,0.031438936,0.031438936
FALSE,Juab County,8/1/08,Hide,Hide,8,2008,3729,3729,3945,3945,1,216,216,0.054752852,0.054752852
FALSE,Juab County,8/1/09,Hide,Hide,8,2009,3532,3532,3924,3924,1,392,392,0.099898063,0.099898063
FALSE,Juab County,8/1/10,Hide,Hide,8,2010,4207,4207,4646,4646,1,439,439,0.094489884,0.094489884
FALSE,Juab County,8/1/11,Hide,Hide,8,2011,4239,4239,4617,4617,1,378,378,0.081871345,0.081871345
FALSE,Juab County,8/1/12,Hide,Hide,8,2012,4373,4373,4647,4647,1,274,274,0.058962772,0.058962772
FALSE,Juab County,8/1/13,Hide,Hide,8,2013,4499,4499,4730,4730,1,231,231,0.048837209,0.048837209
FALSE,Juab County,8/1/14,Hide,Hide,8,2014,4614,4614,4807,4807,1,193,193,0.040149782,0.040149782
FALSE,Juab County,8/1/15,Hide,Hide,8,2015,4770,4770,4968,4968,1,198,198,0.039855072,0.039855072
FALSE,Juab County,8/1/16,Hide,Hide,8,2016,5068,5068,5253,5253,1,185,185,0.035217971,0.035217971
FALSE,Juab County,8/1/17,Hide,Hide,8,2017,5261,5261,5443,5443,1,182,182,0.033437443,0.033437443
FALSE,Juab County,8/1/18,Hide,Hide,8,2018,5403,5403,5565,5565,1,162,162,0.029110512,0.029110512
FALSE,Juab County,8/1/19,Hide,Hide,8,2019,5601,5601,5739,5739,1,138,138,0.024046001,0.024046001
FALSE,Kane County,8/1/93,Hide,Hide,8,1993,2239,2239,2375,2375,1,136,136,0.057263158,0.057263158
FALSE,Kane County,8/1/94,Hide,Hide,8,1994,2443,2443,2721,2721,1,278,278,0.10216832,0.10216832
FALSE,Kane County,8/1/95,Hide,Hide,8,1995,2459,2459,2690,2690,1,231,231,0.085873606,0.085873606
FALSE,Kane County,8/1/96,Hide,Hide,8,1996,2398,2398,2612,2612,1,214,214,0.081929556,0.081929556
FALSE,Kane County,8/1/97,Hide,Hide,8,1997,2453,2453,2560,2560,1,107,107,0.041796875,0.041796875
FALSE,Kane County,8/1/98,Hide,Hide,8,1998,2545,2545,2629,2629,1,84,84,0.031951312,0.031951312
FALSE,Kane County,8/1/99,Hide,Hide,8,1999,2616,2616,2707,2707,1,91,91,0.03361655,0.03361655
FALSE,Kane County,8/1/00,Hide,Hide,8,2000,2996,2996,3118,3118,1,122,122,0.039127646,0.039127646
FALSE,Kane County,8/1/01,Hide,Hide,8,2001,3078,3078,3213,3213,1,135,135,0.042016807,0.042016807
FALSE,Kane County,8/1/02,Hide,Hide,8,2002,2810,2810,2981,2981,1,171,171,0.057363301,0.057363301
FALSE,Kane County,8/1/03,Hide,Hide,8,2003,2944,2944,3125,3125,1,181,181,0.05792,0.05792
FALSE,Kane County,8/1/04,Hide,Hide,8,2004,3087,3087,3274,3274,1,187,187,0.057116677,0.057116677
FALSE,Kane County,8/1/05,Hide,Hide,8,2005,3151,3151,3307,3307,1,156,156,0.047172664,0.047172664
FALSE,Kane County,8/1/06,Hide,Hide,8,2006,3327,3327,3445,3445,1,118,118,0.03425254,0.03425254
FALSE,Kane County,8/1/07,Hide,Hide,8,2007,3333,3333,3447,3447,1,114,114,0.033072237,0.033072237
FALSE,Kane County,8/1/08,Hide,Hide,8,2008,3369,3369,3521,3521,1,152,152,0.043169554,0.043169554
FALSE,Kane County,8/1/09,Hide,Hide,8,2009,3238,3238,3510,3510,1,272,272,0.077492877,0.077492877
FALSE,Kane County,8/1/10,Hide,Hide,8,2010,3264,3264,3546,3546,1,282,282,0.079526227,0.079526227
FALSE,Kane County,8/1/11,Hide,Hide,8,2011,3219,3219,3474,3474,1,255,255,0.073402418,0.073402418
FALSE,Kane County,8/1/12,Hide,Hide,8,2012,3235,3235,3464,3464,1,229,229,0.066108545,0.066108545
FALSE,Kane County,8/1/13,Hide,Hide,8,2013,3287,3287,3468,3468,1,181,181,0.052191465,0.052191465
FALSE,Kane County,8/1/14,Hide,Hide,8,2014,3430,3430,3595,3595,1,165,165,0.045897079,0.045897079
FALSE,Kane County,8/1/15,Hide,Hide,8,2015,3489,3489,3647,3647,1,158,158,0.043323279,0.043323279
FALSE,Kane County,8/1/16,Hide,Hide,8,2016,3550,3550,3687,3687,1,137,137,0.037157581,0.037157581
FALSE,Kane County,8/1/17,Hide,Hide,8,2017,3619,3619,3749,3749,1,130,130,0.034675914,0.034675914
FALSE,Kane County,8/1/18,Hide,Hide,8,2018,3654,3654,3770,3770,1,116,116,0.030769231,0.030769231
FALSE,Kane County,8/1/19,Hide,Hide,8,2019,3724,3724,3832,3832,1,108,108,0.028183716,0.028183716
FALSE,Millard County,8/1/93,Hide,Hide,8,1993,4462,4462,4719,4719,1,257,257,0.054460691,0.054460691
FALSE,Millard County,8/1/94,Hide,Hide,8,1994,4580,4580,4810,4810,1,230,230,0.047817048,0.047817048
FALSE,Millard County,8/1/95,Hide,Hide,8,1995,4442,4442,4660,4660,1,218,218,0.046781116,0.046781116
FALSE,Millard County,8/1/96,Hide,Hide,8,1996,4565,4565,4757,4757,1,192,192,0.040361572,0.040361572
FALSE,Millard County,8/1/97,Hide,Hide,8,1997,4585,4585,4761,4761,1,176,176,0.036967024,0.036967024
FALSE,Millard County,8/1/98,Hide,Hide,8,1998,4493,4493,4712,4712,1,219,219,0.04647708,0.04647708
FALSE,Millard County,8/1/99,Hide,Hide,8,1999,4382,4382,4580,4580,1,198,198,0.043231441,0.043231441
FALSE,Millard County,8/1/00,Hide,Hide,8,2000,5021,5021,5205,5205,1,184,184,0.035350624,0.035350624
FALSE,Millard County,8/1/01,Hide,Hide,8,2001,5635,5635,5874,5874,1,239,239,0.040687777,0.040687777
FALSE,Millard County,8/1/02,Hide,Hide,8,2002,5881,5881,6170,6170,1,289,289,0.046839546,0.046839546
FALSE,Millard County,8/1/03,Hide,Hide,8,2003,5622,5622,5918,5918,1,296,296,0.050016898,0.050016898
FALSE,Millard County,8/1/04,Hide,Hide,8,2004,5707,5707,5997,5997,1,290,290,0.048357512,0.048357512
FALSE,Millard County,8/1/05,Hide,Hide,8,2005,5885,5885,6129,6129,1,244,244,0.039810736,0.039810736
FALSE,Millard County,8/1/06,Hide,Hide,8,2006,6059,6059,6235,6235,1,176,176,0.028227747,0.028227747
FALSE,Millard County,8/1/07,Hide,Hide,8,2007,5938,5938,6099,6099,1,161,161,0.02639777,0.02639777
FALSE,Millard County,8/1/08,Hide,Hide,8,2008,5951,5951,6161,6161,1,210,210,0.034085376,0.034085376
FALSE,Millard County,8/1/09,Hide,Hide,8,2009,6164,6164,6536,6536,1,372,372,0.056915545,0.056915545
FALSE,Millard County,8/1/10,Hide,Hide,8,2010,6156,6156,6557,6557,1,401,401,0.061156016,0.061156016
FALSE,Millard County,8/1/11,Hide,Hide,8,2011,5842,5842,6162,6162,1,320,320,0.051931191,0.051931191
FALSE,Millard County,8/1/12,Hide,Hide,8,2012,5652,5652,5928,5928,1,276,276,0.046558704,0.046558704
FALSE,Millard County,8/1/13,Hide,Hide,8,2013,5596,5596,5833,5833,1,237,237,0.040630893,0.040630893
FALSE,Millard County,8/1/14,Hide,Hide,8,2014,5684,5684,5891,5891,1,207,207,0.035138347,0.035138347
FALSE,Millard County,8/1/15,Hide,Hide,8,2015,5906,5906,6120,6120,1,214,214,0.03496732,0.03496732
FALSE,Millard County,8/1/16,Hide,Hide,8,2016,6088,6088,6293,6293,1,205,205,0.032575878,0.032575878
FALSE,Millard County,8/1/17,Hide,Hide,8,2017,6208,6208,6415,6415,1,207,207,0.032268122,0.032268122
FALSE,Millard County,8/1/18,Hide,Hide,8,2018,5940,5940,6138,6138,1,198,198,0.032258065,0.032258065
FALSE,Millard County,8/1/19,Hide,Hide,8,2019,5837,5837,5995,5995,1,158,158,0.026355296,0.026355296
FALSE,Morgan County,8/1/93,Hide,Hide,8,1993,2806,2806,2972,2972,1,166,166,0.055854643,0.055854643
FALSE,Morgan County,8/1/94,Hide,Hide,8,1994,2925,2925,3078,3078,1,153,153,0.049707602,0.049707602
FALSE,Morgan County,8/1/95,Hide,Hide,8,1995,3321,3321,3469,3469,1,148,148,0.042663592,0.042663592
FALSE,Morgan County,8/1/96,Hide,Hide,8,1996,3394,3394,3536,3536,1,142,142,0.040158371,0.040158371
FALSE,Morgan County,8/1/97,Hide,Hide,8,1997,3477,3477,3619,3619,1,142,142,0.039237358,0.039237358
FALSE,Morgan County,8/1/98,Hide,Hide,8,1998,3551,3551,3697,3697,1,146,146,0.03949148,0.03949148
FALSE,Morgan County,8/1/99,Hide,Hide,8,1999,3415,3415,3556,3556,1,141,141,0.039651294,0.039651294
FALSE,Morgan County,8/1/00,Hide,Hide,8,2000,3273,3273,3391,3391,1,118,118,0.034797995,0.034797995
FALSE,Morgan County,8/1/01,Hide,Hide,8,2001,3318,3318,3455,3455,1,137,137,0.039652677,0.039652677
FALSE,Morgan County,8/1/02,Hide,Hide,8,2002,3371,3371,3562,3562,1,191,191,0.053621561,0.053621561
FALSE,Morgan County,8/1/03,Hide,Hide,8,2003,3404,3404,3588,3588,1,184,184,0.051282051,0.051282051
FALSE,Morgan County,8/1/04,Hide,Hide,8,2004,3514,3514,3687,3687,1,173,173,0.046921616,0.046921616
FALSE,Morgan County,8/1/05,Hide,Hide,8,2005,3679,3679,3837,3837,1,158,158,0.041178004,0.041178004
FALSE,Morgan County,8/1/06,Hide,Hide,8,2006,3839,3839,3953,3953,1,114,114,0.028838857,0.028838857
FALSE,Morgan County,8/1/07,Hide,Hide,8,2007,3901,3901,4013,4013,1,112,112,0.027909295,0.027909295
FALSE,Morgan County,8/1/08,Hide,Hide,8,2008,3927,3927,4059,4059,1,132,132,0.032520325,0.032520325
FALSE,Morgan County,8/1/09,Hide,Hide,8,2009,3790,3790,4050,4050,1,260,260,0.064197531,0.064197531
FALSE,Morgan County,8/1/10,Hide,Hide,8,2010,4003,4003,4303,4303,1,300,300,0.069718801,0.069718801
FALSE,Morgan County,8/1/11,Hide,Hide,8,2011,4023,4023,4255,4255,1,232,232,0.054524089,0.054524089
FALSE,Morgan County,8/1/12,Hide,Hide,8,2012,4142,4142,4349,4349,1,207,207,0.047597149,0.047597149
FALSE,Morgan County,8/1/13,Hide,Hide,8,2013,4346,4346,4524,4524,1,178,178,0.039345712,0.039345712
FALSE,Morgan County,8/1/14,Hide,Hide,8,2014,4541,4541,4702,4702,1,161,161,0.034240749,0.034240749
FALSE,Morgan County,8/1/15,Hide,Hide,8,2015,4792,4792,4946,4946,1,154,154,0.031136272,0.031136272
FALSE,Morgan County,8/1/16,Hide,Hide,8,2016,5030,5030,5180,5180,1,150,150,0.028957529,0.028957529
FALSE,Morgan County,8/1/17,Hide,Hide,8,2017,5259,5259,5411,5411,1,152,152,0.028090926,0.028090926
FALSE,Morgan County,8/1/18,Hide,Hide,8,2018,5294,5294,5444,5444,1,150,150,0.02755327,0.02755327
FALSE,Morgan County,8/1/19,Hide,Hide,8,2019,5457,5457,5590,5590,1,133,133,0.023792487,0.023792487
FALSE,Piute County,8/1/93,Hide,Hide,8,1993,466,466,494,494,1,28,28,0.056680162,0.056680162
FALSE,Piute County,8/1/94,Hide,Hide,8,1994,459,459,505,505,1,46,46,0.091089109,0.091089109
FALSE,Piute County,8/1/95,Hide,Hide,8,1995,457,457,486,486,1,29,29,0.059670782,0.059670782
FALSE,Piute County,8/1/96,Hide,Hide,8,1996,502,502,526,526,1,24,24,0.045627376,0.045627376
FALSE,Piute County,8/1/97,Hide,Hide,8,1997,490,490,513,513,1,23,23,0.044834308,0.044834308
FALSE,Piute County,8/1/98,Hide,Hide,8,1998,488,488,511,511,1,23,23,0.045009785,0.045009785
FALSE,Piute County,8/1/99,Hide,Hide,8,1999,500,500,533,533,1,33,33,0.061913696,0.061913696
FALSE,Piute County,8/1/00,Hide,Hide,8,2000,615,615,643,643,1,28,28,0.043545879,0.043545879
FALSE,Piute County,8/1/01,Hide,Hide,8,2001,750,750,793,793,1,43,43,0.054224464,0.054224464
FALSE,Piute County,8/1/02,Hide,Hide,8,2002,693,693,742,742,1,49,49,0.066037736,0.066037736
FALSE,Piute County,8/1/03,Hide,Hide,8,2003,766,766,811,811,1,45,45,0.055487053,0.055487053
FALSE,Piute County,8/1/04,Hide,Hide,8,2004,840,840,877,877,1,37,37,0.042189282,0.042189282
FALSE,Piute County,8/1/05,Hide,Hide,8,2005,800,800,832,832,1,32,32,0.038461538,0.038461538
FALSE,Piute County,8/1/06,Hide,Hide,8,2006,873,873,898,898,1,25,25,0.027839644,0.027839644
FALSE,Piute County,8/1/07,Hide,Hide,8,2007,904,904,926,926,1,22,22,0.023758099,0.023758099
FALSE,Piute County,8/1/08,Hide,Hide,8,2008,883,883,909,909,1,26,26,0.02860286,0.02860286
FALSE,Piute County,8/1/09,Hide,Hide,8,2009,830,830,891,891,1,61,61,0.068462402,0.068462402
FALSE,Piute County,8/1/10,Hide,Hide,8,2010,500,500,558,558,1,58,58,0.103942652,0.103942652
FALSE,Piute County,8/1/11,Hide,Hide,8,2011,465,465,517,517,1,52,52,0.100580271,0.100580271
FALSE,Piute County,8/1/12,Hide,Hide,8,2012,443,443,485,485,1,42,42,0.086597938,0.086597938
FALSE,Piute County,8/1/13,Hide,Hide,8,2013,455,455,493,493,1,38,38,0.077079108,0.077079108
FALSE,Piute County,8/1/14,Hide,Hide,8,2014,417,417,450,450,1,33,33,0.073333333,0.073333333
FALSE,Piute County,8/1/15,Hide,Hide,8,2015,433,433,461,461,1,28,28,0.060737527,0.060737527
FALSE,Piute County,8/1/16,Hide,Hide,8,2016,436,436,462,462,1,26,26,0.056277056,0.056277056
FALSE,Piute County,8/1/17,Hide,Hide,8,2017,462,462,486,486,1,24,24,0.049382716,0.049382716
FALSE,Piute County,8/1/18,Hide,Hide,8,2018,454,454,478,478,1,24,24,0.050209205,0.050209205
FALSE,Piute County,8/1/19,Hide,Hide,8,2019,461,461,484,484,1,23,23,0.047520661,0.047520661
FALSE,Rich County,8/1/93,Hide,Hide,8,1993,779,779,801,801,1,22,22,0.027465668,0.027465668
FALSE,Rich County,8/1/94,Hide,Hide,8,1994,834,834,868,868,1,34,34,0.039170507,0.039170507
FALSE,Rich County,8/1/95,Hide,Hide,8,1995,854,854,891,891,1,37,37,0.041526375,0.041526375
FALSE,Rich County,8/1/96,Hide,Hide,8,1996,935,935,970,970,1,35,35,0.036082474,0.036082474
FALSE,Rich County,8/1/97,Hide,Hide,8,1997,918,918,951,951,1,33,33,0.034700315,0.034700315
FALSE,Rich County,8/1/98,Hide,Hide,8,1998,934,934,967,967,1,33,33,0.034126163,0.034126163
FALSE,Rich County,8/1/99,Hide,Hide,8,1999,946,946,986,986,1,40,40,0.040567951,0.040567951
FALSE,Rich County,8/1/00,Hide,Hide,8,2000,1046,1046,1075,1075,1,29,29,0.026976744,0.026976744
FALSE,Rich County,8/1/01,Hide,Hide,8,2001,1183,1183,1215,1215,1,32,32,0.026337449,0.026337449
FALSE,Rich County,8/1/02,Hide,Hide,8,2002,1178,1178,1232,1232,1,54,54,0.043831169,0.043831169
FALSE,Rich County,8/1/03,Hide,Hide,8,2003,1218,1218,1265,1265,1,47,47,0.03715415,0.03715415
FALSE,Rich County,8/1/04,Hide,Hide,8,2004,1309,1309,1354,1354,1,45,45,0.03323486,0.03323486
FALSE,Rich County,8/1/05,Hide,Hide,8,2005,1248,1248,1287,1287,1,39,39,0.03030303,0.03030303
FALSE,Rich County,8/1/06,Hide,Hide,8,2006,1398,1398,1429,1429,1,31,31,0.021693492,0.021693492
FALSE,Rich County,8/1/07,Hide,Hide,8,2007,1371,1371,1405,1405,1,34,34,0.024199288,0.024199288
FALSE,Rich County,8/1/08,Hide,Hide,8,2008,1405,1405,1444,1444,1,39,39,0.02700831,0.02700831
FALSE,Rich County,8/1/09,Hide,Hide,8,2009,1377,1377,1453,1453,1,76,76,0.052305575,0.052305575
FALSE,Rich County,8/1/10,Hide,Hide,8,2010,965,965,1038,1038,1,73,73,0.070327553,0.070327553
FALSE,Rich County,8/1/11,Hide,Hide,8,2011,912,912,981,981,1,69,69,0.070336391,0.070336391
FALSE,Rich County,8/1/12,Hide,Hide,8,2012,905,905,954,954,1,49,49,0.051362683,0.051362683
FALSE,Rich County,8/1/13,Hide,Hide,8,2013,926,926,970,970,1,44,44,0.045360825,0.045360825
FALSE,Rich County,8/1/14,Hide,Hide,8,2014,939,939,978,978,1,39,39,0.039877301,0.039877301
FALSE,Rich County,8/1/15,Hide,Hide,8,2015,999,999,1039,1039,1,40,40,0.038498556,0.038498556
FALSE,Rich County,8/1/16,Hide,Hide,8,2016,1077,1077,1112,1112,1,35,35,0.03147482,0.03147482
FALSE,Rich County,8/1/17,Hide,Hide,8,2017,1108,1108,1145,1145,1,37,37,0.03231441,0.03231441
FALSE,Rich County,8/1/18,Hide,Hide,8,2018,1142,1142,1179,1179,1,37,37,0.031382528,0.031382528
FALSE,Rich County,8/1/19,Hide,Hide,8,2019,1149,1149,1184,1184,1,35,35,0.029560811,0.029560811
FALSE,Salt Lake County,8/1/93,Hide,Hide,8,1993,410192,410192,424566,424566,1,14374,14374,0.033855749,0.033855749
FALSE,Salt Lake County,8/1/94,Hide,Hide,8,1994,428102,428102,443268,443268,1,15166,15166,0.034214065,0.034214065
FALSE,Salt Lake County,8/1/95,Hide,Hide,8,1995,441828,441828,455149,455149,1,13321,13321,0.029267339,0.029267339
FALSE,Salt Lake County,8/1/96,Hide,Hide,8,1996,449862,449862,463118,463118,1,13256,13256,0.028623375,0.028623375
FALSE,Salt Lake County,8/1/97,Hide,Hide,8,1997,462683,462683,476014,476014,1,13331,13331,0.028005479,0.028005479
FALSE,Salt Lake County,8/1/98,Hide,Hide,8,1998,468535,468535,484501,484501,1,15966,15966,0.032953492,0.032953492
FALSE,Salt Lake County,8/1/99,Hide,Hide,8,1999,475712,475712,491685,491685,1,15973,15973,0.032486246,0.032486246
FALSE,Salt Lake County,8/1/00,Hide,Hide,8,2000,470494,470494,486197,486197,1,15703,15703,0.032297608,0.032297608
FALSE,Salt Lake County,8/1/01,Hide,Hide,8,2001,469139,469139,491621,491621,1,22482,22482,0.045730349,0.045730349
FALSE,Salt Lake County,8/1/02,Hide,Hide,8,2002,464589,464589,495055,495055,1,30466,30466,0.061540637,0.061540637
FALSE,Salt Lake County,8/1/03,Hide,Hide,8,2003,468537,468537,496667,496667,1,28130,28130,0.056637546,0.056637546
FALSE,Salt Lake County,8/1/04,Hide,Hide,8,2004,476642,476642,501247,501247,1,24605,24605,0.049087576,0.049087576
FALSE,Salt Lake County,8/1/05,Hide,Hide,8,2005,500422,500422,520566,520566,1,20144,20144,0.038696342,0.038696342
FALSE,Salt Lake County,8/1/06,Hide,Hide,8,2006,521810,521810,536868,536868,1,15058,15058,0.028047863,0.028047863
FALSE,Salt Lake County,8/1/07,Hide,Hide,8,2007,538509,538509,552950,552950,1,14441,14441,0.026116285,0.026116285
FALSE,Salt Lake County,8/1/08,Hide,Hide,8,2008,538356,538356,557466,557466,1,19110,19110,0.034280118,0.034280118
FALSE,Salt Lake County,8/1/09,Hide,Hide,8,2009,509796,509796,550802,550802,1,41006,41006,0.074447805,0.074447805
FALSE,Salt Lake County,8/1/10,Hide,Hide,8,2010,506603,506603,549021,549021,1,42418,42418,0.077261161,0.077261161
FALSE,Salt Lake County,8/1/11,Hide,Hide,8,2011,511015,511015,546307,546307,1,35292,35292,0.064601039,0.064601039
FALSE,Salt Lake County,8/1/12,Hide,Hide,8,2012,529793,529793,558110,558110,1,28317,28317,0.05073731,0.05073731
FALSE,Salt Lake County,8/1/13,Hide,Hide,8,2013,546757,546757,571092,571092,1,24335,24335,0.042611348,0.042611348
FALSE,Salt Lake County,8/1/14,Hide,Hide,8,2014,554931,554931,575987,575987,1,21056,21056,0.036556381,0.036556381
FALSE,Salt Lake County,8/1/15,Hide,Hide,8,2015,566534,566534,586212,586212,1,19678,19678,0.033568061,0.033568061
FALSE,Salt Lake County,8/1/16,Hide,Hide,8,2016,585614,585614,604377,604377,1,18763,18763,0.031045192,0.031045192
FALSE,Salt Lake County,8/1/17,Hide,Hide,8,2017,596469,596469,615753,615753,1,19284,19284,0.031317752,0.031317752
FALSE,Salt Lake County,8/1/18,Hide,Hide,8,2018,601444,601444,619750,619750,1,18306,18306,0.029537717,0.029537717
FALSE,Salt Lake County,8/1/19,Hide,Hide,8,2019,622209,622209,637651,637651,1,15442,15442,0.024217009,0.024217009
FALSE,San Juan County,8/1/93,Hide,Hide,8,1993,4772,4772,5129,5129,1,357,357,0.069604211,0.069604211
FALSE,San Juan County,8/1/94,Hide,Hide,8,1994,4742,4742,5171,5171,1,429,429,0.082962676,0.082962676
FALSE,San Juan County,8/1/95,Hide,Hide,8,1995,4819,4819,5270,5270,1,451,451,0.085578748,0.085578748
FALSE,San Juan County,8/1/96,Hide,Hide,8,1996,4582,4582,5069,5069,1,487,487,0.096074176,0.096074176
FALSE,San Juan County,8/1/97,Hide,Hide,8,1997,4462,4462,4863,4863,1,401,401,0.082459387,0.082459387
FALSE,San Juan County,8/1/98,Hide,Hide,8,1998,4641,4641,5035,5035,1,394,394,0.078252234,0.078252234
FALSE,San Juan County,8/1/99,Hide,Hide,8,1999,4651,4651,5024,5024,1,373,373,0.074243631,0.074243631
FALSE,San Juan County,8/1/00,Hide,Hide,8,2000,4265,4265,4645,4645,1,380,380,0.081808396,0.081808396
FALSE,San Juan County,8/1/01,Hide,Hide,8,2001,4211,4211,4584,4584,1,373,373,0.081369983,0.081369983
FALSE,San Juan County,8/1/02,Hide,Hide,8,2002,4377,4377,4788,4788,1,411,411,0.085839599,0.085839599
FALSE,San Juan County,8/1/03,Hide,Hide,8,2003,4277,4277,4713,4713,1,436,436,0.092510079,0.092510079
FALSE,San Juan County,8/1/04,Hide,Hide,8,2004,4428,4428,4875,4875,1,447,447,0.091692308,0.091692308
FALSE,San Juan County,8/1/05,Hide,Hide,8,2005,4435,4435,4798,4798,1,363,363,0.075656524,0.075656524
FALSE,San Juan County,8/1/06,Hide,Hide,8,2006,4618,4618,4923,4923,1,305,305,0.061954093,0.061954093
FALSE,San Juan County,8/1/07,Hide,Hide,8,2007,4702,4702,4979,4979,1,277,277,0.055633661,0.055633661
FALSE,San Juan County,8/1/08,Hide,Hide,8,2008,4723,4723,5036,5036,1,313,313,0.062152502,0.062152502
FALSE,San Juan County,8/1/09,Hide,Hide,8,2009,4681,4681,5333,5333,1,652,652,0.122257641,0.122257641
FALSE,San Juan County,8/1/10,Hide,Hide,8,2010,5505,5505,6164,6164,1,659,659,0.106911097,0.106911097
FALSE,San Juan County,8/1/11,Hide,Hide,8,2011,5345,5345,5930,5930,1,585,585,0.098650927,0.098650927
FALSE,San Juan County,8/1/12,Hide,Hide,8,2012,5184,5184,5680,5680,1,496,496,0.087323944,0.087323944
FALSE,San Juan County,8/1/13,Hide,Hide,8,2013,5237,5237,5691,5691,1,454,454,0.079775083,0.079775083
FALSE,San Juan County,8/1/14,Hide,Hide,8,2014,5145,5145,5578,5578,1,433,433,0.077626389,0.077626389
FALSE,San Juan County,8/1/15,Hide,Hide,8,2015,5251,5251,5705,5705,1,454,454,0.079579316,0.079579316
FALSE,San Juan County,8/1/16,Hide,Hide,8,2016,5282,5282,5740,5740,1,458,458,0.079790941,0.079790941
FALSE,San Juan County,8/1/17,Hide,Hide,8,2017,5296,5296,5685,5685,1,389,389,0.068425682,0.068425682
FALSE,San Juan County,8/1/18,Hide,Hide,8,2018,5378,5378,5726,5726,1,348,348,0.06077541,0.06077541
FALSE,San Juan County,8/1/19,Hide,Hide,8,2019,5437,5437,5721,5721,1,284,284,0.049641671,0.049641671
FALSE,Sanpete County,8/1/93,Hide,Hide,8,1993,6806,6806,7264,7264,1,458,458,0.063050661,0.063050661
FALSE,Sanpete County,8/1/94,Hide,Hide,8,1994,7123,7123,7628,7628,1,505,505,0.066203461,0.066203461
FALSE,Sanpete County,8/1/95,Hide,Hide,8,1995,7324,7324,7792,7792,1,468,468,0.060061602,0.060061602
FALSE,Sanpete County,8/1/96,Hide,Hide,8,1996,7851,7851,8320,8320,1,469,469,0.056370192,0.056370192
FALSE,Sanpete County,8/1/97,Hide,Hide,8,1997,8119,8119,8563,8563,1,444,444,0.051850987,0.051850987
FALSE,Sanpete County,8/1/98,Hide,Hide,8,1998,8524,8524,9040,9040,1,516,516,0.057079646,0.057079646
FALSE,Sanpete County,8/1/99,Hide,Hide,8,1999,8432,8432,8901,8901,1,469,469,0.052690709,0.052690709
FALSE,Sanpete County,8/1/00,Hide,Hide,8,2000,9450,9450,9894,9894,1,444,444,0.044875682,0.044875682
FALSE,Sanpete County,8/1/01,Hide,Hide,8,2001,9664,9664,10211,10211,1,547,547,0.05356968,0.05356968
FALSE,Sanpete County,8/1/02,Hide,Hide,8,2002,9443,9443,10125,10125,1,682,682,0.067358025,0.067358025
FALSE,Sanpete County,8/1/03,Hide,Hide,8,2003,9551,9551,10232,10232,1,681,681,0.066555903,0.066555903
FALSE,Sanpete County,8/1/04,Hide,Hide,8,2004,9795,9795,10451,10451,1,656,656,0.062769113,0.062769113
FALSE,Sanpete County,8/1/05,Hide,Hide,8,2005,10076,10076,10626,10626,1,550,550,0.051759834,0.051759834
FALSE,Sanpete County,8/1/06,Hide,Hide,8,2006,10282,10282,10667,10667,1,385,385,0.036092622,0.036092622
FALSE,Sanpete County,8/1/07,Hide,Hide,8,2007,10568,10568,10920,10920,1,352,352,0.032234432,0.032234432
FALSE,Sanpete County,8/1/08,Hide,Hide,8,2008,10767,10767,11247,11247,1,480,480,0.042678047,0.042678047
FALSE,Sanpete County,8/1/09,Hide,Hide,8,2009,10363,10363,11313,11313,1,950,950,0.083974189,0.083974189
FALSE,Sanpete County,8/1/10,Hide,Hide,8,2010,10396,10396,11495,11495,1,1099,1099,0.095606786,0.095606786
FALSE,Sanpete County,8/1/11,Hide,Hide,8,2011,10240,10240,11093,11093,1,853,853,0.076895339,0.076895339
FALSE,Sanpete County,8/1/12,Hide,Hide,8,2012,10553,10553,11254,11254,1,701,701,0.062288964,0.062288964
FALSE,Sanpete County,8/1/13,Hide,Hide,8,2013,10315,10315,10921,10921,1,606,606,0.055489424,0.055489424
FALSE,Sanpete County,8/1/14,Hide,Hide,8,2014,10578,10578,11074,11074,1,496,496,0.044789597,0.044789597
FALSE,Sanpete County,8/1/15,Hide,Hide,8,2015,10990,10990,11465,11465,1,475,475,0.04143044,0.04143044
FALSE,Sanpete County,8/1/16,Hide,Hide,8,2016,11461,11461,11925,11925,1,464,464,0.038909853,0.038909853
FALSE,Sanpete County,8/1/17,Hide,Hide,8,2017,11512,11512,11990,11990,1,478,478,0.039866555,0.039866555
FALSE,Sanpete County,8/1/18,Hide,Hide,8,2018,12028,12028,12485,12485,1,457,457,0.036603925,0.036603925
FALSE,Sanpete County,8/1/19,Hide,Hide,8,2019,12093,12093,12480,12480,1,387,387,0.031009615,0.031009615
FALSE,Sevier County,8/1/93,Hide,Hide,8,1993,6853,6853,7228,7228,1,375,375,0.051881572,0.051881572
FALSE,Sevier County,8/1/94,Hide,Hide,8,1994,7173,7173,7547,7547,1,374,374,0.049556115,0.049556115
FALSE,Sevier County,8/1/95,Hide,Hide,8,1995,7247,7247,7625,7625,1,378,378,0.04957377,0.04957377
FALSE,Sevier County,8/1/96,Hide,Hide,8,1996,7490,7490,7846,7846,1,356,356,0.045373439,0.045373439
FALSE,Sevier County,8/1/97,Hide,Hide,8,1997,7810,7810,8112,8112,1,302,302,0.037228797,0.037228797
FALSE,Sevier County,8/1/98,Hide,Hide,8,1998,7925,7925,8319,8319,1,394,394,0.047361462,0.047361462
FALSE,Sevier County,8/1/99,Hide,Hide,8,1999,8149,8149,8489,8489,1,340,340,0.040051832,0.040051832
FALSE,Sevier County,8/1/00,Hide,Hide,8,2000,8031,8031,8366,8366,1,335,335,0.040043031,0.040043031
FALSE,Sevier County,8/1/01,Hide,Hide,8,2001,8260,8260,8659,8659,1,399,399,0.046079224,0.046079224
FALSE,Sevier County,8/1/02,Hide,Hide,8,2002,8319,8319,8829,8829,1,510,510,0.057764186,0.057764186
FALSE,Sevier County,8/1/03,Hide,Hide,8,2003,8226,8226,8729,8729,1,503,503,0.057624012,0.057624012
FALSE,Sevier County,8/1/04,Hide,Hide,8,2004,8765,8765,9248,9248,1,483,483,0.052227509,0.052227509
FALSE,Sevier County,8/1/05,Hide,Hide,8,2005,8763,8763,9158,9158,1,395,395,0.043131688,0.043131688
FALSE,Sevier County,8/1/06,Hide,Hide,8,2006,9129,9129,9436,9436,1,307,307,0.032534972,0.032534972
FALSE,Sevier County,8/1/07,Hide,Hide,8,2007,9145,9145,9433,9433,1,288,288,0.030531114,0.030531114
FALSE,Sevier County,8/1/08,Hide,Hide,8,2008,9240,9240,9645,9645,1,405,405,0.041990669,0.041990669
FALSE,Sevier County,8/1/09,Hide,Hide,8,2009,9117,9117,9904,9904,1,787,787,0.079462843,0.079462843
FALSE,Sevier County,8/1/10,Hide,Hide,8,2010,8986,8986,9781,9781,1,795,795,0.081280033,0.081280033
FALSE,Sevier County,8/1/11,Hide,Hide,8,2011,8808,8808,9498,9498,1,690,690,0.072646873,0.072646873
FALSE,Sevier County,8/1/12,Hide,Hide,8,2012,8873,8873,9435,9435,1,562,562,0.059565448,0.059565448
FALSE,Sevier County,8/1/13,Hide,Hide,8,2013,8700,8700,9197,9197,1,497,497,0.054039361,0.054039361
FALSE,Sevier County,8/1/14,Hide,Hide,8,2014,8801,8801,9217,9217,1,416,416,0.045133992,0.045133992
FALSE,Sevier County,8/1/15,Hide,Hide,8,2015,9045,9045,9470,9470,1,425,425,0.044878564,0.044878564
FALSE,Sevier County,8/1/16,Hide,Hide,8,2016,9235,9235,9656,9656,1,421,421,0.043599834,0.043599834
FALSE,Sevier County,8/1/17,Hide,Hide,8,2017,9407,9407,9789,9789,1,382,382,0.039023394,0.039023394
FALSE,Sevier County,8/1/18,Hide,Hide,8,2018,9520,9520,9859,9859,1,339,339,0.034384826,0.034384826
FALSE,Sevier County,8/1/19,Hide,Hide,8,2019,9439,9439,9732,9732,1,293,293,0.030106864,0.030106864
FALSE,State of Utah,8/1/93,Hide,Hide,8,1993,911658,911658,949010,949010,1,37352,37352,0.039358911,0.039358911
FALSE,State of Utah,8/1/94,Hide,Hide,8,1994,958431,958431,996620,996620,1,38189,38189,0.038318517,0.038318517
FALSE,State of Utah,8/1/95,Hide,Hide,8,1995,980279,980279,1015155,1015155,1,34876,34876,0.034355345,0.034355345
FALSE,State of Utah,8/1/96,Hide,Hide,8,1996,1008115,1008115,1042877,1042877,1,34762,34762,0.03333279,0.03333279
FALSE,State of Utah,8/1/97,Hide,Hide,8,1997,1040240,1040240,1073984,1073984,1,33744,33744,0.031419462,0.031419462
FALSE,State of Utah,8/1/98,Hide,Hide,8,1998,1064462,1064462,1105518,1105518,1,41056,41056,0.037137342,0.037137342
FALSE,State of Utah,8/1/99,Hide,Hide,8,1999,1083175,1083175,1123388,1123388,1,40213,40213,0.035796181,0.035796181
FALSE,State of Utah,8/1/00,Hide,Hide,8,2000,1106159,1106159,1145409,1145409,1,39250,39250,0.034267236,0.034267236
FALSE,State of Utah,8/1/01,Hide,Hide,8,2001,1112371,1112371,1164967,1164967,1,52596,52596,0.04514806,0.04514806
FALSE,State of Utah,8/1/02,Hide,Hide,8,2002,1116043,1116043,1186303,1186303,1,70260,70260,0.059226016,0.059226016
FALSE,State of Utah,8/1/03,Hide,Hide,8,2003,1135066,1135066,1201861,1201861,1,66795,66795,0.05557631,0.05557631
FALSE,State of Utah,8/1/04,Hide,Hide,8,2004,1174741,1174741,1235157,1235157,1,60416,60416,0.04891362,0.04891362
FALSE,State of Utah,8/1/05,Hide,Hide,8,2005,1228439,1228439,1279527,1279527,1,51088,51088,0.039927254,0.039927254
FALSE,State of Utah,8/1/06,Hide,Hide,8,2006,1286453,1286453,1324166,1324166,1,37713,37713,0.028480568,0.028480568
FALSE,State of Utah,8/1/07,Hide,Hide,8,2007,1327577,1327577,1363999,1363999,1,36422,36422,0.026702366,0.026702366
FALSE,State of Utah,8/1/08,Hide,Hide,8,2008,1322489,1322489,1371555,1371555,1,49066,49066,0.035773994,0.035773994
FALSE,State of Utah,8/1/09,Hide,Hide,8,2009,1257882,1257882,1360769,1360769,1,102887,102887,0.075609453,0.075609453
FALSE,State of Utah,8/1/10,Hide,Hide,8,2010,1250576,1250576,1356853,1356853,1,106277,106277,0.078326097,0.078326097
FALSE,State of Utah,8/1/11,Hide,Hide,8,2011,1260385,1260385,1348691,1348691,1,88306,88306,0.065475339,0.065475339
FALSE,State of Utah,8/1/12,Hide,Hide,8,2012,1304435,1304435,1376447,1376447,1,72012,72012,0.052317307,0.052317307
FALSE,State of Utah,8/1/13,Hide,Hide,8,2013,1346638,1346638,1410108,1410108,1,63470,63470,0.045010737,0.045010737
FALSE,State of Utah,8/1/14,Hide,Hide,8,2014,1374813,1374813,1428747,1428747,1,53934,53934,0.037749161,0.037749161
FALSE,State of Utah,8/1/15,Hide,Hide,8,2015,1411708,1411708,1464788,1464788,1,53080,53080,0.036237326,0.036237326
FALSE,State of Utah,8/1/16,Hide,Hide,8,2016,1462871,1462871,1513705,1513705,1,50834,50834,0.033582501,0.033582501
FALSE,State of Utah,8/1/17,Hide,Hide,8,2017,1502215,1502215,1552762,1552762,1,50547,50547,0.03255296,0.03255296
FALSE,State of Utah,8/1/18,Hide,Hide,8,2018,1524293,1524293,1573649,1573649,1,49356,49356,0.031364046,0.031364046
FALSE,State of Utah,8/1/19,Hide,Hide,8,2019,1556358,1556358,1601441,1601441,1,45083,45083,0.028151521,0.028151521
FALSE,Summit County,8/1/93,Hide,Hide,8,1993,9919,9919,10442,10442,1,523,523,0.05008619,0.05008619
FALSE,Summit County,8/1/94,Hide,Hide,8,1994,11016,11016,11514,11514,1,498,498,0.043251694,0.043251694
FALSE,Summit County,8/1/95,Hide,Hide,8,1995,11660,11660,12133,12133,1,473,473,0.038984587,0.038984587
FALSE,Summit County,8/1/96,Hide,Hide,8,1996,12457,12457,12892,12892,1,435,435,0.033741855,0.033741855
FALSE,Summit County,8/1/97,Hide,Hide,8,1997,12963,12963,13449,13449,1,486,486,0.036136516,0.036136516
FALSE,Summit County,8/1/98,Hide,Hide,8,1998,13480,13480,14100,14100,1,620,620,0.043971631,0.043971631
FALSE,Summit County,8/1/99,Hide,Hide,8,1999,13803,13803,14507,14507,1,704,704,0.048528297,0.048528297
FALSE,Summit County,8/1/00,Hide,Hide,8,2000,18014,18014,18661,18661,1,647,647,0.034671239,0.034671239
FALSE,Summit County,8/1/01,Hide,Hide,8,2001,18164,18164,19075,19075,1,911,911,0.047758847,0.047758847
FALSE,Summit County,8/1/02,Hide,Hide,8,2002,18272,18272,19569,19569,1,1297,1297,0.066278297,0.066278297
FALSE,Summit County,8/1/03,Hide,Hide,8,2003,18755,18755,19972,19972,1,1217,1217,0.060935309,0.060935309
FALSE,Summit County,8/1/04,Hide,Hide,8,2004,19533,19533,20567,20567,1,1034,1034,0.050274712,0.050274712
FALSE,Summit County,8/1/05,Hide,Hide,8,2005,20783,20783,21617,21617,1,834,834,0.038580747,0.038580747
FALSE,Summit County,8/1/06,Hide,Hide,8,2006,21299,21299,21900,21900,1,601,601,0.027442922,0.027442922
FALSE,Summit County,8/1/07,Hide,Hide,8,2007,21448,21448,21996,21996,1,548,548,0.024913621,0.024913621
FALSE,Summit County,8/1/08,Hide,Hide,8,2008,21695,21695,22440,22440,1,745,745,0.033199643,0.033199643
FALSE,Summit County,8/1/09,Hide,Hide,8,2009,21048,21048,22696,22696,1,1648,1648,0.072611914,0.072611914
FALSE,Summit County,8/1/10,Hide,Hide,8,2010,18891,18891,20455,20455,1,1564,1564,0.076460523,0.076460523
FALSE,Summit County,8/1/11,Hide,Hide,8,2011,19640,19640,20896,20896,1,1256,1256,0.060107198,0.060107198
FALSE,Summit County,8/1/12,Hide,Hide,8,2012,20388,20388,21430,21430,1,1042,1042,0.048623425,0.048623425
FALSE,Summit County,8/1/13,Hide,Hide,8,2013,21263,21263,22161,22161,1,898,898,0.040521637,0.040521637
FALSE,Summit County,8/1/14,Hide,Hide,8,2014,21820,21820,22591,22591,1,771,771,0.034128635,0.034128635
FALSE,Summit County,8/1/15,Hide,Hide,8,2015,22340,22340,23094,23094,1,754,754,0.032649173,0.032649173
FALSE,Summit County,8/1/16,Hide,Hide,8,2016,23331,23331,24067,24067,1,736,736,0.030581294,0.030581294
FALSE,Summit County,8/1/17,Hide,Hide,8,2017,23709,23709,24470,24470,1,761,761,0.031099305,0.031099305
FALSE,Summit County,8/1/18,Hide,Hide,8,2018,23649,23649,24375,24375,1,726,726,0.029784615,0.029784615
FALSE,Summit County,8/1/19,Hide,Hide,8,2019,24679,24679,25272,25272,1,593,593,0.023464704,0.023464704
FALSE,Tooele County,8/1/93,Hide,Hide,8,1993,11445,11445,12079,12079,1,634,634,0.052487789,0.052487789
FALSE,Tooele County,8/1/94,Hide,Hide,8,1994,11047,11047,11729,11729,1,682,682,0.058146475,0.058146475
FALSE,Tooele County,8/1/95,Hide,Hide,8,1995,10731,10731,11374,11374,1,643,643,0.056532442,0.056532442
FALSE,Tooele County,8/1/96,Hide,Hide,8,1996,11134,11134,11730,11730,1,596,596,0.050809889,0.050809889
FALSE,Tooele County,8/1/97,Hide,Hide,8,1997,11313,11313,11829,11829,1,516,516,0.043621608,0.043621608
FALSE,Tooele County,8/1/98,Hide,Hide,8,1998,11735,11735,12340,12340,1,605,605,0.049027553,0.049027553
FALSE,Tooele County,8/1/99,Hide,Hide,8,1999,11896,11896,12566,12566,1,670,670,0.053318478,0.053318478
FALSE,Tooele County,8/1/00,Hide,Hide,8,2000,19767,19767,20527,20527,1,760,760,0.037024407,0.037024407
FALSE,Tooele County,8/1/01,Hide,Hide,8,2001,20502,20502,21562,21562,1,1060,1060,0.04916056,0.04916056
FALSE,Tooele County,8/1/02,Hide,Hide,8,2002,21033,21033,22480,22480,1,1447,1447,0.064368327,0.064368327
FALSE,Tooele County,8/1/03,Hide,Hide,8,2003,21933,21933,23391,23391,1,1458,1458,0.062331666,0.062331666
FALSE,Tooele County,8/1/04,Hide,Hide,8,2004,22817,22817,24110,24110,1,1293,1293,0.0536292,0.0536292
FALSE,Tooele County,8/1/05,Hide,Hide,8,2005,24291,24291,25353,25353,1,1062,1062,0.041888534,0.041888534
FALSE,Tooele County,8/1/06,Hide,Hide,8,2006,25607,25607,26425,26425,1,818,818,0.030955535,0.030955535
FALSE,Tooele County,8/1/07,Hide,Hide,8,2007,26244,26244,27054,27054,1,810,810,0.02994012,0.02994012
FALSE,Tooele County,8/1/08,Hide,Hide,8,2008,26843,26843,27953,27953,1,1110,1110,0.039709512,0.039709512
FALSE,Tooele County,8/1/09,Hide,Hide,8,2009,25727,25727,28042,28042,1,2315,2315,0.082554739,0.082554739
FALSE,Tooele County,8/1/10,Hide,Hide,8,2010,25213,25213,27506,27506,1,2293,2293,0.08336363,0.08336363
FALSE,Tooele County,8/1/11,Hide,Hide,8,2011,25397,25397,27297,27297,1,1900,1900,0.069604718,0.069604718
FALSE,Tooele County,8/1/12,Hide,Hide,8,2012,26217,26217,27846,27846,1,1629,1629,0.058500323,0.058500323
FALSE,Tooele County,8/1/13,Hide,Hide,8,2013,27049,27049,28587,28587,1,1538,1538,0.053800679,0.053800679
FALSE,Tooele County,8/1/14,Hide,Hide,8,2014,27545,27545,28918,28918,1,1373,1373,0.047479079,0.047479079
FALSE,Tooele County,8/1/15,Hide,Hide,8,2015,28409,28409,29606,29606,1,1197,1197,0.040430994,0.040430994
FALSE,Tooele County,8/1/16,Hide,Hide,8,2016,29722,29722,30879,30879,1,1157,1157,0.03746883,0.03746883
FALSE,Tooele County,8/1/17,Hide,Hide,8,2017,31187,31187,32373,32373,1,1186,1186,0.036635468,0.036635468
FALSE,Tooele County,8/1/18,Hide,Hide,8,2018,32145,32145,33259,33259,1,1114,1114,0.033494693,0.033494693
FALSE,Tooele County,8/1/19,Hide,Hide,8,2019,33109,33109,34071,34071,1,962,962,0.028235156,0.028235156
FALSE,Uintah County,8/1/93,Hide,Hide,8,1993,9457,9457,10153,10153,1,696,696,0.068551167,0.068551167
FALSE,Uintah County,8/1/94,Hide,Hide,8,1994,9347,9347,10114,10114,1,767,767,0.075835476,0.075835476
FALSE,Uintah County,8/1/95,Hide,Hide,8,1995,9549,9549,10290,10290,1,741,741,0.072011662,0.072011662
FALSE,Uintah County,8/1/96,Hide,Hide,8,1996,9540,9540,10256,10256,1,716,716,0.069812793,0.069812793
FALSE,Uintah County,8/1/97,Hide,Hide,8,1997,10096,10096,10698,10698,1,602,602,0.0562722,0.0562722
FALSE,Uintah County,8/1/98,Hide,Hide,8,1998,10255,10255,10935,10935,1,680,680,0.062185642,0.062185642
FALSE,Uintah County,8/1/99,Hide,Hide,8,1999,10571,10571,11295,11295,1,724,724,0.064099159,0.064099159
FALSE,Uintah County,8/1/00,Hide,Hide,8,2000,10902,10902,11397,11397,1,495,495,0.043432482,0.043432482
FALSE,Uintah County,8/1/01,Hide,Hide,8,2001,11764,11764,12304,12304,1,540,540,0.043888166,0.043888166
FALSE,Uintah County,8/1/02,Hide,Hide,8,2002,11894,11894,12676,12676,1,782,782,0.061691385,0.061691385
FALSE,Uintah County,8/1/03,Hide,Hide,8,2003,12369,12369,13096,13096,1,727,727,0.055513134,0.055513134
FALSE,Uintah County,8/1/04,Hide,Hide,8,2004,13229,13229,13915,13915,1,686,686,0.049299317,0.049299317
FALSE,Uintah County,8/1/05,Hide,Hide,8,2005,14212,14212,14741,14741,1,529,529,0.035886304,0.035886304
FALSE,Uintah County,8/1/06,Hide,Hide,8,2006,16078,16078,16459,16459,1,381,381,0.023148429,0.023148429
FALSE,Uintah County,8/1/07,Hide,Hide,8,2007,16875,16875,17250,17250,1,375,375,0.02173913,0.02173913
FALSE,Uintah County,8/1/08,Hide,Hide,8,2008,18650,18650,19061,19061,1,411,411,0.021562352,0.021562352
FALSE,Uintah County,8/1/09,Hide,Hide,8,2009,15626,15626,17289,17289,1,1663,1663,0.096188328,0.096188328
FALSE,Uintah County,8/1/10,Hide,Hide,8,2010,13929,13929,15171,15171,1,1242,1242,0.081866719,0.081866719
FALSE,Uintah County,8/1/11,Hide,Hide,8,2011,14624,14624,15507,15507,1,883,883,0.056942026,0.056942026
FALSE,Uintah County,8/1/12,Hide,Hide,8,2012,15290,15290,15982,15982,1,692,692,0.043298711,0.043298711
FALSE,Uintah County,8/1/13,Hide,Hide,8,2013,14935,14935,15602,15602,1,667,667,0.042750929,0.042750929
FALSE,Uintah County,8/1/14,Hide,Hide,8,2014,15460,15460,16046,16046,1,586,586,0.036520005,0.036520005
FALSE,Uintah County,8/1/15,Hide,Hide,8,2015,13965,13965,15077,15077,1,1112,1112,0.073754726,0.073754726
FALSE,Uintah County,8/1/16,Hide,Hide,8,2016,12829,12829,14099,14099,1,1270,1270,0.09007731,0.09007731
FALSE,Uintah County,8/1/17,Hide,Hide,8,2017,12874,12874,13648,13648,1,774,774,0.056711606,0.056711606
FALSE,Uintah County,8/1/18,Hide,Hide,8,2018,12917,12917,13531,13531,1,614,614,0.045377282,0.045377282
FALSE,Uintah County,8/1/19,Hide,Hide,8,2019,13117,13117,13674,13674,1,557,557,0.04073424,0.04073424
FALSE,United States,8/1/93,Hide,Hide,8,1993,120856,120856000,129619,129619000,1,8763,8763000,0.068,0.068
FALSE,United States,8/1/94,Hide,Hide,8,1994,123342,123342000,131275,131275000,1,7933,7933000,0.06,0.06
FALSE,United States,8/1/95,Hide,Hide,8,1995,124852,124852000,132336,132336000,1,7484,7484000,0.057,0.057
FALSE,United States,8/1/96,Hide,Hide,8,1996,127172,127172000,134054,134054000,1,6882,6882000,0.051,0.051
FALSE,United States,8/1/97,Hide,Hide,8,1997,130010,130010000,136618,136618000,1,6608,6608000,0.048,0.048
FALSE,United States,8/1/98,Hide,Hide,8,1998,131390,131390000,137570,137570000,1,6179,6179000,0.045,0.045
FALSE,United States,8/1/99,Hide,Hide,8,1999,133591,133591000,139430,139430000,1,5838,5838000,0.042,0.042
FALSE,United States,8/1/00,Hide,Hide,8,2000,136662,136662000,142514,142514000,1,5853,5853000,0.041,0.041
FALSE,United States,8/1/01,Hide,Hide,8,2001,136241,136241000,143284,143284000,1,7042,7042000,0.049,0.049
FALSE,United States,8/1/02,Hide,Hide,8,2002,136705,136705000,145009,145009000,1,8304,8304000,0.057,0.057
FALSE,United States,8/1/03,Hide,Hide,8,2003,137549,137549000,146445,146445000,1,8896,8896000,0.061,0.061
FALSE,United States,8/1/04,Hide,Hide,8,2004,139573,139573000,147564,147564000,1,7990,7990000,0.054,0.054
FALSE,United States,8/1/05,Hide,Hide,8,2005,142434,142434000,149779,149779000,1,7345,7345000,0.049,0.049
FALSE,United States,8/1/06,Hide,Hide,8,2006,144625,144625000,151716,151716000,1,7091,7091000,0.047,0.047
FALSE,United States,8/1/07,Hide,Hide,8,2007,145682,145682000,152749,152749000,1,7067,7067000,0.046,0.046
FALSE,United States,8/1/08,Hide,Hide,8,2008,145203,145203000,154641,154641000,1,9438,9438000,0.061,0.061
FALSE,United States,8/1/09,Hide,Hide,8,2009,139492,139492000,154307,154307000,1,14814,14814000,0.096,0.096
FALSE,United States,8/1/10,Hide,Hide,8,2010,139438,139438000,154086,154086000,1,14648,14648000,0.095,0.095
FALSE,United States,8/1/11,Hide,Hide,8,2011,139942,139942000,153760,153760000,1,13818,13818000,0.09,0.09
FALSE,United States,8/1/12,Hide,Hide,8,2012,142291,142291000,154763,154763000,1,12471,12471000,0.081,0.081
FALSE,United States,8/1/13,Hide,Hide,8,2013,144326,144326000,155605,155605000,1,11279,11279000,0.072,0.072
FALSE,United States,8/1/14,Hide,Hide,8,2014,146530,146530000,156130,156130000,1,9599,9599000,0.061,0.061
FALSE,United States,8/1/15,Hide,Hide,8,2015,149181,149181000,157172,157172000,1,7992,7992000,0.051,0.051
FALSE,United States,8/1/16,Hide,Hide,8,2016,151770,151770000,159579,159579000,1,7809,7809000,0.049,0.049
FALSE,United States,8/1/17,Hide,Hide,8,2017,153593,153593000,160690,160690000,1,7097,7097000,0.044,0.044
FALSE,United States,8/1/18,Hide,Hide,8,2018,155601,155601000,161768,161768000,1,6167,6167000,0.038,0.038
FALSE,United States,8/1/19,Hide,Hide,8,2019,157895,157895000,163894,163894000,1,5999,5999000,0.037,0.037
FALSE,Utah County,8/1/93,Hide,Hide,8,1993,133138,133138,138056,138056,1,4918,4918,0.035623225,0.035623225
FALSE,Utah County,8/1/94,Hide,Hide,8,1994,142056,142056,146724,146724,1,4668,4668,0.031814836,0.031814836
FALSE,Utah County,8/1/95,Hide,Hide,8,1995,145490,145490,149738,149738,1,4248,4248,0.028369552,0.028369552
FALSE,Utah County,8/1/96,Hide,Hide,8,1996,149709,149709,154188,154188,1,4479,4479,0.029048953,0.029048953
FALSE,Utah County,8/1/97,Hide,Hide,8,1997,154528,154528,158656,158656,1,4128,4128,0.026018556,0.026018556
FALSE,Utah County,8/1/98,Hide,Hide,8,1998,161611,161611,166637,166637,1,5026,5026,0.030161369,0.030161369
FALSE,Utah County,8/1/99,Hide,Hide,8,1999,165137,165137,170142,170142,1,5005,5005,0.029416605,0.029416605
FALSE,Utah County,8/1/00,Hide,Hide,8,2000,176868,176868,182434,182434,1,5566,5566,0.030509664,0.030509664
FALSE,Utah County,8/1/01,Hide,Hide,8,2001,175784,175784,183654,183654,1,7870,7870,0.04285232,0.04285232
FALSE,Utah County,8/1/02,Hide,Hide,8,2002,175311,175311,186262,186262,1,10951,10951,0.058793527,0.058793527
FALSE,Utah County,8/1/03,Hide,Hide,8,2003,178911,178911,188656,188656,1,9745,9745,0.051654864,0.051654864
FALSE,Utah County,8/1/04,Hide,Hide,8,2004,189241,189241,198526,198526,1,9285,9285,0.046769693,0.046769693
FALSE,Utah County,8/1/05,Hide,Hide,8,2005,198581,198581,206406,206406,1,7825,7825,0.03791072,0.03791072
FALSE,Utah County,8/1/06,Hide,Hide,8,2006,209496,209496,215502,215502,1,6006,6006,0.027869811,0.027869811
FALSE,Utah County,8/1/07,Hide,Hide,8,2007,218945,218945,224685,224685,1,5740,5740,0.025546877,0.025546877
FALSE,Utah County,8/1/08,Hide,Hide,8,2008,215238,215238,223166,223166,1,7928,7928,0.035525125,0.035525125
FALSE,Utah County,8/1/09,Hide,Hide,8,2009,204466,204466,220538,220538,1,16072,16072,0.07287633,0.07287633
FALSE,Utah County,8/1/10,Hide,Hide,8,2010,212948,212948,230203,230203,1,17255,17255,0.074955583,0.074955583
FALSE,Utah County,8/1/11,Hide,Hide,8,2011,217217,217217,231456,231456,1,14239,14239,0.061519252,0.061519252
FALSE,Utah County,8/1/12,Hide,Hide,8,2012,228294,228294,239853,239853,1,11559,11559,0.048192018,0.048192018
FALSE,Utah County,8/1/13,Hide,Hide,8,2013,240133,240133,250479,250479,1,10346,10346,0.04130486,0.04130486
FALSE,Utah County,8/1/14,Hide,Hide,8,2014,247231,247231,256044,256044,1,8813,8813,0.034419865,0.034419865
FALSE,Utah County,8/1/15,Hide,Hide,8,2015,258885,258885,267610,267610,1,8725,8725,0.032603415,0.032603415
FALSE,Utah County,8/1/16,Hide,Hide,8,2016,272260,272260,280855,280855,1,8595,8595,0.03060298,0.03060298
FALSE,Utah County,8/1/17,Hide,Hide,8,2017,283567,283567,292148,292148,1,8581,8581,0.029372099,0.029372099
FALSE,Utah County,8/1/18,Hide,Hide,8,2018,290920,290920,299260,299260,1,8340,8340,0.027868743,0.027868743
FALSE,Utah County,8/1/19,Hide,Hide,8,2019,301571,301571,308675,308675,1,7104,7104,0.023014497,0.023014497
FALSE,Wasatch County,8/1/93,Hide,Hide,8,1993,4783,4783,5105,5105,1,322,322,0.063075416,0.063075416
FALSE,Wasatch County,8/1/94,Hide,Hide,8,1994,5113,5113,5437,5437,1,324,324,0.059591687,0.059591687
FALSE,Wasatch County,8/1/95,Hide,Hide,8,1995,5173,5173,5450,5450,1,277,277,0.050825688,0.050825688
FALSE,Wasatch County,8/1/96,Hide,Hide,8,1996,5458,5458,5696,5696,1,238,238,0.041783708,0.041783708
FALSE,Wasatch County,8/1/97,Hide,Hide,8,1997,5664,5664,5894,5894,1,230,230,0.039022735,0.039022735
FALSE,Wasatch County,8/1/98,Hide,Hide,8,1998,5828,5828,6121,6121,1,293,293,0.047867995,0.047867995
FALSE,Wasatch County,8/1/99,Hide,Hide,8,1999,5960,5960,6288,6288,1,328,328,0.05216285,0.05216285
FALSE,Wasatch County,8/1/00,Hide,Hide,8,2000,7708,7708,7992,7992,1,284,284,0.035535536,0.035535536
FALSE,Wasatch County,8/1/01,Hide,Hide,8,2001,7689,7689,8044,8044,1,355,355,0.044132273,0.044132273
FALSE,Wasatch County,8/1/02,Hide,Hide,8,2002,7818,7818,8349,8349,1,531,531,0.063600431,0.063600431
FALSE,Wasatch County,8/1/03,Hide,Hide,8,2003,8083,8083,8594,8594,1,511,511,0.059460088,0.059460088
FALSE,Wasatch County,8/1/04,Hide,Hide,8,2004,8344,8344,8817,8817,1,473,473,0.053646365,0.053646365
FALSE,Wasatch County,8/1/05,Hide,Hide,8,2005,8908,8908,9278,9278,1,370,370,0.039879284,0.039879284
FALSE,Wasatch County,8/1/06,Hide,Hide,8,2006,9996,9996,10315,10315,1,319,319,0.030925836,0.030925836
FALSE,Wasatch County,8/1/07,Hide,Hide,8,2007,10549,10549,10849,10849,1,300,300,0.027652318,0.027652318
FALSE,Wasatch County,8/1/08,Hide,Hide,8,2008,10003,10003,10387,10387,1,384,384,0.036969289,0.036969289
FALSE,Wasatch County,8/1/09,Hide,Hide,8,2009,9186,9186,10046,10046,1,860,860,0.085606211,0.085606211
FALSE,Wasatch County,8/1/10,Hide,Hide,8,2010,10301,10301,11262,11262,1,961,961,0.085331202,0.085331202
FALSE,Wasatch County,8/1/11,Hide,Hide,8,2011,10648,10648,11420,11420,1,772,772,0.067600701,0.067600701
FALSE,Wasatch County,8/1/12,Hide,Hide,8,2012,11031,11031,11691,11691,1,660,660,0.056453682,0.056453682
FALSE,Wasatch County,8/1/13,Hide,Hide,8,2013,11654,11654,12219,12219,1,565,565,0.046239463,0.046239463
FALSE,Wasatch County,8/1/14,Hide,Hide,8,2014,12299,12299,12782,12782,1,483,483,0.037787514,0.037787514
FALSE,Wasatch County,8/1/15,Hide,Hide,8,2015,12903,12903,13366,13366,1,463,463,0.034640132,0.034640132
FALSE,Wasatch County,8/1/16,Hide,Hide,8,2016,13543,13543,14003,14003,1,460,460,0.032850104,0.032850104
FALSE,Wasatch County,8/1/17,Hide,Hide,8,2017,14195,14195,14692,14692,1,497,497,0.033827934,0.033827934
FALSE,Wasatch County,8/1/18,Hide,Hide,8,2018,14734,14734,15207,15207,1,473,473,0.031104097,0.031104097
FALSE,Wasatch County,8/1/19,Hide,Hide,8,2019,15882,15882,16312,16312,1,430,430,0.026360961,0.026360961
FALSE,Washington County,8/1/93,Hide,Hide,8,1993,25821,25821,26757,26757,1,936,936,0.0349815,0.0349815
FALSE,Washington County,8/1/94,Hide,Hide,8,1994,29999,29999,30952,30952,1,953,953,0.03078961,0.03078961
FALSE,Washington County,8/1/95,Hide,Hide,8,1995,31912,31912,32971,32971,1,1059,1059,0.032119135,0.032119135
FALSE,Washington County,8/1/96,Hide,Hide,8,1996,33768,33768,34967,34967,1,1199,1199,0.034289473,0.034289473
FALSE,Washington County,8/1/97,Hide,Hide,8,1997,34465,34465,35654,35654,1,1189,1189,0.033348292,0.033348292
FALSE,Washington County,8/1/98,Hide,Hide,8,1998,35931,35931,37359,37359,1,1428,1428,0.038223721,0.038223721
FALSE,Washington County,8/1/99,Hide,Hide,8,1999,37522,37522,38853,38853,1,1331,1331,0.034257329,0.034257329
FALSE,Washington County,8/1/00,Hide,Hide,8,2000,38146,38146,39565,39565,1,1419,1419,0.035865032,0.035865032
FALSE,Washington County,8/1/01,Hide,Hide,8,2001,40716,40716,42434,42434,1,1718,1718,0.040486402,0.040486402
FALSE,Washington County,8/1/02,Hide,Hide,8,2002,42674,42674,45126,45126,1,2452,2452,0.054336746,0.054336746
FALSE,Washington County,8/1/03,Hide,Hide,8,2003,45094,45094,47607,47607,1,2513,2513,0.052786355,0.052786355
FALSE,Washington County,8/1/04,Hide,Hide,8,2004,50204,50204,52731,52731,1,2527,2527,0.047922474,0.047922474
FALSE,Washington County,8/1/05,Hide,Hide,8,2005,55189,55189,57451,57451,1,2262,2262,0.039372683,0.039372683
FALSE,Washington County,8/1/06,Hide,Hide,8,2006,59940,59940,61774,61774,1,1834,1834,0.029688866,0.029688866
FALSE,Washington County,8/1/07,Hide,Hide,8,2007,62131,62131,63929,63929,1,1798,1798,0.028124951,0.028124951
FALSE,Washington County,8/1/08,Hide,Hide,8,2008,58216,58216,61291,61291,1,3075,3075,0.050170498,0.050170498
FALSE,Washington County,8/1/09,Hide,Hide,8,2009,53659,53659,59637,59637,1,5978,5978,0.100239784,0.100239784
FALSE,Washington County,8/1/10,Hide,Hide,8,2010,50789,50789,56787,56787,1,5998,5998,0.105622766,0.105622766
FALSE,Washington County,8/1/11,Hide,Hide,8,2011,51000,51000,55801,55801,1,4801,4801,0.086037885,0.086037885
FALSE,Washington County,8/1/12,Hide,Hide,8,2012,53585,53585,57377,57377,1,3792,3792,0.0660892,0.0660892
FALSE,Washington County,8/1/13,Hide,Hide,8,2013,56633,56633,59840,59840,1,3207,3207,0.053592914,0.053592914
FALSE,Washington County,8/1/14,Hide,Hide,8,2014,58955,58955,61620,61620,1,2665,2665,0.043248945,0.043248945
FALSE,Washington County,8/1/15,Hide,Hide,8,2015,61173,61173,63755,63755,1,2582,2582,0.040498784,0.040498784
FALSE,Washington County,8/1/16,Hide,Hide,8,2016,65332,65332,67813,67813,1,2481,2481,0.036585905,0.036585905
FALSE,Washington County,8/1/17,Hide,Hide,8,2017,68561,68561,71057,71057,1,2496,2496,0.035126729,0.035126729
FALSE,Washington County,8/1/18,Hide,Hide,8,2018,71908,71908,74401,74401,1,2493,2493,0.033507614,0.033507614
FALSE,Washington County,8/1/19,Hide,Hide,8,2019,74281,74281,76485,76485,1,2204,2204,0.028816108,0.028816108
FALSE,Wayne County,8/1/93,Hide,Hide,8,1993,1033,1033,1104,1104,1,71,71,0.064311594,0.064311594
FALSE,Wayne County,8/1/94,Hide,Hide,8,1994,1097,1097,1192,1192,1,95,95,0.079697987,0.079697987
FALSE,Wayne County,8/1/95,Hide,Hide,8,1995,1280,1280,1375,1375,1,95,95,0.069090909,0.069090909
FALSE,Wayne County,8/1/96,Hide,Hide,8,1996,1263,1263,1332,1332,1,69,69,0.051801802,0.051801802
FALSE,Wayne County,8/1/97,Hide,Hide,8,1997,1332,1332,1393,1393,1,61,61,0.04379038,0.04379038
FALSE,Wayne County,8/1/98,Hide,Hide,8,1998,1381,1381,1475,1475,1,94,94,0.063728814,0.063728814
FALSE,Wayne County,8/1/99,Hide,Hide,8,1999,1399,1399,1475,1475,1,76,76,0.051525424,0.051525424
FALSE,Wayne County,8/1/00,Hide,Hide,8,2000,1264,1264,1324,1324,1,60,60,0.045317221,0.045317221
FALSE,Wayne County,8/1/01,Hide,Hide,8,2001,1409,1409,1474,1474,1,65,65,0.044097693,0.044097693
FALSE,Wayne County,8/1/02,Hide,Hide,8,2002,1306,1306,1403,1403,1,97,97,0.069137562,0.069137562
FALSE,Wayne County,8/1/03,Hide,Hide,8,2003,1213,1213,1309,1309,1,96,96,0.073338426,0.073338426
FALSE,Wayne County,8/1/04,Hide,Hide,8,2004,1271,1271,1361,1361,1,90,90,0.066127847,0.066127847
FALSE,Wayne County,8/1/05,Hide,Hide,8,2005,1274,1274,1346,1346,1,72,72,0.053491828,0.053491828
FALSE,Wayne County,8/1/06,Hide,Hide,8,2006,1336,1336,1394,1394,1,58,58,0.041606887,0.041606887
FALSE,Wayne County,8/1/07,Hide,Hide,8,2007,1312,1312,1369,1369,1,57,57,0.041636231,0.041636231
FALSE,Wayne County,8/1/08,Hide,Hide,8,2008,1330,1330,1408,1408,1,78,78,0.055397727,0.055397727
FALSE,Wayne County,8/1/09,Hide,Hide,8,2009,1360,1360,1479,1479,1,119,119,0.08045977,0.08045977
FALSE,Wayne County,8/1/10,Hide,Hide,8,2010,1458,1458,1597,1597,1,139,139,0.087038197,0.087038197
FALSE,Wayne County,8/1/11,Hide,Hide,8,2011,1254,1254,1404,1404,1,150,150,0.106837607,0.106837607
FALSE,Wayne County,8/1/12,Hide,Hide,8,2012,1218,1218,1370,1370,1,152,152,0.110948905,0.110948905
FALSE,Wayne County,8/1/13,Hide,Hide,8,2013,1239,1239,1390,1390,1,151,151,0.108633094,0.108633094
FALSE,Wayne County,8/1/14,Hide,Hide,8,2014,1232,1232,1361,1361,1,129,129,0.094783248,0.094783248
FALSE,Wayne County,8/1/15,Hide,Hide,8,2015,1295,1295,1420,1420,1,125,125,0.088028169,0.088028169
FALSE,Wayne County,8/1/16,Hide,Hide,8,2016,1306,1306,1417,1417,1,111,111,0.07833451,0.07833451
FALSE,Wayne County,8/1/17,Hide,Hide,8,2017,1364,1364,1473,1473,1,109,109,0.073998642,0.073998642
FALSE,Wayne County,8/1/18,Hide,Hide,8,2018,1338,1338,1416,1416,1,78,78,0.055084746,0.055084746
FALSE,Wayne County,8/1/19,Hide,Hide,8,2019,1341,1341,1415,1415,1,74,74,0.05229682,0.05229682
FALSE,Weber County,8/1/93,Hide,Hide,8,1993,84075,84075,88557,88557,1,4482,4482,0.050611471,0.050611471
FALSE,Weber County,8/1/94,Hide,Hide,8,1994,88117,88117,92302,92302,1,4185,4185,0.045340296,0.045340296
FALSE,Weber County,8/1/95,Hide,Hide,8,1995,88598,88598,92352,92352,1,3754,3754,0.040648822,0.040648822
FALSE,Weber County,8/1/96,Hide,Hide,8,1996,92482,92482,96398,96398,1,3916,3916,0.040623249,0.040623249
FALSE,Weber County,8/1/97,Hide,Hide,8,1997,95412,95412,99274,99274,1,3862,3862,0.038902432,0.038902432
FALSE,Weber County,8/1/98,Hide,Hide,8,1998,96721,96721,101622,101622,1,4901,4901,0.048227746,0.048227746
FALSE,Weber County,8/1/99,Hide,Hide,8,1999,98496,98496,103002,103002,1,4506,4506,0.043746723,0.043746723
FALSE,Weber County,8/1/00,Hide,Hide,8,2000,95944,95944,100315,100315,1,4371,4371,0.043572746,0.043572746
FALSE,Weber County,8/1/01,Hide,Hide,8,2001,96448,96448,101600,101600,1,5152,5152,0.050708661,0.050708661
FALSE,Weber County,8/1/02,Hide,Hide,8,2002,97806,97806,104335,104335,1,6529,6529,0.062577275,0.062577275
FALSE,Weber County,8/1/03,Hide,Hide,8,2003,98851,98851,105737,105737,1,6886,6886,0.065123845,0.065123845
FALSE,Weber County,8/1/04,Hide,Hide,8,2004,101471,101471,107144,107144,1,5673,5673,0.052947435,0.052947435
FALSE,Weber County,8/1/05,Hide,Hide,8,2005,103705,103705,108535,108535,1,4830,4830,0.044501774,0.044501774
FALSE,Weber County,8/1/06,Hide,Hide,8,2006,106405,106405,109896,109896,1,3491,3491,0.031766397,0.031766397
FALSE,Weber County,8/1/07,Hide,Hide,8,2007,109572,109572,113337,113337,1,3765,3765,0.033219513,0.033219513
FALSE,Weber County,8/1/08,Hide,Hide,8,2008,108944,108944,113727,113727,1,4783,4783,0.042056855,0.042056855
FALSE,Weber County,8/1/09,Hide,Hide,8,2009,104280,104280,114215,114215,1,9935,9935,0.086985072,0.086985072
FALSE,Weber County,8/1/10,Hide,Hide,8,2010,103532,103532,113555,113555,1,10023,10023,0.088265598,0.088265598
FALSE,Weber County,8/1/11,Hide,Hide,8,2011,103868,103868,112535,112535,1,8667,8667,0.077016039,0.077016039
FALSE,Weber County,8/1/12,Hide,Hide,8,2012,106448,106448,113461,113461,1,7013,7013,0.061809785,0.061809785
FALSE,Weber County,8/1/13,Hide,Hide,8,2013,108640,108640,114653,114653,1,6013,6013,0.052445204,0.052445204
FALSE,Weber County,8/1/14,Hide,Hide,8,2014,109867,109867,114948,114948,1,5081,5081,0.044202596,0.044202596
FALSE,Weber County,8/1/15,Hide,Hide,8,2015,112528,112528,117312,117312,1,4784,4784,0.040780142,0.040780142
FALSE,Weber County,8/1/16,Hide,Hide,8,2016,116128,116128,120641,120641,1,4513,4513,0.03740851,0.03740851
FALSE,Weber County,8/1/17,Hide,Hide,8,2017,119030,119030,123589,123589,1,4559,4559,0.036888396,0.036888396
FALSE,Weber County,8/1/18,Hide,Hide,8,2018,120568,120568,124856,124856,1,4288,4288,0.034343564,0.034343564
FALSE,Weber County,8/1/19,Hide,Hide,8,2019,124313,124313,127803,127803,1,3490,3490,0.027307653,0.027307653
FALSE,Beaver County,9/1/93,Hide,Hide,9,1993,2062,2062,2166,2166,1,104,104,0.048014774,0.048014774
FALSE,Beaver County,9/1/94,Hide,Hide,9,1994,2175,2175,2259,2259,1,84,84,0.037184595,0.037184595
FALSE,Beaver County,9/1/95,Hide,Hide,9,1995,2277,2277,2380,2380,1,103,103,0.043277311,0.043277311
FALSE,Beaver County,9/1/96,Hide,Hide,9,1996,2369,2369,2505,2505,1,136,136,0.054291417,0.054291417
FALSE,Beaver County,9/1/97,Hide,Hide,9,1997,2441,2441,2552,2552,1,111,111,0.043495298,0.043495298
FALSE,Beaver County,9/1/98,Hide,Hide,9,1998,2368,2368,2482,2482,1,114,114,0.045930701,0.045930701
FALSE,Beaver County,9/1/99,Hide,Hide,9,1999,2346,2346,2439,2439,1,93,93,0.038130381,0.038130381
FALSE,Beaver County,9/1/00,Hide,Hide,9,2000,2621,2621,2717,2717,1,96,96,0.035333088,0.035333088
FALSE,Beaver County,9/1/01,Hide,Hide,9,2001,3063,3063,3185,3185,1,122,122,0.038304553,0.038304553
FALSE,Beaver County,9/1/02,Hide,Hide,9,2002,2914,2914,3065,3065,1,151,151,0.049265905,0.049265905
FALSE,Beaver County,9/1/03,Hide,Hide,9,2003,2784,2784,2938,2938,1,154,154,0.05241661,0.05241661
FALSE,Beaver County,9/1/04,Hide,Hide,9,2004,2797,2797,2928,2928,1,131,131,0.044740437,0.044740437
FALSE,Beaver County,9/1/05,Hide,Hide,9,2005,2981,2981,3108,3108,1,127,127,0.040862291,0.040862291
FALSE,Beaver County,9/1/06,Hide,Hide,9,2006,3077,3077,3165,3165,1,88,88,0.027804107,0.027804107
FALSE,Beaver County,9/1/07,Hide,Hide,9,2007,3019,3019,3104,3104,1,85,85,0.027384021,0.027384021
FALSE,Beaver County,9/1/08,Hide,Hide,9,2008,3077,3077,3202,3202,1,125,125,0.039038101,0.039038101
FALSE,Beaver County,9/1/09,Hide,Hide,9,2009,3436,3436,3667,3667,1,231,231,0.062994273,0.062994273
FALSE,Beaver County,9/1/10,Hide,Hide,9,2010,2882,2882,3194,3194,1,312,312,0.097683156,0.097683156
FALSE,Beaver County,9/1/11,Hide,Hide,9,2011,2788,2788,3016,3016,1,228,228,0.075596817,0.075596817
FALSE,Beaver County,9/1/12,Hide,Hide,9,2012,2748,2748,2918,2918,1,170,170,0.058259082,0.058259082
FALSE,Beaver County,9/1/13,Hide,Hide,9,2013,2877,2877,3010,3010,1,133,133,0.044186047,0.044186047
FALSE,Beaver County,9/1/14,Hide,Hide,9,2014,2787,2787,2902,2902,1,115,115,0.039627843,0.039627843
FALSE,Beaver County,9/1/15,Hide,Hide,9,2015,2990,2990,3110,3110,1,120,120,0.038585209,0.038585209
FALSE,Beaver County,9/1/16,Hide,Hide,9,2016,2896,2896,3061,3061,1,165,165,0.053903953,0.053903953
FALSE,Beaver County,9/1/17,Hide,Hide,9,2017,2936,2936,3048,3048,1,112,112,0.036745407,0.036745407
FALSE,Beaver County,9/1/18,Hide,Hide,9,2018,2908,2908,3006,3006,1,98,98,0.032601464,0.032601464
FALSE,Beaver County,9/1/19,Hide,Hide,9,2019,2755,2755,2836,2836,1,81,81,0.028561354,0.028561354
FALSE,Box Elder County,9/1/93,Hide,Hide,9,1993,16898,16898,17819,17819,1,921,921,0.051686402,0.051686402
FALSE,Box Elder County,9/1/94,Hide,Hide,9,1994,17337,17337,18207,18207,1,870,870,0.047783819,0.047783819
FALSE,Box Elder County,9/1/95,Hide,Hide,9,1995,16779,16779,17588,17588,1,809,809,0.045997271,0.045997271
FALSE,Box Elder County,9/1/96,Hide,Hide,9,1996,17391,17391,18130,18130,1,739,739,0.040761169,0.040761169
FALSE,Box Elder County,9/1/97,Hide,Hide,9,1997,18122,18122,18867,18867,1,745,745,0.039486935,0.039486935
FALSE,Box Elder County,9/1/98,Hide,Hide,9,1998,18459,18459,19380,19380,1,921,921,0.04752322,0.04752322
FALSE,Box Elder County,9/1/99,Hide,Hide,9,1999,17374,17374,18171,18171,1,797,797,0.043861097,0.043861097
FALSE,Box Elder County,9/1/00,Hide,Hide,9,2000,19424,19424,20178,20178,1,754,754,0.03736743,0.03736743
FALSE,Box Elder County,9/1/01,Hide,Hide,9,2001,19925,19925,20907,20907,1,982,982,0.046969914,0.046969914
FALSE,Box Elder County,9/1/02,Hide,Hide,9,2002,19831,19831,21046,21046,1,1215,1215,0.057730685,0.057730685
FALSE,Box Elder County,9/1/03,Hide,Hide,9,2003,20329,20329,21502,21502,1,1173,1173,0.054553065,0.054553065
FALSE,Box Elder County,9/1/04,Hide,Hide,9,2004,20756,20756,21841,21841,1,1085,1085,0.049677213,0.049677213
FALSE,Box Elder County,9/1/05,Hide,Hide,9,2005,21735,21735,22676,22676,1,941,941,0.041497619,0.041497619
FALSE,Box Elder County,9/1/06,Hide,Hide,9,2006,22246,22246,22921,22921,1,675,675,0.029448977,0.029448977
FALSE,Box Elder County,9/1/07,Hide,Hide,9,2007,22829,22829,23477,23477,1,648,648,0.027601482,0.027601482
FALSE,Box Elder County,9/1/08,Hide,Hide,9,2008,22689,22689,23833,23833,1,1144,1144,0.048000671,0.048000671
FALSE,Box Elder County,9/1/09,Hide,Hide,9,2009,21290,21290,23161,23161,1,1871,1871,0.08078235,0.08078235
FALSE,Box Elder County,9/1/10,Hide,Hide,9,2010,21729,21729,23778,23778,1,2049,2049,0.086172092,0.086172092
FALSE,Box Elder County,9/1/11,Hide,Hide,9,2011,21548,21548,23180,23180,1,1632,1632,0.070405522,0.070405522
FALSE,Box Elder County,9/1/12,Hide,Hide,9,2012,21704,21704,22978,22978,1,1274,1274,0.055444338,0.055444338
FALSE,Box Elder County,9/1/13,Hide,Hide,9,2013,22103,22103,23148,23148,1,1045,1045,0.045144289,0.045144289
FALSE,Box Elder County,9/1/14,Hide,Hide,9,2014,22539,22539,23457,23457,1,918,918,0.039135439,0.039135439
FALSE,Box Elder County,9/1/15,Hide,Hide,9,2015,23140,23140,24013,24013,1,873,873,0.036355308,0.036355308
FALSE,Box Elder County,9/1/16,Hide,Hide,9,2016,24043,24043,24890,24890,1,847,847,0.034029731,0.034029731
FALSE,Box Elder County,9/1/17,Hide,Hide,9,2017,24581,24581,25395,25395,1,814,814,0.032053554,0.032053554
FALSE,Box Elder County,9/1/18,Hide,Hide,9,2018,24665,24665,25416,25416,1,751,751,0.029548316,0.029548316
FALSE,Box Elder County,9/1/19,Hide,Hide,9,2019,25348,25348,25982,25982,1,634,634,0.024401509,0.024401509
FALSE,Cache County,9/1/93,Hide,Hide,9,1993,38390,38390,39597,39597,1,1207,1207,0.030482107,0.030482107
FALSE,Cache County,9/1/94,Hide,Hide,9,1994,39691,39691,40968,40968,1,1277,1277,0.03117067,0.03117067
FALSE,Cache County,9/1/95,Hide,Hide,9,1995,40436,40436,41689,41689,1,1253,1253,0.03005589,0.03005589
FALSE,Cache County,9/1/96,Hide,Hide,9,1996,40896,40896,42094,42094,1,1198,1198,0.028460113,0.028460113
FALSE,Cache County,9/1/97,Hide,Hide,9,1997,42146,42146,43218,43218,1,1072,1072,0.02480448,0.02480448
FALSE,Cache County,9/1/98,Hide,Hide,9,1998,43644,43644,45045,45045,1,1401,1401,0.031102231,0.031102231
FALSE,Cache County,9/1/99,Hide,Hide,9,1999,44039,44039,45245,45245,1,1206,1206,0.026654879,0.026654879
FALSE,Cache County,9/1/00,Hide,Hide,9,2000,47381,47381,48760,48760,1,1379,1379,0.028281378,0.028281378
FALSE,Cache County,9/1/01,Hide,Hide,9,2001,49201,49201,50994,50994,1,1793,1793,0.035160999,0.035160999
FALSE,Cache County,9/1/02,Hide,Hide,9,2002,50508,50508,52825,52825,1,2317,2317,0.043861808,0.043861808
FALSE,Cache County,9/1/03,Hide,Hide,9,2003,52567,52567,54633,54633,1,2066,2066,0.037815972,0.037815972
FALSE,Cache County,9/1/04,Hide,Hide,9,2004,54202,54202,56262,56262,1,2060,2060,0.036614411,0.036614411
FALSE,Cache County,9/1/05,Hide,Hide,9,2005,55497,55497,57345,57345,1,1848,1848,0.032226001,0.032226001
FALSE,Cache County,9/1/06,Hide,Hide,9,2006,57371,57371,58624,58624,1,1253,1253,0.021373499,0.021373499
FALSE,Cache County,9/1/07,Hide,Hide,9,2007,59547,59547,60903,60903,1,1356,1356,0.022264913,0.022264913
FALSE,Cache County,9/1/08,Hide,Hide,9,2008,59671,59671,61531,61531,1,1860,1860,0.030228665,0.030228665
FALSE,Cache County,9/1/09,Hide,Hide,9,2009,58651,58651,62087,62087,1,3436,3436,0.055341698,0.055341698
FALSE,Cache County,9/1/10,Hide,Hide,9,2010,53985,53985,57492,57492,1,3507,3507,0.060999791,0.060999791
FALSE,Cache County,9/1/11,Hide,Hide,9,2011,53171,53171,56023,56023,1,2852,2852,0.050907663,0.050907663
FALSE,Cache County,9/1/12,Hide,Hide,9,2012,54490,54490,56950,56950,1,2460,2460,0.043195786,0.043195786
FALSE,Cache County,9/1/13,Hide,Hide,9,2013,55821,55821,58015,58015,1,2194,2194,0.037817806,0.037817806
FALSE,Cache County,9/1/14,Hide,Hide,9,2014,57140,57140,59048,59048,1,1908,1908,0.032312695,0.032312695
FALSE,Cache County,9/1/15,Hide,Hide,9,2015,58349,58349,60233,60233,1,1884,1884,0.031278535,0.031278535
FALSE,Cache County,9/1/16,Hide,Hide,9,2016,59665,59665,61475,61475,1,1810,1810,0.029442863,0.029442863
FALSE,Cache County,9/1/17,Hide,Hide,9,2017,61218,61218,62927,62927,1,1709,1709,0.027158453,0.027158453
FALSE,Cache County,9/1/18,Hide,Hide,9,2018,61824,61824,63491,63491,1,1667,1667,0.02625569,0.02625569
FALSE,Cache County,9/1/19,Hide,Hide,9,2019,62895,62895,64217,64217,1,1322,1322,0.020586449,0.020586449
FALSE,Carbon County,9/1/93,Hide,Hide,9,1993,8525,8525,9148,9148,1,623,623,0.068102317,0.068102317
FALSE,Carbon County,9/1/94,Hide,Hide,9,1994,8617,8617,9306,9306,1,689,689,0.074038255,0.074038255
FALSE,Carbon County,9/1/95,Hide,Hide,9,1995,8515,8515,9097,9097,1,582,582,0.063977135,0.063977135
FALSE,Carbon County,9/1/96,Hide,Hide,9,1996,8952,8952,9504,9504,1,552,552,0.058080808,0.058080808
FALSE,Carbon County,9/1/97,Hide,Hide,9,1997,9242,9242,9732,9732,1,490,490,0.050349363,0.050349363
FALSE,Carbon County,9/1/98,Hide,Hide,9,1998,9267,9267,9922,9922,1,655,655,0.066014916,0.066014916
FALSE,Carbon County,9/1/99,Hide,Hide,9,1999,9200,9200,9813,9813,1,613,613,0.062468154,0.062468154
FALSE,Carbon County,9/1/00,Hide,Hide,9,2000,8508,8508,9060,9060,1,552,552,0.060927152,0.060927152
FALSE,Carbon County,9/1/01,Hide,Hide,9,2001,8635,8635,9186,9186,1,551,551,0.059982582,0.059982582
FALSE,Carbon County,9/1/02,Hide,Hide,9,2002,8779,8779,9481,9481,1,702,702,0.074042822,0.074042822
FALSE,Carbon County,9/1/03,Hide,Hide,9,2003,8586,8586,9304,9304,1,718,718,0.077171109,0.077171109
FALSE,Carbon County,9/1/04,Hide,Hide,9,2004,8721,8721,9304,9304,1,583,583,0.062661221,0.062661221
FALSE,Carbon County,9/1/05,Hide,Hide,9,2005,9203,9203,9644,9644,1,441,441,0.045727914,0.045727914
FALSE,Carbon County,9/1/06,Hide,Hide,9,2006,9597,9597,9900,9900,1,303,303,0.030606061,0.030606061
FALSE,Carbon County,9/1/07,Hide,Hide,9,2007,9172,9172,9551,9551,1,379,379,0.039681709,0.039681709
FALSE,Carbon County,9/1/08,Hide,Hide,9,2008,9823,9823,10280,10280,1,457,457,0.044455253,0.044455253
FALSE,Carbon County,9/1/09,Hide,Hide,9,2009,9510,9510,10412,10412,1,902,902,0.086630811,0.086630811
FALSE,Carbon County,9/1/10,Hide,Hide,9,2010,9064,9064,9905,9905,1,841,841,0.084906613,0.084906613
FALSE,Carbon County,9/1/11,Hide,Hide,9,2011,8818,8818,9512,9512,1,694,694,0.072960471,0.072960471
FALSE,Carbon County,9/1/12,Hide,Hide,9,2012,8484,8484,9125,9125,1,641,641,0.070246575,0.070246575
FALSE,Carbon County,9/1/13,Hide,Hide,9,2013,8360,8360,8897,8897,1,537,537,0.060357424,0.060357424
FALSE,Carbon County,9/1/14,Hide,Hide,9,2014,8255,8255,8688,8688,1,433,433,0.049838858,0.049838858
FALSE,Carbon County,9/1/15,Hide,Hide,9,2015,8155,8155,8678,8678,1,523,523,0.060267343,0.060267343
FALSE,Carbon County,9/1/16,Hide,Hide,9,2016,7752,7752,8224,8224,1,472,472,0.057392996,0.057392996
FALSE,Carbon County,9/1/17,Hide,Hide,9,2017,7886,7886,8296,8296,1,410,410,0.049421408,0.049421408
FALSE,Carbon County,9/1/18,Hide,Hide,9,2018,8127,8127,8486,8486,1,359,359,0.042304973,0.042304973
FALSE,Carbon County,9/1/19,Hide,Hide,9,2019,8251,8251,8550,8550,1,299,299,0.03497076,0.03497076
FALSE,Daggett County,9/1/93,Hide,Hide,9,1993,376,376,390,390,1,14,14,0.035897436,0.035897436
FALSE,Daggett County,9/1/94,Hide,Hide,9,1994,448,448,480,480,1,32,32,0.066666667,0.066666667
FALSE,Daggett County,9/1/95,Hide,Hide,9,1995,424,424,442,442,1,18,18,0.040723982,0.040723982
FALSE,Daggett County,9/1/96,Hide,Hide,9,1996,392,392,412,412,1,20,20,0.048543689,0.048543689
FALSE,Daggett County,9/1/97,Hide,Hide,9,1997,386,386,403,403,1,17,17,0.042183623,0.042183623
FALSE,Daggett County,9/1/98,Hide,Hide,9,1998,401,401,417,417,1,16,16,0.038369305,0.038369305
FALSE,Daggett County,9/1/99,Hide,Hide,9,1999,446,446,460,460,1,14,14,0.030434783,0.030434783
FALSE,Daggett County,9/1/00,Hide,Hide,9,2000,455,455,474,474,1,19,19,0.040084388,0.040084388
FALSE,Daggett County,9/1/01,Hide,Hide,9,2001,478,478,501,501,1,23,23,0.045908184,0.045908184
FALSE,Daggett County,9/1/02,Hide,Hide,9,2002,477,477,503,503,1,26,26,0.051689861,0.051689861
FALSE,Daggett County,9/1/03,Hide,Hide,9,2003,458,458,484,484,1,26,26,0.053719008,0.053719008
FALSE,Daggett County,9/1/04,Hide,Hide,9,2004,448,448,475,475,1,27,27,0.056842105,0.056842105
FALSE,Daggett County,9/1/05,Hide,Hide,9,2005,491,491,516,516,1,25,25,0.048449612,0.048449612
FALSE,Daggett County,9/1/06,Hide,Hide,9,2006,482,482,504,504,1,22,22,0.043650794,0.043650794
FALSE,Daggett County,9/1/07,Hide,Hide,9,2007,498,498,517,517,1,19,19,0.036750484,0.036750484
FALSE,Daggett County,9/1/08,Hide,Hide,9,2008,425,425,444,444,1,19,19,0.042792793,0.042792793
FALSE,Daggett County,9/1/09,Hide,Hide,9,2009,471,471,500,500,1,29,29,0.058,0.058
FALSE,Daggett County,9/1/10,Hide,Hide,9,2010,469,469,506,506,1,37,37,0.07312253,0.07312253
FALSE,Daggett County,9/1/11,Hide,Hide,9,2011,441,441,468,468,1,27,27,0.057692308,0.057692308
FALSE,Daggett County,9/1/12,Hide,Hide,9,2012,419,419,441,441,1,22,22,0.049886621,0.049886621
FALSE,Daggett County,9/1/13,Hide,Hide,9,2013,399,399,419,419,1,20,20,0.047732697,0.047732697
FALSE,Daggett County,9/1/14,Hide,Hide,9,2014,412,412,430,430,1,18,18,0.041860465,0.041860465
FALSE,Daggett County,9/1/15,Hide,Hide,9,2015,443,443,463,463,1,20,20,0.043196544,0.043196544
FALSE,Daggett County,9/1/16,Hide,Hide,9,2016,431,431,454,454,1,23,23,0.050660793,0.050660793
FALSE,Daggett County,9/1/17,Hide,Hide,9,2017,398,398,424,424,1,26,26,0.061320755,0.061320755
FALSE,Daggett County,9/1/18,Hide,Hide,9,2018,381,381,399,399,1,18,18,0.045112782,0.045112782
FALSE,Daggett County,9/1/19,Hide,Hide,9,2019,381,381,396,396,1,15,15,0.037878788,0.037878788
FALSE,Davis County,9/1/93,Hide,Hide,9,1993,98026,98026,101623,101623,1,3597,3597,0.035395531,0.035395531
FALSE,Davis County,9/1/94,Hide,Hide,9,1994,102789,102789,106653,106653,1,3864,3864,0.036229642,0.036229642
FALSE,Davis County,9/1/95,Hide,Hide,9,1995,103108,103108,106525,106525,1,3417,3417,0.032076977,0.032076977
FALSE,Davis County,9/1/96,Hide,Hide,9,1996,108697,108697,112133,112133,1,3436,3436,0.030642184,0.030642184
FALSE,Davis County,9/1/97,Hide,Hide,9,1997,113106,113106,116653,116653,1,3547,3547,0.030406419,0.030406419
FALSE,Davis County,9/1/98,Hide,Hide,9,1998,117082,117082,121140,121140,1,4058,4058,0.033498432,0.033498432
FALSE,Davis County,9/1/99,Hide,Hide,9,1999,121071,121071,125121,125121,1,4050,4050,0.032368667,0.032368667
FALSE,Davis County,9/1/00,Hide,Hide,9,2000,116066,116066,119956,119956,1,3890,3890,0.032428557,0.032428557
FALSE,Davis County,9/1/01,Hide,Hide,9,2001,116782,116782,121909,121909,1,5127,5127,0.04205596,0.04205596
FALSE,Davis County,9/1/02,Hide,Hide,9,2002,119335,119335,125851,125851,1,6516,6516,0.051775512,0.051775512
FALSE,Davis County,9/1/03,Hide,Hide,9,2003,122446,122446,128976,128976,1,6530,6530,0.050629574,0.050629574
FALSE,Davis County,9/1/04,Hide,Hide,9,2004,127021,127021,133015,133015,1,5994,5994,0.045062587,0.045062587
FALSE,Davis County,9/1/05,Hide,Hide,9,2005,131680,131680,136944,136944,1,5264,5264,0.03843907,0.03843907
FALSE,Davis County,9/1/06,Hide,Hide,9,2006,137512,137512,141341,141341,1,3829,3829,0.027090512,0.027090512
FALSE,Davis County,9/1/07,Hide,Hide,9,2007,141620,141620,145549,145549,1,3929,3929,0.026994346,0.026994346
FALSE,Davis County,9/1/08,Hide,Hide,9,2008,140553,140553,145839,145839,1,5286,5286,0.036245449,0.036245449
FALSE,Davis County,9/1/09,Hide,Hide,9,2009,134320,134320,144380,144380,1,10060,10060,0.069677241,0.069677241
FALSE,Davis County,9/1/10,Hide,Hide,9,2010,136709,136709,147002,147002,1,10293,10293,0.070019456,0.070019456
FALSE,Davis County,9/1/11,Hide,Hide,9,2011,138530,138530,147050,147050,1,8520,8520,0.057939476,0.057939476
FALSE,Davis County,9/1/12,Hide,Hide,9,2012,142232,142232,149181,149181,1,6949,6949,0.046580999,0.046580999
FALSE,Davis County,9/1/13,Hide,Hide,9,2013,147191,147191,153439,153439,1,6248,6248,0.040719765,0.040719765
FALSE,Davis County,9/1/14,Hide,Hide,9,2014,150841,150841,156388,156388,1,5547,5547,0.035469473,0.035469473
FALSE,Davis County,9/1/15,Hide,Hide,9,2015,155228,155228,160655,160655,1,5427,5427,0.033780461,0.033780461
FALSE,Davis County,9/1/16,Hide,Hide,9,2016,160726,160726,165809,165809,1,5083,5083,0.030655755,0.030655755
FALSE,Davis County,9/1/17,Hide,Hide,9,2017,163946,163946,169163,169163,1,5217,5217,0.030840077,0.030840077
FALSE,Davis County,9/1/18,Hide,Hide,9,2018,165235,165235,170061,170061,1,4826,4826,0.028378053,0.028378053
FALSE,Davis County,9/1/19,Hide,Hide,9,2019,170845,170845,174801,174801,1,3956,3956,0.022631449,0.022631449
FALSE,Duchesne County,9/1/93,Hide,Hide,9,1993,5412,5412,5893,5893,1,481,481,0.081622264,0.081622264
FALSE,Duchesne County,9/1/94,Hide,Hide,9,1994,5399,5399,5998,5998,1,599,599,0.099866622,0.099866622
FALSE,Duchesne County,9/1/95,Hide,Hide,9,1995,5154,5154,5688,5688,1,534,534,0.093881857,0.093881857
FALSE,Duchesne County,9/1/96,Hide,Hide,9,1996,5352,5352,5813,5813,1,461,461,0.079305006,0.079305006
FALSE,Duchesne County,9/1/97,Hide,Hide,9,1997,5585,5585,5963,5963,1,378,378,0.063390911,0.063390911
FALSE,Duchesne County,9/1/98,Hide,Hide,9,1998,5636,5636,6124,6124,1,488,488,0.079686479,0.079686479
FALSE,Duchesne County,9/1/99,Hide,Hide,9,1999,5296,5296,5780,5780,1,484,484,0.083737024,0.083737024
FALSE,Duchesne County,9/1/00,Hide,Hide,9,2000,5936,5936,6235,6235,1,299,299,0.047955092,0.047955092
FALSE,Duchesne County,9/1/01,Hide,Hide,9,2001,6673,6673,7039,7039,1,366,366,0.051996022,0.051996022
FALSE,Duchesne County,9/1/02,Hide,Hide,9,2002,6489,6489,6984,6984,1,495,495,0.070876289,0.070876289
FALSE,Duchesne County,9/1/03,Hide,Hide,9,2003,6429,6429,6880,6880,1,451,451,0.065552326,0.065552326
FALSE,Duchesne County,9/1/04,Hide,Hide,9,2004,6861,6861,7246,7246,1,385,385,0.053132763,0.053132763
FALSE,Duchesne County,9/1/05,Hide,Hide,9,2005,7538,7538,7865,7865,1,327,327,0.041576605,0.041576605
FALSE,Duchesne County,9/1/06,Hide,Hide,9,2006,8540,8540,8763,8763,1,223,223,0.025447906,0.025447906
FALSE,Duchesne County,9/1/07,Hide,Hide,9,2007,8984,8984,9207,9207,1,223,223,0.024220702,0.024220702
FALSE,Duchesne County,9/1/08,Hide,Hide,9,2008,10268,10268,10547,10547,1,279,279,0.02645302,0.02645302
FALSE,Duchesne County,9/1/09,Hide,Hide,9,2009,9134,9134,10147,10147,1,1013,1013,0.099832463,0.099832463
FALSE,Duchesne County,9/1/10,Hide,Hide,9,2010,7383,7383,8137,8137,1,754,754,0.092663144,0.092663144
FALSE,Duchesne County,9/1/11,Hide,Hide,9,2011,7989,7989,8526,8526,1,537,537,0.062983814,0.062983814
FALSE,Duchesne County,9/1/12,Hide,Hide,9,2012,8846,8846,9269,9269,1,423,423,0.045635991,0.045635991
FALSE,Duchesne County,9/1/13,Hide,Hide,9,2013,8933,8933,9327,9327,1,394,394,0.042242951,0.042242951
FALSE,Duchesne County,9/1/14,Hide,Hide,9,2014,9230,9230,9590,9590,1,360,360,0.037539103,0.037539103
FALSE,Duchesne County,9/1/15,Hide,Hide,9,2015,7777,7777,8511,8511,1,734,734,0.086241335,0.086241335
FALSE,Duchesne County,9/1/16,Hide,Hide,9,2016,7371,7371,8021,8021,1,650,650,0.081037277,0.081037277
FALSE,Duchesne County,9/1/17,Hide,Hide,9,2017,7544,7544,7956,7956,1,412,412,0.051784816,0.051784816
FALSE,Duchesne County,9/1/18,Hide,Hide,9,2018,7312,7312,7654,7654,1,342,342,0.044682519,0.044682519
FALSE,Duchesne County,9/1/19,Hide,Hide,9,2019,7499,7499,7791,7791,1,292,292,0.037479143,0.037479143
FALSE,Emery County,9/1/93,Hide,Hide,9,1993,3862,3862,4191,4191,1,329,329,0.078501551,0.078501551
FALSE,Emery County,9/1/94,Hide,Hide,9,1994,3834,3834,4164,4164,1,330,330,0.07925072,0.07925072
FALSE,Emery County,9/1/95,Hide,Hide,9,1995,3891,3891,4223,4223,1,332,332,0.078617097,0.078617097
FALSE,Emery County,9/1/96,Hide,Hide,9,1996,3848,3848,4154,4154,1,306,306,0.073663938,0.073663938
FALSE,Emery County,9/1/97,Hide,Hide,9,1997,3930,3930,4183,4183,1,253,253,0.060482907,0.060482907
FALSE,Emery County,9/1/98,Hide,Hide,9,1998,3941,3941,4274,4274,1,333,333,0.077912962,0.077912962
FALSE,Emery County,9/1/99,Hide,Hide,9,1999,3722,3722,3980,3980,1,258,258,0.064824121,0.064824121
FALSE,Emery County,9/1/00,Hide,Hide,9,2000,4464,4464,4710,4710,1,246,246,0.052229299,0.052229299
FALSE,Emery County,9/1/01,Hide,Hide,9,2001,4536,4536,4868,4868,1,332,332,0.068200493,0.068200493
FALSE,Emery County,9/1/02,Hide,Hide,9,2002,4476,4476,4832,4832,1,356,356,0.073675497,0.073675497
FALSE,Emery County,9/1/03,Hide,Hide,9,2003,4479,4479,4867,4867,1,388,388,0.079720567,0.079720567
FALSE,Emery County,9/1/04,Hide,Hide,9,2004,4777,4777,5103,5103,1,326,326,0.06388399,0.06388399
FALSE,Emery County,9/1/05,Hide,Hide,9,2005,4963,4963,5209,5209,1,246,246,0.047225955,0.047225955
FALSE,Emery County,9/1/06,Hide,Hide,9,2006,5095,5095,5262,5262,1,167,167,0.031736982,0.031736982
FALSE,Emery County,9/1/07,Hide,Hide,9,2007,4928,4928,5104,5104,1,176,176,0.034482759,0.034482759
FALSE,Emery County,9/1/08,Hide,Hide,9,2008,4779,4779,4978,4978,1,199,199,0.039975894,0.039975894
FALSE,Emery County,9/1/09,Hide,Hide,9,2009,4926,4926,5350,5350,1,424,424,0.079252336,0.079252336
FALSE,Emery County,9/1/10,Hide,Hide,9,2010,4853,4853,5234,5234,1,381,381,0.072793275,0.072793275
FALSE,Emery County,9/1/11,Hide,Hide,9,2011,4622,4622,4989,4989,1,367,367,0.073561836,0.073561836
FALSE,Emery County,9/1/12,Hide,Hide,9,2012,4401,4401,4741,4741,1,340,340,0.071714828,0.071714828
FALSE,Emery County,9/1/13,Hide,Hide,9,2013,4403,4403,4672,4672,1,269,269,0.057577055,0.057577055
FALSE,Emery County,9/1/14,Hide,Hide,9,2014,4274,4274,4514,4514,1,240,240,0.053167922,0.053167922
FALSE,Emery County,9/1/15,Hide,Hide,9,2015,4103,4103,4398,4398,1,295,295,0.067075944,0.067075944
FALSE,Emery County,9/1/16,Hide,Hide,9,2016,3965,3965,4208,4208,1,243,243,0.057747148,0.057747148
FALSE,Emery County,9/1/17,Hide,Hide,9,2017,4001,4001,4209,4209,1,208,208,0.049417914,0.049417914
FALSE,Emery County,9/1/18,Hide,Hide,9,2018,4151,4151,4348,4348,1,197,197,0.045308188,0.045308188
FALSE,Emery County,9/1/19,Hide,Hide,9,2019,4114,4114,4277,4277,1,163,163,0.038110825,0.038110825
FALSE,Garfield County,9/1/92,Hide,Hide,9,1992,1984,1984,2316,2316,1,332,332,0.143350604,0.143350604
FALSE,Garfield County,9/1/93,Hide,Hide,9,1993,2138,2138,2324,2324,1,186,186,0.080034423,0.080034423
FALSE,Garfield County,9/1/94,Hide,Hide,9,1994,2280,2280,2566,2566,1,286,286,0.111457521,0.111457521
FALSE,Garfield County,9/1/95,Hide,Hide,9,1995,2361,2361,2679,2679,1,318,318,0.118701008,0.118701008
FALSE,Garfield County,9/1/96,Hide,Hide,9,1996,2417,2417,2692,2692,1,275,275,0.102154532,0.102154532
FALSE,Garfield County,9/1/97,Hide,Hide,9,1997,2532,2532,2751,2751,1,219,219,0.079607415,0.079607415
FALSE,Garfield County,9/1/98,Hide,Hide,9,1998,2476,2476,2705,2705,1,229,229,0.084658041,0.084658041
FALSE,Garfield County,9/1/99,Hide,Hide,9,1999,2724,2724,2932,2932,1,208,208,0.070941337,0.070941337
FALSE,Garfield County,9/1/00,Hide,Hide,9,2000,2284,2284,2452,2452,1,168,168,0.068515498,0.068515498
FALSE,Garfield County,9/1/01,Hide,Hide,9,2001,2424,2424,2625,2625,1,201,201,0.076571429,0.076571429
FALSE,Garfield County,9/1/02,Hide,Hide,9,2002,2336,2336,2585,2585,1,249,249,0.096324952,0.096324952
FALSE,Garfield County,9/1/03,Hide,Hide,9,2003,2314,2314,2539,2539,1,225,225,0.088617566,0.088617566
FALSE,Garfield County,9/1/04,Hide,Hide,9,2004,2436,2436,2648,2648,1,212,212,0.080060423,0.080060423
FALSE,Garfield County,9/1/05,Hide,Hide,9,2005,2535,2535,2727,2727,1,192,192,0.070407041,0.070407041
FALSE,Garfield County,9/1/06,Hide,Hide,9,2006,2540,2540,2665,2665,1,125,125,0.046904315,0.046904315
FALSE,Garfield County,9/1/07,Hide,Hide,9,2007,2558,2558,2690,2690,1,132,132,0.049070632,0.049070632
FALSE,Garfield County,9/1/08,Hide,Hide,9,2008,2713,2713,2893,2893,1,180,180,0.06221915,0.06221915
FALSE,Garfield County,9/1/09,Hide,Hide,9,2009,2554,2554,2868,2868,1,314,314,0.109483961,0.109483961
FALSE,Garfield County,9/1/10,Hide,Hide,9,2010,2766,2766,3080,3080,1,314,314,0.101948052,0.101948052
FALSE,Garfield County,9/1/11,Hide,Hide,9,2011,2657,2657,2983,2983,1,326,326,0.109285954,0.109285954
FALSE,Garfield County,9/1/12,Hide,Hide,9,2012,2606,2606,2882,2882,1,276,276,0.095766829,0.095766829
FALSE,Garfield County,9/1/13,Hide,Hide,9,2013,2500,2500,2765,2765,1,265,265,0.095840868,0.095840868
FALSE,Garfield County,9/1/14,Hide,Hide,9,2014,2458,2458,2696,2696,1,238,238,0.088278932,0.088278932
FALSE,Garfield County,9/1/15,Hide,Hide,9,2015,2466,2466,2711,2711,1,245,245,0.090372556,0.090372556
FALSE,Garfield County,9/1/16,Hide,Hide,9,2016,2568,2568,2797,2797,1,229,229,0.081873436,0.081873436
FALSE,Garfield County,9/1/17,Hide,Hide,9,2017,2703,2703,2919,2919,1,216,216,0.073997945,0.073997945
FALSE,Garfield County,9/1/18,Hide,Hide,9,2018,2548,2548,2744,2744,1,196,196,0.071428571,0.071428571
FALSE,Garfield County,9/1/19,Hide,Hide,9,2019,2612,2612,2768,2768,1,156,156,0.056358382,0.056358382
FALSE,Grand County,9/1/92,Hide,Hide,9,1992,3838,3838,4154,4154,1,316,316,0.076071257,0.076071257
FALSE,Grand County,9/1/93,Hide,Hide,9,1993,4477,4477,4783,4783,1,306,306,0.063976584,0.063976584
FALSE,Grand County,9/1/94,Hide,Hide,9,1994,4564,4564,4895,4895,1,331,331,0.06762002,0.06762002
FALSE,Grand County,9/1/95,Hide,Hide,9,1995,4687,4687,5011,5011,1,324,324,0.064657753,0.064657753
FALSE,Grand County,9/1/96,Hide,Hide,9,1996,4640,4640,4997,4997,1,357,357,0.071442866,0.071442866
FALSE,Grand County,9/1/97,Hide,Hide,9,1997,4938,4938,5255,5255,1,317,317,0.060323501,0.060323501
FALSE,Grand County,9/1/98,Hide,Hide,9,1998,4930,4930,5309,5309,1,379,379,0.071388209,0.071388209
FALSE,Grand County,9/1/99,Hide,Hide,9,1999,5199,5199,5520,5520,1,321,321,0.058152174,0.058152174
FALSE,Grand County,9/1/00,Hide,Hide,9,2000,4323,4323,4628,4628,1,305,305,0.065903198,0.065903198
FALSE,Grand County,9/1/01,Hide,Hide,9,2001,4435,4435,4765,4765,1,330,330,0.069254984,0.069254984
FALSE,Grand County,9/1/02,Hide,Hide,9,2002,4401,4401,4770,4770,1,369,369,0.077358491,0.077358491
FALSE,Grand County,9/1/03,Hide,Hide,9,2003,4503,4503,4867,4867,1,364,364,0.074789398,0.074789398
FALSE,Grand County,9/1/04,Hide,Hide,9,2004,4482,4482,4834,4834,1,352,352,0.072817542,0.072817542
FALSE,Grand County,9/1/05,Hide,Hide,9,2005,4786,4786,5098,5098,1,312,312,0.061200471,0.061200471
FALSE,Grand County,9/1/06,Hide,Hide,9,2006,4819,4819,5044,5044,1,225,225,0.044607454,0.044607454
FALSE,Grand County,9/1/07,Hide,Hide,9,2007,4884,4884,5139,5139,1,255,255,0.049620549,0.049620549
FALSE,Grand County,9/1/08,Hide,Hide,9,2008,4999,4999,5324,5324,1,325,325,0.061044328,0.061044328
FALSE,Grand County,9/1/09,Hide,Hide,9,2009,4900,4900,5456,5456,1,556,556,0.101906158,0.101906158
FALSE,Grand County,9/1/10,Hide,Hide,9,2010,4729,4729,5304,5304,1,575,575,0.108408748,0.108408748
FALSE,Grand County,9/1/11,Hide,Hide,9,2011,4820,4820,5334,5334,1,514,514,0.096362955,0.096362955
FALSE,Grand County,9/1/12,Hide,Hide,9,2012,4954,4954,5412,5412,1,458,458,0.084626755,0.084626755
FALSE,Grand County,9/1/13,Hide,Hide,9,2013,5062,5062,5487,5487,1,425,425,0.077455805,0.077455805
FALSE,Grand County,9/1/14,Hide,Hide,9,2014,5196,5196,5535,5535,1,339,339,0.061246612,0.061246612
FALSE,Grand County,9/1/15,Hide,Hide,9,2015,5279,5279,5621,5621,1,342,342,0.060843266,0.060843266
FALSE,Grand County,9/1/16,Hide,Hide,9,2016,5409,5409,5736,5736,1,327,327,0.057008368,0.057008368
FALSE,Grand County,9/1/17,Hide,Hide,9,2017,5671,5671,5981,5981,1,310,310,0.051830798,0.051830798
FALSE,Grand County,9/1/18,Hide,Hide,9,2018,5758,5758,6027,6027,1,269,269,0.044632487,0.044632487
FALSE,Grand County,9/1/19,Hide,Hide,9,2019,6044,6044,6266,6266,1,222,222,0.035429301,0.035429301
FALSE,Iron County,9/1/92,Hide,Hide,9,1992,10110,10110,10465,10465,1,355,355,0.033922599,0.033922599
FALSE,Iron County,9/1/93,Hide,Hide,9,1993,10942,10942,11372,11372,1,430,430,0.03781217,0.03781217
FALSE,Iron County,9/1/94,Hide,Hide,9,1994,12032,12032,12490,12490,1,458,458,0.036669335,0.036669335
FALSE,Iron County,9/1/95,Hide,Hide,9,1995,12656,12656,13115,13115,1,459,459,0.034998094,0.034998094
FALSE,Iron County,9/1/96,Hide,Hide,9,1996,13103,13103,13575,13575,1,472,472,0.034769797,0.034769797
FALSE,Iron County,9/1/97,Hide,Hide,9,1997,13796,13796,14297,14297,1,501,501,0.035042317,0.035042317
FALSE,Iron County,9/1/98,Hide,Hide,9,1998,14519,14519,15097,15097,1,578,578,0.038285752,0.038285752
FALSE,Iron County,9/1/99,Hide,Hide,9,1999,14697,14697,15220,15220,1,523,523,0.034362681,0.034362681
FALSE,Iron County,9/1/00,Hide,Hide,9,2000,16487,16487,17064,17064,1,577,577,0.033813877,0.033813877
FALSE,Iron County,9/1/01,Hide,Hide,9,2001,16781,16781,17603,17603,1,822,822,0.046696586,0.046696586
FALSE,Iron County,9/1/02,Hide,Hide,9,2002,16770,16770,17729,17729,1,959,959,0.054092165,0.054092165
FALSE,Iron County,9/1/03,Hide,Hide,9,2003,17105,17105,18027,18027,1,922,922,0.051145504,0.051145504
FALSE,Iron County,9/1/04,Hide,Hide,9,2004,18073,18073,18928,18928,1,855,855,0.045171175,0.045171175
FALSE,Iron County,9/1/05,Hide,Hide,9,2005,19342,19342,20099,20099,1,757,757,0.037663565,0.037663565
FALSE,Iron County,9/1/06,Hide,Hide,9,2006,20662,20662,21264,21264,1,602,602,0.02831076,0.02831076
FALSE,Iron County,9/1/07,Hide,Hide,9,2007,20140,20140,20811,20811,1,671,671,0.032242564,0.032242564
FALSE,Iron County,9/1/08,Hide,Hide,9,2008,19788,19788,20812,20812,1,1024,1024,0.049202383,0.049202383
FALSE,Iron County,9/1/09,Hide,Hide,9,2009,19092,19092,20971,20971,1,1879,1879,0.089599924,0.089599924
FALSE,Iron County,9/1/10,Hide,Hide,9,2010,18435,18435,20378,20378,1,1943,1943,0.095347924,0.095347924
FALSE,Iron County,9/1/11,Hide,Hide,9,2011,18211,18211,19784,19784,1,1573,1573,0.079508694,0.079508694
FALSE,Iron County,9/1/12,Hide,Hide,9,2012,18207,18207,19494,19494,1,1287,1287,0.066020314,0.066020314
FALSE,Iron County,9/1/13,Hide,Hide,9,2013,18277,18277,19300,19300,1,1023,1023,0.053005181,0.053005181
FALSE,Iron County,9/1/14,Hide,Hide,9,2014,19061,19061,19961,19961,1,900,900,0.045087921,0.045087921
FALSE,Iron County,9/1/15,Hide,Hide,9,2015,19521,19521,20424,20424,1,903,903,0.044212691,0.044212691
FALSE,Iron County,9/1/16,Hide,Hide,9,2016,20816,20816,21772,21772,1,956,956,0.043909609,0.043909609
FALSE,Iron County,9/1/17,Hide,Hide,9,2017,21513,21513,22408,22408,1,895,895,0.039941092,0.039941092
FALSE,Iron County,9/1/18,Hide,Hide,9,2018,22251,22251,23045,23045,1,794,794,0.034454328,0.034454328
FALSE,Iron County,9/1/19,Hide,Hide,9,2019,23635,23635,24304,24304,1,669,669,0.027526333,0.027526333
FALSE,Juab County,9/1/92,Hide,Hide,9,1992,2948,2948,3173,3173,1,225,225,0.07091081,0.07091081
FALSE,Juab County,9/1/93,Hide,Hide,9,1993,3145,3145,3339,3339,1,194,194,0.058101228,0.058101228
FALSE,Juab County,9/1/94,Hide,Hide,9,1994,3167,3167,3335,3335,1,168,168,0.050374813,0.050374813
FALSE,Juab County,9/1/95,Hide,Hide,9,1995,3186,3186,3343,3343,1,157,157,0.046963805,0.046963805
FALSE,Juab County,9/1/96,Hide,Hide,9,1996,3276,3276,3412,3412,1,136,136,0.03985932,0.03985932
FALSE,Juab County,9/1/97,Hide,Hide,9,1997,3313,3313,3447,3447,1,134,134,0.038874384,0.038874384
FALSE,Juab County,9/1/98,Hide,Hide,9,1998,3523,3523,3689,3689,1,166,166,0.044998645,0.044998645
FALSE,Juab County,9/1/99,Hide,Hide,9,1999,3428,3428,3590,3590,1,162,162,0.045125348,0.045125348
FALSE,Juab County,9/1/00,Hide,Hide,9,2000,3639,3639,3776,3776,1,137,137,0.03628178,0.03628178
FALSE,Juab County,9/1/01,Hide,Hide,9,2001,3569,3569,3767,3767,1,198,198,0.05256172,0.05256172
FALSE,Juab County,9/1/02,Hide,Hide,9,2002,3420,3420,3707,3707,1,287,287,0.077421095,0.077421095
FALSE,Juab County,9/1/03,Hide,Hide,9,2003,3423,3423,3676,3676,1,253,253,0.06882481,0.06882481
FALSE,Juab County,9/1/04,Hide,Hide,9,2004,3600,3600,3826,3826,1,226,226,0.059069524,0.059069524
FALSE,Juab County,9/1/05,Hide,Hide,9,2005,3761,3761,3944,3944,1,183,183,0.046399594,0.046399594
FALSE,Juab County,9/1/06,Hide,Hide,9,2006,3925,3925,4069,4069,1,144,144,0.035389531,0.035389531
FALSE,Juab County,9/1/07,Hide,Hide,9,2007,4009,4009,4142,4142,1,133,133,0.032110092,0.032110092
FALSE,Juab County,9/1/08,Hide,Hide,9,2008,3721,3721,3961,3961,1,240,240,0.06059076,0.06059076
FALSE,Juab County,9/1/09,Hide,Hide,9,2009,3536,3536,3937,3937,1,401,401,0.101854204,0.101854204
FALSE,Juab County,9/1/10,Hide,Hide,9,2010,4209,4209,4644,4644,1,435,435,0.093669251,0.093669251
FALSE,Juab County,9/1/11,Hide,Hide,9,2011,4257,4257,4621,4621,1,364,364,0.078770829,0.078770829
FALSE,Juab County,9/1/12,Hide,Hide,9,2012,4396,4396,4667,4667,1,271,271,0.058067281,0.058067281
FALSE,Juab County,9/1/13,Hide,Hide,9,2013,4506,4506,4733,4733,1,227,227,0.047961124,0.047961124
FALSE,Juab County,9/1/14,Hide,Hide,9,2014,4632,4632,4825,4825,1,193,193,0.04,0.04
FALSE,Juab County,9/1/15,Hide,Hide,9,2015,4782,4782,4980,4980,1,198,198,0.039759036,0.039759036
FALSE,Juab County,9/1/16,Hide,Hide,9,2016,5082,5082,5263,5263,1,181,181,0.034391032,0.034391032
FALSE,Juab County,9/1/17,Hide,Hide,9,2017,5282,5282,5465,5465,1,183,183,0.033485819,0.033485819
FALSE,Juab County,9/1/18,Hide,Hide,9,2018,5419,5419,5580,5580,1,161,161,0.028853047,0.028853047
FALSE,Juab County,9/1/19,Hide,Hide,9,2019,5627,5627,5761,5761,1,134,134,0.023259851,0.023259851
FALSE,Kane County,9/1/92,Hide,Hide,9,1992,2813,2813,3030,3030,1,217,217,0.071617162,0.071617162
FALSE,Kane County,9/1/93,Hide,Hide,9,1993,2297,2297,2440,2440,1,143,143,0.058606557,0.058606557
FALSE,Kane County,9/1/94,Hide,Hide,9,1994,2459,2459,2746,2746,1,287,287,0.104515659,0.104515659
FALSE,Kane County,9/1/95,Hide,Hide,9,1995,2467,2467,2680,2680,1,213,213,0.079477612,0.079477612
FALSE,Kane County,9/1/96,Hide,Hide,9,1996,2407,2407,2619,2619,1,212,212,0.080946926,0.080946926
FALSE,Kane County,9/1/97,Hide,Hide,9,1997,2464,2464,2571,2571,1,107,107,0.041618047,0.041618047
FALSE,Kane County,9/1/98,Hide,Hide,9,1998,2558,2558,2647,2647,1,89,89,0.033622969,0.033622969
FALSE,Kane County,9/1/99,Hide,Hide,9,1999,2653,2653,2743,2743,1,90,90,0.032810791,0.032810791
FALSE,Kane County,9/1/00,Hide,Hide,9,2000,2942,2942,3064,3064,1,122,122,0.039817232,0.039817232
FALSE,Kane County,9/1/01,Hide,Hide,9,2001,3091,3091,3226,3226,1,135,135,0.041847489,0.041847489
FALSE,Kane County,9/1/02,Hide,Hide,9,2002,2809,2809,2978,2978,1,169,169,0.056749496,0.056749496
FALSE,Kane County,9/1/03,Hide,Hide,9,2003,2937,2937,3119,3119,1,182,182,0.058352036,0.058352036
FALSE,Kane County,9/1/04,Hide,Hide,9,2004,3066,3066,3251,3251,1,185,185,0.056905568,0.056905568
FALSE,Kane County,9/1/05,Hide,Hide,9,2005,3169,3169,3322,3322,1,153,153,0.046056592,0.046056592
FALSE,Kane County,9/1/06,Hide,Hide,9,2006,3342,3342,3455,3455,1,113,113,0.032706223,0.032706223
FALSE,Kane County,9/1/07,Hide,Hide,9,2007,3329,3329,3445,3445,1,116,116,0.033671988,0.033671988
FALSE,Kane County,9/1/08,Hide,Hide,9,2008,3368,3368,3532,3532,1,164,164,0.046432616,0.046432616
FALSE,Kane County,9/1/09,Hide,Hide,9,2009,3257,3257,3536,3536,1,279,279,0.078902715,0.078902715
FALSE,Kane County,9/1/10,Hide,Hide,9,2010,3255,3255,3538,3538,1,283,283,0.079988694,0.079988694
FALSE,Kane County,9/1/11,Hide,Hide,9,2011,3218,3218,3469,3469,1,251,251,0.072355146,0.072355146
FALSE,Kane County,9/1/12,Hide,Hide,9,2012,3239,3239,3462,3462,1,223,223,0.064413634,0.064413634
FALSE,Kane County,9/1/13,Hide,Hide,9,2013,3294,3294,3473,3473,1,179,179,0.051540455,0.051540455
FALSE,Kane County,9/1/14,Hide,Hide,9,2014,3426,3426,3593,3593,1,167,167,0.046479265,0.046479265
FALSE,Kane County,9/1/15,Hide,Hide,9,2015,3498,3498,3657,3657,1,159,159,0.043478261,0.043478261
FALSE,Kane County,9/1/16,Hide,Hide,9,2016,3557,3557,3691,3691,1,134,134,0.036304525,0.036304525
FALSE,Kane County,9/1/17,Hide,Hide,9,2017,3629,3629,3758,3758,1,129,129,0.03432677,0.03432677
FALSE,Kane County,9/1/18,Hide,Hide,9,2018,3657,3657,3773,3773,1,116,116,0.030744765,0.030744765
FALSE,Kane County,9/1/19,Hide,Hide,9,2019,3732,3732,3837,3837,1,105,105,0.027365129,0.027365129
FALSE,Millard County,9/1/92,Hide,Hide,9,1992,4359,4359,4660,4660,1,301,301,0.064592275,0.064592275
FALSE,Millard County,9/1/93,Hide,Hide,9,1993,4503,4503,4749,4749,1,246,246,0.051800379,0.051800379
FALSE,Millard County,9/1/94,Hide,Hide,9,1994,4609,4609,4840,4840,1,231,231,0.047727273,0.047727273
FALSE,Millard County,9/1/95,Hide,Hide,9,1995,4435,4435,4651,4651,1,216,216,0.046441625,0.046441625
FALSE,Millard County,9/1/96,Hide,Hide,9,1996,4569,4569,4758,4758,1,189,189,0.039722573,0.039722573
FALSE,Millard County,9/1/97,Hide,Hide,9,1997,4604,4604,4787,4787,1,183,183,0.038228536,0.038228536
FALSE,Millard County,9/1/98,Hide,Hide,9,1998,4499,4499,4718,4718,1,219,219,0.046417974,0.046417974
FALSE,Millard County,9/1/99,Hide,Hide,9,1999,4351,4351,4541,4541,1,190,190,0.041841004,0.041841004
FALSE,Millard County,9/1/00,Hide,Hide,9,2000,4993,4993,5180,5180,1,187,187,0.036100386,0.036100386
FALSE,Millard County,9/1/01,Hide,Hide,9,2001,5747,5747,5996,5996,1,249,249,0.041527685,0.041527685
FALSE,Millard County,9/1/02,Hide,Hide,9,2002,6016,6016,6303,6303,1,287,287,0.045533873,0.045533873
FALSE,Millard County,9/1/03,Hide,Hide,9,2003,5589,5589,5890,5890,1,301,301,0.051103565,0.051103565
FALSE,Millard County,9/1/04,Hide,Hide,9,2004,5592,5592,5875,5875,1,283,283,0.048170213,0.048170213
FALSE,Millard County,9/1/05,Hide,Hide,9,2005,5884,5884,6125,6125,1,241,241,0.039346939,0.039346939
FALSE,Millard County,9/1/06,Hide,Hide,9,2006,6067,6067,6238,6238,1,171,171,0.027412632,0.027412632
FALSE,Millard County,9/1/07,Hide,Hide,9,2007,5945,5945,6110,6110,1,165,165,0.02700491,0.02700491
FALSE,Millard County,9/1/08,Hide,Hide,9,2008,5968,5968,6189,6189,1,221,221,0.035708515,0.035708515
FALSE,Millard County,9/1/09,Hide,Hide,9,2009,6188,6188,6566,6566,1,378,378,0.057569296,0.057569296
FALSE,Millard County,9/1/10,Hide,Hide,9,2010,6201,6201,6600,6600,1,399,399,0.060454545,0.060454545
FALSE,Millard County,9/1/11,Hide,Hide,9,2011,5818,5818,6135,6135,1,317,317,0.051670742,0.051670742
FALSE,Millard County,9/1/12,Hide,Hide,9,2012,5662,5662,5933,5933,1,271,271,0.045676723,0.045676723
FALSE,Millard County,9/1/13,Hide,Hide,9,2013,5584,5584,5815,5815,1,231,231,0.03972485,0.03972485
FALSE,Millard County,9/1/14,Hide,Hide,9,2014,5699,5699,5910,5910,1,211,211,0.0357022,0.0357022
FALSE,Millard County,9/1/15,Hide,Hide,9,2015,5876,5876,6089,6089,1,213,213,0.034981113,0.034981113
FALSE,Millard County,9/1/16,Hide,Hide,9,2016,6061,6061,6269,6269,1,208,208,0.033179135,0.033179135
FALSE,Millard County,9/1/17,Hide,Hide,9,2017,6254,6254,6457,6457,1,203,203,0.031438749,0.031438749
FALSE,Millard County,9/1/18,Hide,Hide,9,2018,5925,5925,6122,6122,1,197,197,0.032179026,0.032179026
FALSE,Millard County,9/1/19,Hide,Hide,9,2019,5835,5835,5989,5989,1,154,154,0.025713809,0.025713809
FALSE,Morgan County,9/1/92,Hide,Hide,9,1992,2788,2788,2958,2958,1,170,170,0.057471264,0.057471264
FALSE,Morgan County,9/1/93,Hide,Hide,9,1993,2814,2814,2975,2975,1,161,161,0.054117647,0.054117647
FALSE,Morgan County,9/1/94,Hide,Hide,9,1994,2979,2979,3136,3136,1,157,157,0.050063776,0.050063776
FALSE,Morgan County,9/1/95,Hide,Hide,9,1995,3300,3300,3448,3448,1,148,148,0.042923434,0.042923434
FALSE,Morgan County,9/1/96,Hide,Hide,9,1996,3386,3386,3527,3527,1,141,141,0.039977318,0.039977318
FALSE,Morgan County,9/1/97,Hide,Hide,9,1997,3506,3506,3649,3649,1,143,143,0.039188819,0.039188819
FALSE,Morgan County,9/1/98,Hide,Hide,9,1998,3550,3550,3695,3695,1,145,145,0.039242219,0.039242219
FALSE,Morgan County,9/1/99,Hide,Hide,9,1999,3410,3410,3547,3547,1,137,137,0.038624189,0.038624189
FALSE,Morgan County,9/1/00,Hide,Hide,9,2000,3277,3277,3395,3395,1,118,118,0.034756996,0.034756996
FALSE,Morgan County,9/1/01,Hide,Hide,9,2001,3315,3315,3458,3458,1,143,143,0.041353383,0.041353383
FALSE,Morgan County,9/1/02,Hide,Hide,9,2002,3375,3375,3570,3570,1,195,195,0.054621849,0.054621849
FALSE,Morgan County,9/1/03,Hide,Hide,9,2003,3417,3417,3601,3601,1,184,184,0.051096918,0.051096918
FALSE,Morgan County,9/1/04,Hide,Hide,9,2004,3524,3524,3695,3695,1,171,171,0.046278755,0.046278755
FALSE,Morgan County,9/1/05,Hide,Hide,9,2005,3691,3691,3847,3847,1,156,156,0.040551079,0.040551079
FALSE,Morgan County,9/1/06,Hide,Hide,9,2006,3851,3851,3962,3962,1,111,111,0.028016153,0.028016153
FALSE,Morgan County,9/1/07,Hide,Hide,9,2007,3907,3907,4021,4021,1,114,114,0.028351156,0.028351156
FALSE,Morgan County,9/1/08,Hide,Hide,9,2008,3925,3925,4065,4065,1,140,140,0.034440344,0.034440344
FALSE,Morgan County,9/1/09,Hide,Hide,9,2009,3787,3787,4053,4053,1,266,266,0.065630397,0.065630397
FALSE,Morgan County,9/1/10,Hide,Hide,9,2010,4003,4003,4301,4301,1,298,298,0.069286213,0.069286213
FALSE,Morgan County,9/1/11,Hide,Hide,9,2011,4039,4039,4268,4268,1,229,229,0.053655108,0.053655108
FALSE,Morgan County,9/1/12,Hide,Hide,9,2012,4157,4157,4362,4362,1,205,205,0.04699679,0.04699679
FALSE,Morgan County,9/1/13,Hide,Hide,9,2013,4365,4365,4541,4541,1,176,176,0.038757983,0.038757983
FALSE,Morgan County,9/1/14,Hide,Hide,9,2014,4557,4557,4718,4718,1,161,161,0.034124629,0.034124629
FALSE,Morgan County,9/1/15,Hide,Hide,9,2015,4803,4803,4957,4957,1,154,154,0.031067178,0.031067178
FALSE,Morgan County,9/1/16,Hide,Hide,9,2016,5050,5050,5199,5199,1,149,149,0.028659358,0.028659358
FALSE,Morgan County,9/1/17,Hide,Hide,9,2017,5266,5266,5418,5418,1,152,152,0.028054633,0.028054633
FALSE,Morgan County,9/1/18,Hide,Hide,9,2018,5303,5303,5452,5452,1,149,149,0.02732942,0.02732942
FALSE,Morgan County,9/1/19,Hide,Hide,9,2019,5473,5473,5603,5603,1,130,130,0.023201856,0.023201856
FALSE,Piute County,9/1/92,Hide,Hide,9,1992,419,419,453,453,1,34,34,0.075055188,0.075055188
FALSE,Piute County,9/1/93,Hide,Hide,9,1993,470,470,499,499,1,29,29,0.058116232,0.058116232
FALSE,Piute County,9/1/94,Hide,Hide,9,1994,462,462,506,506,1,44,44,0.086956522,0.086956522
FALSE,Piute County,9/1/95,Hide,Hide,9,1995,458,458,487,487,1,29,29,0.059548255,0.059548255
FALSE,Piute County,9/1/96,Hide,Hide,9,1996,509,509,533,533,1,24,24,0.045028143,0.045028143
FALSE,Piute County,9/1/97,Hide,Hide,9,1997,497,497,521,521,1,24,24,0.046065259,0.046065259
FALSE,Piute County,9/1/98,Hide,Hide,9,1998,495,495,520,520,1,25,25,0.048076923,0.048076923
FALSE,Piute County,9/1/99,Hide,Hide,9,1999,492,492,522,522,1,30,30,0.057471264,0.057471264
FALSE,Piute County,9/1/00,Hide,Hide,9,2000,614,614,644,644,1,30,30,0.046583851,0.046583851
FALSE,Piute County,9/1/01,Hide,Hide,9,2001,755,755,798,798,1,43,43,0.053884712,0.053884712
FALSE,Piute County,9/1/02,Hide,Hide,9,2002,706,706,755,755,1,49,49,0.064900662,0.064900662
FALSE,Piute County,9/1/03,Hide,Hide,9,2003,769,769,813,813,1,44,44,0.054120541,0.054120541
FALSE,Piute County,9/1/04,Hide,Hide,9,2004,838,838,875,875,1,37,37,0.042285714,0.042285714
FALSE,Piute County,9/1/05,Hide,Hide,9,2005,796,796,827,827,1,31,31,0.037484885,0.037484885
FALSE,Piute County,9/1/06,Hide,Hide,9,2006,866,866,890,890,1,24,24,0.026966292,0.026966292
FALSE,Piute County,9/1/07,Hide,Hide,9,2007,899,899,923,923,1,24,24,0.026002167,0.026002167
FALSE,Piute County,9/1/08,Hide,Hide,9,2008,885,885,912,912,1,27,27,0.029605263,0.029605263
FALSE,Piute County,9/1/09,Hide,Hide,9,2009,820,820,881,881,1,61,61,0.069239501,0.069239501
FALSE,Piute County,9/1/10,Hide,Hide,9,2010,502,502,560,560,1,58,58,0.103571429,0.103571429
FALSE,Piute County,9/1/11,Hide,Hide,9,2011,463,463,514,514,1,51,51,0.09922179,0.09922179
FALSE,Piute County,9/1/12,Hide,Hide,9,2012,441,441,482,482,1,41,41,0.085062241,0.085062241
FALSE,Piute County,9/1/13,Hide,Hide,9,2013,450,450,487,487,1,37,37,0.075975359,0.075975359
FALSE,Piute County,9/1/14,Hide,Hide,9,2014,419,419,452,452,1,33,33,0.07300885,0.07300885
FALSE,Piute County,9/1/15,Hide,Hide,9,2015,425,425,453,453,1,28,28,0.061810155,0.061810155
FALSE,Piute County,9/1/16,Hide,Hide,9,2016,437,437,463,463,1,26,26,0.056155508,0.056155508
FALSE,Piute County,9/1/17,Hide,Hide,9,2017,466,466,489,489,1,23,23,0.047034765,0.047034765
FALSE,Piute County,9/1/18,Hide,Hide,9,2018,455,455,479,479,1,24,24,0.050104384,0.050104384
FALSE,Piute County,9/1/19,Hide,Hide,9,2019,463,463,486,486,1,23,23,0.047325103,0.047325103
FALSE,Rich County,9/1/92,Hide,Hide,9,1992,713,713,745,745,1,32,32,0.04295302,0.04295302
FALSE,Rich County,9/1/93,Hide,Hide,9,1993,785,785,808,808,1,23,23,0.028465347,0.028465347
FALSE,Rich County,9/1/94,Hide,Hide,9,1994,836,836,870,870,1,34,34,0.03908046,0.03908046
FALSE,Rich County,9/1/95,Hide,Hide,9,1995,860,860,895,895,1,35,35,0.039106145,0.039106145
FALSE,Rich County,9/1/96,Hide,Hide,9,1996,932,932,965,965,1,33,33,0.034196891,0.034196891
FALSE,Rich County,9/1/97,Hide,Hide,9,1997,930,930,965,965,1,35,35,0.03626943,0.03626943
FALSE,Rich County,9/1/98,Hide,Hide,9,1998,934,934,967,967,1,33,33,0.034126163,0.034126163
FALSE,Rich County,9/1/99,Hide,Hide,9,1999,932,932,971,971,1,39,39,0.040164779,0.040164779
FALSE,Rich County,9/1/00,Hide,Hide,9,2000,1030,1030,1061,1061,1,31,31,0.029217719,0.029217719
FALSE,Rich County,9/1/01,Hide,Hide,9,2001,1221,1221,1254,1254,1,33,33,0.026315789,0.026315789
FALSE,Rich County,9/1/02,Hide,Hide,9,2002,1196,1196,1250,1250,1,54,54,0.0432,0.0432
FALSE,Rich County,9/1/03,Hide,Hide,9,2003,1220,1220,1267,1267,1,47,47,0.037095501,0.037095501
FALSE,Rich County,9/1/04,Hide,Hide,9,2004,1283,1283,1328,1328,1,45,45,0.033885542,0.033885542
FALSE,Rich County,9/1/05,Hide,Hide,9,2005,1255,1255,1294,1294,1,39,39,0.030139104,0.030139104
FALSE,Rich County,9/1/06,Hide,Hide,9,2006,1394,1394,1424,1424,1,30,30,0.021067416,0.021067416
FALSE,Rich County,9/1/07,Hide,Hide,9,2007,1384,1384,1419,1419,1,35,35,0.024665257,0.024665257
FALSE,Rich County,9/1/08,Hide,Hide,9,2008,1410,1410,1452,1452,1,42,42,0.02892562,0.02892562
FALSE,Rich County,9/1/09,Hide,Hide,9,2009,1368,1368,1443,1443,1,75,75,0.051975052,0.051975052
FALSE,Rich County,9/1/10,Hide,Hide,9,2010,961,961,1034,1034,1,73,73,0.070599613,0.070599613
FALSE,Rich County,9/1/11,Hide,Hide,9,2011,910,910,978,978,1,68,68,0.069529652,0.069529652
FALSE,Rich County,9/1/12,Hide,Hide,9,2012,896,896,945,945,1,49,49,0.051851852,0.051851852
FALSE,Rich County,9/1/13,Hide,Hide,9,2013,937,937,979,979,1,42,42,0.042900919,0.042900919
FALSE,Rich County,9/1/14,Hide,Hide,9,2014,948,948,986,986,1,38,38,0.038539554,0.038539554
FALSE,Rich County,9/1/15,Hide,Hide,9,2015,990,990,1029,1029,1,39,39,0.037900875,0.037900875
FALSE,Rich County,9/1/16,Hide,Hide,9,2016,1069,1069,1105,1105,1,36,36,0.032579186,0.032579186
FALSE,Rich County,9/1/17,Hide,Hide,9,2017,1120,1120,1156,1156,1,36,36,0.031141869,0.031141869
FALSE,Rich County,9/1/18,Hide,Hide,9,2018,1144,1144,1181,1181,1,37,37,0.031329382,0.031329382
FALSE,Rich County,9/1/19,Hide,Hide,9,2019,1144,1144,1179,1179,1,35,35,0.029686175,0.029686175
FALSE,Salt Lake County,9/1/92,Hide,Hide,9,1992,384634,384634,402014,402014,1,17380,17380,0.043232325,0.043232325
FALSE,Salt Lake County,9/1/93,Hide,Hide,9,1993,412380,412380,426431,426431,1,14051,14051,0.032950231,0.032950231
FALSE,Salt Lake County,9/1/94,Hide,Hide,9,1994,428771,428771,444009,444009,1,15238,15238,0.034319124,0.034319124
FALSE,Salt Lake County,9/1/95,Hide,Hide,9,1995,442871,442871,456052,456052,1,13181,13181,0.028902406,0.028902406
FALSE,Salt Lake County,9/1/96,Hide,Hide,9,1996,450728,450728,463997,463997,1,13269,13269,0.028597168,0.028597168
FALSE,Salt Lake County,9/1/97,Hide,Hide,9,1997,463456,463456,477014,477014,1,13558,13558,0.028422646,0.028422646
FALSE,Salt Lake County,9/1/98,Hide,Hide,9,1998,468999,468999,484959,484959,1,15960,15960,0.032909999,0.032909999
FALSE,Salt Lake County,9/1/99,Hide,Hide,9,1999,476047,476047,491752,491752,1,15705,15705,0.03193683,0.03193683
FALSE,Salt Lake County,9/1/00,Hide,Hide,9,2000,472031,472031,488143,488143,1,16112,16112,0.033006721,0.033006721
FALSE,Salt Lake County,9/1/01,Hide,Hide,9,2001,467251,467251,490484,490484,1,23233,23233,0.047367498,0.047367498
FALSE,Salt Lake County,9/1/02,Hide,Hide,9,2002,464853,464853,495433,495433,1,30580,30580,0.061723785,0.061723785
FALSE,Salt Lake County,9/1/03,Hide,Hide,9,2003,469141,469141,496980,496980,1,27839,27839,0.056016339,0.056016339
FALSE,Salt Lake County,9/1/04,Hide,Hide,9,2004,479045,479045,503273,503273,1,24228,24228,0.04814087,0.04814087
FALSE,Salt Lake County,9/1/05,Hide,Hide,9,2005,501839,501839,521934,521934,1,20095,20095,0.038501037,0.038501037
FALSE,Salt Lake County,9/1/06,Hide,Hide,9,2006,523557,523557,538212,538212,1,14655,14655,0.027229047,0.027229047
FALSE,Salt Lake County,9/1/07,Hide,Hide,9,2007,538855,538855,553837,553837,1,14982,14982,0.02705128,0.02705128
FALSE,Salt Lake County,9/1/08,Hide,Hide,9,2008,537114,537114,557509,557509,1,20395,20395,0.036582369,0.036582369
FALSE,Salt Lake County,9/1/09,Hide,Hide,9,2009,508141,508141,549551,549551,1,41410,41410,0.075352424,0.075352424
FALSE,Salt Lake County,9/1/10,Hide,Hide,9,2010,506526,506526,548740,548740,1,42214,42214,0.076928965,0.076928965
FALSE,Salt Lake County,9/1/11,Hide,Hide,9,2011,512039,512039,546723,546723,1,34684,34684,0.063439804,0.063439804
FALSE,Salt Lake County,9/1/12,Hide,Hide,9,2012,531210,531210,559132,559132,1,27922,27922,0.049938118,0.049938118
FALSE,Salt Lake County,9/1/13,Hide,Hide,9,2013,548017,548017,571855,571855,1,23838,23838,0.041685392,0.041685392
FALSE,Salt Lake County,9/1/14,Hide,Hide,9,2014,555547,555547,576591,576591,1,21044,21044,0.036497274,0.036497274
FALSE,Salt Lake County,9/1/15,Hide,Hide,9,2015,567915,567915,587553,587553,1,19638,19638,0.033423368,0.033423368
FALSE,Salt Lake County,9/1/16,Hide,Hide,9,2016,587056,587056,605867,605867,1,18811,18811,0.031048068,0.031048068
FALSE,Salt Lake County,9/1/17,Hide,Hide,9,2017,596995,596995,616141,616141,1,19146,19146,0.031074056,0.031074056
FALSE,Salt Lake County,9/1/18,Hide,Hide,9,2018,602145,602145,620422,620422,1,18277,18277,0.029458981,0.029458981
FALSE,Salt Lake County,9/1/19,Hide,Hide,9,2019,624078,624078,639350,639350,1,15272,15272,0.02388676,0.02388676
FALSE,San Juan County,9/1/92,Hide,Hide,9,1992,4095,4095,4556,4556,1,461,461,0.10118525,0.10118525
FALSE,San Juan County,9/1/93,Hide,Hide,9,1993,4768,4768,5135,5135,1,367,367,0.071470302,0.071470302
FALSE,San Juan County,9/1/94,Hide,Hide,9,1994,4745,4745,5175,5175,1,430,430,0.083091787,0.083091787
FALSE,San Juan County,9/1/95,Hide,Hide,9,1995,4829,4829,5275,5275,1,446,446,0.084549763,0.084549763
FALSE,San Juan County,9/1/96,Hide,Hide,9,1996,4558,4558,5054,5054,1,496,496,0.098140087,0.098140087
FALSE,San Juan County,9/1/97,Hide,Hide,9,1997,4460,4460,4849,4849,1,389,389,0.080222726,0.080222726
FALSE,San Juan County,9/1/98,Hide,Hide,9,1998,4670,4670,5066,5066,1,396,396,0.07816818,0.07816818
FALSE,San Juan County,9/1/99,Hide,Hide,9,1999,4613,4613,4972,4972,1,359,359,0.072204344,0.072204344
FALSE,San Juan County,9/1/00,Hide,Hide,9,2000,4245,4245,4632,4632,1,387,387,0.083549223,0.083549223
FALSE,San Juan County,9/1/01,Hide,Hide,9,2001,4238,4238,4616,4616,1,378,378,0.081889081,0.081889081
FALSE,San Juan County,9/1/02,Hide,Hide,9,2002,4393,4393,4808,4808,1,415,415,0.086314476,0.086314476
FALSE,San Juan County,9/1/03,Hide,Hide,9,2003,4276,4276,4711,4711,1,435,435,0.092337083,0.092337083
FALSE,San Juan County,9/1/04,Hide,Hide,9,2004,4405,4405,4845,4845,1,440,440,0.090815273,0.090815273
FALSE,San Juan County,9/1/05,Hide,Hide,9,2005,4453,4453,4812,4812,1,359,359,0.074605154,0.074605154
FALSE,San Juan County,9/1/06,Hide,Hide,9,2006,4625,4625,4921,4921,1,296,296,0.060150376,0.060150376
FALSE,San Juan County,9/1/07,Hide,Hide,9,2007,4707,4707,4989,4989,1,282,282,0.056524354,0.056524354
FALSE,San Juan County,9/1/08,Hide,Hide,9,2008,4743,4743,5070,5070,1,327,327,0.064497041,0.064497041
FALSE,San Juan County,9/1/09,Hide,Hide,9,2009,4717,4717,5383,5383,1,666,666,0.123722831,0.123722831
FALSE,San Juan County,9/1/10,Hide,Hide,9,2010,5509,5509,6171,6171,1,662,662,0.107275968,0.107275968
FALSE,San Juan County,9/1/11,Hide,Hide,9,2011,5332,5332,5909,5909,1,577,577,0.097647656,0.097647656
FALSE,San Juan County,9/1/12,Hide,Hide,9,2012,5172,5172,5659,5659,1,487,487,0.086057607,0.086057607
FALSE,San Juan County,9/1/13,Hide,Hide,9,2013,5269,5269,5720,5720,1,451,451,0.078846154,0.078846154
FALSE,San Juan County,9/1/14,Hide,Hide,9,2014,5139,5139,5578,5578,1,439,439,0.078702044,0.078702044
FALSE,San Juan County,9/1/15,Hide,Hide,9,2015,5239,5239,5693,5693,1,454,454,0.079747058,0.079747058
FALSE,San Juan County,9/1/16,Hide,Hide,9,2016,5286,5286,5737,5737,1,451,451,0.078612515,0.078612515
FALSE,San Juan County,9/1/17,Hide,Hide,9,2017,5311,5311,5697,5697,1,386,386,0.067754959,0.067754959
FALSE,San Juan County,9/1/18,Hide,Hide,9,2018,5380,5380,5722,5722,1,342,342,0.059769311,0.059769311
FALSE,San Juan County,9/1/19,Hide,Hide,9,2019,5432,5432,5719,5719,1,287,287,0.050183599,0.050183599
FALSE,Sanpete County,9/1/92,Hide,Hide,9,1992,6250,6250,6883,6883,1,633,633,0.091965713,0.091965713
FALSE,Sanpete County,9/1/93,Hide,Hide,9,1993,6843,6843,7296,7296,1,453,453,0.062088816,0.062088816
FALSE,Sanpete County,9/1/94,Hide,Hide,9,1994,7164,7164,7673,7673,1,509,509,0.066336505,0.066336505
FALSE,Sanpete County,9/1/95,Hide,Hide,9,1995,7365,7365,7835,7835,1,470,470,0.059987237,0.059987237
FALSE,Sanpete County,9/1/96,Hide,Hide,9,1996,7893,7893,8358,8358,1,465,465,0.055635319,0.055635319
FALSE,Sanpete County,9/1/97,Hide,Hide,9,1997,8161,8161,8602,8602,1,441,441,0.051267147,0.051267147
FALSE,Sanpete County,9/1/98,Hide,Hide,9,1998,8537,8537,9049,9049,1,512,512,0.056580838,0.056580838
FALSE,Sanpete County,9/1/99,Hide,Hide,9,1999,8433,8433,8879,8879,1,446,446,0.050230882,0.050230882
FALSE,Sanpete County,9/1/00,Hide,Hide,9,2000,9458,9458,9913,9913,1,455,455,0.045899324,0.045899324
FALSE,Sanpete County,9/1/01,Hide,Hide,9,2001,9742,9742,10296,10296,1,554,554,0.053807304,0.053807304
FALSE,Sanpete County,9/1/02,Hide,Hide,9,2002,9487,9487,10177,10177,1,690,690,0.067799941,0.067799941
FALSE,Sanpete County,9/1/03,Hide,Hide,9,2003,9582,9582,10265,10265,1,683,683,0.066536775,0.066536775
FALSE,Sanpete County,9/1/04,Hide,Hide,9,2004,9713,9713,10358,10358,1,645,645,0.062270709,0.062270709
FALSE,Sanpete County,9/1/05,Hide,Hide,9,2005,10119,10119,10659,10659,1,540,540,0.050661413,0.050661413
FALSE,Sanpete County,9/1/06,Hide,Hide,9,2006,10321,10321,10690,10690,1,369,369,0.034518241,0.034518241
FALSE,Sanpete County,9/1/07,Hide,Hide,9,2007,10585,10585,10943,10943,1,358,358,0.032714978,0.032714978
FALSE,Sanpete County,9/1/08,Hide,Hide,9,2008,10761,10761,11284,11284,1,523,523,0.046348812,0.046348812
FALSE,Sanpete County,9/1/09,Hide,Hide,9,2009,10392,10392,11357,11357,1,965,965,0.084969622,0.084969622
FALSE,Sanpete County,9/1/10,Hide,Hide,9,2010,10392,10392,11489,11489,1,1097,1097,0.095482636,0.095482636
FALSE,Sanpete County,9/1/11,Hide,Hide,9,2011,10289,10289,11120,11120,1,831,831,0.074730216,0.074730216
FALSE,Sanpete County,9/1/12,Hide,Hide,9,2012,10574,10574,11272,11272,1,698,698,0.06192335,0.06192335
FALSE,Sanpete County,9/1/13,Hide,Hide,9,2013,10293,10293,10883,10883,1,590,590,0.054212993,0.054212993
FALSE,Sanpete County,9/1/14,Hide,Hide,9,2014,10608,10608,11102,11102,1,494,494,0.044496487,0.044496487
FALSE,Sanpete County,9/1/15,Hide,Hide,9,2015,10962,10962,11436,11436,1,474,474,0.041448059,0.041448059
FALSE,Sanpete County,9/1/16,Hide,Hide,9,2016,11451,11451,11914,11914,1,463,463,0.038861843,0.038861843
FALSE,Sanpete County,9/1/17,Hide,Hide,9,2017,11590,11590,12066,12066,1,476,476,0.039449693,0.039449693
FALSE,Sanpete County,9/1/18,Hide,Hide,9,2018,12054,12054,12509,12509,1,455,455,0.036373811,0.036373811
FALSE,Sanpete County,9/1/19,Hide,Hide,9,2019,12098,12098,12481,12481,1,383,383,0.030686644,0.030686644
FALSE,Sevier County,9/1/92,Hide,Hide,9,1992,6261,6261,6722,6722,1,461,461,0.06858078,0.06858078
FALSE,Sevier County,9/1/93,Hide,Hide,9,1993,6902,6902,7265,7265,1,363,363,0.049965588,0.049965588
FALSE,Sevier County,9/1/94,Hide,Hide,9,1994,7203,7203,7576,7576,1,373,373,0.049234424,0.049234424
FALSE,Sevier County,9/1/95,Hide,Hide,9,1995,7262,7262,7635,7635,1,373,373,0.048853962,0.048853962
FALSE,Sevier County,9/1/96,Hide,Hide,9,1996,7511,7511,7873,7873,1,362,362,0.045979931,0.045979931
FALSE,Sevier County,9/1/97,Hide,Hide,9,1997,7844,7844,8151,8151,1,307,307,0.03766409,0.03766409
FALSE,Sevier County,9/1/98,Hide,Hide,9,1998,7925,7925,8307,8307,1,382,382,0.045985314,0.045985314
FALSE,Sevier County,9/1/99,Hide,Hide,9,1999,8141,8141,8472,8472,1,331,331,0.039069877,0.039069877
FALSE,Sevier County,9/1/00,Hide,Hide,9,2000,7995,7995,8345,8345,1,350,350,0.041941282,0.041941282
FALSE,Sevier County,9/1/01,Hide,Hide,9,2001,8331,8331,8737,8737,1,406,406,0.04646904,0.04646904
FALSE,Sevier County,9/1/02,Hide,Hide,9,2002,8338,8338,8847,8847,1,509,509,0.057533627,0.057533627
FALSE,Sevier County,9/1/03,Hide,Hide,9,2003,8249,8249,8752,8752,1,503,503,0.057472578,0.057472578
FALSE,Sevier County,9/1/04,Hide,Hide,9,2004,8719,8719,9194,9194,1,475,475,0.051664129,0.051664129
FALSE,Sevier County,9/1/05,Hide,Hide,9,2005,8801,8801,9193,9193,1,392,392,0.04264114,0.04264114
FALSE,Sevier County,9/1/06,Hide,Hide,9,2006,9156,9156,9455,9455,1,299,299,0.03162348,0.03162348
FALSE,Sevier County,9/1/07,Hide,Hide,9,2007,9155,9155,9447,9447,1,292,292,0.030909283,0.030909283
FALSE,Sevier County,9/1/08,Hide,Hide,9,2008,9212,9212,9655,9655,1,443,443,0.045882962,0.045882962
FALSE,Sevier County,9/1/09,Hide,Hide,9,2009,9135,9135,9936,9936,1,801,801,0.080615942,0.080615942
FALSE,Sevier County,9/1/10,Hide,Hide,9,2010,8987,8987,9779,9779,1,792,792,0.080989876,0.080989876
FALSE,Sevier County,9/1/11,Hide,Hide,9,2011,8833,8833,9505,9505,1,672,672,0.070699632,0.070699632
FALSE,Sevier County,9/1/12,Hide,Hide,9,2012,8870,8870,9427,9427,1,557,557,0.059085605,0.059085605
FALSE,Sevier County,9/1/13,Hide,Hide,9,2013,8705,8705,9192,9192,1,487,487,0.052980853,0.052980853
FALSE,Sevier County,9/1/14,Hide,Hide,9,2014,8817,8817,9232,9232,1,415,415,0.04495234,0.04495234
FALSE,Sevier County,9/1/15,Hide,Hide,9,2015,9010,9010,9436,9436,1,426,426,0.045146248,0.045146248
FALSE,Sevier County,9/1/16,Hide,Hide,9,2016,9233,9233,9649,9649,1,416,416,0.043113276,0.043113276
FALSE,Sevier County,9/1/17,Hide,Hide,9,2017,9439,9439,9819,9819,1,380,380,0.038700479,0.038700479
FALSE,Sevier County,9/1/18,Hide,Hide,9,2018,9535,9535,9871,9871,1,336,336,0.034039104,0.034039104
FALSE,Sevier County,9/1/19,Hide,Hide,9,2019,9450,9450,9739,9739,1,289,289,0.029674505,0.029674505
FALSE,State of Utah,9/1/92,Hide,Hide,9,1992,853082,853082,895927,895927,1,42845,42845,0.047821977,0.047821977
FALSE,State of Utah,9/1/93,Hide,Hide,9,1993,917054,917054,953711,953711,1,36657,36657,0.038436172,0.038436172
FALSE,State of Utah,9/1/94,Hide,Hide,9,1994,960221,960221,998790,998790,1,38569,38569,0.038615725,0.038615725
FALSE,State of Utah,9/1/95,Hide,Hide,9,1995,982839,982839,1017351,1017351,1,34512,34512,0.033923395,0.033923395
FALSE,State of Utah,9/1/96,Hide,Hide,9,1996,1010840,1010840,1045763,1045763,1,34923,34923,0.033394756,0.033394756
FALSE,State of Utah,9/1/97,Hide,Hide,9,1997,1042111,1042111,1076377,1076377,1,34266,34266,0.031834571,0.031834571
FALSE,State of Utah,9/1/98,Hide,Hide,9,1998,1066856,1066856,1108001,1108001,1,41145,41145,0.037134443,0.037134443
FALSE,State of Utah,9/1/99,Hide,Hide,9,1999,1084773,1084773,1124028,1124028,1,39255,39255,0.034923507,0.034923507
FALSE,State of Utah,9/1/00,Hide,Hide,9,2000,1107901,1107901,1148144,1148144,1,40243,40243,0.035050481,0.035050481
FALSE,State of Utah,9/1/01,Hide,Hide,9,2001,1111943,1111943,1166276,1166276,1,54333,54333,0.046586743,0.046586743
FALSE,State of Utah,9/1/02,Hide,Hide,9,2002,1117450,1117450,1187938,1187938,1,70488,70488,0.05933643,0.05933643
FALSE,State of Utah,9/1/03,Hide,Hide,9,2003,1138031,1138031,1204373,1204373,1,66342,66342,0.055084264,0.055084264
FALSE,State of Utah,9/1/04,Hide,Hide,9,2004,1178153,1178153,1237613,1237613,1,59460,59460,0.048044098,0.048044098
FALSE,State of Utah,9/1/05,Hide,Hide,9,2005,1232859,1232859,1283692,1283692,1,50833,50833,0.039599063,0.039599063
FALSE,State of Utah,9/1/06,Hide,Hide,9,2006,1290988,1290988,1327531,1327531,1,36543,36543,0.027527041,0.027527041
FALSE,State of Utah,9/1/07,Hide,Hide,9,2007,1328918,1328918,1366220,1366220,1,37302,37302,0.02730307,0.02730307
FALSE,State of Utah,9/1/08,Hide,Hide,9,2008,1319447,1319447,1370622,1370622,1,51175,51175,0.037337063,0.037337063
FALSE,State of Utah,9/1/09,Hide,Hide,9,2009,1254831,1254831,1358521,1358521,1,103690,103690,0.076325651,0.076325651
FALSE,State of Utah,9/1/10,Hide,Hide,9,2010,1250305,1250305,1355732,1355732,1,105427,105427,0.077763894,0.077763894
FALSE,State of Utah,9/1/11,Hide,Hide,9,2011,1263369,1263369,1349818,1349818,1,86449,86449,0.064044931,0.064044931
FALSE,State of Utah,9/1/12,Hide,Hide,9,2012,1307993,1307993,1379310,1379310,1,71317,71317,0.051704838,0.051704838
FALSE,State of Utah,9/1/13,Hide,Hide,9,2013,1349876,1349876,1412304,1412304,1,62428,62428,0.044202948,0.044202948
FALSE,State of Utah,9/1/14,Hide,Hide,9,2014,1377823,1377823,1431682,1431682,1,53859,53859,0.037619388,0.037619388
FALSE,State of Utah,9/1/15,Hide,Hide,9,2015,1414507,1414507,1467487,1467487,1,52980,52980,0.036102534,0.036102534
FALSE,State of Utah,9/1/16,Hide,Hide,9,2016,1467055,1467055,1517657,1517657,1,50602,50602,0.033342185,0.033342185
FALSE,State of Utah,9/1/17,Hide,Hide,9,2017,1505091,1505091,1555255,1555255,1,50164,50164,0.032254518,0.032254518
FALSE,State of Utah,9/1/18,Hide,Hide,9,2018,1527249,1527249,1576879,1576879,1,49630,49630,0.031473563,0.031473563
FALSE,State of Utah,9/1/19,Hide,Hide,9,2019,1562718,1562718,1606085,1606085,1,43367,43367,0.027001684,0.027001684
FALSE,Summit County,9/1/92,Hide,Hide,9,1992,8939,8939,9569,9569,1,630,630,0.065837601,0.065837601
FALSE,Summit County,9/1/93,Hide,Hide,9,1993,10021,10021,10531,10531,1,510,510,0.048428449,0.048428449
FALSE,Summit County,9/1/94,Hide,Hide,9,1994,11106,11106,11613,11613,1,507,507,0.04365797,0.04365797
FALSE,Summit County,9/1/95,Hide,Hide,9,1995,11710,11710,12186,12186,1,476,476,0.039061218,0.039061218
FALSE,Summit County,9/1/96,Hide,Hide,9,1996,12515,12515,12946,12946,1,431,431,0.033292137,0.033292137
FALSE,Summit County,9/1/97,Hide,Hide,9,1997,13012,13012,13516,13516,1,504,504,0.037289139,0.037289139
FALSE,Summit County,9/1/98,Hide,Hide,9,1998,13564,13564,14182,14182,1,618,618,0.043576364,0.043576364
FALSE,Summit County,9/1/99,Hide,Hide,9,1999,13912,13912,14597,14597,1,685,685,0.046927451,0.046927451
FALSE,Summit County,9/1/00,Hide,Hide,9,2000,18075,18075,18728,18728,1,653,653,0.034867578,0.034867578
FALSE,Summit County,9/1/01,Hide,Hide,9,2001,18092,18092,19079,19079,1,987,987,0.051732271,0.051732271
FALSE,Summit County,9/1/02,Hide,Hide,9,2002,18284,18284,19584,19584,1,1300,1300,0.066380719,0.066380719
FALSE,Summit County,9/1/03,Hide,Hide,9,2003,18785,18785,19991,19991,1,1206,1206,0.060327147,0.060327147
FALSE,Summit County,9/1/04,Hide,Hide,9,2004,19607,19607,20615,20615,1,1008,1008,0.048896435,0.048896435
FALSE,Summit County,9/1/05,Hide,Hide,9,2005,20855,20855,21683,21683,1,828,828,0.038186598,0.038186598
FALSE,Summit County,9/1/06,Hide,Hide,9,2006,21378,21378,21953,21953,1,575,575,0.02619232,0.02619232
FALSE,Summit County,9/1/07,Hide,Hide,9,2007,21483,21483,22045,22045,1,562,562,0.025493309,0.025493309
FALSE,Summit County,9/1/08,Hide,Hide,9,2008,21699,21699,22497,22497,1,798,798,0.035471396,0.035471396
FALSE,Summit County,9/1/09,Hide,Hide,9,2009,21054,21054,22713,22713,1,1659,1659,0.07304187,0.07304187
FALSE,Summit County,9/1/10,Hide,Hide,9,2010,18999,18999,20560,20560,1,1561,1561,0.075924125,0.075924125
FALSE,Summit County,9/1/11,Hide,Hide,9,2011,19760,19760,20988,20988,1,1228,1228,0.058509625,0.058509625
FALSE,Summit County,9/1/12,Hide,Hide,9,2012,20524,20524,21566,21566,1,1042,1042,0.048316795,0.048316795
FALSE,Summit County,9/1/13,Hide,Hide,9,2013,21285,21285,22168,22168,1,883,883,0.039832191,0.039832191
FALSE,Summit County,9/1/14,Hide,Hide,9,2014,21831,21831,22601,22601,1,770,770,0.034069289,0.034069289
FALSE,Summit County,9/1/15,Hide,Hide,9,2015,22437,22437,23191,23191,1,754,754,0.032512613,0.032512613
FALSE,Summit County,9/1/16,Hide,Hide,9,2016,23340,23340,24080,24080,1,740,740,0.030730897,0.030730897
FALSE,Summit County,9/1/17,Hide,Hide,9,2017,23663,23663,24420,24420,1,757,757,0.030999181,0.030999181
FALSE,Summit County,9/1/18,Hide,Hide,9,2018,23724,23724,24446,24446,1,722,722,0.029534484,0.029534484
FALSE,Summit County,9/1/19,Hide,Hide,9,2019,24748,24748,25332,25332,1,584,584,0.023053845,0.023053845
FALSE,Tooele County,9/1/92,Hide,Hide,9,1992,11656,11656,12453,12453,1,797,797,0.064000642,0.064000642
FALSE,Tooele County,9/1/93,Hide,Hide,9,1993,11488,11488,12111,12111,1,623,623,0.051440839,0.051440839
FALSE,Tooele County,9/1/94,Hide,Hide,9,1994,11034,11034,11723,11723,1,689,689,0.058773352,0.058773352
FALSE,Tooele County,9/1/95,Hide,Hide,9,1995,10746,10746,11373,11373,1,627,627,0.055130572,0.055130572
FALSE,Tooele County,9/1/96,Hide,Hide,9,1996,11163,11163,11756,11756,1,593,593,0.050442327,0.050442327
FALSE,Tooele County,9/1/97,Hide,Hide,9,1997,11455,11455,11970,11970,1,515,515,0.043024227,0.043024227
FALSE,Tooele County,9/1/98,Hide,Hide,9,1998,11864,11864,12485,12485,1,621,621,0.049739688,0.049739688
FALSE,Tooele County,9/1/99,Hide,Hide,9,1999,12198,12198,12857,12857,1,659,659,0.051256125,0.051256125
FALSE,Tooele County,9/1/00,Hide,Hide,9,2000,19967,19967,20754,20754,1,787,787,0.037920401,0.037920401
FALSE,Tooele County,9/1/01,Hide,Hide,9,2001,20531,20531,21624,21624,1,1093,1093,0.05054569,0.05054569
FALSE,Tooele County,9/1/02,Hide,Hide,9,2002,21104,21104,22554,22554,1,1450,1450,0.064290148,0.064290148
FALSE,Tooele County,9/1/03,Hide,Hide,9,2003,22005,22005,23446,23446,1,1441,1441,0.061460377,0.061460377
FALSE,Tooele County,9/1/04,Hide,Hide,9,2004,22943,22943,24228,24228,1,1285,1285,0.053037807,0.053037807
FALSE,Tooele County,9/1/05,Hide,Hide,9,2005,24388,24388,25448,25448,1,1060,1060,0.041653568,0.041653568
FALSE,Tooele County,9/1/06,Hide,Hide,9,2006,25720,25720,26522,26522,1,802,802,0.030239047,0.030239047
FALSE,Tooele County,9/1/07,Hide,Hide,9,2007,26272,26272,27109,27109,1,837,837,0.030875355,0.030875355
FALSE,Tooele County,9/1/08,Hide,Hide,9,2008,26789,26789,27979,27979,1,1190,1190,0.042531899,0.042531899
FALSE,Tooele County,9/1/09,Hide,Hide,9,2009,25627,25627,27970,27970,1,2343,2343,0.083768323,0.083768323
FALSE,Tooele County,9/1/10,Hide,Hide,9,2010,25210,25210,27474,27474,1,2264,2264,0.082405183,0.082405183
FALSE,Tooele County,9/1/11,Hide,Hide,9,2011,25445,25445,27316,27316,1,1871,1871,0.068494655,0.068494655
FALSE,Tooele County,9/1/12,Hide,Hide,9,2012,26298,26298,27912,27912,1,1614,1614,0.057824592,0.057824592
FALSE,Tooele County,9/1/13,Hide,Hide,9,2013,27130,27130,28650,28650,1,1520,1520,0.053054101,0.053054101
FALSE,Tooele County,9/1/14,Hide,Hide,9,2014,27611,27611,28976,28976,1,1365,1365,0.047107951,0.047107951
FALSE,Tooele County,9/1/15,Hide,Hide,9,2015,28502,28502,29698,29698,1,1196,1196,0.040272072,0.040272072
FALSE,Tooele County,9/1/16,Hide,Hide,9,2016,29855,29855,31007,31007,1,1152,1152,0.037152901,0.037152901
FALSE,Tooele County,9/1/17,Hide,Hide,9,2017,31236,31236,32407,32407,1,1171,1171,0.036134169,0.036134169
FALSE,Tooele County,9/1/18,Hide,Hide,9,2018,32196,32196,33309,33309,1,1113,1113,0.033414393,0.033414393
FALSE,Tooele County,9/1/19,Hide,Hide,9,2019,33230,33230,34180,34180,1,950,950,0.027794032,0.027794032
FALSE,Uintah County,9/1/92,Hide,Hide,9,1992,9087,9087,9856,9856,1,769,769,0.078023539,0.078023539
FALSE,Uintah County,9/1/93,Hide,Hide,9,1993,9460,9460,10138,10138,1,678,678,0.066877096,0.066877096
FALSE,Uintah County,9/1/94,Hide,Hide,9,1994,9387,9387,10147,10147,1,760,760,0.074898985,0.074898985
FALSE,Uintah County,9/1/95,Hide,Hide,9,1995,9532,9532,10281,10281,1,749,749,0.072852835,0.072852835
FALSE,Uintah County,9/1/96,Hide,Hide,9,1996,9564,9564,10282,10282,1,718,718,0.069830772,0.069830772
FALSE,Uintah County,9/1/97,Hide,Hide,9,1997,10107,10107,10692,10692,1,585,585,0.054713805,0.054713805
FALSE,Uintah County,9/1/98,Hide,Hide,9,1998,10284,10284,10985,10985,1,701,701,0.063814292,0.063814292
FALSE,Uintah County,9/1/99,Hide,Hide,9,1999,10597,10597,11277,11277,1,680,680,0.060299725,0.060299725
FALSE,Uintah County,9/1/00,Hide,Hide,9,2000,10975,10975,11479,11479,1,504,504,0.043906264,0.043906264
FALSE,Uintah County,9/1/01,Hide,Hide,9,2001,11837,11837,12396,12396,1,559,559,0.045095192,0.045095192
FALSE,Uintah County,9/1/02,Hide,Hide,9,2002,11890,11890,12679,12679,1,789,789,0.062228882,0.062228882
FALSE,Uintah County,9/1/03,Hide,Hide,9,2003,12456,12456,13183,13183,1,727,727,0.05514678,0.05514678
FALSE,Uintah County,9/1/04,Hide,Hide,9,2004,13249,13249,13927,13927,1,678,678,0.048682415,0.048682415
FALSE,Uintah County,9/1/05,Hide,Hide,9,2005,14346,14346,14874,14874,1,528,528,0.035498185,0.035498185
FALSE,Uintah County,9/1/06,Hide,Hide,9,2006,16221,16221,16583,16583,1,362,362,0.021829585,0.021829585
FALSE,Uintah County,9/1/07,Hide,Hide,9,2007,16796,16796,17178,17178,1,382,382,0.022237746,0.022237746
FALSE,Uintah County,9/1/08,Hide,Hide,9,2008,18745,18745,19168,19168,1,423,423,0.02206803,0.02206803
FALSE,Uintah County,9/1/09,Hide,Hide,9,2009,15460,15460,17195,17195,1,1735,1735,0.100901425,0.100901425
FALSE,Uintah County,9/1/10,Hide,Hide,9,2010,13959,13959,15206,15206,1,1247,1247,0.082007102,0.082007102
FALSE,Uintah County,9/1/11,Hide,Hide,9,2011,14676,14676,15535,15535,1,859,859,0.055294496,0.055294496
FALSE,Uintah County,9/1/12,Hide,Hide,9,2012,15282,15282,15984,15984,1,702,702,0.043918919,0.043918919
FALSE,Uintah County,9/1/13,Hide,Hide,9,2013,14906,14906,15570,15570,1,664,664,0.042646114,0.042646114
FALSE,Uintah County,9/1/14,Hide,Hide,9,2014,15485,15485,16074,16074,1,589,589,0.036643026,0.036643026
FALSE,Uintah County,9/1/15,Hide,Hide,9,2015,13825,13825,14981,14981,1,1156,1156,0.077164408,0.077164408
FALSE,Uintah County,9/1/16,Hide,Hide,9,2016,12739,12739,13972,13972,1,1233,1233,0.088247924,0.088247924
FALSE,Uintah County,9/1/17,Hide,Hide,9,2017,12896,12896,13661,13661,1,765,765,0.055998829,0.055998829
FALSE,Uintah County,9/1/18,Hide,Hide,9,2018,12934,12934,13546,13546,1,612,612,0.045179389,0.045179389
FALSE,Uintah County,9/1/19,Hide,Hide,9,2019,13136,13136,13692,13692,1,556,556,0.040607654,0.040607654
FALSE,United States,9/1/92,Hide,Hide,9,1992,118720,118720000,128501,128501000,1,9781,9781000,0.076,0.076
FALSE,United States,9/1/93,Hide,Hide,9,1993,120554,120554000,129268,129268000,1,8714,8714000,0.067,0.067
FALSE,United States,9/1/94,Hide,Hide,9,1994,123687,123687000,131421,131421000,1,7734,7734000,0.059,0.059
FALSE,United States,9/1/95,Hide,Hide,9,1995,125133,125133000,132611,132611000,1,7478,7478000,0.056,0.056
FALSE,United States,9/1/96,Hide,Hide,9,1996,127536,127536000,134515,134515000,1,6979,6979000,0.052,0.052
FALSE,United States,9/1/97,Hide,Hide,9,1997,130019,130019000,136675,136675000,1,6656,6656000,0.049,0.049
FALSE,United States,9/1/98,Hide,Hide,9,1998,131986,131986000,138286,138286000,1,6300,6300000,0.046,0.046
FALSE,United States,9/1/99,Hide,Hide,9,1999,133707,133707000,139622,139622000,1,5915,5915000,0.042,0.042
FALSE,United States,9/1/00,Hide,Hide,9,2000,136893,136893000,142518,142518000,1,5625,5625000,0.039,0.039
FALSE,United States,9/1/01,Hide,Hide,9,2001,136846,136846000,143989,143989000,1,7142,7142000,0.05,0.05
FALSE,United States,9/1/02,Hide,Hide,9,2002,137302,137302000,145552,145552000,1,8251,8251000,0.057,0.057
FALSE,United States,9/1/03,Hide,Hide,9,2003,137609,137609000,146530,146530000,1,8921,8921000,0.061,0.061
FALSE,United States,9/1/04,Hide,Hide,9,2004,139487,139487000,147415,147415000,1,7927,7927000,0.054,0.054
FALSE,United States,9/1/05,Hide,Hide,9,2005,142401,142401000,149954,149954000,1,7553,7553000,0.05,0.05
FALSE,United States,9/1/06,Hide,Hide,9,2006,144815,144815000,151662,151662000,1,6847,6847000,0.045,0.045
FALSE,United States,9/1/07,Hide,Hide,9,2007,146244,146244000,153414,153414000,1,7170,7170000,0.047,0.047
FALSE,United States,9/1/08,Hide,Hide,9,2008,145076,145076000,154570,154570000,1,9494,9494000,0.061,0.061
FALSE,United States,9/1/09,Hide,Hide,9,2009,138818,138818000,153827,153827000,1,15009,15009000,0.098,0.098
FALSE,United States,9/1/10,Hide,Hide,9,2010,139396,139396000,153975,153975000,1,14579,14579000,0.095,0.095
FALSE,United States,9/1/11,Hide,Hide,9,2011,140183,140183000,154131,154131000,1,13948,13948000,0.09,0.09
FALSE,United States,9/1/12,Hide,Hide,9,2012,143044,143044000,155160,155160000,1,12115,12115000,0.078,0.078
FALSE,United States,9/1/13,Hide,Hide,9,2013,144418,144418000,155687,155687000,1,11270,11270000,0.072,0.072
FALSE,United States,9/1/14,Hide,Hide,9,2014,146778,146778000,156040,156040000,1,9262,9262000,0.059,0.059
FALSE,United States,9/1/15,Hide,Hide,9,2015,148826,148826000,156733,156733000,1,7907,7907000,0.05,0.05
FALSE,United States,9/1/16,Hide,Hide,9,2016,151850,151850000,159817,159817000,1,7967,7967000,0.05,0.05
FALSE,United States,9/1/17,Hide,Hide,9,2017,154371,154371000,161212,161212000,1,6841,6841000,0.042,0.042
FALSE,United States,9/1/18,Hide,Hide,9,2018,156032,156032000,162078,162078000,1,6045,6045000,0.037,0.037
FALSE,United States,9/1/19,Hide,Hide,9,2019,158298,158298000,164051,164051000,1,5753,5753000,0.035,0.035
FALSE,Utah County,9/1/92,Hide,Hide,9,1992,124266,124266,129364,129364,1,5098,5098,0.039408182,0.039408182
FALSE,Utah County,9/1/93,Hide,Hide,9,1993,133761,133761,138539,138539,1,4778,4778,0.034488483,0.034488483
FALSE,Utah County,9/1/94,Hide,Hide,9,1994,141947,141947,146613,146613,1,4666,4666,0.031825282,0.031825282
FALSE,Utah County,9/1/95,Hide,Hide,9,1995,146623,146623,150811,150811,1,4188,4188,0.027769858,0.027769858
FALSE,Utah County,9/1/96,Hide,Hide,9,1996,150371,150371,154881,154881,1,4510,4510,0.02911913,0.02911913
FALSE,Utah County,9/1/97,Hide,Hide,9,1997,154732,154732,158896,158896,1,4164,4164,0.02620582,0.02620582
FALSE,Utah County,9/1/98,Hide,Hide,9,1998,162133,162133,167352,167352,1,5219,5219,0.031185764,0.031185764
FALSE,Utah County,9/1/99,Hide,Hide,9,1999,165818,165818,170650,170650,1,4832,4832,0.028315265,0.028315265
FALSE,Utah County,9/1/00,Hide,Hide,9,2000,177161,177161,182771,182771,1,5610,5610,0.030694147,0.030694147
FALSE,Utah County,9/1/01,Hide,Hide,9,2001,175383,175383,183591,183591,1,8208,8208,0.044708074,0.044708074
FALSE,Utah County,9/1/02,Hide,Hide,9,2002,175841,175841,186958,186958,1,11117,11117,0.059462553,0.059462553
FALSE,Utah County,9/1/03,Hide,Hide,9,2003,179536,179536,189315,189315,1,9779,9779,0.05165465,0.05165465
FALSE,Utah County,9/1/04,Hide,Hide,9,2004,189889,189889,199109,199109,1,9220,9220,0.046306295,0.046306295
FALSE,Utah County,9/1/05,Hide,Hide,9,2005,199380,199380,207219,207219,1,7839,7839,0.037829543,0.037829543
FALSE,Utah County,9/1/06,Hide,Hide,9,2006,210561,210561,216261,216261,1,5700,5700,0.026357041,0.026357041
FALSE,Utah County,9/1/07,Hide,Hide,9,2007,219171,219171,224952,224952,1,5781,5781,0.025698816,0.025698816
FALSE,Utah County,9/1/08,Hide,Hide,9,2008,214911,214911,223279,223279,1,8368,8368,0.037477774,0.037477774
FALSE,Utah County,9/1/09,Hide,Hide,9,2009,204080,204080,220739,220739,1,16659,16659,0.075469219,0.075469219
FALSE,Utah County,9/1/10,Hide,Hide,9,2010,212945,212945,230103,230103,1,17158,17158,0.074566607,0.074566607
FALSE,Utah County,9/1/11,Hide,Hide,9,2011,218091,218091,232011,232011,1,13920,13920,0.059997155,0.059997155
FALSE,Utah County,9/1/12,Hide,Hide,9,2012,229459,229459,240912,240912,1,11453,11453,0.047540181,0.047540181
FALSE,Utah County,9/1/13,Hide,Hide,9,2013,240731,240731,250881,250881,1,10150,10150,0.040457428,0.040457428
FALSE,Utah County,9/1/14,Hide,Hide,9,2014,248224,248224,257030,257030,1,8806,8806,0.034260592,0.034260592
FALSE,Utah County,9/1/15,Hide,Hide,9,2015,259687,259687,268401,268401,1,8714,8714,0.032466347,0.032466347
FALSE,Utah County,9/1/16,Hide,Hide,9,2016,273218,273218,281805,281805,1,8587,8587,0.030471425,0.030471425
FALSE,Utah County,9/1/17,Hide,Hide,9,2017,284579,284579,293125,293125,1,8546,8546,0.029154797,0.029154797
FALSE,Utah County,9/1/18,Hide,Hide,9,2018,291619,291619,299982,299982,1,8363,8363,0.027878339,0.027878339
FALSE,Utah County,9/1/19,Hide,Hide,9,2019,302891,302891,309935,309935,1,7044,7044,0.022727346,0.022727346
FALSE,Wasatch County,9/1/92,Hide,Hide,9,1992,4540,4540,4849,4849,1,309,309,0.063724479,0.063724479
FALSE,Wasatch County,9/1/93,Hide,Hide,9,1993,4811,4811,5134,5134,1,323,323,0.062913907,0.062913907
FALSE,Wasatch County,9/1/94,Hide,Hide,9,1994,5137,5137,5456,5456,1,319,319,0.058467742,0.058467742
FALSE,Wasatch County,9/1/95,Hide,Hide,9,1995,5181,5181,5444,5444,1,263,263,0.048310066,0.048310066
FALSE,Wasatch County,9/1/96,Hide,Hide,9,1996,5469,5469,5709,5709,1,240,240,0.042038886,0.042038886
FALSE,Wasatch County,9/1/97,Hide,Hide,9,1997,5676,5676,5915,5915,1,239,239,0.040405748,0.040405748
FALSE,Wasatch County,9/1/98,Hide,Hide,9,1998,5858,5858,6151,6151,1,293,293,0.047634531,0.047634531
FALSE,Wasatch County,9/1/99,Hide,Hide,9,1999,5979,5979,6295,6295,1,316,316,0.05019857,0.05019857
FALSE,Wasatch County,9/1/00,Hide,Hide,9,2000,7686,7686,7979,7979,1,293,293,0.036721394,0.036721394
FALSE,Wasatch County,9/1/01,Hide,Hide,9,2001,7693,7693,8064,8064,1,371,371,0.046006944,0.046006944
FALSE,Wasatch County,9/1/02,Hide,Hide,9,2002,7790,7790,8325,8325,1,535,535,0.064264264,0.064264264
FALSE,Wasatch County,9/1/03,Hide,Hide,9,2003,8082,8082,8591,8591,1,509,509,0.05924805,0.05924805
FALSE,Wasatch County,9/1/04,Hide,Hide,9,2004,8415,8415,8878,8878,1,463,463,0.052151385,0.052151385
FALSE,Wasatch County,9/1/05,Hide,Hide,9,2005,8985,8985,9354,9354,1,369,369,0.039448364,0.039448364
FALSE,Wasatch County,9/1/06,Hide,Hide,9,2006,10051,10051,10361,10361,1,310,310,0.029919892,0.029919892
FALSE,Wasatch County,9/1/07,Hide,Hide,9,2007,10595,10595,10907,10907,1,312,312,0.028605483,0.028605483
FALSE,Wasatch County,9/1/08,Hide,Hide,9,2008,9964,9964,10383,10383,1,419,419,0.040354426,0.040354426
FALSE,Wasatch County,9/1/09,Hide,Hide,9,2009,9211,9211,10084,10084,1,873,873,0.086572789,0.086572789
FALSE,Wasatch County,9/1/10,Hide,Hide,9,2010,10369,10369,11321,11321,1,952,952,0.084091511,0.084091511
FALSE,Wasatch County,9/1/11,Hide,Hide,9,2011,10727,10727,11484,11484,1,757,757,0.065917799,0.065917799
FALSE,Wasatch County,9/1/12,Hide,Hide,9,2012,11118,11118,11771,11771,1,653,653,0.055475321,0.055475321
FALSE,Wasatch County,9/1/13,Hide,Hide,9,2013,11706,11706,12260,12260,1,554,554,0.045187602,0.045187602
FALSE,Wasatch County,9/1/14,Hide,Hide,9,2014,12310,12310,12792,12792,1,482,482,0.0376798,0.0376798
FALSE,Wasatch County,9/1/15,Hide,Hide,9,2015,12921,12921,13389,13389,1,468,468,0.034954067,0.034954067
FALSE,Wasatch County,9/1/16,Hide,Hide,9,2016,13563,13563,14022,14022,1,459,459,0.032734275,0.032734275
FALSE,Wasatch County,9/1/17,Hide,Hide,9,2017,14270,14270,14762,14762,1,492,492,0.033328817,0.033328817
FALSE,Wasatch County,9/1/18,Hide,Hide,9,2018,14795,14795,15267,15267,1,472,472,0.030916356,0.030916356
FALSE,Wasatch County,9/1/19,Hide,Hide,9,2019,15964,15964,16391,16391,1,427,427,0.026050882,0.026050882
FALSE,Washington County,9/1/92,Hide,Hide,9,1992,22330,22330,23320,23320,1,990,990,0.04245283,0.04245283
FALSE,Washington County,9/1/93,Hide,Hide,9,1993,26226,26226,27141,27141,1,915,915,0.033712833,0.033712833
FALSE,Washington County,9/1/94,Hide,Hide,9,1994,30196,30196,31182,31182,1,986,986,0.031620807,0.031620807
FALSE,Washington County,9/1/95,Hide,Hide,9,1995,32142,32142,33221,33221,1,1079,1079,0.032479456,0.032479456
FALSE,Washington County,9/1/96,Hide,Hide,9,1996,33816,33816,35015,35015,1,1199,1199,0.034242468,0.034242468
FALSE,Washington County,9/1/97,Hide,Hide,9,1997,34498,34498,35683,35683,1,1185,1185,0.033209091,0.033209091
FALSE,Washington County,9/1/98,Hide,Hide,9,1998,36169,36169,37613,37613,1,1444,1444,0.038390982,0.038390982
FALSE,Washington County,9/1/99,Hide,Hide,9,1999,37667,37667,38981,38981,1,1314,1314,0.03370873,0.03370873
FALSE,Washington County,9/1/00,Hide,Hide,9,2000,38269,38269,39700,39700,1,1431,1431,0.03604534,0.03604534
FALSE,Washington County,9/1/01,Hide,Hide,9,2001,40715,40715,42480,42480,1,1765,1765,0.041548964,0.041548964
FALSE,Washington County,9/1/02,Hide,Hide,9,2002,42880,42880,45407,45407,1,2527,2527,0.055652212,0.055652212
FALSE,Washington County,9/1/03,Hide,Hide,9,2003,45585,45585,48108,48108,1,2523,2523,0.0524445,0.0524445
FALSE,Washington County,9/1/04,Hide,Hide,9,2004,50616,50616,53121,53121,1,2505,2505,0.047156492,0.047156492
FALSE,Washington County,9/1/05,Hide,Hide,9,2005,55572,55572,57834,57834,1,2262,2262,0.039111941,0.039111941
FALSE,Washington County,9/1/06,Hide,Hide,9,2006,60000,60000,61768,61768,1,1768,1768,0.028623235,0.028623235
FALSE,Washington County,9/1/07,Hide,Hide,9,2007,62338,62338,64153,64153,1,1815,1815,0.02829174,0.02829174
FALSE,Washington County,9/1/08,Hide,Hide,9,2008,57811,57811,61152,61152,1,3341,3341,0.054634354,0.054634354
FALSE,Washington County,9/1/09,Hide,Hide,9,2009,53271,53271,59407,59407,1,6136,6136,0.103287491,0.103287491
FALSE,Washington County,9/1/10,Hide,Hide,9,2010,50657,50657,56609,56609,1,5952,5952,0.105142292,0.105142292
FALSE,Washington County,9/1/11,Hide,Hide,9,2011,51205,51205,55924,55924,1,4719,4719,0.084382376,0.084382376
FALSE,Washington County,9/1/12,Hide,Hide,9,2012,53901,53901,57651,57651,1,3750,3750,0.065046573,0.065046573
FALSE,Washington County,9/1/13,Hide,Hide,9,2013,56750,56750,59868,59868,1,3118,3118,0.052081245,0.052081245
FALSE,Washington County,9/1/14,Hide,Hide,9,2014,59185,59185,61859,61859,1,2674,2674,0.04322734,0.04322734
FALSE,Washington County,9/1/15,Hide,Hide,9,2015,61476,61476,64058,64058,1,2582,2582,0.040307222,0.040307222
FALSE,Washington County,9/1/16,Hide,Hide,9,2016,65598,65598,68065,68065,1,2467,2467,0.036244766,0.036244766
FALSE,Washington County,9/1/17,Hide,Hide,9,2017,68821,68821,71306,71306,1,2485,2485,0.034849802,0.034849802
FALSE,Washington County,9/1/18,Hide,Hide,9,2018,72162,72162,74659,74659,1,2497,2497,0.033445398,0.033445398
FALSE,Washington County,9/1/19,Hide,Hide,9,2019,74607,74607,76780,76780,1,2173,2173,0.028301641,0.028301641
FALSE,Wayne County,9/1/92,Hide,Hide,9,1992,980,980,1063,1063,1,83,83,0.078080903,0.078080903
FALSE,Wayne County,9/1/93,Hide,Hide,9,1993,1045,1045,1117,1117,1,72,72,0.064458371,0.064458371
FALSE,Wayne County,9/1/94,Hide,Hide,9,1994,1098,1098,1192,1192,1,94,94,0.07885906,0.07885906
FALSE,Wayne County,9/1/95,Hide,Hide,9,1995,1273,1273,1366,1366,1,93,93,0.068081991,0.068081991
FALSE,Wayne County,9/1/96,Hide,Hide,9,1996,1263,1263,1332,1332,1,69,69,0.051801802,0.051801802
FALSE,Wayne County,9/1/97,Hide,Hide,9,1997,1356,1356,1420,1420,1,64,64,0.045070423,0.045070423
FALSE,Wayne County,9/1/98,Hide,Hide,9,1998,1364,1364,1460,1460,1,96,96,0.065753425,0.065753425
FALSE,Wayne County,9/1/99,Hide,Hide,9,1999,1409,1409,1480,1480,1,71,71,0.047972973,0.047972973
FALSE,Wayne County,9/1/00,Hide,Hide,9,2000,1258,1258,1319,1319,1,61,61,0.046247157,0.046247157
FALSE,Wayne County,9/1/01,Hide,Hide,9,2001,1434,1434,1500,1500,1,66,66,0.044,0.044
FALSE,Wayne County,9/1/02,Hide,Hide,9,2002,1299,1299,1397,1397,1,98,98,0.070150322,0.070150322
FALSE,Wayne County,9/1/03,Hide,Hide,9,2003,1206,1206,1302,1302,1,96,96,0.073732719,0.073732719
FALSE,Wayne County,9/1/04,Hide,Hide,9,2004,1245,1245,1333,1333,1,88,88,0.066016504,0.066016504
FALSE,Wayne County,9/1/05,Hide,Hide,9,2005,1287,1287,1359,1359,1,72,72,0.052980132,0.052980132
FALSE,Wayne County,9/1/06,Hide,Hide,9,2006,1331,1331,1387,1387,1,56,56,0.04037491,0.04037491
FALSE,Wayne County,9/1/07,Hide,Hide,9,2007,1320,1320,1378,1378,1,58,58,0.042089985,0.042089985
FALSE,Wayne County,9/1/08,Hide,Hide,9,2008,1342,1342,1426,1426,1,84,84,0.058906031,0.058906031
FALSE,Wayne County,9/1/09,Hide,Hide,9,2009,1373,1373,1496,1496,1,123,123,0.082219251,0.082219251
FALSE,Wayne County,9/1/10,Hide,Hide,9,2010,1450,1450,1589,1589,1,139,139,0.0874764,0.0874764
FALSE,Wayne County,9/1/11,Hide,Hide,9,2011,1230,1230,1381,1381,1,151,151,0.109341057,0.109341057
FALSE,Wayne County,9/1/12,Hide,Hide,9,2012,1213,1213,1364,1364,1,151,151,0.110703812,0.110703812
FALSE,Wayne County,9/1/13,Hide,Hide,9,2013,1248,1248,1399,1399,1,151,151,0.107934239,0.107934239
FALSE,Wayne County,9/1/14,Hide,Hide,9,2014,1242,1242,1371,1371,1,129,129,0.094091904,0.094091904
FALSE,Wayne County,9/1/15,Hide,Hide,9,2015,1295,1295,1420,1420,1,125,125,0.088028169,0.088028169
FALSE,Wayne County,9/1/16,Hide,Hide,9,2016,1303,1303,1414,1414,1,111,111,0.078500707,0.078500707
FALSE,Wayne County,9/1/17,Hide,Hide,9,2017,1369,1369,1474,1474,1,105,105,0.071234735,0.071234735
FALSE,Wayne County,9/1/18,Hide,Hide,9,2018,1333,1333,1411,1411,1,78,78,0.055279943,0.055279943
FALSE,Wayne County,9/1/19,Hide,Hide,9,2019,1348,1348,1422,1422,1,74,74,0.052039381,0.052039381
FALSE,Weber County,9/1/92,Hide,Hide,9,1992,78932,78932,84011,84011,1,5079,5079,0.060456369,0.060456369
FALSE,Weber County,9/1/93,Hide,Hide,9,1993,84481,84481,88854,88854,1,4373,4373,0.049215567,0.049215567
FALSE,Weber County,9/1/94,Hide,Hide,9,1994,88260,88260,92521,92521,1,4261,4261,0.046054409,0.046054409
FALSE,Weber County,9/1/95,Hide,Hide,9,1995,88826,88826,92569,92569,1,3743,3743,0.040434703,0.040434703
FALSE,Weber County,9/1/96,Hide,Hide,9,1996,92672,92672,96646,96646,1,3974,3974,0.041119136,0.041119136
FALSE,Weber County,9/1/97,Hide,Hide,9,1997,95616,95616,99569,99569,1,3953,3953,0.039701112,0.039701112
FALSE,Weber County,9/1/98,Hide,Hide,9,1998,96872,96872,101720,101720,1,4848,4848,0.047660244,0.047660244
FALSE,Weber County,9/1/99,Hide,Hide,9,1999,98639,98639,103098,103098,1,4459,4459,0.043250112,0.043250112
FALSE,Weber County,9/1/00,Hide,Hide,9,2000,95890,95890,100344,100344,1,4454,4454,0.044387308,0.044387308
FALSE,Weber County,9/1/01,Hide,Hide,9,2001,96229,96229,101555,101555,1,5326,5326,0.052444488,0.052444488
FALSE,Weber County,9/1/02,Hide,Hide,9,2002,97851,97851,104431,104431,1,6580,6580,0.063008111,0.063008111
FALSE,Weber County,9/1/03,Hide,Hide,9,2003,99162,99162,105927,105927,1,6765,6765,0.063864737,0.063864737
FALSE,Weber County,9/1/04,Hide,Hide,9,2004,101702,101702,107317,107317,1,5615,5615,0.052321627,0.052321627
FALSE,Weber County,9/1/05,Hide,Hide,9,2005,103945,103945,108853,108853,1,4908,4908,0.04508833,0.04508833
FALSE,Weber County,9/1/06,Hide,Hide,9,2006,106625,106625,109945,109945,1,3320,3320,0.030196917,0.030196917
FALSE,Weber County,9/1/07,Hide,Hide,9,2007,109627,109627,113421,113421,1,3794,3794,0.033450596,0.033450596
FALSE,Weber County,9/1/08,Hide,Hide,9,2008,108723,108723,113883,113883,1,5160,5160,0.04530966,0.04530966
FALSE,Weber County,9/1/09,Hide,Hide,9,2009,103994,103994,114061,114061,1,10067,10067,0.088259791,0.088259791
FALSE,Weber County,9/1/10,Hide,Hide,9,2010,103340,103340,113387,113387,1,10047,10047,0.088608041,0.088608041
FALSE,Weber County,9/1/11,Hide,Hide,9,2011,104089,104089,112597,112597,1,8508,8508,0.075561516,0.075561516
FALSE,Weber County,9/1/12,Hide,Hide,9,2012,106663,106663,113538,113538,1,6875,6875,0.060552414,0.060552414
FALSE,Weber County,9/1/13,Hide,Hide,9,2013,108908,108908,114870,114870,1,5962,5962,0.05190215,0.05190215
FALSE,Weber County,9/1/14,Hide,Hide,9,2014,110032,110032,115083,115083,1,5051,5051,0.043890062,0.043890062
FALSE,Weber County,9/1/15,Hide,Hide,9,2015,112736,112736,117492,117492,1,4756,4756,0.040479352,0.040479352
FALSE,Weber County,9/1/16,Hide,Hide,9,2016,116602,116602,121102,121102,1,4500,4500,0.037158759,0.037158759
FALSE,Weber County,9/1/17,Hide,Hide,9,2017,119091,119091,123705,123705,1,4614,4614,0.037298412,0.037298412
FALSE,Weber County,9/1/18,Hide,Hide,9,2018,120763,120763,125018,125018,1,4255,4255,0.034035099,0.034035099
FALSE,Weber County,9/1/19,Hide,Hide,9,2019,124677,124677,128030,128030,1,3353,3353,0.026189174,0.026189174