"state_fips","whole_fips","labor_force","employed","unemployed","unemployment_rate"
"01","01001",25215,22321,2894,11.5
"01","01003",91688,77301,14387,15.7
"01","01005",8101,7292,809,10
"01","01007",9041,7437,1604,17.7
"01","01009",23980,21711,2269,9.5
"01","01011",4335,3942,393,9.1
"01","01013",9617,7714,1903,19.8
"01","01015",47701,38939,8762,18.4
"01","01017",16287,13776,2511,15.4
"01","01019",12493,11071,1422,11.4
"01","01021",19351,16993,2358,12.2
"01","01023",4283,3774,509,11.9
"01","01025",7403,6296,1107,15
"01","01027",5782,5247,535,9.3
"01","01029",5503,4815,688,12.5
"01","01031",20174,18267,1907,9.5
"01","01033",23701,19788,3913,16.5
"01","01035",4483,3818,665,14.8
"01","01037",4441,3862,579,13
"01","01039",14576,13034,1542,10.6
"01","01041",6447,5441,1006,15.6
"01","01043",37900,33450,4450,11.7
"01","01045",19387,17547,1840,9.5
"01","01047",15427,12202,3225,20.9
"01","01049",30168,26644,3524,11.7
"01","01051",36122,32104,4018,11.1
"01","01053",14046,12448,1598,11.4
"01","01055",44060,35776,8284,18.8
"01","01057",6332,5631,701,11.1
"01","01059",14118,12529,1589,11.3
"01","01061",10044,9235,809,8.1
"01","01063",3114,2424,690,22.2
"01","01065",6374,5044,1330,20.9
"01","01067",6372,5784,588,9.2
"01","01069",43726,38906,4820,11
"01","01071",22696,19685,3011,13.3
"01","01073",313537,273910,39627,12.6
"01","01075",5614,4988,626,11.2
"01","01077",41834,35740,6094,14.6
"01","01079",13405,11832,1573,11.7
"01","01081",74057,64841,9216,12.4
"01","01083",42808,37910,4898,11.4
"01","01085",4006,2964,1042,26
"01","01087",8269,6718,1551,18.8
"01","01089",179201,160476,18725,10.4
"01","01091",7330,6459,871,11.9
"01","01093",12517,11127,1390,11.1
"01","01095",42915,38192,4723,11
"01","01097",186844,158671,28173,15.1
"01","01099",7401,6224,1177,15.9
"01","01101",106077,90087,15990,15.1
"01","01103",54744,48573,6171,11.3
"01","01105",3532,2795,737,20.9
"01","01107",7688,6589,1099,14.3
"01","01109",14774,13431,1343,9.1
"01","01111",9361,8210,1151,12.3
"01","01113",22199,19924,2275,10.2
"01","01115",40125,34839,5286,13.2
"01","01117",110465,100282,10183,9.2
"01","01119",4675,4090,585,12.5
"01","01121",37932,30391,7541,19.9
"01","01123",19109,15985,3124,16.3
"01","01125",106255,88367,17888,16.8
"01","01127",24827,21624,3203,12.9
"01","01129",6466,5654,812,12.6
"01","01131",2886,2227,659,22.8
"01","01133",9827,8807,1020,10.4
"02","02013",2159,1935,224,10.4
"02","02016",3847,3674,173,4.5
"02","02020",143916,123911,20005,13.9
"02","02050",6678,5835,843,12.6
"02","02060",406,365,41,10.1
"02","02068",673,508,165,24.5
"02","02070",1837,1661,176,9.6
"02","02090",42769,37960,4809,11.2
"02","02100",1022,743,279,27.3
"02","02105",942,772,170,18
"02","02110",16338,14577,1761,10.8
"02","02122",24197,20041,4156,17.2
"02","02130",6241,5163,1078,17.3
"02","02150",5497,4913,584,10.6
"02","02158",2536,2019,517,20.4
"02","02164",614,527,87,14.2
"02","02170",45913,38775,7138,15.5
"02","02180",3897,3405,492,12.6
"02","02185",3289,3107,182,5.5
"02","02188",2768,2367,401,14.5
"02","02195",1293,1092,201,15.5
"02","02198",2639,2281,358,13.6
"02","02220",4063,3544,519,12.8
"02","02230",671,460,211,31.4
"02","02240",2570,2300,270,10.5
"02","02261",4352,3744,608,14
"02","02275",939,801,138,14.7
"02","02282",311,283,28,9
"02","02290",2368,2004,364,15.4
"04","04001",20206,17086,3120,15.4
"04","04003",51362,45833,5529,10.8
"04","04005",72728,60426,12302,16.9
"04","04007",21275,18816,2459,11.6
"04","04009",15506,14337,1169,7.5
"04","04011",4595,4353,242,5.3
"04","04012",9131,8357,774,8.5
"04","04013",2309037,2023872,285165,12.3
"04","04015",88406,72209,16197,18.3
"04","04017",40409,34728,5681,14.1
"04","04019",496958,434139,62819,12.6
"04","04021",183823,161994,21829,11.9
"04","04023",19555,16513,3042,15.6
"04","04025",110896,95552,15344,13.8
"04","04027",97390,74908,22482,23.1
"05","05001",8817,8368,449,5.1
"05","05003",7234,6320,914,12.6
"05","05005",15910,14207,1703,10.7
"05","05007",130669,120253,10416,8
"05","05009",15883,14181,1702,10.7
"05","05011",4393,3919,474,10.8
"05","05013",2311,2139,172,7.4
"05","05015",12569,11231,1338,10.6
"05","05017",3075,2644,431,14
"05","05019",9312,8452,860,9.2
"05","05021",5334,4859,475,8.9
"05","05023",9334,7844,1490,16
"05","05025",3021,2745,276,9.1
"05","05027",8983,8131,852,9.5
"05","05029",8107,7194,913,11.3
"05","05031",54418,49399,5019,9.2
"05","05033",25653,23208,2445,9.5
"05","05035",20921,18020,2901,13.9
"05","05037",7240,6478,762,10.5
"05","05039",2656,2411,245,9.2
"05","05041",5106,4617,489,9.6
"05","05043",7528,6712,816,10.8
"05","05045",60024,53537,6487,10.8
"05","05047",7186,6553,633,8.8
"05","05049",4781,4420,361,7.6
"05","05051",40003,33887,6116,15.3
"05","05053",7851,7200,651,8.3
"05","05055",19693,17578,2115,10.7
"05","05057",9412,8596,816,8.7
"05","05059",13492,12075,1417,10.5
"05","05061",5333,4898,435,8.2
"05","05063",16688,14711,1977,11.8
"05","05065",4814,4152,662,13.8
"05","05067",5402,4835,567,10.5
"05","05069",26039,23272,2767,10.6
"05","05071",9989,8857,1132,11.3
"05","05073",2360,2114,246,10.4
"05","05075",6697,6060,637,9.5
"05","05077",2648,2383,265,10
"05","05079",3693,3352,341,9.2
"05","05081",5143,4586,557,10.8
"05","05083",8235,7208,1027,12.5
"05","05085",32581,29506,3075,9.4
"05","05087",6911,6507,404,5.8
"05","05089",6331,5763,568,9
"05","05091",19080,16444,2636,13.8
"05","05093",17062,14822,2240,13.1
"05","05095",2611,2391,220,8.4
"05","05097",2773,2483,290,10.5
"05","05099",3478,3159,319,9.2
"05","05101",3228,2933,295,9.1
"05","05103",9436,8523,913,9.7
"05","05105",4022,3625,397,9.9
"05","05107",6170,5312,858,13.9
"05","05109",4075,3716,359,8.8
"05","05111",9840,9059,781,7.9
"05","05113",7806,6988,818,10.5
"05","05115",28071,25390,2681,9.6
"05","05117",3379,3129,250,7.4
"05","05119",184178,162476,21702,11.8
"05","05121",7196,6493,703,9.8
"05","05123",7961,7013,948,11.9
"05","05125",55862,50789,5073,9.1
"05","05127",4100,3846,254,6.2
"05","05129",2793,2488,305,10.9
"05","05131",54975,48886,6089,11.1
"05","05133",5226,4790,436,8.3
"05","05135",5619,4980,639,11.4
"05","05137",4584,4041,543,11.8
"05","05139",15225,13422,1803,11.8
"05","05141",5595,4945,650,11.6
"05","05143",119589,109705,9884,8.3
"05","05145",32600,29313,3287,10.1
"05","05147",2575,2365,210,8.2
"05","05149",8005,7415,590,7.4
"06","06001",800321,687821,112500,14.1
"06","06003",484,377,107,22.1
"06","06005",14391,12337,2054,14.3
"06","06007",98272,83668,14604,14.9
"06","06009",20564,17830,2734,13.3
"06","06011",11234,8274,2960,26.3
"06","06013",534109,456473,77636,14.5
"06","06015",9481,8241,1240,13.1
"06","06017",88112,74585,13527,15.4
"06","06019",457591,381109,76482,16.7
"06","06021",11304,9472,1832,16.2
"06","06023",62799,54195,8604,13.7
"06","06025",71484,51437,20047,28
"06","06027",8161,7041,1120,13.7
"06","06029",375771,305988,69783,18.6
"06","06031",58251,48441,9810,16.8
"06","06033",28316,24003,4313,15.2
"06","06035",8942,7902,1040,11.6
"06","06037",4759763,3791378,968385,20.3
"06","06039",63051,52601,10450,16.6
"06","06041",128788,114476,14312,11.1
"06","06043",7805,6413,1392,17.8
"06","06045",37245,31722,5523,14.8
"06","06047",116325,94488,21837,18.8
"06","06049",3044,2609,435,14.3
"06","06051",8170,6361,1809,22.1
"06","06053",207418,165571,41847,20.2
"06","06055",72717,61172,11545,15.9
"06","06057",45085,38554,6531,14.5
"06","06059",1529552,1317796,211756,13.8
"06","06061",176640,153204,23436,13.3
"06","06063",6890,5479,1411,20.5
"06","06065",1100140,931311,168829,15.3
"06","06067",677062,577737,99325,14.7
"06","06069",30755,24657,6098,19.8
"06","06071",947393,820692,126701,13.4
"06","06073",1543403,1312081,231322,15
"06","06075",551425,482070,69355,12.6
"06","06077",317154,259140,58014,18.3
"06","06079",135095,116543,18552,13.7
"06","06081",429534,380609,48925,11.4
"06","06083",215401,185864,29537,13.7
"06","06085",1013319,894471,118848,11.7
"06","06087",132798,109656,23142,17.4
"06","06089",70622,59394,11228,15.9
"06","06091",1234,1059,175,14.2
"06","06093",16583,13958,2625,15.8
"06","06095",203007,172744,30263,14.9
"06","06097",235793,199847,35946,15.2
"06","06099",239405,198593,40812,17
"06","06101",46076,37820,8256,17.9
"06","06103",25240,21576,3664,14.5
"06","06105",4348,3792,556,12.8
"06","06107",200705,162559,38146,19
"06","06109",21835,18090,3745,17.2
"06","06111",409293,351876,57417,14
"06","06113",99381,87530,11851,11.9
"06","06115",30349,25545,4804,15.8
"08","08001",269354,235826,33528,12.4
"08","08003",7660,6941,719,9.4
"08","08005",360277,316106,44171,12.3
"08","08007",6394,5374,1020,16
"08","08009",1840,1790,50,2.7
"08","08011",1663,1579,84,5.1
"08","08013",191331,172831,18500,9.7
"08","08014",39117,34846,4271,10.9
"08","08015",8874,7715,1159,13.1
"08","08017",1033,1008,25,2.4
"08","08019",6223,5256,967,15.5
"08","08021",3658,3354,304,8.3
"08","08023",1635,1504,131,8
"08","08025",1274,1191,83,6.5
"08","08027",1785,1657,128,7.2
"08","08029",12781,11476,1305,10.2
"08","08031",416427,361425,55002,13.2
"08","08033",1057,924,133,12.6
"08","08035",187467,168905,18562,9.9
"08","08037",37488,29818,7670,20.5
"08","08039",14358,13285,1073,7.5
"08","08041",335350,294308,41042,12.2
"08","08043",13341,11650,1691,12.7
"08","08045",29855,25866,3989,13.4
"08","08047",4271,3290,981,23
"08","08049",9269,7510,1759,19
"08","08051",10687,8981,1706,16
"08","08053",291,266,25,8.6
"08","08055",2192,1920,272,12.4
"08","08057",883,818,65,7.4
"08","08059",330351,291065,39286,11.9
"08","08061",851,829,22,2.6
"08","08063",3704,3561,143,3.9
"08","08065",4844,4035,809,16.7
"08","08067",28940,25079,3861,13.3
"08","08069",201895,179757,22138,11
"08","08071",5833,5219,614,10.5
"08","08073",1985,1863,122,6.1
"08","08075",9467,8806,661,7
"08","08077",73342,64072,9270,12.6
"08","08079",467,418,49,10.5
"08","08081",6341,5675,666,10.5
"08","08083",11314,9970,1344,11.9
"08","08085",19782,17410,2372,12
"08","08087",14281,13314,967,6.8
"08","08089",7289,6736,553,7.6
"08","08091",2210,1800,410,18.6
"08","08093",10790,9720,1070,9.9
"08","08095",2264,2178,86,3.8
"08","08097",11604,8921,2683,23.1
"08","08099",5536,5259,277,5
"08","08101",72044,63579,8465,11.7
"08","08103",2638,2445,193,7.3
"08","08105",4897,4375,522,10.7
"08","08107",15851,13038,2813,17.7
"08","08109",3186,2963,223,7
"08","08111",447,384,63,14.1
"08","08113",6022,4679,1343,22.3
"08","08115",1094,1051,43,3.9
"08","08117",23810,18782,5028,21.1
"08","08119",12942,11028,1914,14.8
"08","08121",2460,2370,90,3.7
"08","08123",165122,148975,16147,9.8
"08","08125",5240,5069,171,3.3
"09","09001",432344,398691,33653,7.8
"09","09003",456005,420248,35757,7.8
"09","09005",96900,89735,7165,7.4
"09","09007",88043,82021,6022,6.8
"09","09009",427171,393731,33440,7.8
"09","09011",120257,105712,14545,12.1
"09","09013",81576,76298,5278,6.5
"09","09015",59472,54670,4802,8.1
"10","10001",78850,66370,12480,15.8
"10","10003",283987,244003,39984,14.1
"10","10005",100509,84463,16046,16
"11","11001",403204,358366,44838,11.1
"12","12001",124349,113209,11140,9
"12","12003",10283,9500,783,7.6
"12","12005",76916,67038,9878,12.8
"12","12007",9871,9029,842,8.5
"12","12009",268858,234043,34815,12.9
"12","12011",935487,799479,136008,14.5
"12","12013",4234,3893,341,8.1
"12","12015",64362,54296,10066,15.6
"12","12017",44560,37536,7024,15.8
"12","12019",96175,86381,9794,10.2
"12","12021",164585,142513,22072,13.4
"12","12023",26743,24182,2561,9.6
"12","12027",13573,12565,1008,7.4
"12","12029",5231,4816,415,7.9
"12","12031",443680,393536,50144,11.3
"12","12033",137914,120324,17590,12.8
"12","12035",44185,37390,6795,15.4
"12","12037",4136,3711,425,10.3
"12","12039",16836,15562,1274,7.6
"12","12041",6258,5743,515,8.2
"12","12043",4920,4568,352,7.2
"12","12045",5017,4545,472,9.4
"12","12047",3840,3456,384,10
"12","12049",7916,7274,642,8.1
"12","12051",14421,12914,1507,10.5
"12","12053",66987,56966,10021,15
"12","12055",33475,29656,3819,11.4
"12","12057",684108,601754,82354,12
"12","12059",6294,5713,581,9.2
"12","12061",61883,53142,8741,14.1
"12","12063",15305,14081,1224,8
"12","12065",4997,4613,384,7.7
"12","12067",2495,2357,138,5.5
"12","12069",143756,122638,21118,14.7
"12","12071",321446,274556,46890,14.6
"12","12073",138628,127243,11385,8.2
"12","12075",15172,13508,1664,11
"12","12077",2323,2160,163,7
"12","12079",6645,6107,538,8.1
"12","12081",161474,139654,21820,13.5
"12","12083",129422,113768,15654,12.1
"12","12085",68784,60572,8212,11.9
"12","12086",1215918,1071624,144294,11.9
"12","12087",46816,38609,8207,17.5
"12","12089",37751,33054,4697,12.4
"12","12091",88976,77171,11805,13.3
"12","12093",15858,14573,1285,8.1
"12","12095",703093,587057,116036,16.5
"12","12097",177131,141222,35909,20.3
"12","12099",653719,562585,91134,13.9
"12","12101",220731,190035,30696,13.9
"12","12103",460388,396407,63981,13.9
"12","12105",285778,247526,38252,13.4
"12","12107",24022,21391,2631,11
"12","12109",120714,106702,14012,11.6
"12","12111",137026,117542,19484,14.2
"12","12113",76550,68484,8066,10.5
"12","12115",171832,146394,25438,14.8
"12","12117",226241,196612,29629,13.1
"12","12119",29930,26241,3689,12.3
"12","12121",16181,14812,1369,8.5
"12","12123",7447,6866,581,7.8
"12","12125",4136,3827,309,7.5
"12","12127",237582,202847,34735,14.6
"12","12129",13298,12256,1042,7.8
"12","12131",29357,25098,4259,14.5
"12","12133",8680,7797,883,10.2
"13","13001",9275,8599,676,7.3
"13","13003",4309,3977,332,7.7
"13","13005",4777,4416,361,7.6
"13","13007",1082,993,89,8.2
"13","13009",17605,15758,1847,10.5
"13","13011",9595,8697,898,9.4
"13","13013",38118,33636,4482,11.8
"13","13015",49179,41920,7259,14.8
"13","13017",5308,4720,588,11.1
"13","13019",7590,6521,1069,14.1
"13","13021",64500,57023,7477,11.6
"13","13023",4284,3883,401,9.4
"13","13025",6082,5382,700,11.5
"13","13027",6378,5892,486,7.6
"13","13029",16677,14575,2102,12.6
"13","13031",36601,32427,4174,11.4
"13","13033",8510,7618,892,10.5
"13","13035",10059,8903,1156,11.5
"13","13037",2239,2099,140,6.3
"13","13039",19963,18063,1900,9.5
"13","13043",5555,5173,382,6.9
"13","13045",52476,45688,6788,12.9
"13","13047",32079,28881,3198,10
"13","13049",4477,4220,257,5.7
"13","13051",132629,110868,21761,16.4
"13","13053",1829,1632,197,10.8
"13","13055",10270,8510,1760,17.1
"13","13057",127165,113034,14131,11.1
"13","13059",55913,49024,6889,12.3
"13","13061",947,776,171,18.1
"13","13063",134591,113093,21498,16
"13","13065",2512,2329,183,7.3
"13","13067",398651,353055,45596,11.4
"13","13069",18800,16947,1853,9.9
"13","13071",20765,19225,1540,7.4
"13","13073",69464,63369,6095,8.8
"13","13075",7955,7317,638,8
"13","13077",71382,62040,9342,13.1
"13","13079",5246,4745,501,9.6
"13","13081",9447,8520,927,9.8
"13","13083",7592,7006,586,7.7
"13","13085",11650,10248,1402,12
"13","13087",11138,10348,790,7.1
"13","13089",380317,330105,50212,13.2
"13","13091",6480,5939,541,8.3
"13","13093",5231,4444,787,15
"13","13095",36159,31538,4621,12.8
"13","13097",69181,60455,8726,12.6
"13","13099",4225,3992,233,5.5
"13","13101",1774,1663,111,6.3
"13","13103",27978,24651,3327,11.9
"13","13105",7878,6877,1001,12.7
"13","13107",7961,7223,738,9.3
"13","13109",4728,4363,365,7.7
"13","13111",12355,11198,1157,9.4
"13","13113",53580,48177,5403,10.1
"13","13115",44399,38427,5972,13.5
"13","13117",113551,101691,11860,10.4
"13","13119",10117,8954,1163,11.5
"13","13121",533726,460297,73429,13.8
"13","13123",11263,10032,1231,10.9
"13","13125",1188,1107,81,6.8
"13","13127",34666,28775,5891,17
"13","13129",29023,25332,3691,12.7
"13","13131",10222,9350,872,8.5
"13","13133",7130,6400,730,10.2
"13","13135",463600,406251,57349,12.4
"13","13137",18777,16745,2032,10.8
"13","13139",96929,86663,10266,10.6
"13","13141",2488,2201,287,11.5
"13","13143",11857,10385,1472,12.4
"13","13145",15277,13738,1539,10.1
"13","13147",10975,9846,1129,10.3
"13","13149",5128,4355,773,15.1
"13","13151",110250,95503,14747,13.4
"13","13153",65322,58646,6676,10.2
"13","13155",3344,3050,294,8.8
"13","13157",35877,31860,4017,11.2
"13","13159",6381,5776,605,9.5
"13","13161",5839,5333,506,8.7
"13","13163",6453,5837,616,9.5
"13","13165",2978,2725,253,8.5
"13","13167",3884,3586,298,7.7
"13","13169",12630,11610,1020,8.1
"13","13171",7560,6766,794,10.5
"13","13173",3497,3140,357,10.2
"13","13175",18976,16798,2178,11.5
"13","13177",13620,12329,1291,9.5
"13","13179",24694,22176,2518,10.2
"13","13181",3297,3002,295,8.9
"13","13183",7515,6950,565,7.5
"13","13185",48009,43035,4974,10.4
"13","13187",16217,14442,1775,10.9
"13","13189",8500,7322,1178,13.9
"13","13191",5192,4590,602,11.6
"13","13193",4519,4106,413,9.1
"13","13195",12408,11066,1342,10.8
"13","13197",2925,2697,228,7.8
"13","13199",8682,7306,1376,15.8
"13","13201",2632,2503,129,4.9
"13","13205",8079,7420,659,8.2
"13","13207",12126,10997,1129,9.3
"13","13209",3800,3474,326,8.6
"13","13211",8728,7703,1025,11.7
"13","13213",15701,12542,3159,20.1
"13","13215",72629,62805,9824,13.5
"13","13217",49108,43019,6089,12.4
"13","13219",17936,16340,1596,8.9
"13","13221",6420,5806,614,9.6
"13","13223",80541,71473,9068,11.3
"13","13225",11038,9829,1209,11
"13","13227",14200,12687,1513,10.7
"13","13229",8352,7649,703,8.4
"13","13231",8229,7396,833,10.1
"13","13233",18059,15905,2154,11.9
"13","13235",3644,3380,264,7.2
"13","13237",7961,7020,941,11.8
"13","13239",730,692,38,5.2
"13","13241",7174,6263,911,12.7
"13","13243",2462,2292,170,6.9
"13","13245",80791,70756,10035,12.4
"13","13247",42184,36862,5322,12.6
"13","13249",2141,2018,123,5.7
"13","13251",5113,4445,668,13.1
"13","13253",2969,2764,205,6.9
"13","13255",27057,23591,3466,12.8
"13","13257",10918,9615,1303,11.9
"13","13259",2463,2291,172,7
"13","13261",12785,11556,1229,9.6
"13","13263",2643,2316,327,12.4
"13","13265",572,511,61,10.7
"13","13267",9023,8436,587,6.5
"13","13269",2791,2493,298,10.7
"13","13271",3650,3205,445,12.2
"13","13273",3192,2888,304,9.5
"13","13275",16482,14784,1698,10.3
"13","13277",19923,18174,1749,8.8
"13","13279",12096,10633,1463,12.1
"13","13281",3820,3275,545,14.3
"13","13283",2621,2349,272,10.4
"13","13285",39820,33682,6138,15.4
"13","13287",3166,2832,334,10.5
"13","13289",2677,2390,287,10.7
"13","13291",10302,9331,971,9.4
"13","13293",11179,9805,1374,12.3
"13","13295",30181,26891,3290,10.9
"13","13297",43471,38223,5248,12.1
"13","13299",15270,13653,1617,10.6
"13","13301",2744,2457,287,10.5
"13","13303",6604,5997,607,9.2
"13","13305",10974,9860,1114,10.2
"13","13307",968,910,58,6
"13","13309",1585,1429,156,9.8
"13","13311",16740,14945,1795,10.7
"13","13313",44568,35381,9187,20.6
"13","13315",2604,2415,189,7.3
"13","13317",3799,3474,325,8.6
"13","13319",3849,3579,270,7
"13","13321",8165,7440,725,8.9
"15","15001",85957,65290,20667,24
"15","15003",419548,335666,83882,20
"15","15007",36254,23766,12488,34.4
"15","15009",91266,59324,31942,35
"16","16001",256544,225376,31168,12.1
"16","16003",1746,1367,379,21.7
"16","16005",41492,37405,4087,9.9
"16","16007",2867,2625,242,8.4
"16","16009",4202,3443,759,18.1
"16","16011",23186,21663,1523,6.6
"16","16013",13434,10403,3031,22.6
"16","16015",3678,3074,604,16.4
"16","16017",20677,17015,3662,17.7
"16","16019",58896,54067,4829,8.2
"16","16021",5331,4686,645,12.1
"16","16023",1416,1338,78,5.5
"16","16025",719,624,95,13.2
"16","16027",105312,92096,13216,12.5
"16","16029",3927,3668,259,6.6
"16","16031",11684,10821,863,7.4
"16","16033",363,343,20,5.5
"16","16035",2892,2346,546,18.9
"16","16037",1972,1768,204,10.3
"16","16039",11242,10155,1087,9.7
"16","16041",7160,6577,583,8.1
"16","16043",7532,6974,558,7.4
"16","16045",8364,7370,994,11.9
"16","16047",8032,7477,555,6.9
"16","16049",6572,5710,862,13.1
"16","16051",14222,13325,897,6.3
"16","16053",12144,11215,929,7.6
"16","16055",80479,66802,13677,17
"16","16057",19736,17751,1985,10.1
"16","16059",3359,2950,409,12.2
"16","16061",1702,1444,258,15.2
"16","16063",2709,2344,365,13.5
"16","16065",20094,19116,978,4.9
"16","16067",10979,10186,793,7.2
"16","16069",19597,17237,2360,12
"16","16071",2307,2134,173,7.5
"16","16073",5651,5035,616,10.9
"16","16075",11504,10406,1098,9.5
"16","16077",3989,3743,246,6.2
"16","16079",5206,4116,1090,20.9
"16","16081",6487,5428,1059,16.3
"16","16083",41435,36735,4700,11.3
"16","16085",5791,4500,1291,22.3
"16","16087",4495,4067,428,9.5
"17","17001",30317,26669,3648,12
"17","17003",1809,1524,285,15.8
"17","17005",6837,5970,867,12.7
"17","17007",25010,19133,5877,23.5
"17","17009",2571,2356,215,8.4
"17","17011",16097,13892,2205,13.7
"17","17013",2134,1767,367,17.2
"17","17015",7013,5847,1166,16.6
"17","17017",5594,5009,585,10.5
"17","17019",100205,89257,10948,10.9
"17","17021",13148,11290,1858,14.1
"17","17023",7235,5737,1498,20.7
"17","17025",6250,4764,1486,23.8
"17","17027",18375,15854,2521,13.7
"17","17029",22484,19724,2760,12.3
"17","17031",2555193,2089720,465473,18.2
"17","17033",8167,6854,1313,16.1
"17","17035",5692,5092,600,10.5
"17","17037",48633,41287,7346,15.1
"17","17039",6452,5717,735,11.4
"17","17041",9449,8462,987,10.4
"17","17043",484462,412599,71863,14.8
"17","17045",8499,7161,1338,15.7
"17","17047",2673,2092,581,21.7
"17","17049",18519,15920,2599,14
"17","17051",9376,8086,1290,13.8
"17","17053",5826,5141,685,11.8
"17","17055",16744,12753,3991,23.8
"17","17057",14013,11724,2289,16.3
"17","17059",2139,1825,314,14.7
"17","17061",5506,4863,643,11.7
"17","17063",24436,20292,4144,17
"17","17065",4002,3301,701,17.5
"17","17067",7886,6719,1167,14.8
"17","17069",1248,1070,178,14.3
"17","17071",3432,2908,524,15.3
"17","17073",22452,19028,3424,15.3
"17","17075",13044,11615,1429,11
"17","17077",25600,21953,3647,14.2
"17","17079",4517,4043,474,10.5
"17","17081",16729,12214,4515,27
"17","17083",9989,8441,1548,15.5
"17","17085",9935,8196,1739,17.5
"17","17087",4149,3465,684,16.5
"17","17089",245799,204183,41616,16.9
"17","17091",51527,43320,8207,15.9
"17","17093",66477,55445,11032,16.6
"17","17095",20155,17214,2941,14.6
"17","17097",334581,285147,49434,14.8
"17","17099",51645,42123,9522,18.4
"17","17101",5695,4355,1340,23.5
"17","17103",16404,14290,2114,12.9
"17","17105",15249,13388,1861,12.2
"17","17107",11658,10306,1352,11.6
"17","17109",12460,11011,1449,11.6
"17","17111",160508,133818,26690,16.6
"17","17113",78832,68620,10212,13
"17","17115",41659,34931,6728,16.2
"17","17117",20490,17635,2855,13.9
"17","17119",122259,104073,18186,14.9
"17","17121",17392,13469,3923,22.6
"17","17123",4440,3781,659,14.8
"17","17125",5753,4974,779,13.5
"17","17127",5398,4278,1120,20.7
"17","17129",5728,5020,708,12.4
"17","17131",7247,6117,1130,15.6
"17","17133",16790,14670,2120,12.6
"17","17135",11148,9342,1806,16.2
"17","17137",15160,13471,1689,11.1
"17","17139",6800,6249,551,8.1
"17","17141",23073,19572,3501,15.2
"17","17143",75051,60503,14548,19.4
"17","17145",8580,6738,1842,21.5
"17","17147",7749,6980,769,9.9
"17","17149",6440,5715,725,11.3
"17","17151",1595,1363,232,14.5
"17","17153",1773,1432,341,19.2
"17","17155",2923,2436,487,16.7
"17","17157",13567,11383,2184,16.1
"17","17159",7086,5996,1090,15.4
"17","17161",66222,54626,11596,17.5
"17","17163",116406,97700,18706,16.1
"17","17165",9496,7763,1733,18.2
"17","17167",91362,78251,13111,14.4
"17","17169",3060,2707,353,11.5
"17","17171",2312,2064,248,10.7
"17","17173",9771,8649,1122,11.5
"17","17175",2058,1769,289,14
"17","17177",20044,17448,2596,13
"17","17179",55396,45683,9713,17.5
"17","17181",7015,6032,983,14
"17","17183",30851,25559,5292,17.2
"17","17185",6324,4838,1486,23.5
"17","17187",7736,6949,787,10.2
"17","17189",8426,6948,1478,17.5
"17","17191",7034,5672,1362,19.4
"17","17193",6346,5239,1107,17.4
"17","17195",26834,22553,4281,16
"17","17197",348416,287283,61133,17.5
"17","17199",31105,25051,6054,19.5
"17","17201",131121,101959,29162,22.2
"17","17203",15470,13504,1966,12.7
"18","18001",17017,13490,3527,20.7
"18","18003",184639,147684,36955,20
"18","18005",41928,34228,7700,18.4
"18","18007",4091,3642,449,11
"18","18009",4945,3829,1116,22.6
"18","18011",32273,29335,2938,9.1
"18","18013",7382,6185,1197,16.2
"18","18015",9693,8241,1452,15
"18","18017",16932,13927,3005,17.7
"18","18019",57010,46756,10254,18
"18","18021",11101,9540,1561,14.1
"18","18023",15955,13783,2172,13.6
"18","18025",4464,3732,732,16.4
"18","18027",14641,13412,1229,8.4
"18","18029",24345,19888,4457,18.3
"18","18031",16127,12166,3961,24.6
"18","18033",23041,18034,5007,21.7
"18","18035",52984,44237,8747,16.5
"18","18037",20623,18431,2192,10.6
"18","18039",114147,80708,33439,29.3
"18","18041",8821,6570,2251,25.5
"18","18043",37778,31619,6159,16.3
"18","18045",7728,6282,1446,18.7
"18","18047",10905,8907,1998,18.3
"18","18049",9169,7565,1604,17.5
"18","18051",19867,16092,3775,19
"18","18053",29986,25386,4600,15.3
"18","18055",12440,10845,1595,12.8
"18","18057",166160,149233,16927,10.2
"18","18059",37894,32517,5377,14.2
"18","18061",18462,15394,3068,16.6
"18","18063",81859,73002,8857,10.8
"18","18065",21353,17634,3719,17.4
"18","18067",41165,27130,14035,34.1
"18","18069",18072,14452,3620,20
"18","18071",23280,18095,5185,22.3
"18","18073",15376,12832,2544,16.5
"18","18075",9150,7300,1850,20.2
"18","18077",15293,11938,3355,21.9
"18","18079",13913,10672,3241,23.3
"18","18081",77806,67204,10602,13.6
"18","18083",17259,14473,2786,16.1
"18","18085",41309,33366,7943,19.2
"18","18087",21453,15280,6173,28.8
"18","18089",228004,180845,47159,20.7
"18","18091",46875,37201,9674,20.6
"18","18093",20486,16881,3605,17.6
"18","18095",58282,47379,10903,18.7
"18","18097",460133,395645,64488,14
"18","18099",22336,18150,4186,18.7
"18","18101",4706,4293,413,8.8
"18","18103",15346,11749,3597,23.4
"18","18105",65468,58846,6622,10.1
"18","18107",16940,14922,2018,11.9
"18","18109",33198,29253,3945,11.9
"18","18111",6467,5442,1025,15.8
"18","18113",25940,18493,7447,28.7
"18","18115",3001,2461,540,18
"18","18117",9241,6853,2388,25.8
"18","18119",8825,7757,1068,12.1
"18","18121",6193,5461,732,11.8
"18","18123",8743,7188,1555,17.8
"18","18125",5719,4850,869,15.2
"18","18127",84218,68909,15309,18.2
"18","18129",12685,11225,1460,11.5
"18","18131",6027,5052,975,16.2
"18","18133",15695,13434,2261,14.4
"18","18135",10777,8860,1917,17.8
"18","18137",13830,11298,2532,18.3
"18","18139",8713,7091,1622,18.6
"18","18141",131513,104801,26712,20.3
"18","18143",10536,7984,2552,24.2
"18","18145",23265,18679,4586,19.7
"18","18147",10178,8841,1337,13.1
"18","18149",9566,7663,1903,19.9
"18","18151",20643,16556,4087,19.8
"18","18153",7808,6579,1229,15.7
"18","18155",4755,3847,908,19.1
"18","18157",92143,81007,11136,12.1
"18","18159",9067,7271,1796,19.8
"18","18161",3270,2738,532,16.3
"18","18163",92930,78343,14587,15.7
"18","18165",6529,5425,1104,16.9
"18","18167",45879,38019,7860,17.1
"18","18169",14364,11946,2418,16.8
"18","18171",3802,3305,497,13.1
"18","18173",31504,27379,4125,13.1
"18","18175",12729,10303,2426,19.1
"18","18177",28870,24585,4285,14.8
"18","18179",13718,11445,2273,16.6
"18","18181",12367,10913,1454,11.8
"18","18183",17153,14134,3019,17.6
"19","19001",4122,3738,384,9.3
"19","19003",2081,1934,147,7.1
"19","19005",7298,6548,750,10.3
"19","19007",5998,5365,633,10.6
"19","19009",3017,2828,189,6.3
"19","19011",13343,11966,1377,10.3
"19","19013",70389,61970,8419,12
"19","19015",14558,13272,1286,8.8
"19","19017",13680,12510,1170,8.6
"19","19019",11038,10000,1038,9.4
"19","19021",11605,10892,713,6.1
"19","19023",7824,7082,742,9.5
"19","19025",4126,3814,312,7.6
"19","19027",10790,9837,953,8.8
"19","19029",6781,6285,496,7.3
"19","19031",10739,9783,956,8.9
"19","19033",23927,21152,2775,11.6
"19","19035",6131,5648,483,7.9
"19","19037",6725,5928,797,11.9
"19","19039",4841,4317,524,10.8
"19","19041",8560,7662,898,10.5
"19","19043",9812,8717,1095,11.2
"19","19045",23420,20388,3032,12.9
"19","19047",8070,7371,699,8.7
"19","19049",48524,44816,3708,7.6
"19","19051",4131,3823,308,7.5
"19","19053",4208,3896,312,7.4
"19","19055",10398,9489,909,8.7
"19","19057",19666,16739,2927,14.9
"19","19059",9740,8463,1277,13.1
"19","19061",54413,47512,6901,12.7
"19","19063",5271,4754,517,9.8
"19","19065",10236,9123,1113,10.9
"19","19067",8790,7662,1128,12.8
"19","19069",5534,5128,406,7.3
"19","19071",3550,3338,212,6
"19","19073",5474,4915,559,10.2
"19","19075",6400,5825,575,9
"19","19077",5572,4995,577,10.4
"19","19079",6744,6129,615,9.1
"19","19081",6083,5412,671,11
"19","19083",7874,7196,678,8.6
"19","19085",7183,6619,564,7.9
"19","19087",9963,8807,1156,11.6
"19","19089",5337,4736,601,11.3
"19","19091",5077,4602,475,9.4
"19","19093",4128,3881,247,6
"19","19095",10601,9570,1031,9.7
"19","19097",10861,9640,1221,11.2
"19","19099",19910,17806,2104,10.6
"19","19101",10262,9299,963,9.4
"19","19103",84975,76836,8139,9.6
"19","19105",10618,9441,1177,11.1
"19","19107",5266,4748,518,9.8
"19","19109",8321,7608,713,8.6
"19","19111",16675,14453,2222,13.3
"19","19113",124060,108620,15440,12.4
"19","19115",4994,4445,549,11
"19","19117",4608,4280,328,7.1
"19","19119",6539,6229,310,4.7
"19","19121",8664,7616,1048,12.1
"19","19123",11893,10730,1163,9.8
"19","19125",18082,16585,1497,8.3
"19","19127",17782,15831,1951,11
"19","19129",7248,6664,584,8.1
"19","19131",7142,6656,486,6.8
"19","19133",4287,3792,495,11.5
"19","19135",4070,3681,389,9.6
"19","19137",4965,4555,410,8.3
"19","19139",22724,20279,2445,10.8
"19","19141",8113,7560,553,6.8
"19","19143",3413,3199,214,6.3
"19","19145",6558,5896,662,10.1
"19","19147",4831,4310,521,10.8
"19","19149",14310,13227,1083,7.6
"19","19151",4448,4179,269,6
"19","19153",275794,241566,34228,12.4
"19","19155",49223,43838,5385,10.9
"19","19157",9964,8970,994,10
"19","19159",2349,2178,171,7.3
"19","19161",5127,4776,351,6.8
"19","19163",90076,77967,12109,13.4
"19","19165",6591,6078,513,7.8
"19","19167",19961,18815,1146,5.7
"19","19169",55060,50441,4619,8.4
"19","19171",9365,8600,765,8.2
"19","19173",3123,2923,200,6.4
"19","19175",6512,5713,799,12.3
"19","19177",3657,3289,368,10.1
"19","19179",17811,15870,1941,10.9
"19","19181",28207,25489,2718,9.6
"19","19183",11566,10621,945,8.2
"19","19185",2875,2591,284,9.9
"19","19187",19419,17498,1921,9.9
"19","19189",5617,4629,988,17.6
"19","19191",10300,9130,1170,11.4
"19","19193",55320,49647,5673,10.3
"19","19195",4325,3707,618,14.3
"19","19197",7015,6496,519,7.4
"20","20001",6488,5935,553,8.5
"20","20003",4087,3821,266,6.5
"20","20005",7091,6267,824,11.6
"20","20007",2184,2075,109,5
"20","20009",13659,12613,1046,7.7
"20","20011",6586,6014,572,8.7
"20","20013",5341,4880,461,8.6
"20","20015",33102,28293,4809,14.5
"20","20017",1658,1492,166,10
"20","20019",1461,1317,144,9.9
"20","20021",10174,9123,1051,10.3
"20","20023",1177,1139,38,3.2
"20","20025",960,937,23,2.4
"20","20027",3650,3363,287,7.9
"20","20029",3654,3450,204,5.6
"20","20031",3944,3620,324,8.2
"20","20033",829,794,35,4.2
"20","20035",17324,14875,2449,14.1
"20","20037",19094,17375,1719,9
"20","20039",1128,1073,55,4.9
"20","20041",8779,8074,705,8
"20","20043",4015,3640,375,9.3
"20","20045",66823,59308,7515,11.2
"20","20047",1219,1170,49,4
"20","20049",1155,1049,106,9.2
"20","20051",16856,15654,1202,7.1
"20","20053",2571,2453,118,4.6
"20","20055",20127,18947,1180,5.9
"20","20057",16387,15640,747,4.6
"20","20059",14194,12882,1312,9.2
"20","20061",11457,10205,1252,10.9
"20","20063",1400,1334,66,4.7
"20","20065",1046,991,55,5.3
"20","20067",2875,2754,121,4.2
"20","20069",2965,2885,80,2.7
"20","20071",740,725,15,2
"20","20073",3292,2986,306,9.3
"20","20075",1425,1399,26,1.8
"20","20077",2804,2637,167,6
"20","20079",16695,14828,1867,11.2
"20","20081",2047,1982,65,3.2
"20","20083",919,884,35,3.8
"20","20085",7278,6374,904,12.4
"20","20087",9965,8954,1011,10.1
"20","20089",1200,1151,49,4.1
"20","20091",335068,299745,35323,10.5
"20","20093",1908,1816,92,4.8
"20","20095",3272,2954,318,9.7
"20","20097",1182,1125,57,4.8
"20","20099",9799,8998,801,8.2
"20","20101",694,671,23,3.3
"20","20103",36161,32035,4126,11.4
"20","20105",1598,1541,57,3.6
"20","20107",4203,3774,429,10.2
"20","20109",1531,1465,66,4.3
"20","20111",16894,15631,1263,7.5
"20","20113",17022,16037,985,5.8
"20","20115",5829,5385,444,7.6
"20","20117",5210,4940,270,5.2
"20","20119",1947,1867,80,4.1
"20","20121",16936,15364,1572,9.3
"20","20123",3163,3052,111,3.5
"20","20125",15211,13160,2051,13.5
"20","20127",2869,2672,197,6.9
"20","20129",1018,987,31,3
"20","20131",4939,4676,263,5.3
"20","20133",6060,5445,615,10.1
"20","20135",1256,1190,66,5.3
"20","20137",2456,2378,78,3.2
"20","20139",7797,7026,771,9.9
"20","20141",1884,1798,86,4.6
"20","20143",2922,2742,180,6.2
"20","20145",2599,2467,132,5.1
"20","20147",2549,2382,167,6.6
"20","20149",11674,10786,888,7.6
"20","20151",4789,4522,267,5.6
"20","20153",1368,1316,52,3.8
"20","20155",30726,27588,3138,10.2
"20","20157",2100,2015,85,4
"20","20159",5253,4900,353,6.7
"20","20161",33426,30545,2881,8.6
"20","20163",2342,2210,132,5.6
"20","20165",1570,1432,138,8.8
"20","20167",3164,2929,235,7.4
"20","20169",30799,27856,2943,9.6
"20","20171",2586,2495,91,3.5
"20","20173",268900,218542,50358,18.7
"20","20175",9058,8508,550,6.1
"20","20177",91356,80327,11029,12.1
"20","20179",1290,1249,41,3.2
"20","20181",2630,2516,114,4.3
"20","20183",1834,1765,69,3.8
"20","20185",1854,1756,98,5.3
"20","20187",874,854,20,2.3
"20","20189",2529,2441,88,3.5
"20","20191",11446,9445,2001,17.5
"20","20193",4022,3850,172,4.3
"20","20195",1285,1202,83,6.5
"20","20197",3461,3203,258,7.5
"20","20199",910,888,22,2.4
"20","20201",2792,2680,112,4
"20","20203",1180,1149,31,2.6
"20","20205",4352,3542,810,18.6
"20","20207",1607,1469,138,8.6
"20","20209",78956,67258,11698,14.8
"21","21001",7266,6041,1225,16.9
"21","21003",8283,7108,1175,14.2
"21","21005",12466,10671,1795,14.4
"21","21007",3494,2969,525,15
"21","21009",18708,15246,3462,18.5
"21","21011",4761,3888,873,18.3
"21","21013",8678,7250,1428,16.5
"21","21015",68279,59339,8940,13.1
"21","21017",9751,8144,1607,16.5
"21","21019",18546,15101,3445,18.6
"21","21021",12836,10287,2549,19.9
"21","21023",3664,3152,512,14
"21","21025",3494,2864,630,18
"21","21027",8040,6668,1372,17.1
"21","21029",42668,34845,7823,18.3
"21","21031",4912,4036,876,17.8
"21","21033",5599,4782,817,14.6
"21","21035",19699,17210,2489,12.6
"21","21037",49196,42480,6716,13.7
"21","21039",2215,2023,192,8.7
"21","21041",5325,4641,684,12.8
"21","21043",10256,8194,2062,20.1
"21","21045",7146,5912,1234,17.3
"21","21047",25960,21389,4571,17.6
"21","21049",17332,14497,2835,16.4
"21","21051",5398,4458,940,17.4
"21","21053",3905,3577,328,8.4
"21","21055",3822,3372,450,11.8
"21","21057",3090,2778,312,10.1
"21","21059",46708,40047,6661,14.3
"21","21061",4749,3765,984,20.7
"21","21063",2132,1713,419,19.7
"21","21065",5510,4584,926,16.8
"21","21067",172100,148555,23545,13.7
"21","21069",6490,5295,1195,18.4
"21","21071",11134,9208,1926,17.3
"21","21073",26212,22364,3848,14.7
"21","21075",2062,1821,241,11.7
"21","21077",3947,3389,558,14.1
"21","21079",7660,6490,1170,15.3
"21","21081",11921,9737,2184,18.3
"21","21083",16109,14053,2056,12.8
"21","21085",11638,9467,2171,18.7
"21","21087",5129,4407,722,14.1
"21","21089",13838,11228,2610,18.9
"21","21091",3994,3361,633,15.8
"21","21093",50549,41551,8998,17.8
"21","21095",6825,5442,1383,20.3
"21","21097",9333,7707,1626,17.4
"21","21099",8107,6932,1175,14.5
"21","21101",22842,19499,3343,14.6
"21","21103",8018,6726,1292,16.1
"21","21105",1710,1527,183,10.7
"21","21107",17828,14412,3416,19.2
"21","21109",4295,3447,848,19.7
"21","21111",389570,326428,63142,16.2
"21","21113",26033,22498,3535,13.6
"21","21115",6856,5734,1122,16.4
"21","21117",85057,73333,11724,13.8
"21","21119",4426,3742,684,15.5
"21","21121",10485,8606,1879,17.9
"21","21123",6281,5055,1226,19.5
"21","21125",26226,21619,4607,17.6
"21","21127",5423,4562,861,15.9
"21","21129",2118,1832,286,13.5
"21","21131",2758,2219,539,19.5
"21","21133",6509,5312,1197,18.4
"21","21135",4886,3892,994,20.3
"21","21137",9589,7600,1989,20.7
"21","21139",3663,3093,570,15.6
"21","21141",11686,9783,1903,16.3
"21","21143",3016,2690,326,10.8
"21","21145",29958,24942,5016,16.7
"21","21147",4827,4062,765,15.8
"21","21149",4002,3526,476,11.9
"21","21151",46340,39395,6945,15
"21","21153",3666,2647,1019,27.8
"21","21155",9216,6576,2640,28.6
"21","21157",15637,13444,2193,14
"21","21159",2925,2374,551,18.8
"21","21161",7376,5909,1467,19.9
"21","21163",12477,10332,2145,17.2
"21","21165",2351,1946,405,17.2
"21","21167",9683,7624,2059,21.3
"21","21169",4203,3316,887,21.1
"21","21171",4760,4130,630,13.2
"21","21173",12376,9976,2400,19.4
"21","21175",4623,4047,576,12.5
"21","21177",10800,9046,1754,16.2
"21","21179",24676,19814,4862,19.7
"21","21181",3431,2830,601,17.5
"21","21183",10042,8586,1456,14.5
"21","21185",31644,27375,4269,13.5
"21","21187",5172,4391,781,15.1
"21","21189",1124,980,144,12.8
"21","21191",6612,5828,784,11.9
"21","21193",8395,6980,1415,16.9
"21","21195",18854,15545,3309,17.6
"21","21197",5107,4271,836,16.4
"21","21199",27785,23045,4740,17.1
"21","21201",810,698,112,13.8
"21","21203",6557,5509,1048,16
"21","21205",10961,9102,1859,17
"21","21207",6800,5397,1403,20.6
"21","21209",31423,24674,6749,21.5
"21","21211",24734,20910,3824,15.5
"21","21213",9594,7719,1875,19.5
"21","21215",10223,8372,1851,18.1
"21","21217",12934,10586,2348,18.2
"21","21219",5349,4705,644,12
"21","21221",6214,5155,1059,17
"21","21223",3874,3148,726,18.7
"21","21225",5725,4642,1083,18.9
"21","21227",62495,51285,11210,17.9
"21","21229",6876,5576,1300,18.9
"21","21231",7444,6396,1048,14.1
"21","21233",5557,4702,855,15.4
"21","21235",14156,11989,2167,15.3
"21","21237",2091,1763,328,15.7
"21","21239",14376,12533,1843,12.8
"22","22001",21195,18791,2404,11.3
"22","22003",8212,6935,1277,15.6
"22","22005",59009,51447,7562,12.8
"22","22007",8458,7102,1356,16
"22","22009",14100,12069,2031,14.4
"22","22011",13054,11663,1391,10.7
"22","22013",4769,4310,459,9.6
"22","22015",52711,46489,6222,11.8
"22","22017",96113,82513,13600,14.2
"22","22019",92959,79315,13644,14.7
"22","22021",3304,2979,325,9.8
"22","22023",3246,2953,293,9
"22","22025",3029,2729,300,9.9
"22","22027",4961,4579,382,7.7
"22","22029",6296,5589,707,11.2
"22","22031",9618,8604,1014,10.5
"22","22033",213017,184860,28157,13.2
"22","22035",1581,1395,186,11.8
"22","22037",7141,6379,762,10.7
"22","22039",10431,9234,1197,11.5
"22","22041",6484,5809,675,10.4
"22","22043",7382,6665,717,9.7
"22","22045",25765,22107,3658,14.2
"22","22047",12909,11087,1822,14.1
"22","22049",5835,5414,421,7.2
"22","22051",201568,163766,37802,18.8
"22","22053",11796,10315,1481,12.6
"22","22055",104191,90397,13794,13.2
"22","22057",39034,34694,4340,11.1
"22","22059",5922,5493,429,7.2
"22","22061",18240,16562,1678,9.2
"22","22063",63581,55289,8292,13
"22","22065",3100,2748,352,11.4
"22","22067",8866,7714,1152,13
"22","22069",13985,12627,1358,9.7
"22","22071",174608,136075,38533,22.1
"22","22073",64768,57094,7674,11.8
"22","22075",9061,7708,1353,14.9
"22","22077",8962,7836,1126,12.6
"22","22079",50298,45316,4982,9.9
"22","22081",3251,3013,238,7.3
"22","22083",7240,6465,775,10.7
"22","22085",7958,7316,642,8.1
"22","22087",18798,15118,3680,19.6
"22","22089",22788,19233,3555,15.6
"22","22091",4011,3367,644,16.1
"22","22093",8099,6938,1161,14.3
"22","22095",18123,14826,3297,18.2
"22","22097",28858,25044,3814,13.2
"22","22099",20292,17530,2762,13.6
"22","22101",18012,15411,2601,14.4
"22","22103",107599,91474,16125,15
"22","22105",52028,43131,8897,17.1
"22","22107",1178,1068,110,9.3
"22","22109",44084,38192,5892,13.4
"22","22111",8135,7373,762,9.4
"22","22113",21775,19019,2756,12.7
"22","22115",13993,12448,1545,11
"22","22117",14963,13194,1769,11.8
"22","22119",13005,11478,1527,11.7
"22","22121",12463,10931,1532,12.3
"22","22123",3189,2747,442,13.9
"22","22125",4755,4327,428,9
"22","22127",4171,3798,373,8.9
"23","23001",53351,47652,5699,10.7
"23","23003",28359,25359,3000,10.6
"23","23005",152695,135952,16743,11
"23","23007",13663,11940,1723,12.6
"23","23009",26293,23122,3171,12.1
"23","23011",60223,54142,6081,10.1
"23","23013",19332,16969,2363,12.2
"23","23015",15854,14075,1779,11.2
"23","23017",25595,21999,3596,14
"23","23019",74655,66515,8140,10.9
"23","23021",6873,6138,735,10.7
"23","23023",19203,17111,2092,10.9
"23","23025",21933,18898,3035,13.8
"23","23027",19551,17539,2012,10.3
"23","23029",12758,11335,1423,11.2
"23","23031",105342,93108,12234,11.6
"24","24001",30474,26189,4285,14.1
"24","24003",292743,263486,29257,10
"24","24005",422244,376767,45477,10.8
"24","24009",47388,43434,3954,8.3
"24","24011",16583,15057,1526,9.2
"24","24013",88846,80514,8332,9.4
"24","24015",48135,43529,4606,9.6
"24","24017",83288,75506,7782,9.3
"24","24019",14493,12943,1550,10.7
"24","24021",129770,117100,12670,9.8
"24","24023",14890,12926,1964,13.2
"24","24025",131330,117617,13713,10.4
"24","24027",171159,157228,13931,8.1
"24","24029",9509,8577,932,9.8
"24","24031",531818,486541,45277,8.5
"24","24033",488684,439631,49053,10
"24","24035",26235,23566,2669,10.2
"24","24037",53645,49730,3915,7.3
"24","24039",8316,7337,979,11.8
"24","24041",17594,15733,1861,10.6
"24","24043",69806,61388,8418,12.1
"24","24045",46835,40530,6305,13.5
"24","24047",25550,19723,5827,22.8
"24","24510",267613,235862,31751,11.9
"25","25001",97331,76341,20990,21.6
"25","25003",57586,48003,9583,16.6
"25","25005",282641,225386,57255,20.3
"25","25007",8519,6596,1923,22.6
"25","25009",386540,318353,68187,17.6
"25","25011",36485,31362,5123,14
"25","25013",206298,170255,36043,17.5
"25","25015",77770,68213,9557,12.3
"25","25017",803171,701635,101536,12.6
"25","25019",7062,5068,1994,28.2
"25","25021",350876,297169,53707,15.3
"25","25023",259206,212367,46839,18.1
"25","25025",409939,346376,63563,15.5
"25","25027",402784,340428,62356,15.5
"26","26001",3446,2593,853,24.8
"26","26003",2903,2213,690,23.8
"26","26005",57480,44388,13092,22.8
"26","26007",12645,10291,2354,18.6
"26","26009",9003,6388,2615,29
"26","26011",5707,3862,1845,32.3
"26","26013",3135,2263,872,27.8
"26","26015",29551,22942,6609,22.4
"26","26017",48693,36383,12310,25.3
"26","26019",8839,6499,2340,26.5
"26","26021",70427,56320,14107,20
"26","26023",18697,14395,4302,23
"26","26025",60383,45499,14884,24.6
"26","26027",26023,19543,6480,24.9
"26","26029",11591,7858,3733,32.2
"26","26031",9778,5749,4029,41.2
"26","26033",15840,12608,3232,20.4
"26","26035",10664,7155,3509,32.9
"26","26037",39260,31888,7372,18.8
"26","26039",5100,3600,1500,29.4
"26","26041",16376,12525,3851,23.5
"26","26043",12110,10101,2009,16.6
"26","26045",56122,44039,12083,21.5
"26","26047",17426,12133,5293,30.4
"26","26049",184035,128576,55459,30.1
"26","26051",8790,6336,2454,27.9
"26","26053",5825,4799,1026,17.6
"26","26055",48803,36996,11807,24.2
"26","26057",17205,13334,3871,22.5
"26","26059",19271,13926,5345,27.7
"26","26061",15720,13233,2487,15.8
"26","26063",14677,10585,4092,27.9
"26","26065",142118,116236,25882,18.2
"26","26067",27658,20227,7431,26.9
"26","26069",9725,7155,2570,26.4
"26","26071",4887,3964,923,18.9
"26","26073",33721,26278,7443,22.1
"26","26075",72711,54948,17763,24.4
"26","26077",123423,102140,21283,17.2
"26","26079",8076,5759,2317,28.7
"26","26081",332443,260533,71910,21.6
"26","26083",881,708,173,19.6
"26","26085",3349,2332,1017,30.4
"26","26087",39663,27518,12145,30.6
"26","26089",10076,7849,2227,22.1
"26","26091",43431,31186,12245,28.2
"26","26093",90219,70432,19787,21.9
"26","26095",2241,1793,448,20
"26","26097",4343,2690,1653,38.1
"26","26099",414804,301118,113686,27.4
"26","26101",9058,6187,2871,31.7
"26","26103",31270,24767,6503,20.8
"26","26105",12330,9182,3148,25.5
"26","26107",17334,12856,4478,25.8
"26","26109",10370,8867,1503,14.5
"26","26111",38411,30725,7686,20
"26","26113",6611,4773,1838,27.8
"26","26115",77017,57181,19836,25.8
"26","26117",27873,20360,7513,27
"26","26119",2742,1804,938,34.2
"26","26121",79064,55918,23146,29.3
"26","26123",21510,15925,5585,26
"26","26125",571797,458446,113351,19.8
"26","26127",11038,8063,2975,27
"26","26129",7521,5279,2242,29.8
"26","26131",1865,1348,517,27.7
"26","26133",10470,7544,2926,27.9
"26","26135",2780,1857,923,33.2
"26","26137",11116,7782,3334,30
"26","26139",148585,117116,31469,21.2
"26","26141",4480,3207,1273,28.4
"26","26143",7014,4609,2405,34.3
"26","26145",84061,62523,21538,25.6
"26","26147",71792,50718,21074,29.4
"26","26149",28955,20170,8785,30.3
"26","26151",18756,12934,5822,31
"26","26153",3223,2509,714,22.2
"26","26155",31755,22473,9282,29.2
"26","26157",22322,15127,7195,32.2
"26","26159",33775,26736,7039,20.8
"26","26161",186137,158475,27662,14.9
"26","26163",741441,549699,191742,25.9
"26","26165",14490,9928,4562,31.5
"27","27001",7189,6374,815,11.3
"27","27003",195521,177809,17712,9.1
"27","27005",18983,17088,1895,10
"27","27007",24413,22198,2215,9.1
"27","27009",22292,20193,2099,9.4
"27","27011",2397,2240,157,6.5
"27","27013",41174,37991,3183,7.7
"27","27015",14230,13294,936,6.6
"27","27017",17459,15583,1876,10.7
"27","27019",57111,52936,4175,7.3
"27","27021",14437,12533,1904,13.2
"27","27023",6844,6313,531,7.8
"27","27025",29549,26774,2775,9.4
"27","27027",36302,34150,2152,5.9
"27","27029",4409,3805,604,13.7
"27","27031",3143,2667,476,15.1
"27","27033",5934,5650,284,4.8
"27","27035",32474,28923,3551,10.9
"27","27037",239425,217821,21604,9
"27","27039",11579,10841,738,6.4
"27","27041",20882,19308,1574,7.5
"27","27043",6913,6326,587,8.5
"27","27045",11357,10611,746,6.6
"27","27047",16215,14936,1279,7.9
"27","27049",26842,24532,2310,8.6
"27","27051",3285,3065,220,6.7
"27","27053",698640,636522,62118,8.9
"27","27055",10008,9400,608,6.1
"27","27057",9780,8764,1016,10.4
"27","27059",21022,18995,2027,9.6
"27","27061",21254,18821,2433,11.4
"27","27063",5598,5308,290,5.2
"27","27065",9020,8044,976,10.8
"27","27067",23792,22342,1450,6.1
"27","27069",2332,2183,149,6.4
"27","27071",5712,5108,604,10.6
"27","27073",3517,3313,204,5.8
"27","27075",5306,4783,523,9.9
"27","27077",2428,2165,263,10.8
"27","27079",15935,14385,1550,9.7
"27","27081",3146,3000,146,4.6
"27","27083",14196,13410,786,5.5
"27","27085",18817,17430,1387,7.4
"27","27087",2530,2091,439,17.4
"27","27089",5355,4873,482,9
"27","27091",9807,9162,645,6.6
"27","27093",13067,12202,865,6.6
"27","27095",12829,11374,1455,11.3
"27","27097",17541,15965,1576,9
"27","27099",20286,19057,1229,6.1
"27","27101",4608,4323,285,6.2
"27","27103",21064,19643,1421,6.7
"27","27105",11065,10591,474,4.3
"27","27107",3289,2995,294,8.9
"27","27109",86928,80906,6022,6.9
"27","27111",30728,28301,2427,7.9
"27","27113",8636,7765,871,10.1
"27","27115",15085,13277,1808,12
"27","27117",4634,4427,207,4.5
"27","27119",16530,15334,1196,7.2
"27","27121",6412,6028,384,6
"27","27123",286768,260527,26241,9.2
"27","27125",2204,1995,209,9.5
"27","27127",7745,7065,680,8.8
"27","27129",8404,7803,601,7.2
"27","27131",36782,34236,2546,6.9
"27","27133",5547,5336,211,3.8
"27","27135",7860,7197,663,8.4
"27","27137",99886,89407,10479,10.5
"27","27139",82924,75397,7527,9.1
"27","27141",51637,47015,4622,9
"27","27143",8402,7793,609,7.2
"27","27145",91032,83878,7154,7.9
"27","27147",21113,19654,1459,6.9
"27","27149",5205,5005,200,3.8
"27","27151",4830,4434,396,8.2
"27","27153",13405,12560,845,6.3
"27","27155",1770,1669,101,5.7
"27","27157",12198,11284,914,7.5
"27","27159",6105,5425,680,11.1
"27","27161",8959,8240,719,8
"27","27163",140886,129370,11516,8.2
"27","27165",6399,6049,350,5.5
"27","27167",3521,3320,201,5.7
"27","27169",28496,26433,2063,7.2
"27","27171",74125,67997,6128,8.3
"27","27173",5324,4928,396,7.4
"28","28001",10330,8606,1724,16.7
"28","28003",14826,12864,1962,13.2
"28","28005",4079,3592,487,11.9
"28","28007",6491,5618,873,13.4
"28","28009",2803,2379,424,15.1
"28","28011",11128,9970,1158,10.4
"28","28013",6035,4750,1285,21.3
"28","28015",3199,2778,421,13.2
"28","28017",8019,5504,2515,31.4
"28","28019",3363,3034,329,9.8
"28","28021",2762,2268,494,17.9
"28","28023",5353,4667,686,12.8
"28","28025",8216,6194,2022,24.6
"28","28027",8386,6661,1725,20.6
"28","28029",10057,8876,1181,11.7
"28","28031",7094,6464,630,8.9
"28","28033",81895,72173,9722,11.9
"28","28035",30575,26711,3864,12.6
"28","28037",2577,2263,314,12.2
"28","28039",8191,7006,1185,14.5
"28","28041",4060,3502,558,13.7
"28","28043",8618,7527,1091,12.7
"28","28045",17549,14161,3388,19.3
"28","28047",85260,65483,19777,23.2
"28","28049",100272,84401,15871,15.8
"28","28051",6160,4382,1778,28.9
"28","28053",2233,1863,370,16.6
"28","28055",345,308,37,10.7
"28","28057",10618,8345,2273,21.4
"28","28059",55871,43933,11938,21.4
"28","28061",5516,4927,589,10.7
"28","28063",1834,1474,360,19.6
"28","28065",3690,3271,419,11.4
"28","28067",23219,20994,2225,9.6
"28","28069",3282,2826,456,13.9
"28","28071",25336,22527,2809,11.1
"28","28073",27703,24824,2879,10.4
"28","28075",27261,23963,3298,12.1
"28","28077",4221,3655,566,13.4
"28","28079",7504,6520,984,13.1
"28","28081",41223,32333,8890,21.6
"28","28083",9425,7846,1579,16.8
"28","28085",13312,11586,1726,13
"28","28087",23754,20021,3733,15.7
"28","28089",49387,42404,6983,14.1
"28","28091",8850,7868,982,11.1
"28","28093",12727,11341,1386,10.9
"28","28095",15697,12044,3653,23.3
"28","28097",3631,3183,448,12.3
"28","28099",9756,8179,1577,16.2
"28","28101",8059,7018,1041,12.9
"28","28103",3689,3087,602,16.3
"28","28105",20627,17838,2789,13.5
"28","28107",11706,9828,1878,16
"28","28109",21251,18458,2793,13.1
"28","28111",3907,3420,487,12.5
"28","28113",13232,11559,1673,12.6
"28","28115",15674,11661,4013,25.6
"28","28117",10979,9053,1926,17.5
"28","28119",2344,1973,371,15.8
"28","28121",68545,60905,7640,11.1
"28","28123",11447,10389,1058,9.2
"28","28125",1517,1312,205,13.5
"28","28127",9551,8612,939,9.8
"28","28129",6046,5588,458,7.6
"28","28131",6343,5417,926,14.6
"28","28133",7324,6297,1027,14
"28","28135",4811,4364,447,9.3
"28","28137",11181,9814,1367,12.2
"28","28139",9325,7504,1821,19.5
"28","28141",8310,6997,1313,15.8
"28","28143",5244,3583,1661,31.7
"28","28145",14335,11237,3098,21.6
"28","28147",4441,3879,562,12.7
"28","28149",18936,15866,3070,16.2
"28","28151",15724,13309,2415,15.4
"28","28153",6731,6069,662,9.8
"28","28155",3707,3211,496,13.4
"28","28157",2504,2101,403,16.1
"28","28159",6883,5857,1026,14.9
"28","28161",4611,3877,734,15.9
"28","28163",9116,7588,1528,16.8
"29","29001",10082,9373,709,7
"29","29003",9518,8949,569,6
"29","29005",2857,2691,166,5.8
"29","29007",10916,9802,1114,10.2
"29","29009",16005,14597,1408,8.8
"29","29011",5336,4887,449,8.4
"29","29013",7596,7082,514,6.8
"29","29015",7205,6509,696,9.7
"29","29017",5372,4857,515,9.6
"29","29019",95725,89488,6237,6.5
"29","29021",43575,40418,3157,7.2
"29","29023",18162,16209,1953,10.8
"29","29025",4384,3976,408,9.3
"29","29027",20581,19164,1417,6.9
"29","29029",18905,16388,2517,13.3
"29","29031",39253,35528,3725,9.5
"29","29033",4782,4440,342,7.2
"29","29035",2519,2308,211,8.4
"29","29037",52638,48057,4581,8.7
"29","29039",5720,5437,283,4.9
"29","29041",3775,3578,197,5.2
"29","29043",44433,40488,3945,8.9
"29","29045",3356,3017,339,10.1
"29","29047",136277,119228,17049,12.5
"29","29049",10825,9562,1263,11.7
"29","29051",37333,34819,2514,6.7
"29","29053",7433,6760,673,9.1
"29","29055",10893,9857,1036,9.5
"29","29057",3631,3439,192,5.3
"29","29059",7073,6445,628,8.9
"29","29061",4303,4067,236,5.5
"29","29063",4830,4534,296,6.1
"29","29065",6182,5803,379,6.1
"29","29067",5377,4633,744,13.8
"29","29069",11729,10705,1024,8.7
"29","29071",52229,46643,5586,10.7
"29","29073",7831,7086,745,9.5
"29","29075",3594,3434,160,4.5
"29","29077",150949,136714,14235,9.4
"29","29079",4492,4182,310,6.9
"29","29081",3926,3721,205,5.2
"29","29083",9580,8835,745,7.8
"29","29085",3860,3597,263,6.8
"29","29087",2648,2520,128,4.8
"29","29089",4728,4467,261,5.5
"29","29091",16396,14837,1559,9.5
"29","29093",3482,3187,295,8.5
"29","29095",353609,313494,40115,11.3
"29","29097",56667,51025,5642,10
"29","29099",114702,102837,11865,10.3
"29","29101",23292,21355,1937,8.3
"29","29103",1784,1712,72,4
"29","29105",17961,15297,2664,14.8
"29","29107",16467,15059,1408,8.6
"29","29109",18150,16628,1522,8.4
"29","29111",5144,4780,364,7.1
"29","29113",28558,25027,3531,12.4
"29","29115",5107,4686,421,8.2
"29","29117",7485,7041,444,5.9
"29","29119",10501,9808,693,6.6
"29","29121",7411,6954,457,6.2
"29","29123",5631,5059,572,10.2
"29","29125",3815,3600,215,5.6
"29","29127",14324,13340,984,6.9
"29","29129",2046,1974,72,3.5
"29","29131",12565,11090,1475,11.7
"29","29133",5733,5425,308,5.4
"29","29135",7189,6785,404,5.6
"29","29137",3820,3497,323,8.5
"29","29139",5852,5383,469,8
"29","29141",8192,7370,822,10
"29","29143",8606,7970,636,7.4
"29","29145",27400,24589,2811,10.3
"29","29147",11654,10591,1063,9.1
"29","29149",4087,3745,342,8.4
"29","29151",6869,6531,338,4.9
"29","29153",3576,3209,367,10.3
"29","29155",6470,5895,575,8.9
"29","29157",10699,9119,1580,14.8
"29","29159",21380,19239,2141,10
"29","29161",19164,17892,1272,6.6
"29","29163",7475,6866,609,8.1
"29","29165",57171,51501,5670,9.9
"29","29167",14111,13249,862,6.1
"29","29169",14366,13261,1105,7.7
"29","29171",2347,2229,118,5
"29","29173",5623,5251,372,6.6
"29","29175",10263,9363,900,8.8
"29","29177",11362,9640,1722,15.2
"29","29179",2968,2753,215,7.2
"29","29181",5150,4517,633,12.3
"29","29183",221121,199996,21125,9.6
"29","29185",3802,3509,293,7.7
"29","29186",9170,8389,781,8.5
"29","29187",26409,23766,2643,10
"29","29189",511717,465043,46674,9.1
"29","29195",10739,10230,509,4.7
"29","29197",1970,1846,124,6.3
"29","29199",2440,2332,108,4.4
"29","29201",19679,18175,1504,7.6
"29","29203",3402,3024,378,11.1
"29","29205",3136,3004,132,4.2
"29","29207",13646,12277,1369,10
"29","29209",14444,12081,2363,16.4
"29","29211",2771,2610,161,5.8
"29","29213",31245,23604,7641,24.5
"29","29215",8909,8262,647,7.3
"29","29217",9426,8977,449,4.8
"29","29219",17744,15856,1888,10.6
"29","29221",10192,9132,1060,10.4
"29","29223",4955,4533,422,8.5
"29","29225",17323,15775,1548,8.9
"29","29227",1258,1173,85,6.8
"29","29229",7908,7009,899,11.4
"29","29510",149920,132416,17504,11.7
"30","30001",4735,4395,340,7.2
"30","30003",4358,3896,462,10.6
"30","30005",2353,2225,128,5.4
"30","30007",2456,2182,274,11.2
"30","30009",5495,4813,682,12.4
"30","30011",626,606,20,3.2
"30","30013",36972,32481,4491,12.1
"30","30015",2355,2214,141,6
"30","30017",5594,5127,467,8.3
"30","30019",835,799,36,4.3
"30","30021",4227,3919,308,7.3
"30","30023",4765,4265,500,10.5
"30","30025",1576,1483,93,5.9
"30","30027",5552,5088,464,8.4
"30","30029",47724,39811,7913,16.6
"30","30031",67039,58770,8269,12.3
"30","30033",721,689,32,4.4
"30","30035",5179,4507,672,13
"30","30037",352,328,24,6.8
"30","30039",1715,1434,281,16.4
"30","30041",7042,6432,610,8.7
"30","30043",5351,4842,509,9.5
"30","30045",1027,951,76,7.4
"30","30047",12421,11221,1200,9.7
"30","30049",33925,30309,3616,10.7
"30","30051",944,918,26,2.8
"30","30053",7925,6459,1466,18.5
"30","30055",898,871,27,3
"30","30057",4906,4497,409,8.3
"30","30059",904,833,71,7.9
"30","30061",1763,1441,322,18.3
"30","30063",64828,56316,8512,13.1
"30","30065",2139,1933,206,9.6
"30","30067",9018,7493,1525,16.9
"30","30069",263,255,8,3
"30","30071",1805,1665,140,7.8
"30","30073",2517,2331,186,7.4
"30","30075",928,879,49,5.3
"30","30077",2735,2455,280,10.2
"30","30079",438,411,27,6.2
"30","30081",19414,17330,2084,10.7
"30","30083",5472,4856,616,11.3
"30","30085",4054,3730,324,8
"30","30087",3510,3238,272,7.7
"30","30089",4714,4062,652,13.8
"30","30091",1687,1546,141,8.4
"30","30093",16548,14254,2294,13.9
"30","30095",5173,4685,488,9.4
"30","30097",1704,1588,116,6.8
"30","30099",2612,2431,181,6.9
"30","30101",1982,1821,161,8.1
"30","30103",325,310,15,4.6
"30","30105",3812,3525,287,7.5
"30","30107",816,717,99,12.1
"30","30109",440,394,46,10.5
"30","30111",79769,70945,8824,11.1
"31","31001",17738,16264,1474,8.3
"31","31003",3732,3601,131,3.5
"31","31005",240,226,14,5.8
"31","31007",404,384,20,5
"31","31009",280,272,8,2.9
"31","31011",3086,2977,109,3.5
"31","31013",5623,5197,426,7.6
"31","31015",1142,1089,53,4.6
"31","31017",1434,1386,48,3.3
"31","31019",29859,26913,2946,9.9
"31","31021",3602,3379,223,6.2
"31","31023",4692,4372,320,6.8
"31","31025",13529,12382,1147,8.5
"31","31027",4682,4432,250,5.3
"31","31029",2354,2299,55,2.3
"31","31031",3527,3384,143,4.1
"31","31033",4453,4088,365,8.2
"31","31035",3477,3263,214,6.2
"31","31037",5684,5426,258,4.5
"31","31039",4840,4626,214,4.4
"31","31041",6613,6333,280,4.2
"31","31043",10510,9695,815,7.8
"31","31045",4981,4757,224,4.5
"31","31047",13525,12775,750,5.5
"31","31049",995,941,54,5.4
"31","31051",3027,2840,187,6.2
"31","31053",20052,18655,1397,7
"31","31055",303794,271912,31882,10.5
"31","31057",1235,1202,33,2.7
"31","31059",3269,3110,159,4.9
"31","31061",1530,1448,82,5.4
"31","31063",1660,1601,59,3.6
"31","31065",2694,2558,136,5
"31","31067",11639,10551,1088,9.3
"31","31069",1117,1055,62,5.6
"31","31071",1168,1133,35,3
"31","31073",1122,1074,48,4.3
"31","31075",449,440,9,2
"31","31077",1293,1229,64,4.9
"31","31079",33237,29287,3950,11.9
"31","31081",4837,4482,355,7.3
"31","31083",1846,1766,80,4.3
"31","31085",650,633,17,2.6
"31","31087",1300,1237,63,4.8
"31","31089",5993,5755,238,4
"31","31091",378,361,17,4.5
"31","31093",3498,3144,354,10.1
"31","31095",4273,4070,203,4.8
"31","31097",2137,1997,140,6.6
"31","31099",4042,3760,282,7
"31","31101",4664,4365,299,6.4
"31","31103",637,619,18,2.8
"31","31105",2040,1946,94,4.6
"31","31107",4789,4567,222,4.6
"31","31109",180362,163463,16899,9.4
"31","31111",19066,17630,1436,7.5
"31","31113",503,476,27,5.4
"31","31115",424,412,12,2.8
"31","31117",454,437,17,3.7
"31","31119",20503,19201,1302,6.4
"31","31121",4130,3768,362,8.8
"31","31123",2726,2578,148,5.4
"31","31125",2072,1959,113,5.5
"31","31127",3687,3465,222,6
"31","31129",2494,2393,101,4
"31","31131",8722,8129,593,6.8
"31","31133",1528,1456,72,4.7
"31","31135",1870,1828,42,2.2
"31","31137",5197,4904,293,5.6
"31","31139",4217,4016,201,4.8
"31","31141",18677,17126,1551,8.3
"31","31143",3120,2938,182,5.8
"31","31145",5986,5686,300,5
"31","31147",4348,4115,233,5.4
"31","31149",921,887,34,3.7
"31","31151",7593,7131,462,6.1
"31","31153",96906,88021,8885,9.2
"31","31155",11153,10286,867,7.8
"31","31157",18660,17287,1373,7.4
"31","31159",9089,8353,736,8.1
"31","31161",2728,2641,87,3.2
"31","31163",1749,1649,100,5.7
"31","31165",777,747,30,3.9
"31","31167",3624,3427,197,5.4
"31","31169",2870,2741,129,4.5
"31","31171",430,418,12,2.8
"31","31173",3321,3004,317,9.5
"31","31175",2218,2095,123,5.5
"31","31177",11158,10365,793,7.1
"31","31179",5881,5616,265,4.5
"31","31181",1777,1668,109,6.1
"31","31183",618,599,19,3.1
"31","31185",7567,7107,460,6.1
"32","32001",9435,8232,1203,12.8
"32","32003",1063731,707079,356652,33.5
"32","32005",20454,16498,3956,19.3
"32","32007",23788,20054,3734,15.7
"32","32009",355,329,26,7.3
"32","32011",910,851,59,6.5
"32","32013",6859,6202,657,9.6
"32","32015",2605,2370,235,9
"32","32017",1722,1549,173,10
"32","32019",20735,16576,4159,20.1
"32","32021",1726,1510,216,12.5
"32","32023",15685,12343,3342,21.3
"32","32027",2139,1925,214,10
"32","32029",1834,1430,404,22
"32","32031",225766,181481,44285,19.6
"32","32033",3821,3484,337,8.8
"32","32510",23131,18179,4952,21.4
"33","33001",29301,23231,6070,20.7
"33","33003",21692,16415,5277,24.3
"33","33005",37156,31623,5533,14.9
"33","33007",13750,10648,3102,22.6
"33","33009",45100,37908,7192,15.9
"33","33011",228070,188842,39228,17.2
"33","33013",77235,65063,12172,15.8
"33","33015",172342,142078,30264,17.6
"33","33017",68383,57395,10988,16.1
"33","33019",20514,17764,2750,13.4
"34","34001",123337,82267,41070,33.3
"34","34003",476855,402418,74437,15.6
"34","34005",229950,199662,30288,13.2
"34","34007",257973,217248,40725,15.8
"34","34009",42984,31553,11431,26.6
"34","34011",67334,56407,10927,16.2
"34","34013",365603,304277,61326,16.8
"34","34015",152757,129095,23662,15.5
"34","34017",358022,300446,57576,16.1
"34","34019",61710,54298,7412,12
"34","34021",204228,182685,21543,10.5
"34","34023",424661,364254,60407,14.2
"34","34025",322367,272485,49882,15.5
"34","34027",247738,215475,32263,13
"34","34029",274115,226718,47397,17.3
"34","34031",249345,199389,49956,20
"34","34033",29416,25305,4111,14
"34","34035",163839,143619,20220,12.3
"34","34037",74301,61757,12544,16.9
"34","34039",271917,229914,42003,15.4
"34","34041",57486,49502,7984,13.9
"35","35001",315463,276361,39102,12.4
"35","35003",1027,954,73,7.1
"35","35005",27225,24603,2622,9.6
"35","35006",8666,7883,783,9
"35","35007",5209,4756,453,8.7
"35","35009",21078,19745,1333,6.3
"35","35011",674,644,30,4.5
"35","35013",91434,80837,10597,11.6
"35","35015",35650,33467,2183,6.1
"35","35017",11784,10976,808,6.9
"35","35019",1427,1333,94,6.6
"35","35021",259,251,8,3.1
"35","35023",1982,1892,90,4.5
"35","35025",32330,29489,2841,8.8
"35","35027",9007,7804,1203,13.4
"35","35028",9140,8696,444,4.9
"35","35029",10066,8290,1776,17.6
"35","35031",23916,21450,2466,10.3
"35","35033",2002,1828,174,8.7
"35","35035",25381,22392,2989,11.8
"35","35037",3032,2831,201,6.6
"35","35039",16186,14448,1738,10.7
"35","35041",7744,7252,492,6.4
"35","35043",62773,54561,8212,13.1
"35","35045",48300,41886,6414,13.3
"35","35047",10683,9595,1088,10.2
"35","35049",69551,60963,8588,12.3
"35","35051",3714,3280,434,11.7
"35","35053",6077,5575,502,8.3
"35","35055",16413,13835,2578,15.7
"35","35057",5003,4424,579,11.6
"35","35059",1644,1553,91,5.5
"35","35061",28106,25119,2987,10.6
"36","36001",153435,135329,18106,11.8
"36","36003",19568,17007,2561,13.1
"36","36005",552273,461208,91065,16.5
"36","36007",85401,72583,12818,15
"36","36009",35466,29249,6217,17.5
"36","36011",35872,30369,5503,15.3
"36","36013",55798,47127,8671,15.5
"36","36015",36415,30620,5795,15.9
"36","36017",21792,19244,2548,11.7
"36","36019",37441,31808,5633,15
"36","36021",30643,27316,3327,10.9
"36","36023",22620,19430,3190,14.1
"36","36025",18546,16244,2302,12.4
"36","36027",142161,122169,19992,14.1
"36","36029",438336,356813,81523,18.6
"36","36031",16624,13830,2794,16.8
"36","36033",20051,17190,2861,14.3
"36","36035",22599,19172,3427,15.2
"36","36037",29421,25170,4251,14.4
"36","36039",20656,17590,3066,14.8
"36","36041",2159,1855,304,14.1
"36","36043",27337,23233,4104,15
"36","36045",43637,36257,7380,16.9
"36","36047",1098187,938295,159892,14.6
"36","36049",11232,9612,1620,14.4
"36","36051",29322,25190,4132,14.1
"36","36053",31956,26754,5202,16.3
"36","36055",351110,298327,52783,15
"36","36057",21717,18524,3193,14.7
"36","36059",677948,572452,105496,15.6
"36","36061",806470,718250,88220,10.9
"36","36063",101429,79202,22227,21.9
"36","36065",99997,84895,15102,15.1
"36","36067",216901,182066,34835,16.1
"36","36069",53515,45735,7780,14.5
"36","36071",176223,148724,27499,15.6
"36","36073",16935,14264,2671,15.8
"36","36075",51865,42989,8876,17.1
"36","36077",26735,23519,3216,12
"36","36079",50615,43482,7133,14.1
"36","36081",1073758,897570,176188,16.4
"36","36083",79342,69582,9760,12.3
"36","36085",202476,174170,28306,14
"36","36087",145031,125618,19413,13.4
"36","36089",44648,38383,6265,14
"36","36091",118022,102439,15583,13.2
"36","36093",75217,65217,10000,13.3
"36","36095",14011,12349,1662,11.9
"36","36097",8328,6939,1389,16.7
"36","36099",15959,13529,2430,15.2
"36","36101",43025,36451,6574,15.3
"36","36103",749303,626653,122650,16.4
"36","36105",36955,32132,4823,13.1
"36","36107",23247,19809,3438,14.8
"36","36109",48859,43939,4920,10.1
"36","36111",89971,76823,13148,14.6
"36","36113",30846,25563,5283,17.1
"36","36115",26371,22698,3673,13.9
"36","36117",42000,35979,6021,14.3
"36","36119",455845,391614,64231,14.1
"36","36121",17930,15188,2742,15.3
"36","36123",11155,9681,1474,13.2
"37","37001",73413,64082,9331,12.7
"37","37003",17388,13890,3498,20.1
"37","37005",4364,3904,460,10.5
"37","37007",10052,9226,826,8.2
"37","37009",12827,11456,1371,10.7
"37","37011",7384,6632,752,10.2
"37","37013",18517,17013,1504,8.1
"37","37015",7472,6993,479,6.4
"37","37017",14665,13340,1325,9
"37","37019",46674,38589,8085,17.3
"37","37021",131385,108421,22964,17.5
"37","37023",37190,31422,5768,15.5
"37","37025",100146,87871,12275,12.3
"37","37027",33291,27921,5370,16.1
"37","37029",4502,4114,388,8.6
"37","37031",31149,27647,3502,11.2
"37","37033",9515,8167,1348,14.2
"37","37035",74490,60492,13998,18.8
"37","37037",32193,29448,2745,8.5
"37","37039",11375,10033,1342,11.8
"37","37041",5442,5014,428,7.9
"37","37043",4209,3753,456,10.8
"37","37045",49140,42886,6254,12.7
"37","37047",22407,19950,2457,11
"37","37049",39565,35424,4141,10.5
"37","37051",118888,101283,17605,14.8
"37","37053",13593,11773,1820,13.4
"37","37055",20221,15272,4949,24.5
"37","37057",74892,64778,10114,13.5
"37","37059",19122,16601,2521,13.2
"37","37061",24767,22986,1781,7.2
"37","37063",157296,141658,15638,9.9
"37","37065",19751,17141,2610,13.2
"37","37067",171089,150278,20811,12.2
"37","37069",28187,25037,3150,11.2
"37","37071",103559,89187,14372,13.9
"37","37073",4809,4461,348,7.2
"37","37075",3410,2930,480,14.1
"37","37077",28786,26125,2661,9.2
"37","37079",9184,8471,713,7.8
"37","37081",236165,201248,34917,14.8
"37","37083",19797,17591,2206,11.1
"37","37085",51096,44915,6181,12.1
"37","37087",26991,23039,3952,14.6
"37","37089",49174,42467,6707,13.6
"37","37091",8918,8305,613,6.9
"37","37093",18408,15995,2413,13.1
"37","37095",1803,1537,266,14.8
"37","37097",84000,72080,11920,14.2
"37","37099",21231,18777,2454,11.6
"37","37101",89340,79638,9702,10.9
"37","37103",4083,3741,342,8.4
"37","37105",25879,22276,3603,13.9
"37","37107",27378,25519,1859,6.8
"37","37109",40252,35027,5225,13
"37","37111",21003,18537,2466,11.7
"37","37113",15375,13631,1744,11.3
"37","37115",8920,7810,1110,12.4
"37","37117",8604,7881,723,8.4
"37","37119",573840,500268,73572,12.8
"37","37121",6128,5350,778,12.7
"37","37123",10887,9750,1137,10.4
"37","37125",40936,35721,5215,12.7
"37","37127",40163,35222,4941,12.3
"37","37129",112165,95288,16877,15
"37","37131",7260,6712,548,7.5
"37","37133",61868,54543,7325,11.8
"37","37135",71033,65240,5793,8.2
"37","37137",4955,4550,405,8.2
"37","37139",16596,14720,1876,11.3
"37","37141",25381,22187,3194,12.6
"37","37143",4810,4327,483,10
"37","37145",17409,15154,2255,13
"37","37147",81519,73791,7728,9.5
"37","37149",8601,7695,906,10.5
"37","37151",60123,51055,9068,15.1
"37","37153",16694,14755,1939,11.6
"37","37155",48634,43664,4970,10.2
"37","37157",36495,30715,5780,15.8
"37","37159",62014,53098,8916,14.4
"37","37161",25642,22031,3611,14.1
"37","37163",28538,26472,2066,7.2
"37","37165",11923,10218,1705,14.3
"37","37167",29158,26257,2901,9.9
"37","37169",19532,17393,2139,11
"37","37171",33764,29424,4340,12.9
"37","37173",7369,6284,1085,14.7
"37","37175",14088,12614,1474,10.5
"37","37177",1327,1133,194,14.6
"37","37179",111384,99881,11503,10.3
"37","37181",17736,15557,2179,12.3
"37","37183",538607,479413,59194,11
"37","37185",6616,5812,804,12.2
"37","37187",4133,3719,414,10
"37","37189",29281,26028,3253,11.1
"37","37191",45924,41537,4387,9.6
"37","37193",28381,25095,3286,11.6
"37","37195",35062,30499,4563,13
"37","37197",16873,14270,2603,15.4
"37","37199",7971,7115,856,10.7
"38","38001",1030,979,51,5
"38","38003",5138,4766,372,7.2
"38","38005",2416,2128,288,11.9
"38","38007",363,341,22,6.1
"38","38009",2879,2615,264,9.2
"38","38011",1611,1501,110,6.8
"38","38013",1051,961,90,8.6
"38","38015",48547,44010,4537,9.3
"38","38017",103901,94383,9518,9.2
"38","38019",1874,1765,109,5.8
"38","38021",2368,2135,233,9.8
"38","38023",1378,1305,73,5.3
"38","38025",3297,3139,158,4.8
"38","38027",1212,1121,91,7.5
"38","38029",1424,1311,113,7.9
"38","38031",1466,1372,94,6.4
"38","38033",822,786,36,4.4
"38","38035",37076,33653,3423,9.2
"38","38037",1193,1144,49,4.1
"38","38039",1004,965,39,3.9
"38","38041",1363,1297,66,4.8
"38","38043",1277,1174,103,8.1
"38","38045",2047,1935,112,5.5
"38","38047",872,827,45,5.2
"38","38049",3083,2829,254,8.2
"38","38051",1067,1030,37,3.5
"38","38053",9965,9056,909,9.1
"38","38055",4577,4269,308,6.7
"38","38057",3422,3134,288,8.4
"38","38059",16159,14467,1692,10.5
"38","38061",7251,6818,433,6
"38","38063",1359,1260,99,7.3
"38","38065",847,778,69,8.1
"38","38067",3463,3012,451,13
"38","38069",1678,1534,144,8.6
"38","38071",5533,5048,485,8.8
"38","38073",3097,2612,485,15.7
"38","38075",1210,1120,90,7.4
"38","38077",8819,7930,889,10.1
"38","38079",4679,3941,738,15.8
"38","38081",3094,2530,564,18.2
"38","38083",673,616,57,8.5
"38","38085",1143,1102,41,3.6
"38","38087",389,375,14,3.6
"38","38089",18739,16891,1848,9.9
"38","38091",974,931,43,4.4
"38","38093",10139,9537,602,5.9
"38","38095",1081,1040,41,3.8
"38","38097",4298,4025,273,6.4
"38","38099",5042,4687,355,7
"38","38101",31943,28636,3307,10.4
"38","38103",1889,1762,127,6.7
"38","38105",24014,21337,2677,11.1
"39","39001",10489,8651,1838,17.5
"39","39003",49248,39111,10137,20.6
"39","39005",26263,22961,3302,12.6
"39","39007",42943,36152,6791,15.8
"39","39009",26641,23629,3012,11.3
"39","39011",25641,20649,4992,19.5
"39","39013",28790,23603,5187,18
"39","39015",18972,15964,3008,15.9
"39","39017",186913,160314,26599,14.2
"39","39019",12793,10629,2164,16.9
"39","39021",19674,15706,3968,20.2
"39","39023",65149,53787,11362,17.4
"39","39025",102008,87776,14232,14
"39","39027",17992,14898,3094,17.2
"39","39029",47185,37561,9624,20.4
"39","39031",13907,11603,2304,16.6
"39","39033",18381,13978,4403,24
"39","39035",593568,453871,139697,23.5
"39","39037",25757,21218,4539,17.6
"39","39039",18375,14275,4100,22.3
"39","39041",104476,92981,11495,11
"39","39043",38111,28390,9721,25.5
"39","39045",76281,65628,10653,14
"39","39047",14052,11778,2274,16.2
"39","39049",678908,585183,93725,13.8
"39","39051",22638,17862,4776,21.1
"39","39053",12561,10872,1689,13.4
"39","39055",44426,36837,7589,17.1
"39","39057",81141,70738,10403,12.8
"39","39059",18388,15645,2743,14.9
"39","39061",397468,341241,56227,14.1
"39","39063",43118,35655,7463,17.3
"39","39065",13626,10560,3066,22.5
"39","39067",6508,5528,980,15.1
"39","39069",12981,10237,2744,21.1
"39","39071",16779,13395,3384,20.2
"39","39073",12887,10844,2043,15.9
"39","39075",20848,19494,1354,6.5
"39","39077",28176,22111,6065,21.5
"39","39079",12772,10842,1930,15.1
"39","39081",27117,22222,4895,18.1
"39","39083",30659,26848,3811,12.4
"39","39085",120674,94265,26409,21.9
"39","39087",23789,19980,3809,16
"39","39089",87690,76051,11639,13.3
"39","39091",24047,16819,7228,30.1
"39","39093",153539,114208,39331,25.6
"39","39095",214215,163544,50671,23.7
"39","39097",20392,17747,2645,13
"39","39099",101452,81063,20389,20.1
"39","39101",28441,23459,4982,17.5
"39","39103",92750,73150,19600,21.1
"39","39105",8655,7292,1363,15.7
"39","39107",23638,20317,3321,14
"39","39109",54866,46096,8770,16
"39","39111",5194,4350,844,16.2
"39","39113",256178,212905,43273,16.9
"39","39115",6364,5245,1119,17.6
"39","39117",16806,14080,2726,16.2
"39","39119",39699,33379,6320,15.9
"39","39121",4598,3830,768,16.7
"39","39123",19958,16074,3884,19.5
"39","39125",8599,6896,1703,19.8
"39","39127",15897,13211,2686,16.9
"39","39129",25836,22272,3564,13.8
"39","39131",10853,8906,1947,17.9
"39","39133",81758,69717,12041,14.7
"39","39135",20199,17292,2907,14.4
"39","39137",18599,15831,2768,14.9
"39","39139",53775,42851,10924,20.3
"39","39141",35756,29171,6585,18.4
"39","39143",30447,24388,6059,19.9
"39","39145",28767,24439,4328,15
"39","39147",27501,21656,5845,21.3
"39","39149",25366,19869,5497,21.7
"39","39151",181371,151901,29470,16.2
"39","39153",259552,217047,42505,16.4
"39","39155",85885,67869,18016,21
"39","39157",44758,37929,6829,15.3
"39","39159",29588,24656,4932,16.7
"39","39161",15272,12794,2478,16.2
"39","39163",5412,4507,905,16.7
"39","39165",113207,98179,15028,13.3
"39","39167",28049,23894,4155,14.8
"39","39169",61725,54460,7265,11.8
"39","39171",19396,15312,4084,21.1
"39","39173",67733,56122,11611,17.1
"39","39175",13313,10591,2722,20.4
"40","40001",7573,6764,809,10.7
"40","40003",2578,2421,157,6.1
"40","40005",4721,4091,630,13.3
"40","40007",2531,2433,98,3.9
"40","40009",9268,7860,1408,15.2
"40","40011",4449,3960,489,11
"40","40013",20134,17730,2404,11.9
"40","40015",11325,9912,1413,12.5
"40","40017",72000,60805,11195,15.5
"40","40019",21405,17491,3914,18.3
"40","40021",17679,15749,1930,10.9
"40","40023",5207,4466,741,14.2
"40","40025",1261,1228,33,2.6
"40","40027",135468,116455,19013,14
"40","40029",2251,2001,250,11.1
"40","40031",47347,38352,8995,19
"40","40033",2757,2237,520,18.9
"40","40035",5541,4915,626,11.3
"40","40037",30031,25741,4290,14.3
"40","40039",14530,13030,1500,10.3
"40","40041",17623,15389,2234,12.7
"40","40043",2740,2538,202,7.4
"40","40045",1963,1830,133,6.8
"40","40047",25751,22814,2937,11.4
"40","40049",11938,10320,1618,13.6
"40","40051",25250,21772,3478,13.8
"40","40053",2468,2314,154,6.2
"40","40055",1867,1604,263,14.1
"40","40057",1119,1057,62,5.5
"40","40059",1654,1572,82,5
"40","40061",4082,3473,609,14.9
"40","40063",5186,4457,729,14.1
"40","40065",10494,9644,850,8.1
"40","40067",2466,2105,361,14.6
"40","40069",3336,2700,636,19.1
"40","40071",17841,15160,2681,15
"40","40073",8251,7591,660,8
"40","40075",3258,2897,361,11.1
"40","40077",3002,2482,520,17.3
"40","40079",17905,15426,2479,13.8
"40","40081",14714,12897,1817,12.3
"40","40083",20582,18139,2443,11.9
"40","40085",5893,5183,710,12
"40","40087",18727,16246,2481,13.2
"40","40089",14018,12365,1653,11.8
"40","40091",7101,5953,1148,16.2
"40","40093",3567,3269,298,8.4
"40","40095",7026,5827,1199,17.1
"40","40097",18131,16297,1834,10.1
"40","40099",6068,5332,736,12.1
"40","40101",28029,24351,3678,13.1
"40","40103",5185,4687,498,9.6
"40","40105",4293,3864,429,10
"40","40107",4299,3746,553,12.9
"40","40109",369676,312877,56799,15.4
"40","40111",14969,12695,2274,15.2
"40","40113",19669,16913,2756,14
"40","40115",15148,12832,2316,15.3
"40","40117",7014,6022,992,14.1
"40","40119",35748,31203,4545,12.7
"40","40121",16573,13797,2776,16.8
"40","40123",17934,15652,2282,12.7
"40","40125",31493,27247,4246,13.5
"40","40127",4133,3598,535,12.9
"40","40129",1756,1588,168,9.6
"40","40131",42706,36949,5757,13.5
"40","40133",9119,7812,1307,14.3
"40","40135",15762,13172,2590,16.4
"40","40137",18169,15468,2701,14.9
"40","40139",10961,10660,301,2.7
"40","40141",3174,2548,626,19.7
"40","40143",312554,264180,48374,15.5
"40","40145",36083,31076,5007,13.9
"40","40147",20685,17991,2694,13
"40","40149",4887,4283,604,12.4
"40","40151",4250,3971,279,6.6
"40","40153",8882,7857,1025,11.5
"41","41001",7175,6205,970,13.5
"41","41003",48077,43159,4918,10.2
"41","41005",218729,188517,30212,13.8
"41","41007",19161,14492,4669,24.4
"41","41009",24541,20794,3747,15.3
"41","41011",26903,21832,5071,18.8
"41","41013",9714,7903,1811,18.6
"41","41015",8687,7120,1567,18
"41","41017",96492,78936,17556,18.2
"41","41019",47674,39728,7946,16.7
"41","41021",899,797,102,11.3
"41","41023",3234,2738,496,15.3
"41","41025",3524,3168,356,10.1
"41","41027",13581,11680,1901,14
"41","41029",103221,86653,16568,16.1
"41","41031",9848,8439,1409,14.3
"41","41033",35775,30212,5563,15.5
"41","41035",29206,24559,4647,15.9
"41","41037",3520,3180,340,9.7
"41","41039",179746,150845,28901,16.1
"41","41041",20968,15472,5496,26.2
"41","41043",60870,51401,9469,15.6
"41","41045",12500,11463,1037,8.3
"41","41047",159116,137775,21341,13.4
"41","41049",5561,5113,448,8.1
"41","41051",462804,390174,72630,15.7
"41","41053",38840,33828,5012,12.9
"41","41055",964,843,121,12.6
"41","41057",11923,9728,2195,18.4
"41","41059",37132,31817,5315,14.3
"41","41061",12304,9931,2373,19.3
"41","41063",3368,2892,476,14.1
"41","41065",12465,10615,1850,14.8
"41","41067",317871,279816,38055,12
"41","41069",686,646,40,5.8
"41","41071",54601,47417,7184,13.2
"42","42001",53988,46075,7913,14.7
"42","42003",630144,532706,97438,15.5
"42","42005",31743,26228,5515,17.4
"42","42007",84024,68715,15309,18.2
"42","42009",23460,19272,4188,17.9
"42","42011",219873,182086,37787,17.2
"42","42013",61376,50788,10588,17.3
"42","42015",27720,24228,3492,12.6
"42","42017",334223,284620,49603,14.8
"42","42019",96940,82164,14776,15.2
"42","42021",58635,48442,10193,17.4
"42","42023",2228,1686,542,24.3
"42","42025",33124,26971,6153,18.6
"42","42027",79765,72045,7720,9.7
"42","42029",268194,237757,30437,11.3
"42","42031",17114,14258,2856,16.7
"42","42033",36779,30526,6253,17
"42","42035",17766,14966,2800,15.8
"42","42037",34936,29699,5237,15
"42","42039",37882,31696,6186,16.3
"42","42041",129863,114171,15692,12.1
"42","42043",145010,123885,21125,14.6
"42","42045",297374,254732,42642,14.3
"42","42047",16982,12664,4318,25.4
"42","42049",128271,106893,21378,16.7
"42","42051",57590,46061,11529,20
"42","42053",1859,1529,330,17.8
"42","42055",76578,66622,9956,13
"42","42057",8078,6682,1396,17.3
"42","42059",15589,13398,2191,14.1
"42","42061",19882,16438,3444,17.3
"42","42063",37865,32121,5744,15.2
"42","42065",20355,17015,3340,16.4
"42","42067",12851,10531,2320,18.1
"42","42069",104016,86228,17788,17.1
"42","42071",277006,236220,40786,14.7
"42","42073",40614,33136,7478,18.4
"42","42075",73494,63365,10129,13.8
"42","42077",194876,163219,31657,16.2
"42","42079",157132,128168,28964,18.4
"42","42081",53178,44157,9021,17
"42","42083",17289,14107,3182,18.4
"42","42085",48412,40078,8334,17.2
"42","42087",21182,17690,3492,16.5
"42","42089",80387,63633,16754,20.8
"42","42091",435345,377450,57895,13.3
"42","42093",9210,8177,1033,11.2
"42","42095",162340,136684,25656,15.8
"42","42097",43059,35688,7371,17.1
"42","42099",24314,21065,3249,13.4
"42","42101",734343,613160,121183,16.5
"42","42103",24854,20060,4794,19.3
"42","42105",7010,5922,1088,15.5
"42","42107",66996,55954,11042,16.5
"42","42109",20580,16982,3598,17.5
"42","42111",32666,26845,5821,17.8
"42","42113",2496,2118,378,15.1
"42","42115",19268,16785,2483,12.9
"42","42117",18472,15696,2776,15
"42","42119",19354,16636,2718,14
"42","42121",21764,18481,3283,15.1
"42","42123",18263,15888,2375,13
"42","42125",105366,87622,17744,16.8
"42","42127",21654,17667,3987,18.4
"42","42129",179040,148204,30836,17.2
"42","42131",13200,11159,2041,15.5
"42","42133",241180,205340,35840,14.9
"44","44001",23759,20301,3458,14.6
"44","44003",86318,70670,15648,18.1
"44","44005",41147,34526,6621,16.1
"44","44007",309545,251831,57714,18.6
"44","44009",62343,52467,9876,15.8
"45","45001",10107,8709,1398,13.8
"45","45003",75469,67974,7495,9.9
"45","45005",2575,2246,329,12.8
"45","45007",93272,81525,11747,12.6
"45","45009",4813,4248,565,11.7
"45","45011",7822,7007,815,10.4
"45","45013",76501,67424,9077,11.9
"45","45015",101834,90936,10898,10.7
"45","45017",6401,5850,551,8.6
"45","45019",212814,185087,27727,13
"45","45021",26704,22318,4386,16.4
"45","45023",13347,11403,1944,14.6
"45","45025",21705,19316,2389,11
"45","45027",12687,11240,1447,11.4
"45","45029",16225,14759,1466,9
"45","45031",30131,27028,3103,10.3
"45","45033",12782,11612,1170,9.2
"45","45035",76958,68330,8628,11.2
"45","45037",10846,9729,1117,10.3
"45","45039",9558,8452,1106,11.6
"45","45041",65224,59607,5617,8.6
"45","45043",26182,22187,3995,15.3
"45","45045",260275,228430,31845,12.2
"45","45047",30780,27309,3471,11.3
"45","45049",7966,7395,571,7.2
"45","45051",147357,113966,33391,22.7
"45","45053",12091,10961,1130,9.3
"45","45055",28827,26133,2694,9.3
"45","45057",40538,35311,5227,12.9
"45","45059",31363,26896,4467,14.2
"45","45061",6631,5835,796,12
"45","45063",145978,134758,11220,7.7
"45","45065",3316,2929,387,11.7
"45","45067",12512,11020,1492,11.9
"45","45069",9560,7887,1673,17.5
"45","45071",18485,16863,1622,8.8
"45","45073",35393,31109,4284,12.1
"45","45075",35089,30429,4660,13.3
"45","45077",57613,51254,6359,11
"45","45079",195439,177807,17632,9
"45","45081",8618,8004,614,7.1
"45","45083",161055,137034,24021,14.9
"45","45085",45226,40225,5001,11.1
"45","45087",12667,10323,2344,18.5
"45","45089",11886,10446,1440,12.1
"45","45091",136997,120623,16374,12
"46","46003",1483,1402,81,5.5
"46","46005",9501,8804,697,7.3
"46","46007",1041,972,69,6.6
"46","46009",2831,2596,235,8.3
"46","46011",19284,17618,1666,8.6
"46","46013",21317,19138,2179,10.2
"46","46015",2523,2245,278,11
"46","46017",698,596,102,14.6
"46","46019",5239,4592,647,12.3
"46","46021",750,700,50,6.7
"46","46023",3821,3381,440,11.5
"46","46025",1872,1698,174,9.3
"46","46027",7801,7149,652,8.4
"46","46029",16313,14176,2137,13.1
"46","46031",1290,1209,81,6.3
"46","46033",4038,3507,531,13.2
"46","46035",11095,10134,961,8.7
"46","46037",2797,2421,376,13.4
"46","46039",2207,1943,264,12
"46","46041",2139,1944,195,9.1
"46","46043",1501,1437,64,4.3
"46","46045",1969,1880,89,4.5
"46","46047",2999,2692,307,10.2
"46","46049",1004,954,50,5
"46","46051",4438,4046,392,8.8
"46","46053",1999,1858,141,7.1
"46","46055",1005,961,44,4.4
"46","46057",3206,2961,245,7.6
"46","46059",1697,1616,81,4.8
"46","46061",1719,1559,160,9.3
"46","46063",706,658,48,6.8
"46","46065",9861,9099,762,7.7
"46","46067",3529,3286,243,6.9
"46","46069",646,621,25,3.9
"46","46071",1179,1113,66,5.6
"46","46073",1067,1017,50,4.7
"46","46075",513,480,33,6.4
"46","46077",2649,2466,183,6.9
"46","46079",6658,6191,467,7
"46","46081",15310,11981,3329,21.7
"46","46083",34234,31107,3127,9.1
"46","46085",1643,1477,166,10.1
"46","46087",3011,2776,235,7.8
"46","46089",995,900,95,9.5
"46","46091",2364,2088,276,11.7
"46","46093",14229,12361,1868,13.1
"46","46095",725,663,62,8.6
"46","46097",1144,1061,83,7.3
"46","46099",114059,101322,12737,11.2
"46","46101",4116,3608,508,12.3
"46","46102",3412,3049,363,10.6
"46","46103",57504,49483,8021,13.9
"46","46105",1373,1305,68,5
"46","46107",992,938,54,5.4
"46","46109",5194,4291,903,17.4
"46","46111",1134,1047,87,7.7
"46","46115",3135,2886,249,7.9
"46","46117",1845,1673,172,9.3
"46","46119",767,726,41,5.3
"46","46121",3114,2840,274,8.8
"46","46123",2940,2780,160,5.4
"46","46125",4632,4258,374,8.1
"46","46127",8564,7522,1042,12.2
"46","46129",2090,1856,234,11.2
"46","46135",12495,11038,1457,11.7
"46","46137",878,832,46,5.2
"47","47001",33802,28779,5023,14.9
"47","47003",21741,17673,4068,18.7
"47","47005",6825,5818,1007,14.8
"47","47007",4407,3671,736,16.7
"47","47009",61980,53036,8944,14.4
"47","47011",50091,43304,6787,13.5
"47","47013",14678,12212,2466,16.8
"47","47015",6426,5383,1043,16.2
"47","47017",11538,9934,1604,13.9
"47","47019",22958,20061,2897,12.6
"47","47021",20317,17952,2365,11.6
"47","47023",7490,6666,824,11
"47","47025",12870,10928,1942,15.1
"47","47027",2652,2288,364,13.7
"47","47029",16129,12006,4123,25.6
"47","47031",26777,21483,5294,19.8
"47","47033",6159,5502,657,10.7
"47","47035",22686,19795,2891,12.7
"47","47037",393655,331041,62614,15.9
"47","47039",4457,3787,670,15
"47","47041",7793,6047,1746,22.4
"47","47043",25650,22052,3598,14
"47","47045",16132,13792,2340,14.5
"47","47047",17538,15895,1643,9.4
"47","47049",7280,6547,733,10.1
"47","47051",21715,17128,4587,21.1
"47","47053",21138,18584,2554,12.1
"47","47055",15401,12371,3030,19.7
"47","47057",9228,7896,1332,14.4
"47","47059",29951,24842,5109,17.1
"47","47061",5731,4281,1450,25.3
"47","47063",27728,23506,4222,15.2
"47","47065",184295,157832,26463,14.4
"47","47067",2064,1804,260,12.6
"47","47069",8935,8064,871,9.7
"47","47071",10263,9115,1148,11.2
"47","47073",23284,19674,3610,15.5
"47","47075",7381,6450,931,12.6
"47","47077",12082,10143,1939,16
"47","47079",14001,11938,2063,14.7
"47","47081",10690,9348,1342,12.6
"47","47083",3178,2747,431,13.6
"47","47085",8633,7599,1034,12
"47","47087",4725,3919,806,17.1
"47","47089",24920,20569,4351,17.5
"47","47091",7496,6622,874,11.7
"47","47093",234458,204138,30320,12.9
"47","47095",1716,1484,232,13.5
"47","47097",9469,8149,1320,13.9
"47","47099",19809,16113,3696,18.7
"47","47101",5356,4285,1071,20
"47","47103",16042,13358,2684,16.7
"47","47105",23106,19599,3507,15.2
"47","47107",24495,20268,4227,17.3
"47","47109",8269,7237,1032,12.5
"47","47111",10759,9260,1499,13.9
"47","47113",44467,38017,6450,14.5
"47","47115",12426,10607,1819,14.6
"47","47117",16774,12755,4019,24
"47","47119",51657,40283,11374,22
"47","47121",5357,4362,995,18.6
"47","47123",21381,16708,4673,21.9
"47","47125",83065,70297,12768,15.4
"47","47127",3621,3171,450,12.4
"47","47129",7311,6526,785,10.7
"47","47131",12248,10988,1260,10.3
"47","47133",9784,8451,1333,13.6
"47","47135",2982,2286,696,23.3
"47","47137",2231,1992,239,10.7
"47","47139",7185,6224,961,13.4
"47","47141",34989,29863,5126,14.7
"47","47143",14056,10618,3438,24.5
"47","47145",21989,19360,2629,12
"47","47147",35755,31108,4647,13
"47","47149",180933,150670,30263,16.7
"47","47151",8506,7016,1490,17.5
"47","47153",6324,5268,1056,16.7
"47","47155",57367,40432,16935,29.5
"47","47157",420621,366297,54324,12.9
"47","47159",9026,7733,1293,14.3
"47","47161",5272,4674,598,11.3
"47","47163",68349,58456,9893,14.5
"47","47165",98366,83781,14585,14.8
"47","47167",26026,23233,2793,10.7
"47","47169",5049,4431,618,12.2
"47","47171",6794,5898,896,13.2
"47","47173",7254,6316,938,12.9
"47","47175",2103,1680,423,20.1
"47","47177",17496,13253,4243,24.3
"47","47179",58602,50754,7848,13.4
"47","47181",6139,5349,790,12.9
"47","47183",14661,13255,1406,9.6
"47","47185",12126,10076,2050,16.9
"47","47187",117675,105441,12234,10.4
"47","47189",72917,62726,10191,14
"48","48001",20916,19295,1621,7.8
"48","48003",8911,7954,957,10.7
"48","48005",32356,28530,3826,11.8
"48","48007",8377,7137,1240,14.8
"48","48009",3574,3267,307,8.6
"48","48011",820,766,54,6.6
"48","48013",19952,17366,2586,13
"48","48015",12542,11340,1202,9.6
"48","48017",2096,1961,135,6.4
"48","48019",8895,8059,836,9.4
"48","48021",38520,34396,4124,10.7
"48","48023",1523,1459,64,4.2
"48","48025",8939,7781,1158,13
"48","48027",132527,117177,15350,11.6
"48","48029",884673,763079,121594,13.7
"48","48031",5657,5270,387,6.8
"48","48033",358,344,14,3.9
"48","48035",7268,6634,634,8.7
"48","48037",36181,31044,5137,14.2
"48","48039",165699,143372,22327,13.5
"48","48041",108557,98914,9643,8.9
"48","48043",3872,3399,473,12.2
"48","48045",493,463,30,6.1
"48","48047",2392,2077,315,13.2
"48","48049",13533,12165,1368,10.1
"48","48051",7566,6905,661,8.7
"48","48053",20624,18788,1836,8.9
"48","48055",17549,15715,1834,10.5
"48","48057",10900,9929,971,8.9
"48","48059",5399,4983,416,7.7
"48","48061",155287,128710,26577,17.1
"48","48063",4437,3975,462,10.4
"48","48065",2658,2486,172,6.5
"48","48067",11223,9862,1361,12.1
"48","48069",2916,2798,118,4
"48","48071",18256,15495,2761,15.1
"48","48073",19102,16653,2449,12.8
"48","48075",2486,2346,140,5.6
"48","48077",4276,3892,384,9
"48","48079",1003,904,99,9.9
"48","48081",1246,1154,92,7.4
"48","48083",2532,2239,293,11.6
"48","48085",524670,460662,64008,12.2
"48","48087",946,895,51,5.4
"48","48089",8487,7866,621,7.3
"48","48091",66789,58843,7946,11.9
"48","48093",4833,4499,334,6.9
"48","48095",1175,1103,72,6.1
"48","48097",18736,16112,2624,14
"48","48099",21948,19620,2328,10.6
"48","48101",450,420,30,6.7
"48","48103",1459,1190,269,18.4
"48","48105",1471,1302,169,11.5
"48","48107",2168,2014,154,7.1
"48","48109",892,800,92,10.3
"48","48111",3226,3116,110,3.4
"48","48113",1274059,1109777,164282,12.9
"48","48115",4170,3727,443,10.6
"48","48117",7282,6938,344,4.7
"48","48119",2143,1955,188,8.8
"48","48121",464928,405095,59833,12.9
"48","48123",8637,7971,666,7.7
"48","48125",592,538,54,9.1
"48","48127",6316,5856,460,7.3
"48","48129",1152,1087,65,5.6
"48","48131",4535,3836,699,15.4
"48","48133",6754,6147,607,9
"48","48135",79055,68405,10650,13.5
"48","48137",949,916,33,3.5
"48","48139",84894,75681,9213,10.9
"48","48141",333526,284198,49328,14.8
"48","48143",18380,16780,1600,8.7
"48","48145",5841,5316,525,9
"48","48147",15552,14377,1175,7.6
"48","48149",10318,9587,731,7.1
"48","48151",1356,1289,67,4.9
"48","48153",2234,2051,183,8.2
"48","48155",515,477,38,7.4
"48","48157",361957,315105,46852,12.9
"48","48159",4084,3726,358,8.8
"48","48161",5582,4964,618,11.1
"48","48163",9021,8435,586,6.5
"48","48165",8538,7930,608,7.1
"48","48167",156686,132203,24483,15.6
"48","48169",1874,1718,156,8.3
"48","48171",12001,10756,1245,10.4
"48","48173",682,649,33,4.8
"48","48175",2825,2518,307,10.9
"48","48177",8341,7734,607,7.3
"48","48179",7149,6415,734,10.3
"48","48181",58740,52525,6215,10.6
"48","48183",53012,46006,7006,13.2
"48","48185",10087,8985,1102,10.9
"48","48187",73753,65715,8038,10.9
"48","48189",10457,9502,955,9.1
"48","48191",910,835,75,8.2
"48","48193",3131,2916,215,6.9
"48","48195",2250,2174,76,3.4
"48","48197",1478,1398,80,5.4
"48","48199",23269,19595,3674,15.8
"48","48201",2165453,1852552,312901,14.4
"48","48203",26058,23029,3029,11.6
"48","48205",2316,2255,61,2.6
"48","48207",1950,1816,134,6.9
"48","48209",110437,96335,14102,12.8
"48","48211",1554,1460,94,6
"48","48213",32783,29476,3307,10.1
"48","48215",338467,276811,61656,18.2
"48","48217",14595,13113,1482,10.2
"48","48219",10092,8920,1172,11.6
"48","48221",24627,21915,2712,11
"48","48223",15413,14112,1301,8.4
"48","48225",8760,8171,589,6.7
"48","48227",12594,11285,1309,10.4
"48","48229",1645,1448,197,12
"48","48231",39660,35268,4392,11.1
"48","48233",7590,6776,814,10.7
"48","48235",647,601,46,7.1
"48","48237",2932,2636,296,10.1
"48","48239",6619,6089,530,8
"48","48241",11906,9845,2061,17.3
"48","48243",872,800,72,8.3
"48","48245",100715,81681,19034,18.9
"48","48247",1592,1396,196,12.3
"48","48249",15703,13087,2616,16.7
"48","48251",74413,65652,8761,11.8
"48","48253",5157,4670,487,9.4
"48","48255",6390,5925,465,7.3
"48","48257",59641,52754,6887,11.5
"48","48259",19655,17814,1841,9.4
"48","48261",171,160,11,6.4
"48","48263",409,388,21,5.1
"48","48265",20014,17748,2266,11.3
"48","48267",1547,1461,86,5.6
"48","48269",203,198,5,2.5
"48","48271",1193,1107,86,7.2
"48","48273",12218,10683,1535,12.6
"48","48275",1241,1153,88,7.1
"48","48277",21929,19614,2315,10.6
"48","48279",4603,4291,312,6.8
"48","48281",8199,7527,672,8.2
"48","48283",3749,3446,303,8.1
"48","48285",7167,6642,525,7.3
"48","48287",8653,8029,624,7.2
"48","48289",5534,4959,575,10.4
"48","48291",30911,26171,4740,15.3
"48","48293",7523,6845,678,9
"48","48295",1353,1281,72,5.3
"48","48297",4938,4481,457,9.3
"48","48299",7593,6881,712,9.4
"48","48301",602,594,8,1.3
"48","48303",140603,126550,14053,10
"48","48305",2415,2251,164,6.8
"48","48307",2865,2567,298,10.4
"48","48309",107527,96052,11475,10.7
"48","48311",743,724,19,2.6
"48","48313",3930,3573,357,9.1
"48","48315",3780,3293,487,12.9
"48","48317",2433,2258,175,7.2
"48","48319",1502,1392,110,7.3
"48","48321",15477,13240,2237,14.5
"48","48323",22568,18093,4475,19.8
"48","48325",19597,17573,2024,10.3
"48","48327",737,681,56,7.6
"48","48329",93005,83462,9543,10.3
"48","48331",8552,7603,949,11.1
"48","48333",1596,1518,78,4.9
"48","48335",2030,1841,189,9.3
"48","48337",8404,7445,959,11.4
"48","48339",262503,228008,34495,13.1
"48","48341",9177,8739,438,4.8
"48","48343",4377,3767,610,13.9
"48","48345",405,381,24,5.9
"48","48347",24716,22125,2591,10.5
"48","48349",21299,19208,2091,9.8
"48","48351",4734,3951,783,16.5
"48","48353",6179,5781,398,6.4
"48","48355",150800,127021,23779,15.8
"48","48357",3633,3348,285,7.8
"48","48359",804,758,46,5.7
"48","48361",33934,27963,5971,17.6
"48","48363",12048,10774,1274,10.6
"48","48365",8899,7944,955,10.7
"48","48367",60279,53922,6357,10.5
"48","48369",4051,3944,107,2.6
"48","48371",5541,4992,549,9.9
"48","48373",16208,14256,1952,12
"48","48375",49749,45166,4583,9.2
"48","48377",3025,2398,627,20.7
"48","48379",5379,4971,408,7.6
"48","48381",65008,59438,5570,8.6
"48","48383",1729,1540,189,10.9
"48","48385",866,785,81,9.4
"48","48387",4424,4026,398,9
"48","48389",10700,10127,573,5.4
"48","48391",2790,2473,317,11.4
"48","48393",356,334,22,6.2
"48","48395",6911,6309,602,8.7
"48","48397",48212,42513,5699,11.8
"48","48399",3996,3687,309,7.7
"48","48401",20319,18220,2099,10.3
"48","48403",3409,2825,584,17.1
"48","48405",3118,2777,341,10.9
"48","48407",10466,9283,1183,11.3
"48","48409",26950,22444,4506,16.7
"48","48411",2154,2017,137,6.4
"48","48413",1081,993,88,8.1
"48","48415",5828,5210,618,10.6
"48","48417",1608,1501,107,6.7
"48","48419",9722,8853,869,8.9
"48","48421",1175,1143,32,2.7
"48","48423",98894,86859,12035,12.2
"48","48425",3872,3468,404,10.4
"48","48427",24458,18507,5951,24.3
"48","48429",3444,3212,232,6.7
"48","48431",509,469,40,7.9
"48","48433",478,451,27,5.6
"48","48435",1164,1027,137,11.8
"48","48437",2238,2076,162,7.2
"48","48439",997947,863704,134243,13.5
"48","48441",60388,55012,5376,8.9
"48","48443",310,294,16,5.2
"48","48445",4323,3909,414,9.6
"48","48447",529,505,24,4.5
"48","48449",11639,10394,1245,10.7
"48","48451",47781,42716,5065,10.6
"48","48453",680114,595892,84222,12.4
"48","48455",4710,4197,513,10.9
"48","48457",6541,5568,973,14.9
"48","48459",15986,14128,1858,11.6
"48","48461",1454,1346,108,7.4
"48","48463",10077,9031,1046,10.4
"48","48465",20548,17843,2705,13.2
"48","48467",23414,21003,2411,10.3
"48","48469",38453,32897,5556,14.4
"48","48471",21669,19260,2409,11.1
"48","48473",21418,18843,2575,12
"48","48475",7001,6361,640,9.1
"48","48477",13250,12221,1029,7.8
"48","48479",104251,90038,14213,13.6
"48","48481",19317,17460,1857,9.6
"48","48483",1945,1810,135,6.9
"48","48485",49866,44019,5847,11.7
"48","48487",4280,3958,322,7.5
"48","48489",6256,5167,1089,17.4
"48","48491",286258,252451,33807,11.8
"48","48493",21994,20056,1938,8.8
"48","48495",3491,3083,408,11.7
"48","48497",28790,25473,3317,11.5
"48","48499",15823,14161,1662,10.5
"48","48501",3614,3012,602,16.7
"48","48503",6962,6378,584,8.4
"48","48505",4236,3663,573,13.5
"48","48507",2940,2422,518,17.6
"49","49001",2811,2630,181,6.4
"49","49003",26475,23730,2745,10.4
"49","49005",62744,58976,3768,6
"49","49007",8374,7569,805,9.6
"49","49009",369,336,33,8.9
"49","49011",174197,158705,15492,8.9
"49","49013",7890,6890,1000,12.7
"49","49015",4231,3873,358,8.5
"49","49017",2869,2182,687,23.9
"49","49019",6790,4961,1829,26.9
"49","49021",23356,21201,2155,9.2
"49","49023",5483,5175,308,5.6
"49","49025",3566,3023,543,15.2
"49","49027",5817,5487,330,5.7
"49","49029",5510,5085,425,7.7
"49","49031",482,432,50,10.4
"49","49033",992,920,72,7.3
"49","49035",630366,559768,70598,11.2
"49","49037",5883,4908,975,16.6
"49","49039",12251,11524,727,5.9
"49","49041",9513,8738,775,8.1
"49","49043",24094,19211,4883,20.3
"49","49045",33340,29910,3430,10.3
"49","49047",14100,11863,2237,15.9
"49","49049",301899,278334,23565,7.8
"49","49051",16099,13287,2812,17.5
"49","49053",75471,66189,9282,12.3
"49","49055",1420,1192,228,16.1
"49","49057",129915,116043,13872,10.7
"50","50001",20688,17539,3149,15.2
"50","50003",18223,14785,3438,18.9
"50","50005",14567,11946,2621,18
"50","50007",95580,82194,13386,14
"50","50009",2798,2220,578,20.7
"50","50011",27439,23116,4323,15.8
"50","50013",4114,3406,708,17.2
"50","50015",15356,11450,3906,25.4
"50","50017",15987,13675,2312,14.5
"50","50019",14007,10650,3357,24
"50","50021",32122,25229,6893,21.5
"50","50023",35397,30073,5324,15
"50","50025",22532,18494,4038,17.9
"50","50027",29107,24647,4460,15.3
"51","51001",16475,14868,1607,9.8
"51","51003",56442,51319,5123,9.1
"51","51005",6982,6177,805,11.5
"51","51007",6018,5426,592,9.8
"51","51009",13968,12634,1334,9.6
"51","51011",6631,6006,625,9.4
"51","51013",147504,137176,10328,7
"51","51015",37857,34682,3175,8.4
"51","51017",2859,2274,585,20.5
"51","51019",35950,32390,3560,9.9
"51","51021",2873,2544,329,11.5
"51","51023",16497,15075,1422,8.6
"51","51025",5824,5219,605,10.4
"51","51027",6690,5747,943,14.1
"51","51029",6309,5662,647,10.3
"51","51031",24313,21843,2470,10.2
"51","51033",14812,13183,1629,11
"51","51035",14183,11897,2286,16.1
"51","51036",3527,3166,361,10.2
"51","51037",5113,4690,423,8.3
"51","51041",182290,162869,19421,10.7
"51","51043",7302,6705,597,8.2
"51","51045",2196,1975,221,10.1
"51","51047",23810,21646,2164,9.1
"51","51049",4535,4119,416,9.2
"51","51051",4836,4258,578,12
"51","51053",13032,11786,1246,9.6
"51","51057",5406,4805,601,11.1
"51","51059",625663,561807,63856,10.2
"51","51061",36071,32894,3177,8.8
"51","51063",7805,6942,863,11.1
"51","51065",13763,12498,1265,9.2
"51","51067",25141,22742,2399,9.5
"51","51069",46934,42469,4465,9.5
"51","51071",7621,6629,992,13
"51","51073",19040,17097,1943,10.2
"51","51075",10671,9718,953,8.9
"51","51077",8313,7414,899,10.8
"51","51079",10420,9417,1003,9.6
"51","51081",4149,3800,349,8.4
"51","51083",15483,13822,1661,10.7
"51","51085",56755,51634,5121,9
"51","51087",177712,158072,19640,11.1
"51","51089",24386,21257,3129,12.8
"51","51091",1145,1073,72,6.3
"51","51093",18494,16929,1565,8.5
"51","51095",36980,31916,5064,13.7
"51","51097",3722,3435,287,7.7
"51","51099",13136,12137,999,7.6
"51","51101",8793,7937,856,9.7
"51","51103",5458,4839,619,11.3
"51","51105",8315,7409,906,10.9
"51","51107",218667,197063,21604,9.9
"51","51109",19637,17885,1752,8.9
"51","51111",5127,4737,390,7.6
"51","51113",7171,6664,507,7.1
"51","51115",3956,3602,354,8.9
"51","51117",12254,10922,1332,10.9
"51","51119",5184,4719,465,9
"51","51121",46646,42297,4349,9.3
"51","51125",7341,6622,719,9.8
"51","51127",11939,10872,1067,8.9
"51","51131",5287,4676,611,11.6
"51","51133",5517,4984,533,9.7
"51","51135",7064,6535,529,7.5
"51","51137",17279,15583,1696,9.8
"51","51139",12337,10607,1730,14
"51","51141",7293,6263,1030,14.1
"51","51143",30341,26485,3856,12.7
"51","51145",13595,12293,1302,9.6
"51","51147",10388,9403,985,9.5
"51","51149",14481,13028,1453,10
"51","51153",244629,216922,27707,11.3
"51","51155",16248,13469,2779,17.1
"51","51157",3535,3240,295,8.3
"51","51159",4008,3717,291,7.3
"51","51161",47375,42719,4656,9.8
"51","51163",10796,9783,1013,9.4
"51","51165",40848,36892,3956,9.7
"51","51167",11237,10027,1210,10.8
"51","51169",8754,7894,860,9.8
"51","51171",22401,20263,2138,9.5
"51","51173",13601,12143,1458,10.7
"51","51175",8647,8054,593,6.9
"51","51177",66331,58981,7350,11.1
"51","51179",70547,63557,6990,9.9
"51","51181",3524,3198,326,9.3
"51","51183",3633,3258,375,10.3
"51","51185",15699,13733,1966,12.5
"51","51187",20191,17956,2235,11.1
"51","51191",25869,23086,2783,10.8
"51","51193",9468,8650,818,8.6
"51","51195",13586,11968,1618,11.9
"51","51197",14543,12040,2503,17.2
"51","51199",31930,28610,3320,10.4
"51","51510",99725,89845,9880,9.9
"51","51520",7284,6170,1114,15.3
"51","51530",3609,3295,314,8.7
"51","51540",26646,23778,2868,10.8
"51","51550",119075,106931,12144,10.2
"51","51570",8605,7612,993,11.5
"51","51580",2542,2135,407,16
"51","51590",19804,16643,3161,16
"51","51595",2304,2004,300,13
"51","51600",13244,11910,1334,10.1
"51","51610",8092,7621,471,5.8
"51","51620",3458,3126,332,9.6
"51","51630",14109,12401,1708,12.1
"51","51640",3150,2604,546,17.3
"51","51650",64147,55581,8566,13.4
"51","51660",24579,21834,2745,11.2
"51","51670",9710,8285,1425,14.7
"51","51678",2093,1877,216,10.3
"51","51680",34572,30372,4200,12.1
"51","51683",21846,19469,2377,10.9
"51","51685",9356,8271,1085,11.6
"51","51690",5839,4854,985,16.9
"51","51700",89403,76947,12456,13.9
"51","51710",111500,96715,14785,13.3
"51","51720",1717,1504,213,12.4
"51","51730",13189,10988,2201,16.7
"51","51735",6074,5588,486,8
"51","51740",43774,38171,5603,12.8
"51","51750",8185,7244,941,11.5
"51","51760",119111,102179,16932,14.2
"51","51770",48521,42319,6202,12.8
"51","51775",12564,11208,1356,10.8
"51","51790",12750,11314,1436,11.3
"51","51800",43002,38848,4154,9.7
"51","51810",231672,203317,28355,12.2
"51","51820",11118,9872,1246,11.2
"51","51830",6786,5765,1021,15
"51","51840",14653,13005,1648,11.2
"53","53001",9317,8521,796,8.5
"53","53003",9522,8697,825,8.7
"53","53005",105822,92330,13492,12.7
"53","53007",44088,37281,6807,15.4
"53","53009",30773,24942,5831,18.9
"53","53011",244084,210369,33715,13.8
"53","53013",1706,1528,178,10.4
"53","53015",48734,41066,7668,15.7
"53","53017",21123,18109,3014,14.3
"53","53019",2433,2055,378,15.5
"53","53021",44080,38519,5561,12.6
"53","53023",794,698,96,12.1
"53","53025",47607,41612,5995,12.6
"53","53027",31455,25367,6088,19.4
"53","53029",37892,32130,5762,15.2
"53","53031",14071,11639,2432,17.3
"53","53033",1252303,1066218,186085,14.9
"53","53035",131278,112827,18451,14.1
"53","53037",24591,20947,3644,14.8
"53","53039",10187,9023,1164,11.4
"53","53041",37334,31252,6082,16.3
"53","53043",4467,3995,472,10.6
"53","53045",27610,23151,4459,16.1
"53","53047",19376,16567,2809,14.5
"53","53049",9420,7823,1597,17
"53","53051",4846,4086,760,15.7
"53","53053",453208,370515,82693,18.2
"53","53055",8412,6956,1456,17.3
"53","53057",65337,52852,12485,19.1
"53","53059",5556,4756,800,14.4
"53","53061",453361,361978,91383,20.2
"53","53063",256263,215644,40619,15.9
"53","53065",18404,15496,2908,15.8
"53","53067",150129,127815,22314,14.9
"53","53069",1383,1200,183,13.2
"53","53071",30081,26752,3329,11.1
"53","53073",119559,99042,20517,17.2
"53","53075",22583,21086,1497,6.6
"53","53077",132966,114532,18434,13.9
"54","54001",6778,5820,958,14.1
"54","54003",54664,47976,6688,12.2
"54","54005",7431,5974,1457,19.6
"54","54007",4845,4020,825,17
"54","54009",9568,8010,1558,16.3
"54","54011",41690,34958,6732,16.1
"54","54013",2232,1706,526,23.6
"54","54015",3042,2446,596,19.6
"54","54017",3670,3283,387,10.5
"54","54019",16430,13345,3085,18.8
"54","54021",2315,1978,337,14.6
"54","54023",5564,4936,628,11.3
"54","54025",15105,12942,2163,14.3
"54","54027",10397,9371,1026,9.9
"54","54029",13152,10480,2672,20.3
"54","54031",5711,4983,728,12.7
"54","54033",34080,28849,5231,15.3
"54","54035",12497,10594,1903,15.2
"54","54037",28780,25465,3315,11.5
"54","54039",81185,66764,14421,17.8
"54","54041",6369,5203,1166,18.3
"54","54043",7193,5917,1276,17.7
"54","54045",11153,8568,2585,23.2
"54","54047",4332,3683,649,15
"54","54049",25119,20802,4317,17.2
"54","54051",13245,10934,2311,17.4
"54","54053",9922,8240,1682,17
"54","54055",21044,17527,3517,16.7
"54","54057",11897,10257,1640,13.8
"54","54059",6876,5176,1700,24.7
"54","54061",53851,47450,6401,11.9
"54","54063",5690,4932,758,13.3
"54","54065",7708,6655,1053,13.7
"54","54067",9123,7240,1883,20.6
"54","54069",20060,16691,3369,16.8
"54","54071",3528,3220,308,8.7
"54","54073",2868,2420,448,15.6
"54","54075",4020,3365,655,16.3
"54","54077",15542,13364,2178,14
"54","54079",26904,22484,4420,16.4
"54","54081",30897,25291,5606,18.1
"54","54083",12101,9820,2281,18.8
"54","54085",4232,3671,561,13.3
"54","54087",4803,3855,948,19.7
"54","54089",4065,3481,584,14.4
"54","54091",7341,6282,1059,14.4
"54","54093",3128,2546,582,18.6
"54","54095",2904,2469,435,15
"54","54097",9149,7598,1551,17
"54","54099",15508,13139,2369,15.3
"54","54101",3053,2594,459,15
"54","54103",6216,5275,941,15.1
"54","54105",2271,1906,365,16.1
"54","54107",37712,31360,6352,16.8
"54","54109",6197,5046,1151,18.6
"55","55001",8442,6591,1851,21.9
"55","55003",7996,6361,1635,20.4
"55","55005",24013,20213,3800,15.8
"55","55007",7997,6066,1931,24.1
"55","55009",139959,120576,19383,13.8
"55","55011",6839,5493,1346,19.7
"55","55013",7485,5726,1759,23.5
"55","55015",26975,23785,3190,11.8
"55","55017",31882,27397,4485,14.1
"55","55019",16991,15295,1696,10
"55","55021",30906,26289,4617,14.9
"55","55023",7752,6260,1492,19.2
"55","55025",301761,267811,33950,11.3
"55","55027",45846,40348,5498,12
"55","55029",14444,11558,2886,20
"55","55031",24873,19086,5787,23.3
"55","55033",22414,19654,2760,12.3
"55","55035",55954,48684,7270,13
"55","55037",2292,1862,430,18.8
"55","55039",58715,49155,9560,16.3
"55","55041",4001,3333,668,16.7
"55","55043",26236,23106,3130,11.9
"55","55045",20082,17680,2402,12
"55","55047",9663,7683,1980,20.5
"55","55049",14109,11607,2502,17.7
"55","55051",2809,2072,737,26.2
"55","55053",10690,8555,2135,20
"55","55055",44565,38868,5697,12.8
"55","55057",13567,11309,2258,16.6
"55","55059",90373,75831,14542,16.1
"55","55061",10601,9521,1080,10.2
"55","55063",65088,56588,8500,13.1
"55","55065",9675,8734,941,9.7
"55","55067",9089,7803,1286,14.1
"55","55069",14721,12617,2104,14.3
"55","55071",41162,34508,6654,16.2
"55","55073",71898,63042,8856,12.3
"55","55075",19826,16006,3820,19.3
"55","55077",7706,6442,1264,16.4
"55","55078",1783,1315,468,26.2
"55","55079",471243,396803,74440,15.8
"55","55081",22909,19907,3002,13.1
"55","55083",20745,17503,3242,15.6
"55","55085",17683,14130,3553,20.1
"55","55087",102855,88353,14502,14.1
"55","55089",48343,42202,6141,12.7
"55","55091",4087,3471,616,15.1
"55","55093",26147,21606,4541,17.4
"55","55095",24869,20462,4407,17.7
"55","55097",36006,31776,4230,11.7
"55","55099",6487,5383,1104,17
"55","55101",101440,85749,15691,15.5
"55","55103",8969,7809,1160,12.9
"55","55105",86565,71821,14744,17
"55","55107",6580,5581,999,15.2
"55","55109",52100,42818,9282,17.8
"55","55111",37330,29657,7673,20.6
"55","55113",8009,6335,1674,20.9
"55","55115",20963,17811,3152,15
"55","55117",62458,53118,9340,15
"55","55119",10442,9302,1140,10.9
"55","55121",16656,13468,3188,19.1
"55","55123",14837,13076,1761,11.9
"55","55125",10064,7909,2155,21.4
"55","55127",55614,47190,8424,15.1
"55","55129",7999,6476,1523,19
"55","55131",76896,66483,10413,13.5
"55","55133",220414,193064,27350,12.4
"55","55135",25322,21957,3365,13.3
"55","55137",11328,9581,1747,15.4
"55","55139",91430,78409,13021,14.2
"55","55141",34921,29540,5381,15.4
"56","56001",21227,20084,1143,5.4
"56","56003",5107,4768,339,6.6
"56","56005",23587,21190,2397,10.2
"56","56007",7536,7029,507,6.7
"56","56009",8782,8221,561,6.4
"56","56011",3560,3355,205,5.8
"56","56013",18930,17173,1757,9.3
"56","56015",6312,5923,389,6.2
"56","56017",2157,2008,149,6.9
"56","56019",4109,3706,403,9.8
"56","56021",50631,46103,4528,8.9
"56","56023",8846,8061,785,8.9
"56","56025",39924,34837,5087,12.7
"56","56027",1169,1117,52,4.4
"56","56029",14864,13456,1408,9.5
"56","56031",4621,4295,326,7.1
"56","56033",15770,14431,1339,8.5
"56","56035",4014,3559,455,11.3
"56","56037",21198,18978,2220,10.5
"56","56039",15531,12696,2835,18.3
"56","56041",8936,8104,832,9.3
"56","56043",3775,3496,279,7.4
"56","56045",3722,3511,211,5.7
"72","72001",NA,NA,NA,NA
"72","72003",NA,NA,NA,NA
"72","72005",NA,NA,NA,NA
"72","72007",NA,NA,NA,NA
"72","72009",NA,NA,NA,NA
"72","72011",NA,NA,NA,NA
"72","72013",NA,NA,NA,NA
"72","72015",NA,NA,NA,NA
"72","72017",NA,NA,NA,NA
"72","72019",NA,NA,NA,NA
"72","72021",NA,NA,NA,NA
"72","72023",NA,NA,NA,NA
"72","72025",NA,NA,NA,NA
"72","72027",NA,NA,NA,NA
"72","72029",NA,NA,NA,NA
"72","72031",NA,NA,NA,NA
"72","72033",NA,NA,NA,NA
"72","72035",NA,NA,NA,NA
"72","72037",NA,NA,NA,NA
"72","72039",NA,NA,NA,NA
"72","72041",NA,NA,NA,NA
"72","72043",NA,NA,NA,NA
"72","72045",NA,NA,NA,NA
"72","72047",NA,NA,NA,NA
"72","72049",NA,NA,NA,NA
"72","72051",NA,NA,NA,NA
"72","72053",NA,NA,NA,NA
"72","72054",NA,NA,NA,NA
"72","72055",NA,NA,NA,NA
"72","72057",NA,NA,NA,NA
"72","72059",NA,NA,NA,NA
"72","72061",NA,NA,NA,NA
"72","72063",NA,NA,NA,NA
"72","72065",NA,NA,NA,NA
"72","72067",NA,NA,NA,NA
"72","72069",NA,NA,NA,NA
"72","72071",NA,NA,NA,NA
"72","72073",NA,NA,NA,NA
"72","72075",NA,NA,NA,NA
"72","72077",NA,NA,NA,NA
"72","72079",NA,NA,NA,NA
"72","72081",NA,NA,NA,NA
"72","72083",NA,NA,NA,NA
"72","72085",NA,NA,NA,NA
"72","72087",NA,NA,NA,NA
"72","72089",NA,NA,NA,NA
"72","72091",NA,NA,NA,NA
"72","72093",NA,NA,NA,NA
"72","72095",NA,NA,NA,NA
"72","72097",NA,NA,NA,NA
"72","72099",NA,NA,NA,NA
"72","72101",NA,NA,NA,NA
"72","72103",NA,NA,NA,NA
"72","72105",NA,NA,NA,NA
"72","72107",NA,NA,NA,NA
"72","72109",NA,NA,NA,NA
"72","72111",NA,NA,NA,NA
"72","72113",NA,NA,NA,NA
"72","72115",NA,NA,NA,NA
"72","72117",NA,NA,NA,NA
"72","72119",NA,NA,NA,NA
"72","72121",NA,NA,NA,NA
"72","72123",NA,NA,NA,NA
"72","72125",NA,NA,NA,NA
"72","72127",NA,NA,NA,NA
"72","72129",NA,NA,NA,NA
"72","72131",NA,NA,NA,NA
"72","72133",NA,NA,NA,NA
"72","72135",NA,NA,NA,NA
"72","72137",NA,NA,NA,NA
"72","72139",NA,NA,NA,NA
"72","72141",NA,NA,NA,NA
"72","72143",NA,NA,NA,NA
"72","72145",NA,NA,NA,NA
"72","72147",NA,NA,NA,NA
"72","72149",NA,NA,NA,NA
"72","72151",NA,NA,NA,NA
"72","72153",NA,NA,NA,NA
